GEOID,year,force,employed,unemployed,rate
01001,2010,25713,23431,2282,8.9
01003,2010,83459,75120,8339,10
01005,2010,10221,8959,1262,12.3
01007,2010,8934,7914,1020,11.4
01009,2010,24906,22460,2446,9.8
01011,2010,4941,4356,585,11.8
01013,2010,9261,7998,1263,13.6
01015,2010,51559,45699,5860,11.4
01017,2010,14754,12554,2200,14.9
01019,2010,11464,10245,1219,10.6
01021,2010,19462,17464,1998,10.3
01023,2010,4860,4216,644,13.3
01025,2010,9108,7300,1808,19.9
01027,2010,5851,5005,846,14.5
01029,2010,6033,5429,604,10
01031,2010,21088,19271,1817,8.6
01033,2010,24228,21453,2775,11.5
01035,2010,4991,4131,860,17.2
01037,2010,4654,3937,717,15.4
01039,2010,16417,14721,1696,10.3
01041,2010,6285,5646,639,10.2
01043,2010,35959,32202,3757,10.4
01045,2010,22072,20124,1948,8.8
01047,2010,17808,14806,3002,16.9
01049,2010,30942,27026,3916,12.7
01051,2010,36683,33362,3321,9.1
01053,2010,15007,13238,1769,11.8
01055,2010,44000,39193,4807,10.9
01057,2010,6831,5942,889,13
01059,2010,14255,12724,1531,10.7
01061,2010,11559,10362,1197,10.4
01063,2010,3306,2735,571,17.3
01065,2010,6445,5473,972,15.1
01067,2010,7259,6469,790,10.9
01069,2010,46414,42170,4244,9.1
01071,2010,24348,21468,2880,11.8
01073,2010,318520,285627,32893,10.3
01075,2010,5802,5035,767,13.2
01077,2010,43596,39193,4403,10.1
01079,2010,14901,13024,1877,12.6
01081,2010,66764,60758,6006,9
01083,2010,38321,34625,3696,9.6
01085,2010,4350,3547,803,18.5
01087,2010,8937,7618,1319,14.8
01089,2010,169833,155656,14177,8.3
01091,2010,8136,7021,1115,13.7
01093,2010,13215,11423,1792,13.6
01095,2010,41637,37640,3997,9.6
01097,2010,192730,170943,21787,11.3
01099,2010,8712,7131,1581,18.1
01101,2010,108753,97892,10861,10
01103,2010,57817,51600,6217,10.8
01105,2010,3891,3236,655,16.8
01107,2010,7699,6687,1012,13.1
01109,2010,15677,14198,1479,9.4
01111,2010,9706,8410,1296,13.4
01113,2010,23814,21225,2589,10.9
01115,2010,38280,34397,3883,10.1
01117,2010,102372,95110,7262,7.1
01119,2010,5777,5006,771,13.3
01121,2010,35129,30389,4740,13.5
01123,2010,19079,16579,2500,13.1
01125,2010,93915,85273,8642,9.2
01127,2010,27279,23815,3464,12.7
01129,2010,7385,6335,1050,14.2
01131,2010,3066,2261,805,26.3
01133,2010,9883,8304,1579,16
02013,2010,2031,1917,114,5.6
02016,2010,3955,3755,200,5.1
02020,2010,157923,147539,10384,6.6
02050,2010,7161,6114,1047,14.6
02060,2010,505,456,49,9.7
02068,2010,1011,891,120,11.9
02070,2010,2089,1878,211,10.1
02090,2010,48285,45083,3202,6.6
02100,2010,1150,1028,122,10.6
02105,2010,1064,915,149,14
02110,2010,17903,16848,1055,5.9
02122,2010,27001,24310,2691,10
02130,2010,7123,6501,622,8.7
02150,2010,6470,5993,477,7.4
02158,2010,2658,2115,543,20.4
02164,2010,604,517,87,14.4
02170,2010,42314,38319,3995,9.4
02180,2010,4111,3595,516,12.6
02185,2010,3968,3649,319,8
02188,2010,2957,2560,397,13.4
02195,2010,1844,1698,146,7.9
02198,2010,2543,2276,267,10.5
02220,2010,4561,4274,287,6.3
02230,2010,718,614,104,14.5
02240,2010,3196,2816,380,11.9
02261,2010,4875,4419,456,9.4
02275,2010,1027,945,82,8
02282,2010,297,265,32,10.8
02290,2010,2567,2125,442,17.2
04001,2010,23438,19589,3849,16.4
04003,2010,57023,51694,5329,9.3
04005,2010,72846,65650,7196,9.9
04007,2010,21623,18914,2709,12.5
04009,2010,14570,12687,1883,12.9
04011,2010,3439,2875,564,16.4
04012,2010,7868,7063,805,10.2
04013,2010,1919590,1736764,182826,9.5
04015,2010,82726,71999,10727,13
04017,2010,43903,37450,6453,14.7
04019,2010,478743,434106,44637,9.3
04021,2010,153707,137242,16465,10.7
04023,2010,20881,17697,3184,15.2
04025,2010,96533,86224,10309,10.7
04027,2010,92816,69500,23316,25.1
05001,2010,11332,9224,2108,18.6
05003,2010,9745,8765,980,10.1
05005,2010,16610,15050,1560,9.4
05007,2010,107121,99999,7122,6.6
05009,2010,16519,15226,1293,7.8
05011,2010,5002,4462,540,10.8
05013,2010,2681,2445,236,8.8
05015,2010,12611,11686,925,7.3
05017,2010,4272,3745,527,12.3
05019,2010,10212,9337,875,8.6
05021,2010,7479,6659,820,11
05023,2010,10336,9444,892,8.6
05025,2010,3888,3562,326,8.4
05027,2010,10507,9458,1049,10
05029,2010,9029,8156,873,9.7
05031,2010,47796,44249,3547,7.4
05033,2010,28323,25996,2327,8.2
05035,2010,22819,20433,2386,10.5
05037,2010,8618,7903,715,8.3
05039,2010,3487,3057,430,12.3
05041,2010,5884,5229,655,11.1
05043,2010,8568,7633,935,10.9
05045,2010,58711,54465,4246,7.2
05047,2010,7800,7197,603,7.7
05049,2010,5172,4767,405,7.8
05051,2010,41563,38046,3517,8.5
05053,2010,8567,7960,607,7.1
05055,2010,19683,17768,1915,9.7
05057,2010,10674,9685,989,9.3
05059,2010,14188,12969,1219,8.6
05061,2010,6545,6037,508,7.8
05063,2010,17059,15559,1500,8.8
05065,2010,5139,4622,517,10.1
05067,2010,6734,5936,798,11.9
05069,2010,33973,30438,3535,10.4
05071,2010,10977,10072,905,8.2
05073,2010,3041,2741,300,9.9
05075,2010,7445,6737,708,9.5
05077,2010,3704,3387,317,8.6
05079,2010,4699,4258,441,9.4
05081,2010,6220,5738,482,7.7
05083,2010,9805,8964,841,8.6
05085,2010,33287,31036,2251,6.8
05087,2010,7270,6756,514,7.1
05089,2010,6716,6035,681,10.1
05091,2010,20560,19364,1196,5.8
05093,2010,20195,17667,2528,12.5
05095,2010,3413,3098,315,9.2
05097,2010,3904,3562,342,8.8
05099,2010,4016,3614,402,10
05101,2010,3790,3528,262,6.9
05103,2010,11294,10214,1080,9.6
05105,2010,4560,4154,406,8.9
05107,2010,8585,7681,904,10.5
05109,2010,4843,4400,443,9.1
05111,2010,10737,9736,1001,9.3
05113,2010,8981,8311,670,7.5
05115,2010,30054,27706,2348,7.8
05117,2010,3967,3602,365,9.2
05119,2010,189321,175512,13809,7.3
05121,2010,7260,6516,744,10.2
05123,2010,9830,8784,1046,10.6
05125,2010,53382,49824,3558,6.7
05127,2010,4721,4386,335,7.1
05129,2010,3393,3081,312,9.2
05131,2010,59543,54760,4783,8
05133,2010,7059,6563,496,7
05135,2010,6309,5690,619,9.8
05137,2010,5522,5103,419,7.6
05139,2010,17164,15222,1942,11.3
05141,2010,6476,5752,724,11.2
05143,2010,102865,96162,6703,6.5
05145,2010,36442,33437,3005,8.2
05147,2010,3630,3251,379,10.4
05149,2010,9714,8928,786,8.1
06001,2010,782522,697112,85410,10.9
06003,2010,542,472,70,12.9
06005,2010,15507,13326,2181,14.1
06007,2010,102568,88322,14246,13.9
06009,2010,21012,17977,3035,14.4
06011,2010,11519,9118,2401,20.8
06013,2010,525547,467914,57633,11
06015,2010,10931,9489,1442,13.2
06017,2010,91129,80002,11127,12.2
06019,2010,439593,366221,73372,16.7
06021,2010,13218,11180,2038,15.4
06023,2010,66061,59084,6977,10.6
06025,2010,78665,55978,22687,28.8
06027,2010,9753,8806,947,9.7
06029,2010,371515,313361,58154,15.7
06031,2010,59440,49857,9583,16.1
06033,2010,29847,25343,4504,15.1
06035,2010,12100,10401,1699,14
06037,2010,4917375,4302274,615101,12.5
06039,2010,61607,51366,10241,16.6
06041,2010,133012,122570,10442,7.9
06043,2010,8709,7582,1127,12.9
06045,2010,41601,36772,4829,11.6
06047,2010,113579,93191,20388,18
06049,2010,3818,3237,581,15.2
06051,2010,8890,7984,906,10.2
06053,2010,215788,188339,27449,12.7
06055,2010,70216,62989,7227,10.3
06057,2010,48915,43178,5737,11.7
06059,2010,1537187,1387438,149749,9.7
06061,2010,173338,153236,20102,11.6
06063,2010,9147,7479,1668,18.2
06065,2010,976444,841285,135159,13.8
06067,2010,683127,596992,86135,12.6
06069,2010,27906,23691,4215,15.1
06071,2010,890278,769890,120388,13.5
06073,2010,1515198,1352266,162932,10.8
06075,2010,486019,442695,43324,8.9
06077,2010,311437,259995,51442,16.5
06079,2010,133651,120209,13442,10.1
06081,2010,393004,360163,32841,8.4
06083,2010,212267,191680,20587,9.7
06085,2010,926525,830114,96411,10.4
06087,2010,141717,122872,18845,13.3
06089,2010,78503,65334,13169,16.8
06091,2010,1611,1364,247,15.3
06093,2010,19628,16325,3303,16.8
06095,2010,202407,176969,25438,12.6
06097,2010,244634,218100,26534,10.8
06099,2010,243274,202182,41092,16.9
06101,2010,45965,37528,8437,18.4
06103,2010,25714,21754,3960,15.4
06105,2010,5423,4501,922,17
06107,2010,203021,168110,34911,17.2
06109,2010,22617,19173,3444,15.2
06111,2010,430010,383424,46586,10.8
06113,2010,102188,89834,12354,12.1
06115,2010,29064,23902,5162,17.8
08001,2010,234221,210728,23493,10
08003,2010,7702,7010,692,9
08005,2010,316886,289715,27171,8.6
08007,2010,5785,5169,616,10.6
08009,2010,2084,1982,102,4.9
08011,2010,2006,1843,163,8.1
08013,2010,170293,158308,11985,7
08014,2010,31538,29198,2340,7.4
08015,2010,8270,7634,636,7.7
08017,2010,1047,1004,43,4.1
08019,2010,5623,5167,456,8.1
08021,2010,3753,3394,359,9.6
08023,2010,1553,1388,165,10.6
08025,2010,1522,1383,139,9.1
08027,2010,2078,1940,138,6.6
08029,2010,14510,12961,1549,10.7
08031,2010,347590,315922,31668,9.1
08033,2010,1000,823,177,17.7
08035,2010,157522,146562,10960,7
08037,2010,32447,29697,2750,8.5
08039,2010,12755,11727,1028,8.1
08041,2010,306308,277678,28630,9.3
08043,2010,15825,13973,1852,11.7
08045,2010,31357,28115,3242,10.3
08047,2010,3327,3060,267,8
08049,2010,8950,8165,785,8.8
08051,2010,10087,9439,648,6.4
08053,2010,470,443,27,5.7
08055,2010,2705,2327,378,14
08057,2010,919,838,81,8.8
08059,2010,304252,278790,25462,8.4
08061,2010,779,729,50,6.4
08063,2010,4389,4190,199,4.5
08065,2010,4372,3891,481,11
08067,2010,29874,27744,2130,7.1
08069,2010,170001,157025,12976,7.6
08071,2010,7195,6432,763,10.6
08073,2010,2153,2024,129,6
08075,2010,11261,10551,710,6.3
08077,2010,76113,67776,8337,11
08079,2010,416,387,29,7
08081,2010,8078,7277,801,9.9
08083,2010,13057,11867,1190,9.1
08085,2010,20624,18360,2264,11
08087,2010,14436,13423,1013,7
08089,2010,8489,7710,779,9.2
08091,2010,2151,1940,211,9.8
08093,2010,9641,8856,785,8.1
08095,2010,2197,2081,116,5.3
08097,2010,10879,10000,879,8.1
08099,2010,6166,5736,430,7
08101,2010,74396,66667,7729,10.4
08103,2010,3146,2866,280,8.9
08105,2010,5209,4655,554,10.6
08107,2010,14541,13192,1349,9.3
08109,2010,3066,2755,311,10.1
08111,2010,505,442,63,12.5
08113,2010,4892,4508,384,7.8
08115,2010,1101,1019,82,7.4
08117,2010,19126,17837,1289,6.7
08119,2010,12354,11198,1156,9.4
08121,2010,2590,2437,153,5.9
08123,2010,131910,119796,12114,9.2
08125,2010,4928,4651,277,5.6
09001,2010,473386,433561,39825,8.4
09003,2010,479963,434736,45227,9.4
09005,2010,108434,98974,9460,8.7
09007,2010,93292,85940,7352,7.9
09009,2010,461566,415404,46162,10
09011,2010,143924,131073,12851,8.9
09013,2010,86492,79750,6742,7.8
09015,2010,64653,58010,6643,10.3
10001,2010,72711,66250,6461,8.9
10003,2010,271575,249148,22427,8.3
10005,2010,90133,82471,7662,8.5
11001,2010,346065,313508,32557,9.4
12001,2010,128370,118072,10298,8
12003,2010,11552,10246,1306,11.3
12005,2010,86072,77054,9018,10.5
12007,2010,11587,10444,1143,9.9
12009,2010,265643,235757,29886,11.3
12011,2010,936563,841473,95090,10.2
12013,2010,5314,4777,537,10.1
12015,2010,66293,57846,8447,12.7
12017,2010,52847,45594,7253,13.7
12019,2010,95867,86356,9511,9.9
12021,2010,145349,128427,16922,11.6
12023,2010,28788,25669,3119,10.8
12027,2010,13081,11481,1600,12.2
12029,2010,5749,5008,741,12.9
12031,2010,454798,403171,51627,11.4
12033,2010,139913,125755,14158,10.1
12035,2010,41338,36208,5130,12.4
12037,2010,4936,4543,393,8
12039,2010,20080,17714,2366,11.8
12041,2010,6874,6132,742,10.8
12043,2010,5544,5017,527,9.5
12045,2010,6232,5591,641,10.3
12047,2010,4808,4258,550,11.4
12049,2010,11764,10410,1354,11.5
12051,2010,18361,15786,2575,14
12053,2010,66470,57464,9006,13.5
12055,2010,37247,32587,4660,12.5
12057,2010,645687,576400,69287,10.7
12059,2010,7190,6445,745,10.4
12061,2010,61384,52848,8536,13.9
12063,2010,18938,17214,1724,9.1
12065,2010,6042,5443,599,9.9
12067,2010,3404,3156,248,7.3
12069,2010,134021,118246,15775,11.8
12071,2010,283236,247790,35446,12.5
12073,2010,149972,138074,11898,7.9
12075,2010,17327,15262,2065,11.9
12077,2010,2933,2676,257,8.8
12079,2010,7946,7148,798,10
12081,2010,147572,130750,16822,11.4
12083,2010,132351,114297,18054,13.6
12085,2010,66636,59472,7164,10.8
12086,2010,1225397,1089226,136171,11.1
12087,2010,42182,38904,3278,7.8
12089,2010,35799,31995,3804,10.6
12091,2010,89046,81547,7499,8.4
12093,2010,18103,15816,2287,12.6
12095,2010,635299,566478,68821,10.8
12097,2010,137372,120253,17119,12.5
12099,2010,645737,574890,70847,11
12101,2010,207364,182593,24771,11.9
12103,2010,465178,414856,50322,10.8
12105,2010,278479,244668,33811,12.1
12107,2010,30518,26434,4084,13.4
12109,2010,99104,90440,8664,8.7
12111,2010,128690,110976,17714,13.8
12113,2010,71333,64713,6620,9.3
12115,2010,167222,147825,19397,11.6
12117,2010,230697,206168,24529,10.6
12119,2010,25310,21955,3355,13.3
12121,2010,19153,17267,1886,9.8
12123,2010,9473,8471,1002,10.6
12125,2010,5479,5013,466,8.5
12127,2010,238183,208987,29196,12.3
12129,2010,14589,13368,1221,8.4
12131,2010,25984,23547,2437,9.4
12133,2010,10298,9210,1088,10.6
13001,2010,8746,7710,1036,11.8
13003,2010,3451,2925,526,15.2
13005,2010,4542,4059,483,10.6
13007,2010,1232,1083,149,12.1
13009,2010,19192,16243,2949,15.4
13011,2010,8457,7640,817,9.7
13013,2010,34670,30939,3731,10.8
13015,2010,47837,42007,5830,12.2
13017,2010,6516,5481,1035,15.9
13019,2010,7990,6951,1039,13
13021,2010,70225,62053,8172,11.6
13023,2010,5474,4792,682,12.5
13025,2010,7468,6516,952,12.7
13027,2010,7309,6605,704,9.6
13029,2010,14455,13070,1385,9.6
13031,2010,33132,29802,3330,10.1
13033,2010,9791,8601,1190,12.2
13035,2010,10491,9288,1203,11.5
13037,2010,2620,2390,230,8.8
13039,2010,20695,18643,2052,9.9
13043,2010,4917,4482,435,8.8
13045,2010,51817,45762,6055,11.7
13047,2010,31351,28665,2686,8.6
13049,2010,4797,4288,509,10.6
13051,2010,127323,114777,12546,9.9
13053,2010,2218,1976,242,10.9
13055,2010,10671,9425,1246,11.7
13057,2010,112578,102687,9891,8.8
13059,2010,56637,51361,5276,9.3
13061,2010,1101,973,128,11.6
13063,2010,125156,108243,16913,13.5
13065,2010,2900,2579,321,11.1
13067,2010,380297,344871,35426,9.3
13069,2010,17202,14484,2718,15.8
13071,2010,21316,19247,2069,9.7
13073,2010,61522,57027,4495,7.3
13075,2010,7885,6966,919,11.7
13077,2010,64319,58095,6224,9.7
13079,2010,5769,5109,660,11.4
13081,2010,9208,7901,1307,14.2
13083,2010,8348,7624,724,8.7
13085,2010,10966,9771,1195,10.9
13087,2010,12446,10897,1549,12.4
13089,2010,363001,323687,39314,10.8
13091,2010,8361,7271,1090,13
13093,2010,4960,4386,574,11.6
13095,2010,41490,36281,5209,12.6
13097,2010,66575,59108,7467,11.2
13099,2010,4478,3953,525,11.7
13101,2010,1876,1722,154,8.2
13103,2010,25777,23310,2467,9.6
13105,2010,8934,7605,1329,14.9
13107,2010,9118,7946,1172,12.9
13109,2010,4769,4336,433,9.1
13111,2010,10271,9070,1201,11.7
13113,2010,52927,48564,4363,8.2
13115,2010,45087,39750,5337,11.8
13117,2010,88343,81251,7092,8
13119,2010,9698,8468,1230,12.7
13121,2010,485002,434315,50687,10.5
13123,2010,12811,11366,1445,11.3
13125,2010,1324,1178,146,11
13127,2010,38340,34508,3832,10
13129,2010,26068,22749,3319,12.7
13131,2010,10399,9309,1090,10.5
13133,2010,6412,5567,845,13.2
13135,2010,418368,379794,38574,9.2
13137,2010,18347,16390,1957,10.7
13139,2010,86546,78205,8341,9.6
13141,2010,3104,2393,711,22.9
13143,2010,12385,10866,1519,12.3
13145,2010,16415,15149,1266,7.7
13147,2010,10959,9697,1262,11.5
13149,2010,5249,4615,634,12.1
13151,2010,101141,90686,10455,10.3
13153,2010,67099,61422,5677,8.5
13155,2010,3674,3135,539,14.7
13157,2010,28656,25660,2996,10.5
13159,2010,6873,6069,804,11.7
13161,2010,6372,5557,815,12.8
13163,2010,7158,6151,1007,14.1
13165,2010,3229,2738,491,15.2
13167,2010,4240,3781,459,10.8
13169,2010,13698,12366,1332,9.7
13171,2010,8160,6998,1162,14.2
13173,2010,3872,3464,408,10.5
13175,2010,20599,17879,2720,13.2
13177,2010,14345,13047,1298,9
13179,2010,26927,24493,2434,9
13181,2010,3679,3256,423,11.5
13183,2010,6231,5706,525,8.4
13185,2010,51019,46120,4899,9.6
13187,2010,14711,13184,1527,10.4
13189,2010,9447,8204,1243,13.2
13191,2010,6289,5625,664,10.6
13193,2010,5383,4672,711,13.2
13195,2010,13374,11984,1390,10.4
13197,2010,3723,3326,397,10.7
13199,2010,9336,8054,1282,13.7
13201,2010,2803,2512,291,10.4
13205,2010,9646,8602,1044,10.8
13207,2010,12551,11273,1278,10.2
13209,2010,3876,3411,465,12
13211,2010,8630,7729,901,10.4
13213,2010,17181,14812,2369,13.8
13215,2010,81718,73484,8234,10.1
13217,2010,47977,41899,6078,12.7
13219,2010,16837,15635,1202,7.1
13221,2010,7079,6396,683,9.6
13223,2010,73735,66352,7383,10
13225,2010,12918,11359,1559,12.1
13227,2010,14045,12505,1540,11
13229,2010,8245,7387,858,10.4
13231,2010,8505,7599,906,10.7
13233,2010,18690,16444,2246,12
13235,2010,4530,4112,418,9.2
13237,2010,9053,7883,1170,12.9
13239,2010,1006,905,101,10
13241,2010,7141,6298,843,11.8
13243,2010,2979,2616,363,12.2
13245,2010,87887,78209,9678,11
13247,2010,41960,37210,4750,11.3
13249,2010,2165,1903,262,12.1
13251,2010,5804,4818,986,17
13253,2010,3383,2959,424,12.5
13255,2010,28669,24409,4260,14.9
13257,2010,11892,10429,1463,12.3
13259,2010,2402,2154,248,10.3
13261,2010,14262,12370,1892,13.3
13263,2010,2875,2585,290,10.1
13265,2010,634,520,114,18
13267,2010,9678,8802,876,9.1
13269,2010,3255,2784,471,14.5
13271,2010,5234,4462,772,14.7
13273,2010,3917,3439,478,12.2
13275,2010,17884,15874,2010,11.2
13277,2010,18784,16537,2247,12
13279,2010,12303,10792,1511,12.3
13281,2010,4341,3783,558,12.9
13283,2010,2945,2589,356,12.1
13285,2010,32546,28788,3758,11.5
13287,2010,3530,2944,586,16.6
13289,2010,3265,2760,505,15.5
13291,2010,9502,8456,1046,11
13293,2010,11932,10471,1461,12.2
13295,2010,30980,27788,3192,10.3
13297,2010,41037,36667,4370,10.6
13299,2010,15561,13847,1714,11
13301,2010,2657,2200,457,17.2
13303,2010,8124,6943,1181,14.5
13305,2010,12377,10886,1491,12
13307,2010,1043,909,134,12.8
13309,2010,1937,1644,293,15.1
13311,2010,12902,11589,1313,10.2
13313,2010,47639,41978,5661,11.9
13315,2010,2935,2570,365,12.4
13317,2010,4017,3486,531,13.2
13319,2010,3842,3303,539,14
13321,2010,9781,8597,1184,12.1
15001,2010,87774,79112,8662,9.9
15003,2010,446189,419631,26558,6
15007,2010,34321,31317,3004,8.8
15009,2010,78966,72223,6743,8.5
16001,2010,196945,180585,16360,8.3
16003,2010,1861,1516,345,18.5
16005,2010,41095,37813,3282,8
16007,2010,2884,2670,214,7.4
16009,2010,4209,3636,573,13.6
16011,2010,22848,21201,1647,7.2
16013,2010,11949,10808,1141,9.5
16015,2010,3048,2726,322,10.6
16017,2010,19497,16981,2516,12.9
16019,2010,49099,45683,3416,7
16021,2010,5368,4648,720,13.4
16023,2010,1352,1254,98,7.2
16025,2010,643,561,82,12.8
16027,2010,84738,75198,9540,11.3
16029,2010,3841,3541,300,7.8
16031,2010,11114,10327,787,7.1
16033,2010,537,487,50,9.3
16035,2010,3423,2922,501,14.6
16037,2010,2295,2107,188,8.2
16039,2010,11395,10411,984,8.6
16041,2010,6195,5868,327,5.3
16043,2010,6746,6162,584,8.7
16045,2010,7681,6803,878,11.4
16047,2010,8496,7862,634,7.5
16049,2010,6654,5824,830,12.5
16051,2010,12611,11721,890,7.1
16053,2010,11005,10119,886,8.1
16055,2010,68859,61345,7514,10.9
16057,2010,19282,18002,1280,6.6
16059,2010,3775,3390,385,10.2
16061,2010,1571,1466,105,6.7
16063,2010,2709,2355,354,13.1
16065,2010,17485,16546,939,5.4
16067,2010,10468,9691,777,7.4
16069,2010,20088,18744,1344,6.7
16071,2010,2007,1886,121,6
16073,2010,5051,4839,212,4.2
16075,2010,11145,10067,1078,9.7
16077,2010,3872,3515,357,9.2
16079,2010,5488,4615,873,15.9
16081,2010,5447,5019,428,7.9
16083,2010,36865,33718,3147,8.5
16085,2010,4693,3957,736,15.7
16087,2010,4726,4238,488,10.3
17001,2010,34905,32208,2697,7.7
17003,2010,2971,2622,349,11.7
17005,2010,8535,7678,857,10
17007,2010,27437,23648,3789,13.8
17009,2010,2586,2406,180,7
17011,2010,19167,17097,2070,10.8
17013,2010,2499,2248,251,10
17015,2010,8544,7654,890,10.4
17017,2010,7011,6430,581,8.3
17019,2010,108977,100035,8942,8.2
17021,2010,17211,15469,1742,10.1
17023,2010,8321,7348,973,11.7
17025,2010,6826,6054,772,11.3
17027,2010,20550,19051,1499,7.3
17029,2010,25672,23153,2519,9.8
17031,2010,2643831,2356470,287361,10.9
17033,2010,10388,9500,888,8.5
17035,2010,6069,5512,557,9.2
17037,2010,56390,50461,5929,10.5
17039,2010,8811,8044,767,8.7
17041,2010,10339,9433,906,8.8
17043,2010,502807,458264,44543,8.9
17045,2010,9465,8405,1060,11.2
17047,2010,3230,2948,282,8.7
17049,2010,18666,17194,1472,7.9
17051,2010,11242,10110,1132,10.1
17053,2010,7292,6603,689,9.4
17055,2010,18004,15783,2221,12.3
17057,2010,17592,15534,2058,11.7
17059,2010,2637,2384,253,9.6
17061,2010,6816,6183,633,9.3
17063,2010,25953,22505,3448,13.3
17065,2010,4014,3636,378,9.4
17067,2010,9959,8906,1053,10.6
17069,2010,1795,1601,194,10.8
17071,2010,3930,3564,366,9.3
17073,2010,26795,24358,2437,9.1
17075,2010,16043,14427,1616,10.1
17077,2010,29861,27403,2458,8.2
17079,2010,5100,4646,454,8.9
17081,2010,18234,16373,1861,10.2
17083,2010,11612,10549,1063,9.2
17085,2010,12451,11343,1108,8.9
17087,2010,4454,3898,556,12.5
17089,2010,267247,237779,29468,11
17091,2010,57060,49991,7069,12.4
17093,2010,62411,56086,6325,10.1
17095,2010,25352,22930,2422,9.6
17097,2010,370042,333639,36403,9.8
17099,2010,61858,54430,7428,12
17101,2010,6706,5987,719,10.7
17103,2010,19238,17310,1928,10
17105,2010,19315,17389,1926,10
17107,2010,13958,12747,1211,8.7
17109,2010,15645,14310,1335,8.5
17111,2010,168798,151014,17784,10.5
17113,2010,96138,89351,6787,7.1
17115,2010,55193,49031,6162,11.2
17117,2010,24782,22228,2554,10.3
17119,2010,138764,125134,13630,9.8
17121,2010,19395,17296,2099,10.8
17123,2010,6427,5768,659,10.3
17125,2010,7432,6524,908,12.2
17127,2010,7072,6401,671,9.5
17129,2010,7150,6612,538,7.5
17131,2010,8980,8087,893,9.9
17133,2010,18008,16693,1315,7.3
17135,2010,13902,12194,1708,12.3
17137,2010,18415,16864,1551,8.4
17139,2010,7678,7022,656,8.5
17141,2010,28215,24709,3506,12.4
17143,2010,96018,85933,10085,10.5
17145,2010,9593,8534,1059,11
17147,2010,9176,8457,719,7.8
17149,2010,8126,7398,728,9
17151,2010,2031,1839,192,9.5
17153,2010,2480,2172,308,12.4
17155,2010,3311,2913,398,12
17157,2010,15026,13708,1318,8.8
17159,2010,8016,7301,715,8.9
17161,2010,76522,69244,7278,9.5
17163,2010,133097,119414,13683,10.3
17165,2010,11634,10449,1185,10.2
17167,2010,108716,100303,8413,7.7
17169,2010,3865,3546,319,8.3
17171,2010,2885,2634,251,8.7
17173,2010,11207,10117,1090,9.7
17175,2010,3029,2734,295,9.7
17177,2010,24685,21955,2730,11.1
17179,2010,71668,64562,7106,9.9
17181,2010,7971,7017,954,12
17183,2010,37958,33617,4341,11.4
17185,2010,5863,5290,573,9.8
17187,2010,9298,8576,722,7.8
17189,2010,8498,7882,616,7.2
17191,2010,8397,7649,748,8.9
17193,2010,7583,6939,644,8.5
17195,2010,29905,26821,3084,10.3
17197,2010,355646,316212,39434,11.1
17199,2010,32530,29372,3158,9.7
17201,2010,150082,129018,21064,14
17203,2010,20339,18779,1560,7.7
18001,2010,16398,14744,1654,10.1
18003,2010,175942,157113,18829,10.7
18005,2010,38387,34727,3660,9.5
18007,2010,4662,4232,430,9.2
18009,2010,5847,5007,840,14.4
18011,2010,29394,27162,2232,7.6
18013,2010,7566,6781,785,10.4
18015,2010,10254,9239,1015,9.9
18017,2010,18851,16810,2041,10.8
18019,2010,55317,50043,5274,9.5
18021,2010,13180,11712,1468,11.1
18023,2010,16899,15185,1714,10.1
18025,2010,4919,4283,636,12.9
18027,2010,14747,13790,957,6.5
18029,2010,25524,22752,2772,10.9
18031,2010,12919,11415,1504,11.6
18033,2010,20595,18138,2457,11.9
18035,2010,54724,48402,6322,11.6
18037,2010,21927,20285,1642,7.5
18039,2010,94498,81899,12599,13.3
18041,2010,9770,8342,1428,14.6
18043,2010,37858,34505,3353,8.9
18045,2010,8608,7593,1015,11.8
18047,2010,11395,10088,1307,11.5
18049,2010,10284,9109,1175,11.4
18051,2010,16897,15543,1354,8
18053,2010,33554,29667,3887,11.6
18055,2010,14390,12856,1534,10.7
18057,2010,144861,135158,9703,6.7
18059,2010,35809,32491,3318,9.3
18061,2010,18989,17118,1871,9.9
18063,2010,74718,68852,5866,7.9
18065,2010,21391,18426,2965,13.9
18067,2010,35806,31300,4506,12.6
18069,2010,19039,16774,2265,11.9
18071,2010,20476,18323,2153,10.5
18073,2010,16141,14456,1685,10.4
18075,2010,10627,9494,1133,10.7
18077,2010,15464,13709,1755,11.3
18079,2010,13303,11581,1722,12.9
18081,2010,71598,65283,6315,8.8
18083,2010,18520,17006,1514,8.2
18085,2010,39226,34899,4327,11
18087,2010,16570,14574,1996,12
18089,2010,229142,204408,24734,10.8
18091,2010,51336,45158,6178,12
18093,2010,20728,18100,2628,12.7
18095,2010,59406,52242,7164,12.1
18097,2010,452835,405070,47765,10.5
18099,2010,23476,20823,2653,11.3
18101,2010,5262,4865,397,7.5
18103,2010,15947,13956,1991,12.5
18105,2010,67736,62375,5361,7.9
18107,2010,18896,16970,1926,10.2
18109,2010,35025,31393,3632,10.4
18111,2010,7075,6272,803,11.3
18113,2010,23011,19984,3027,13.2
18115,2010,3263,2902,361,11.1
18117,2010,9110,7948,1162,12.8
18119,2010,10316,9126,1190,11.5
18121,2010,7332,6530,802,10.9
18123,2010,8931,7987,944,10.6
18125,2010,6199,5611,588,9.5
18127,2010,81607,73876,7731,9.5
18129,2010,13494,12440,1054,7.8
18131,2010,6370,5736,634,10
18133,2010,16674,14732,1942,11.6
18135,2010,13019,11486,1533,11.8
18137,2010,14527,12898,1629,11.2
18139,2010,8683,7716,967,11.1
18141,2010,130462,115384,15078,11.6
18143,2010,10590,9195,1395,13.2
18145,2010,22714,20223,2491,11
18147,2010,10996,10030,966,8.8
18149,2010,10444,9052,1392,13.3
18151,2010,18438,16385,2053,11.1
18153,2010,9085,8170,915,10.1
18155,2010,5025,4558,467,9.3
18157,2010,86530,78863,7667,8.9
18159,2010,8046,7221,825,10.3
18161,2010,3729,3346,383,10.3
18163,2010,92127,83894,8233,8.9
18165,2010,7810,6799,1011,12.9
18167,2010,51128,45401,5727,11.2
18169,2010,15955,14133,1822,11.4
18171,2010,4201,3758,443,10.5
18173,2010,30817,28345,2472,8
18175,2010,13806,12118,1688,12.2
18177,2010,31330,27310,4020,12.8
18179,2010,14137,12757,1380,9.8
18181,2010,12975,11613,1362,10.5
18183,2010,17603,15579,2024,11.5
19001,2010,4104,3877,227,5.5
19003,2010,2240,2132,108,4.8
19005,2010,7916,7296,620,7.8
19007,2010,6199,5748,451,7.3
19009,2010,3478,3284,194,5.6
19011,2010,14329,13442,887,6.2
19013,2010,70978,66590,4388,6.2
19015,2010,14843,13995,848,5.7
19017,2010,13861,13182,679,4.9
19019,2010,11349,10670,679,6
19021,2010,11420,10880,540,4.7
19023,2010,8198,7702,496,6.1
19025,2010,4655,4375,280,6
19027,2010,11712,11207,505,4.3
19029,2010,7409,6945,464,6.3
19031,2010,10987,10395,592,5.4
19033,2010,24561,22880,1681,6.8
19035,2010,7087,6768,319,4.5
19037,2010,6554,6069,485,7.4
19039,2010,4784,4417,367,7.7
19041,2010,9346,8798,548,5.9
19043,2010,10481,9736,745,7.1
19045,2010,26447,24589,1858,7
19047,2010,8981,8560,421,4.7
19049,2010,37290,35590,1700,4.6
19051,2010,4253,3950,303,7.1
19053,2010,4465,4194,271,6.1
19055,2010,10360,9733,627,6.1
19057,2010,20211,18707,1504,7.4
19059,2010,9296,8665,631,6.8
19061,2010,54215,51079,3136,5.8
19063,2010,5868,5456,412,7
19065,2010,11013,10226,787,7.1
19067,2010,8548,7929,619,7.2
19069,2010,6026,5650,376,6.2
19071,2010,3978,3743,235,5.9
19073,2010,5201,4895,306,5.9
19075,2010,6754,6370,384,5.7
19077,2010,5851,5473,378,6.5
19079,2010,8082,7494,588,7.3
19081,2010,6069,5666,403,6.6
19083,2010,9131,8536,595,6.5
19085,2010,7999,7553,446,5.6
19087,2010,9958,9132,826,8.3
19089,2010,5338,5002,336,6.3
19091,2010,5226,4956,270,5.2
19093,2010,3846,3650,196,5.1
19095,2010,9659,9128,531,5.5
19097,2010,11104,10310,794,7.2
19099,2010,19022,17633,1389,7.3
19101,2010,8954,8319,635,7.1
19103,2010,79254,75904,3350,4.2
19105,2010,11106,10400,706,6.4
19107,2010,5547,5185,362,6.5
19109,2010,8380,7954,426,5.1
19111,2010,17739,16165,1574,8.9
19113,2010,120103,112921,7182,6
19115,2010,5963,5530,433,7.3
19117,2010,4232,3973,259,6.1
19119,2010,6404,6157,247,3.9
19121,2010,8459,7916,543,6.4
19123,2010,11913,11112,801,6.7
19125,2010,17597,16554,1043,5.9
19127,2010,20153,18775,1378,6.8
19129,2010,7609,7210,399,5.2
19131,2010,5733,5436,297,5.2
19133,2010,4886,4534,352,7.2
19135,2010,4096,3800,296,7.2
19137,2010,5248,4825,423,8.1
19139,2010,21811,20070,1741,8
19141,2010,8145,7766,379,4.7
19143,2010,3669,3488,181,4.9
19145,2010,7130,6647,483,6.8
19147,2010,4844,4552,292,6
19149,2010,14566,13914,652,4.5
19151,2010,4056,3849,207,5.1
19153,2010,244906,230305,14601,6
19155,2010,50336,47429,2907,5.8
19157,2010,10568,9956,612,5.8
19159,2010,2615,2492,123,4.7
19161,2010,5715,5448,267,4.7
19163,2010,87133,81354,5779,6.6
19165,2010,6611,6311,300,4.5
19167,2010,19668,18897,771,3.9
19169,2010,53335,51095,2240,4.2
19171,2010,9356,8754,602,6.4
19173,2010,3188,3011,177,5.6
19175,2010,7018,6622,396,5.6
19177,2010,3970,3681,289,7.3
19179,2010,18504,17050,1454,7.9
19181,2010,26352,24866,1486,5.6
19183,2010,12420,11787,633,5.1
19185,2010,2876,2699,177,6.2
19187,2010,20142,18745,1397,6.9
19189,2010,5819,5430,389,6.7
19191,2010,12293,11614,679,5.5
19193,2010,55988,52304,3684,6.6
19195,2010,4342,4027,315,7.3
19197,2010,6856,6365,491,7.2
20001,2010,7010,6429,581,8.3
20003,2010,4572,4220,352,7.7
20005,2010,7938,7154,784,9.9
20007,2010,2769,2644,125,4.5
20009,2010,15001,14100,901,6
20011,2010,7223,6572,651,9
20013,2010,5266,4917,349,6.6
20015,2010,33009,30447,2562,7.8
20017,2010,1442,1361,81,5.6
20019,2010,1740,1583,157,9
20021,2010,10798,9817,981,9.1
20023,2010,1405,1348,57,4.1
20025,2010,1223,1169,54,4.4
20027,2010,4631,4374,257,5.5
20029,2010,4654,4392,262,5.6
20031,2010,4847,4479,368,7.6
20033,2010,994,949,45,4.5
20035,2010,17259,15906,1353,7.8
20037,2010,19356,17672,1684,8.7
20039,2010,1457,1384,73,5
20041,2010,10234,9557,677,6.6
20043,2010,4540,4139,401,8.8
20045,2010,64379,60574,3805,5.9
20047,2010,1683,1593,90,5.3
20049,2010,1414,1296,118,8.3
20051,2010,17642,16946,696,3.9
20053,2010,3395,3235,160,4.7
20055,2010,20174,19255,919,4.6
20057,2010,18114,17361,753,4.2
20059,2010,14363,13070,1293,9
20061,2010,13359,12136,1223,9.2
20063,2010,1505,1454,51,3.4
20065,2010,1389,1323,66,4.8
20067,2010,4202,4021,181,4.3
20069,2010,3489,3376,113,3.2
20071,2010,827,799,28,3.4
20073,2010,3441,3181,260,7.6
20075,2010,1825,1768,57,3.1
20077,2010,2937,2753,184,6.3
20079,2010,17774,16497,1277,7.2
20081,2010,2445,2357,88,3.6
20083,2010,1085,1045,40,3.7
20085,2010,7509,7046,463,6.2
20087,2010,10671,9871,800,7.5
20089,2010,1558,1473,85,5.5
20091,2010,307190,288469,18721,6.1
20093,2010,2155,2058,97,4.5
20095,2010,3862,3594,268,6.9
20097,2010,1398,1325,73,5.2
20099,2010,11277,10203,1074,9.5
20101,2010,985,944,41,4.2
20103,2010,34342,31735,2607,7.6
20105,2010,1882,1770,112,6
20107,2010,4534,4028,506,11.2
20109,2010,1737,1676,61,3.5
20111,2010,17481,16316,1165,6.7
20113,2010,16477,15627,850,5.2
20115,2010,6742,6342,400,5.9
20117,2010,5908,5608,300,5.1
20119,2010,2567,2458,109,4.2
20121,2010,17111,15815,1296,7.6
20123,2010,3874,3689,185,4.8
20125,2010,18083,16158,1925,10.6
20127,2010,3311,3085,226,6.8
20129,2010,1756,1680,76,4.3
20131,2010,5820,5570,250,4.3
20133,2010,7410,6651,759,10.2
20135,2010,1618,1554,64,4
20137,2010,3098,2980,118,3.8
20139,2010,8618,7906,712,8.3
20141,2010,2224,2116,108,4.9
20143,2010,3286,3090,196,6
20145,2010,3608,3439,169,4.7
20147,2010,3037,2881,156,5.1
20149,2010,11890,11268,622,5.2
20151,2010,5289,4993,296,5.6
20153,2010,1511,1458,53,3.5
20155,2010,32894,30800,2094,6.4
20157,2010,2732,2614,118,4.3
20159,2010,5306,5018,288,5.4
20161,2010,36091,34289,1802,5
20163,2010,2767,2593,174,6.3
20165,2010,1793,1697,96,5.4
20167,2010,3741,3550,191,5.1
20169,2010,30934,29027,1907,6.2
20171,2010,2767,2661,106,3.8
20173,2010,252713,230497,22216,8.8
20175,2010,10794,10261,533,4.9
20177,2010,93584,87047,6537,7
20179,2010,1514,1463,51,3.4
20181,2010,3154,3004,150,4.8
20183,2010,2333,2232,101,4.3
20185,2010,2366,2246,120,5.1
20187,2010,1093,1048,45,4.1
20189,2010,2870,2749,121,4.2
20191,2010,11958,10896,1062,8.9
20193,2010,4543,4363,180,4
20195,2010,1509,1438,71,4.7
20197,2010,3887,3633,254,6.5
20199,2010,893,840,53,5.9
20201,2010,3346,3184,162,4.8
20203,2010,1336,1290,46,3.4
20205,2010,4500,3962,538,12
20207,2010,1736,1599,137,7.9
20209,2010,74994,67433,7561,10.1
21001,2010,7810,6839,971,12.4
21003,2010,9126,8056,1070,11.7
21005,2010,11579,10466,1113,9.6
21007,2010,3839,3445,394,10.3
21009,2010,19749,17540,2209,11.2
21011,2010,4887,4172,715,14.6
21013,2010,10197,8959,1238,12.1
21015,2010,63271,57662,5609,8.9
21017,2010,10064,9151,913,9.1
21019,2010,20421,18342,2079,10.2
21021,2010,13342,11853,1489,11.2
21023,2010,3982,3529,453,11.4
21025,2010,4528,3916,612,13.5
21027,2010,8273,7202,1071,12.9
21029,2010,38803,34671,4132,10.6
21031,2010,5457,4802,655,12
21033,2010,5916,5293,623,10.5
21035,2010,18915,17391,1524,8.1
21037,2010,48713,44284,4429,9.1
21039,2010,2251,2047,204,9.1
21041,2010,4999,4274,725,14.5
21043,2010,11925,10244,1681,14.1
21045,2010,6914,6155,759,11
21047,2010,27294,24107,3187,11.7
21049,2010,17775,15862,1913,10.8
21051,2010,6030,5153,877,14.5
21053,2010,4273,3803,470,11
21055,2010,4064,3660,404,9.9
21057,2010,3174,2800,374,11.8
21059,2010,46881,42523,4358,9.3
21061,2010,5122,4440,682,13.3
21063,2010,2399,2019,380,15.8
21065,2010,5694,4923,771,13.5
21067,2010,163286,151190,12096,7.4
21069,2010,6713,5940,773,11.5
21071,2010,13940,12064,1876,13.5
21073,2010,24625,22481,2144,8.7
21075,2010,2729,2415,314,11.5
21077,2010,4076,3573,503,12.3
21079,2010,7935,7051,884,11.1
21081,2010,11684,10308,1376,11.8
21083,2010,16827,15231,1596,9.5
21085,2010,11549,9904,1645,14.2
21087,2010,5596,4938,658,11.8
21089,2010,15351,13579,1772,11.5
21091,2010,4060,3643,417,10.3
21093,2010,46901,42359,4542,9.7
21095,2010,10193,8979,1214,11.9
21097,2010,9016,8013,1003,11.1
21099,2010,8110,7264,846,10.4
21101,2010,22850,20503,2347,10.3
21103,2010,7834,7060,774,9.9
21105,2010,2300,2112,188,8.2
21107,2010,21211,19157,2054,9.7
21109,2010,5142,4419,723,14.1
21111,2010,378722,340806,37916,10
21113,2010,24710,22615,2095,8.5
21115,2010,8925,7804,1121,12.6
21117,2010,83798,75611,8187,9.8
21119,2010,5924,5126,798,13.5
21121,2010,10648,9209,1439,13.5
21123,2010,6062,5378,684,11.3
21125,2010,24952,22105,2847,11.4
21127,2010,5767,4983,784,13.6
21129,2010,2590,2263,327,12.6
21131,2010,3607,3141,466,12.9
21133,2010,8659,7669,990,11.4
21135,2010,5589,4818,771,13.8
21137,2010,10625,9261,1364,12.8
21139,2010,4035,3549,486,12
21141,2010,12612,11362,1250,9.9
21143,2010,2982,2636,346,11.6
21145,2010,30650,27876,2774,9.1
21147,2010,5723,4896,827,14.5
21149,2010,4524,4062,462,10.2
21151,2010,43050,39386,3664,8.5
21153,2010,4290,3411,879,20.5
21155,2010,9110,7961,1149,12.6
21157,2010,15404,13783,1621,10.5
21159,2010,3998,3586,412,10.3
21161,2010,7892,7004,888,11.3
21163,2010,12338,10882,1456,11.8
21165,2010,2560,2163,397,15.5
21167,2010,10532,9353,1179,11.2
21169,2010,4674,4051,623,13.3
21171,2010,4850,4331,519,10.7
21173,2010,12077,10603,1474,12.2
21175,2010,5114,4447,667,13
21177,2010,13040,11615,1425,10.9
21179,2010,21971,19514,2457,11.2
21181,2010,3631,3264,367,10.1
21183,2010,10316,9159,1157,11.2
21185,2010,29248,27042,2206,7.5
21187,2010,5915,5418,497,8.4
21189,2010,1362,1181,181,13.3
21191,2010,7387,6480,907,12.3
21193,2010,11065,9766,1299,11.7
21195,2010,24504,21948,2556,10.4
21197,2010,5290,4468,822,15.5
21199,2010,27776,24831,2945,10.6
21201,2010,869,768,101,11.6
21203,2010,7028,6240,788,11.2
21205,2010,10912,9807,1105,10.1
21207,2010,7297,6361,936,12.8
21209,2010,25429,23216,2213,8.7
21211,2010,21851,19900,1951,8.9
21213,2010,8642,7521,1121,13
21215,2010,9205,8291,914,9.9
21217,2010,11802,10355,1447,12.3
21219,2010,5676,5106,570,10
21221,2010,6440,5531,909,14.1
21223,2010,4088,3561,527,12.9
21225,2010,7687,6941,746,9.7
21227,2010,58221,52861,5360,9.2
21229,2010,6089,5471,618,10.1
21231,2010,8213,7059,1154,14.1
21233,2010,6121,5542,579,9.5
21235,2010,14127,12346,1781,12.6
21237,2010,2152,1800,352,16.4
21239,2010,14441,13394,1047,7.3
22001,2010,26130,24233,1897,7.3
22003,2010,9395,8471,924,9.8
22005,2010,53392,49414,3978,7.5
22007,2010,10067,8902,1165,11.6
22009,2010,16867,15453,1414,8.4
22011,2010,14585,13429,1156,7.9
22013,2010,5918,5324,594,10
22015,2010,56576,53152,3424,6.1
22017,2010,116799,107285,9514,8.1
22019,2010,87896,80851,7045,8
22021,2010,4179,3726,453,10.8
22023,2010,3299,3092,207,6.3
22025,2010,4229,3792,437,10.3
22027,2010,6892,6289,603,8.7
22029,2010,7875,7093,782,9.9
22031,2010,11394,10392,1002,8.8
22033,2010,221984,205112,16872,7.6
22035,2010,2477,2038,439,17.7
22037,2010,8103,7427,676,8.3
22039,2010,13141,12015,1126,8.6
22041,2010,8333,7409,924,11.1
22043,2010,8590,7864,726,8.5
22045,2010,32240,29464,2776,8.6
22047,2010,14031,12622,1409,10
22049,2010,7085,6568,517,7.3
22051,2010,216258,200303,15955,7.4
22053,2010,13113,12124,989,7.5
22055,2010,113571,106487,7084,6.2
22057,2010,45070,42305,2765,6.1
22059,2010,6444,6024,420,6.5
22061,2010,20309,18533,1776,8.7
22063,2010,61281,56675,4606,7.5
22065,2010,4170,3668,502,12
22067,2010,11097,9385,1712,15.4
22069,2010,16590,15101,1489,9
22071,2010,162592,148465,14127,8.7
22073,2010,70729,64888,5841,8.3
22075,2010,10028,9420,608,6.1
22077,2010,10001,9134,867,8.7
22079,2010,58820,54349,4471,7.6
22081,2010,4020,3680,340,8.5
22083,2010,8802,7834,968,11
22085,2010,9673,8970,703,7.3
22087,2010,15951,14621,1330,8.3
22089,2010,25481,23594,1887,7.4
22091,2010,4716,4097,619,13.1
22093,2010,10130,8949,1181,11.7
22095,2010,21535,19252,2283,10.6
22097,2010,34308,31015,3293,9.6
22099,2010,24050,22137,1913,8
22101,2010,25185,22815,2370,9.4
22103,2010,108755,101906,6849,6.3
22105,2010,53664,48451,5213,9.7
22107,2010,2121,1828,293,13.8
22109,2010,50910,47617,3293,6.5
22111,2010,9674,8667,1007,10.4
22113,2010,25637,23770,1867,7.3
22115,2010,18553,16958,1595,8.6
22117,2010,17114,15469,1645,9.6
22119,2010,16831,15083,1748,10.4
22121,2010,11924,10986,938,7.9
22123,2010,4452,3727,725,16.3
22125,2010,5237,4885,352,6.7
22127,2010,5813,5270,543,9.3
23001,2010,55909,51116,4793,8.6
23003,2010,34717,31344,3373,9.7
23005,2010,156017,145846,10171,6.5
23007,2010,15502,14071,1431,9.2
23009,2010,29815,27185,2630,8.8
23011,2010,62924,58135,4789,7.6
23013,2010,20391,18883,1508,7.4
23015,2010,17122,15824,1298,7.6
23017,2010,27923,24935,2988,10.7
23019,2010,79017,72321,6696,8.5
23021,2010,7962,7110,852,10.7
23023,2010,19219,17940,1279,6.7
23025,2010,24679,21939,2740,11.1
23027,2010,20407,18675,1732,8.5
23029,2010,14945,13332,1613,10.8
23031,2010,108635,99974,8661,8
24001,2010,34419,31206,3213,9.3
24003,2010,286070,266359,19711,6.9
24005,2010,431530,395920,35610,8.3
24009,2010,47831,44547,3284,6.9
24011,2010,17421,15811,1610,9.2
24013,2010,92598,86283,6315,6.8
24015,2010,51981,47031,4950,9.5
24017,2010,78222,72815,5407,6.9
24019,2010,16549,14665,1884,11.4
24021,2010,127913,119084,8829,6.9
24023,2010,15807,14405,1402,8.9
24025,2010,132791,122453,10338,7.8
24027,2010,160638,151618,9020,5.6
24029,2010,10631,9694,937,8.8
24031,2010,532572,502733,29839,5.6
24033,2010,479626,443655,35971,7.5
24035,2010,26142,24233,1909,7.3
24037,2010,53619,50116,3503,6.5
24039,2010,9931,8749,1182,11.9
24041,2010,19402,17858,1544,8
24043,2010,75805,68531,7274,9.6
24045,2010,50381,45464,4917,9.8
24047,2010,26437,22906,3531,13.4
24510,2010,295516,262359,33157,11.2
25001,2010,111092,100062,11030,9.9
25003,2010,68182,62266,5916,8.7
25005,2010,286799,256458,30341,10.6
25007,2010,9103,8214,889,9.8
25009,2010,392103,357987,34116,8.7
25011,2010,39971,36925,3046,7.6
25013,2010,220925,198217,22708,10.3
25015,2010,85528,79532,5996,7
25017,2010,825687,768485,57202,6.9
25019,2010,6167,5573,594,9.6
25021,2010,358192,331514,26678,7.4
25023,2010,262147,238691,23456,8.9
25025,2010,393870,363769,30101,7.6
25027,2010,420320,383125,37195,8.8
26001,2010,3880,3188,692,17.8
26003,2010,3593,3085,508,14.1
26005,2010,57023,50551,6472,11.3
26007,2010,14273,12397,1876,13.1
26009,2010,10563,8875,1688,16
26011,2010,6958,5810,1148,16.5
26013,2010,3906,3150,756,19.4
26015,2010,29360,26318,3042,10.4
26017,2010,54666,48347,6319,11.6
26019,2010,8961,7755,1206,13.5
26021,2010,76628,67415,9213,12
26023,2010,20042,17507,2535,12.6
26025,2010,64996,57389,7607,11.7
26027,2010,24583,21792,2791,11.4
26029,2010,13357,11483,1874,14
26031,2010,11358,9772,1586,14
26033,2010,17806,15682,2124,11.9
26035,2010,12542,10592,1950,15.5
26037,2010,39637,36310,3327,8.4
26039,2010,5631,4832,799,14.2
26041,2010,18177,15898,2279,12.5
26043,2010,13213,11692,1521,11.5
26045,2010,57180,51676,5504,9.6
26047,2010,18512,15839,2673,14.4
26049,2010,188190,161918,26272,14
26051,2010,10413,8869,1544,14.8
26053,2010,7226,6281,945,13.1
26055,2010,47553,42015,5538,11.6
26057,2010,19544,17233,2311,11.8
26059,2010,21487,18577,2910,13.5
26061,2010,17939,16010,1929,10.8
26063,2010,16642,14567,2075,12.5
26065,2010,148442,133197,15245,10.3
26067,2010,29931,26363,3568,11.9
26069,2010,10377,8737,1640,15.8
26071,2010,5296,4661,635,12
26073,2010,35522,32046,3476,9.8
26075,2010,74673,65564,9109,12.2
26077,2010,129632,116657,12975,10
26079,2010,7918,6680,1238,15.6
26081,2010,316233,284168,32065,10.1
26083,2010,1015,862,153,15.1
26085,2010,3890,3258,632,16.2
26087,2010,41335,34587,6748,16.3
26089,2010,10588,9490,1098,10.4
26091,2010,49811,43318,6493,13
26093,2010,94112,83600,10512,11.2
26095,2010,2498,2163,335,13.4
26097,2010,5560,4746,814,14.6
26099,2010,420803,362380,58423,13.9
26101,2010,11051,9605,1446,13.1
26103,2010,34937,31502,3435,9.8
26105,2010,14567,12733,1834,12.6
26107,2010,19304,16872,2432,12.6
26109,2010,11958,10566,1392,11.6
26111,2010,41219,37196,4023,9.8
26113,2010,7146,6241,905,12.7
26115,2010,75640,66771,8869,11.7
26117,2010,27809,23888,3921,14.1
26119,2010,3552,2836,716,20.2
26121,2010,77712,66420,11292,14.5
26123,2010,22988,20078,2910,12.7
26125,2010,621876,548699,73177,11.8
26127,2010,13380,11217,2163,16.2
26129,2010,9082,7767,1315,14.5
26131,2010,3075,2560,515,16.7
26133,2010,10383,8970,1413,13.6
26135,2010,3316,2667,649,19.6
26137,2010,11870,10180,1690,14.2
26139,2010,140585,126112,14473,10.3
26141,2010,5755,4751,1004,17.4
26143,2010,8652,7212,1440,16.6
26145,2010,90722,79625,11097,12.2
26147,2010,77675,64934,12741,16.4
26149,2010,28110,24585,3525,12.5
26151,2010,20006,16923,3083,15.4
26153,2010,3798,3280,518,13.6
26155,2010,34707,30234,4473,12.9
26157,2010,26057,22214,3843,14.7
26159,2010,37784,32687,5097,13.5
26161,2010,182801,167969,14832,8.1
26163,2010,802754,678426,124328,15.5
26165,2010,15218,13023,2195,14.4
27001,2010,7310,6550,760,10.4
27003,2010,187355,172342,15013,8
27005,2010,17602,16210,1392,7.9
27007,2010,22591,20737,1854,8.2
27009,2010,21100,19263,1837,8.7
27011,2010,2911,2722,189,6.5
27013,2010,38114,35687,2427,6.4
27015,2010,15102,14064,1038,6.9
27017,2010,17794,16304,1490,8.4
27019,2010,51621,48148,3473,6.7
27021,2010,14383,12864,1519,10.6
27023,2010,7153,6628,525,7.3
27025,2010,29314,26707,2607,8.9
27027,2010,33883,32009,1874,5.5
27029,2010,4589,3988,601,13.1
27031,2010,3056,2837,219,7.2
27033,2010,6227,5822,405,6.5
27035,2010,32033,28983,3050,9.5
27037,2010,227259,211414,15845,7
27039,2010,11307,10525,782,6.9
27041,2010,19817,18471,1346,6.8
27043,2010,7831,7207,624,8
27045,2010,11246,10402,844,7.5
27047,2010,17087,15767,1320,7.7
27049,2010,26734,24853,1881,7
27051,2010,3399,3129,270,7.9
27053,2010,650891,605294,45597,7
27055,2010,10830,9999,831,7.7
27057,2010,9751,8784,967,9.9
27059,2010,20561,18583,1978,9.6
27061,2010,22499,20214,2285,10.2
27063,2010,6026,5674,352,5.8
27065,2010,8784,7800,984,11.2
27067,2010,23568,21997,1571,6.7
27069,2010,2576,2382,194,7.5
27071,2010,6938,6336,602,8.7
27073,2010,4082,3810,272,6.7
27075,2010,5798,5316,482,8.3
27077,2010,2282,2134,148,6.5
27079,2010,15715,14324,1391,8.9
27081,2010,3445,3255,190,5.5
27083,2010,15226,14375,851,5.6
27085,2010,20307,18487,1820,9
27087,2010,2503,2296,207,8.3
27089,2010,5698,5170,528,9.3
27091,2010,11506,10664,842,7.3
27093,2010,12811,11684,1127,8.8
27095,2010,13152,11695,1457,11.1
27097,2010,18617,16849,1768,9.5
27099,2010,20908,19634,1274,6.1
27101,2010,5022,4678,344,6.8
27103,2010,19782,18575,1207,6.1
27105,2010,11522,10876,646,5.6
27107,2010,3603,3355,248,6.9
27109,2010,81197,76368,4829,5.9
27111,2010,30869,28657,2212,7.2
27113,2010,8398,7639,759,9
27115,2010,15355,13848,1507,9.8
27117,2010,5148,4809,339,6.6
27119,2010,17156,16019,1137,6.6
27121,2010,5880,5461,419,7.1
27123,2010,270063,249935,20128,7.5
27125,2010,2419,2187,232,9.6
27127,2010,8580,8002,578,6.7
27129,2010,8993,8269,724,8.1
27131,2010,34985,32264,2721,7.8
27133,2010,5377,5105,272,5.1
27135,2010,8685,8130,555,6.4
27137,2010,103374,94990,8384,8.1
27139,2010,74150,69064,5086,6.9
27141,2010,48989,44866,4123,8.4
27143,2010,8506,7836,670,7.9
27145,2010,85674,79494,6180,7.2
27147,2010,21063,19426,1637,7.8
27149,2010,5547,5238,309,5.6
27151,2010,5239,4815,424,8.1
27153,2010,13519,12471,1048,7.8
27155,2010,1881,1764,117,6.2
27157,2010,12107,11242,865,7.1
27159,2010,6483,5822,661,10.2
27161,2010,10577,9786,791,7.5
27163,2010,132046,123188,8858,6.7
27165,2010,6311,5850,461,7.3
27167,2010,3822,3613,209,5.5
27169,2010,29217,27196,2021,6.9
27171,2010,70095,64461,5634,8
27173,2010,5878,5508,370,6.3
28001,2010,12608,11162,1446,11.5
28003,2010,15721,13906,1815,11.5
28005,2010,4979,4385,594,11.9
28007,2010,7955,6957,998,12.5
28009,2010,3273,2865,408,12.5
28011,2010,14909,13212,1697,11.4
28013,2010,7025,6376,649,9.2
28015,2010,3834,3330,504,13.1
28017,2010,7944,6989,955,12
28019,2010,3766,3322,444,11.8
28021,2010,3580,2982,598,16.7
28023,2010,6606,5776,830,12.6
28025,2010,8682,7257,1425,16.4
28027,2010,10480,9044,1436,13.7
28029,2010,11991,10622,1369,11.4
28031,2010,8235,7402,833,10.1
28033,2010,79619,73681,5938,7.5
28035,2010,34083,30756,3327,9.8
28037,2010,3234,2866,368,11.4
28039,2010,8759,7753,1006,11.5
28041,2010,4580,4034,546,11.9
28043,2010,9433,8342,1091,11.6
28045,2010,19653,17887,1766,9
28047,2010,88745,80951,7794,8.8
28049,2010,113892,102705,11187,9.8
28051,2010,6848,5506,1342,19.6
28053,2010,3482,2882,600,17.2
28055,2010,525,440,85,16.2
28057,2010,10355,9188,1167,11.3
28059,2010,64425,58293,6132,9.5
28061,2010,7013,6154,859,12.2
28063,2010,2472,2007,465,18.8
28065,2010,4609,3961,648,14.1
28067,2010,27932,25384,2548,9.1
28069,2010,3906,3330,576,14.7
28071,2010,21649,19630,2019,9.3
28073,2010,27659,25673,1986,7.2
28075,2010,33063,29541,3522,10.7
28077,2010,5147,4534,613,11.9
28079,2010,9177,8289,888,9.7
28081,2010,39180,35112,4068,10.4
28083,2010,11604,9825,1779,15.3
28085,2010,14459,12940,1519,10.5
28087,2010,26144,23046,3098,11.8
28089,2010,48712,45114,3598,7.4
28091,2010,10544,9259,1285,12.2
28093,2010,15497,13626,1871,12.1
28095,2010,16300,14157,2143,13.1
28097,2010,4675,4031,644,13.8
28099,2010,11806,10579,1227,10.4
28101,2010,9201,8274,927,10.1
28103,2010,4430,3731,699,15.8
28105,2010,21697,19478,2219,10.2
28107,2010,14409,12457,1952,13.5
28109,2010,23423,21198,2225,9.5
28111,2010,4636,4004,632,13.6
28113,2010,15611,13799,1812,11.6
28115,2010,13672,12280,1392,10.2
28117,2010,11604,10235,1369,11.8
28119,2010,3197,2721,476,14.9
28121,2010,70858,66002,4856,6.9
28123,2010,13551,12469,1082,8
28125,2010,2059,1760,299,14.5
28127,2010,11372,10304,1068,9.4
28129,2010,7314,6650,664,9.1
28131,2010,6843,6117,726,10.6
28133,2010,9869,8348,1521,15.4
28135,2010,5885,5166,719,12.2
28137,2010,12631,11271,1360,10.8
28139,2010,8991,7777,1214,13.5
28141,2010,7813,6817,996,12.7
28143,2010,5027,4339,688,13.7
28145,2010,12138,10814,1324,10.9
28147,2010,5813,5060,753,13
28149,2010,23335,20888,2447,10.5
28151,2010,20950,17637,3313,15.8
28153,2010,8631,7589,1042,12.1
28155,2010,4372,3868,504,11.5
28157,2010,3444,2968,476,13.8
28159,2010,7945,6597,1348,17
28161,2010,5205,4499,706,13.6
28163,2010,9913,8701,1212,12.2
29001,2010,11083,10124,959,8.7
29003,2010,9898,9078,820,8.3
29005,2010,2999,2741,258,8.6
29007,2010,11136,10068,1068,9.6
29009,2010,15616,14109,1507,9.7
29011,2010,5757,5164,593,10.3
29013,2010,8397,7474,923,11
29015,2010,7291,6407,884,12.1
29017,2010,5842,5254,588,10.1
29019,2010,92559,86588,5971,6.5
29021,2010,46660,42383,4277,9.2
29023,2010,18765,16969,1796,9.6
29025,2010,4560,4124,436,9.6
29027,2010,22377,20524,1853,8.3
29029,2010,19459,17129,2330,12
29031,2010,41030,38022,3008,7.3
29033,2010,4796,4246,550,11.5
29035,2010,2666,2359,307,11.5
29037,2010,53355,48217,5138,9.6
29039,2010,6113,5530,583,9.5
29041,2010,4128,3736,392,9.5
29043,2010,40861,37420,3441,8.4
29045,2010,3462,3032,430,12.4
29047,2010,125001,114532,10469,8.4
29049,2010,11071,10002,1069,9.7
29051,2010,40685,37894,2791,6.9
29053,2010,7961,7184,777,9.8
29055,2010,10811,9439,1372,12.7
29057,2010,3402,3071,331,9.7
29059,2010,7285,6369,916,12.6
29061,2010,4011,3617,394,9.8
29063,2010,5025,4581,444,8.8
29065,2010,6512,5838,674,10.4
29067,2010,5249,4612,637,12.1
29069,2010,12289,10632,1657,13.5
29071,2010,53456,47397,6059,11.3
29073,2010,7752,6943,809,10.4
29075,2010,3523,3245,278,7.9
29077,2010,144734,132665,12069,8.3
29079,2010,4837,4450,387,8
29081,2010,4062,3676,386,9.5
29083,2010,10139,9045,1094,10.8
29085,2010,3677,3213,464,12.6
29087,2010,2693,2479,214,7.9
29089,2010,5002,4565,437,8.7
29091,2010,17064,15218,1846,10.8
29093,2010,3574,2977,597,16.7
29095,2010,361018,322489,38529,10.7
29097,2010,59026,54018,5008,8.5
29099,2010,117544,105349,12195,10.4
29101,2010,23492,21158,2334,9.9
29103,2010,2007,1851,156,7.8
29105,2010,15918,13942,1976,12.4
29107,2010,17549,15830,1719,9.8
29109,2010,17558,15925,1633,9.3
29111,2010,5203,4759,444,8.5
29113,2010,26706,23558,3148,11.8
29115,2010,5450,4766,684,12.6
29117,2010,7146,6563,583,8.2
29119,2010,10360,9411,949,9.2
29121,2010,7482,6789,693,9.3
29123,2010,5457,4793,664,12.2
29125,2010,4256,3853,403,9.5
29127,2010,14770,13427,1343,9.1
29129,2010,1796,1646,150,8.4
29131,2010,11858,10331,1527,12.9
29133,2010,6108,5518,590,9.7
29135,2010,7397,6772,625,8.4
29137,2010,4118,3613,505,12.3
29139,2010,6047,5374,673,11.1
29141,2010,7984,6824,1160,14.5
29143,2010,8225,7406,819,10
29145,2010,28759,26175,2584,9
29147,2010,11758,10909,849,7.2
29149,2010,4107,3651,456,11.1
29151,2010,7467,6951,516,6.9
29153,2010,3602,3179,423,11.7
29155,2010,7205,6306,899,12.5
29157,2010,9835,9122,713,7.2
29159,2010,20080,18219,1861,9.3
29161,2010,19813,18028,1785,9
29163,2010,8241,7433,808,9.8
29165,2010,51580,47591,3989,7.7
29167,2010,14405,12924,1481,10.3
29169,2010,16707,15240,1467,8.8
29171,2010,2387,2195,192,8
29173,2010,5635,5140,495,8.8
29175,2010,10792,9547,1245,11.5
29177,2010,11572,10383,1189,10.3
29179,2010,2383,2023,360,15.1
29181,2010,5395,4700,695,12.9
29183,2010,205228,188398,16830,8.2
29185,2010,4136,3672,464,11.2
29186,2010,9404,8436,968,10.3
29187,2010,27272,23931,3341,12.3
29189,2010,535129,487371,47758,8.9
29195,2010,10980,10004,976,8.9
29197,2010,1960,1757,203,10.4
29199,2010,2306,2120,186,8.1
29201,2010,19006,17161,1845,9.7
29203,2010,3243,2762,481,14.8
29205,2010,3241,2962,279,8.6
29207,2010,13607,12186,1421,10.4
29209,2010,14494,12492,2002,13.8
29211,2010,2937,2678,259,8.8
29213,2010,26075,22447,3628,13.9
29215,2010,9841,8758,1083,11
29217,2010,9572,8781,791,8.3
29219,2010,17262,15364,1898,11
29221,2010,10256,8787,1469,14.3
29223,2010,5565,4965,600,10.8
29225,2010,16383,14660,1723,10.5
29227,2010,1249,1164,85,6.8
29229,2010,7612,6707,905,11.9
29510,2010,164915,145959,18956,11.5
30001,2010,5010,4713,297,5.9
30003,2010,5525,4920,605,11
30005,2010,2522,2354,168,6.7
30007,2010,2508,2322,186,7.4
30009,2010,5330,4988,342,6.4
30011,2010,725,697,28,3.9
30013,2010,38447,35996,2451,6.4
30015,2010,2738,2618,120,4.4
30017,2010,6400,6110,290,4.5
30019,2010,946,913,33,3.5
30021,2010,4513,4323,190,4.2
30023,2010,5181,4864,317,6.1
30025,2010,1898,1840,58,3.1
30027,2010,6017,5631,386,6.4
30029,2010,43786,38512,5274,12
30031,2010,50768,47316,3452,6.8
30033,2010,763,736,27,3.5
30035,2010,6260,5648,612,9.8
30037,2010,418,390,28,6.7
30039,2010,1458,1323,135,9.3
30041,2010,7982,7518,464,5.8
30043,2010,5628,5274,354,6.3
30045,2010,1009,944,65,6.4
30047,2010,12644,11512,1132,9
30049,2010,34314,32427,1887,5.5
30051,2010,1033,988,45,4.4
30053,2010,8429,7167,1262,15
30055,2010,1131,1098,33,2.9
30057,2010,4155,3840,315,7.6
30059,2010,935,860,75,8
30061,2010,1789,1566,223,12.5
30063,2010,58536,54244,4292,7.3
30065,2010,2381,2217,164,6.9
30067,2010,7890,7199,691,8.8
30069,2010,299,283,16,5.4
30071,2010,2208,2058,150,6.8
30073,2010,2953,2780,173,5.9
30075,2010,1044,1005,39,3.7
30077,2010,2959,2735,224,7.6
30079,2010,567,538,29,5.1
30081,2010,18864,17095,1769,9.4
30083,2010,5763,5545,218,3.8
30085,2010,4583,4268,315,6.9
30087,2010,4358,4054,304,7
30089,2010,5000,4345,655,13.1
30091,2010,1819,1752,67,3.7
30093,2010,16952,15846,1106,6.5
30095,2010,4762,4484,278,5.8
30097,2010,1738,1643,95,5.5
30099,2010,3030,2849,181,6
30101,2010,2448,2336,112,4.6
30103,2010,398,377,21,5.3
30105,2010,3910,3719,191,4.9
30107,2010,861,793,68,7.9
30109,2010,529,507,22,4.2
30111,2010,76415,71920,4495,5.9
31001,2010,16494,15713,781,4.7
31003,2010,3526,3400,126,3.6
31005,2010,226,208,18,8
31007,2010,413,395,18,4.4
31009,2010,258,245,13,5
31011,2010,2959,2855,104,3.5
31013,2010,5852,5561,291,5
31015,2010,1107,1064,43,3.9
31017,2010,1461,1393,68,4.7
31019,2010,26386,25429,957,3.6
31021,2010,3641,3425,216,5.9
31023,2010,4651,4469,182,3.9
31025,2010,13404,12649,755,5.6
31027,2010,4627,4462,165,3.6
31029,2010,2293,2229,64,2.8
31031,2010,3385,3285,100,3
31033,2010,5558,5356,202,3.6
31035,2010,3433,3286,147,4.3
31037,2010,5659,5436,223,3.9
31039,2010,4863,4685,178,3.7
31041,2010,5986,5766,220,3.7
31043,2010,11299,10470,829,7.3
31045,2010,5499,5281,218,4
31047,2010,13210,12559,651,4.9
31049,2010,1031,991,40,3.9
31051,2010,3115,2966,149,4.8
31053,2010,18851,17855,996,5.3
31055,2010,279280,264986,14294,5.1
31057,2010,1216,1178,38,3.1
31059,2010,3240,3119,121,3.7
31061,2010,1634,1563,71,4.3
31063,2010,1596,1536,60,3.8
31065,2010,2661,2571,90,3.4
31067,2010,11408,10752,656,5.8
31069,2010,1266,1214,52,4.1
31071,2010,1202,1165,37,3.1
31073,2010,1147,1106,41,3.6
31075,2010,421,405,16,3.8
31077,2010,1360,1311,49,3.6
31079,2010,31519,30054,1465,4.6
31081,2010,4806,4625,181,3.8
31083,2010,1893,1832,61,3.2
31085,2010,640,618,22,3.4
31087,2010,1400,1328,72,5.1
31089,2010,5832,5621,211,3.6
31091,2010,410,389,21,5.1
31093,2010,3346,3198,148,4.4
31095,2010,4251,4050,201,4.7
31097,2010,2343,2234,109,4.7
31099,2010,3796,3663,133,3.5
31101,2010,4585,4390,195,4.3
31103,2010,568,548,20,3.5
31105,2010,2124,2024,100,4.7
31107,2010,4751,4554,197,4.1
31109,2010,162567,155716,6851,4.2
31111,2010,19401,18524,877,4.5
31113,2010,492,470,22,4.5
31115,2010,368,347,21,5.7
31117,2010,353,343,10,2.8
31119,2010,18950,18151,799,4.2
31121,2010,4199,4010,189,4.5
31123,2010,2650,2542,108,4.1
31125,2010,1980,1903,77,3.9
31127,2010,3851,3646,205,5.3
31129,2010,2441,2341,100,4.1
31131,2010,8476,8048,428,5
31133,2010,1586,1523,63,4
31135,2010,1769,1710,59,3.3
31137,2010,4958,4781,177,3.6
31139,2010,4175,4022,153,3.7
31141,2010,17655,16910,745,4.2
31143,2010,2958,2839,119,4
31145,2010,6216,5989,227,3.7
31147,2010,4328,4058,270,6.2
31149,2010,891,866,25,2.8
31151,2010,7287,6946,341,4.7
31153,2010,84923,81145,3778,4.4
31155,2010,11179,10643,536,4.8
31157,2010,19200,18144,1056,5.5
31159,2010,8765,8414,351,4
31161,2010,2821,2721,100,3.5
31163,2010,1730,1660,70,4
31165,2010,835,804,31,3.7
31167,2010,3584,3438,146,4.1
31169,2010,2803,2697,106,3.8
31171,2010,396,377,19,4.8
31173,2010,3054,2762,292,9.6
31175,2010,2143,2048,95,4.4
31177,2010,11232,10716,516,4.6
31179,2010,5671,5456,215,3.8
31181,2010,1705,1623,82,4.8
31183,2010,515,495,20,3.9
31185,2010,7411,7067,344,4.6
32001,2010,11199,9814,1385,12.4
32003,2010,984004,848573,135431,13.8
32005,2010,23087,19910,3177,13.8
32007,2010,26898,24828,2070,7.7
32009,2010,414,376,38,9.2
32011,2010,1029,949,80,7.8
32013,2010,8346,7622,724,8.7
32015,2010,3070,2777,293,9.5
32017,2010,2018,1805,213,10.6
32019,2010,22998,18976,4022,17.5
32021,2010,2334,1999,335,14.4
32023,2010,16686,13797,2889,17.3
32027,2010,2396,2142,254,10.6
32029,2010,2013,1676,337,16.7
32031,2010,220825,192289,28536,12.9
32033,2010,4563,4142,421,9.2
32510,2010,26700,23100,3600,13.5
33001,2010,32261,30206,2055,6.4
33003,2010,24941,23527,1414,5.7
33005,2010,42624,40263,2361,5.5
33007,2010,16588,15368,1220,7.4
33009,2010,48324,46005,2319,4.8
33011,2010,226152,212241,13911,6.2
33013,2010,81401,77049,4352,5.3
33015,2010,172358,162057,10301,6
33017,2010,69571,65628,3943,5.7
33019,2010,24038,22792,1246,5.2
34001,2010,140598,123330,17268,12.3
34003,2010,478945,440499,38446,8
34005,2010,237144,215841,21303,9
34007,2010,264826,235862,28964,10.9
34009,2010,50213,43187,7026,14
34011,2010,72664,63233,9431,13
34013,2010,382021,340577,41444,10.8
34015,2010,152605,136957,15648,10.3
34017,2010,352903,319151,33752,9.6
34019,2010,68281,63232,5049,7.4
34021,2010,192673,176570,16103,8.4
34023,2010,424100,386139,37961,9
34025,2010,330154,301281,28873,8.7
34027,2010,264785,245153,19632,7.4
34029,2010,264400,237254,27146,10.3
34031,2010,253373,224610,28763,11.4
34033,2010,32172,28427,3745,11.6
34035,2010,173443,160265,13178,7.6
34037,2010,82239,74482,7757,9.4
34039,2010,279122,252505,26617,9.5
34041,2010,58671,52900,5771,9.8
35001,2010,326594,301358,25236,7.7
35003,2010,1216,1070,146,12
35005,2010,28042,25927,2115,7.5
35006,2010,9327,8431,896,9.6
35007,2010,6363,5830,533,8.4
35009,2010,21586,20428,1158,5.4
35011,2010,833,783,50,6
35013,2010,93597,86337,7260,7.8
35015,2010,25658,24015,1643,6.4
35017,2010,12349,11156,1193,9.7
35019,2010,1652,1485,167,10.1
35021,2010,295,277,18,6.1
35023,2010,2300,2105,195,8.5
35025,2010,26301,24223,2078,7.9
35027,2010,9386,8682,704,7.5
35028,2010,9460,9113,347,3.7
35029,2010,11677,9327,2350,20.1
35031,2010,25440,22929,2511,9.9
35033,2010,2434,2134,300,12.3
35035,2010,24984,23170,1814,7.3
35037,2010,3501,3171,330,9.4
35039,2010,18005,16358,1647,9.1
35041,2010,8409,7883,526,6.3
35043,2010,60901,55793,5108,8.4
35045,2010,54860,49713,5147,9.4
35047,2010,11204,10131,1073,9.6
35049,2010,74289,69245,5044,6.8
35051,2010,4026,3656,370,9.2
35053,2010,6876,6340,536,7.8
35055,2010,15398,13757,1641,10.7
35057,2010,6028,5331,697,11.6
35059,2010,1930,1809,121,6.3
35061,2010,31167,28187,2980,9.6
36001,2010,161511,150264,11247,7
36003,2010,24240,22022,2218,9.2
36005,2010,582287,512477,69810,12
36007,2010,97844,89316,8528,8.7
36009,2010,39654,35881,3773,9.5
36011,2010,39885,36480,3405,8.5
36013,2010,63922,58262,5660,8.9
36015,2010,41594,38105,3489,8.4
36017,2010,23691,21509,2182,9.2
36019,2010,39701,35809,3892,9.8
36021,2010,32137,29789,2348,7.3
36023,2010,24475,22304,2171,8.9
36025,2010,22431,20465,1966,8.8
36027,2010,149196,137679,11517,7.7
36029,2010,465675,426962,38713,8.3
36031,2010,18736,17021,1715,9.2
36033,2010,22245,20249,1996,9
36035,2010,26105,23337,2768,10.6
36037,2010,31730,29189,2541,8
36039,2010,22101,20097,2004,9.1
36041,2010,2502,2256,246,9.8
36043,2010,31552,28841,2711,8.6
36045,2010,50310,45638,4672,9.3
36047,2010,1163502,1047981,115521,9.9
36049,2010,12756,11592,1164,9.1
36051,2010,32754,30104,2650,8.1
36053,2010,35586,32631,2955,8.3
36055,2010,378251,347846,30405,8
36057,2010,23919,21507,2412,10.1
36059,2010,691435,642118,49317,7.1
36061,2010,881204,805555,75649,8.6
36063,2010,107847,97467,10380,9.6
36065,2010,112248,103684,8564,7.6
36067,2010,236994,217970,19024,8
36069,2010,56368,52176,4192,7.4
36071,2010,181295,166830,14465,8
36073,2010,19149,17314,1835,9.6
36075,2010,58886,52618,6268,10.6
36077,2010,31880,29469,2411,7.6
36079,2010,52594,48807,3787,7.2
36081,2010,1106461,1011049,95412,8.6
36083,2010,84603,78045,6558,7.8
36085,2010,216950,196490,20460,9.4
36087,2010,149978,138804,11174,7.5
36089,2010,49964,44802,5162,10.3
36091,2010,118048,109910,8138,6.9
36093,2010,79016,72974,6042,7.6
36095,2010,15924,14504,1420,8.9
36097,2010,9042,8220,822,9.1
36099,2010,16423,15078,1345,8.2
36101,2010,47303,42780,4523,9.6
36103,2010,777863,717598,60265,7.7
36105,2010,36475,33226,3249,8.9
36107,2010,26568,24448,2120,8
36109,2010,54767,51397,3370,6.2
36111,2010,93606,86310,7296,7.8
36113,2010,34154,31082,3072,9
36115,2010,30233,27741,2492,8.2
36117,2010,47429,43227,4202,8.9
36119,2010,478676,443476,35200,7.4
36121,2010,19457,17616,1841,9.5
36123,2010,12230,11327,903,7.4
37001,2010,76806,68451,8355,10.9
37003,2010,18260,15877,2383,13.1
37005,2010,4748,4179,569,12
37007,2010,11180,9602,1578,14.1
37009,2010,13722,12100,1622,11.8
37011,2010,7945,7089,856,10.8
37013,2010,21171,18692,2479,11.7
37015,2010,9191,8108,1083,11.8
37017,2010,15194,13169,2025,13.3
37019,2010,46529,40701,5828,12.5
37021,2010,123680,113096,10584,8.6
37023,2010,41687,36305,5382,12.9
37025,2010,89049,78773,10276,11.5
37027,2010,38213,32542,5671,14.8
37029,2010,4594,4209,385,8.4
37031,2010,31379,28373,3006,9.6
37033,2010,10069,8737,1332,13.2
37035,2010,77898,67726,10172,13.1
37037,2010,30661,28039,2622,8.6
37039,2010,11654,10150,1504,12.9
37041,2010,6151,5413,738,12
37043,2010,4243,3712,531,12.5
37045,2010,45633,38893,6740,14.8
37047,2010,24184,20943,3241,13.4
37049,2010,42279,37743,4536,10.7
37051,2010,131096,117827,13269,10.1
37053,2010,12189,11104,1085,8.9
37055,2010,19686,17300,2386,12.1
37057,2010,80622,70703,9919,12.3
37059,2010,20258,17878,2380,11.7
37061,2010,25810,23416,2394,9.3
37063,2010,143411,131592,11819,8.2
37065,2010,25501,21486,4015,15.7
37067,2010,173002,155453,17549,10.1
37069,2010,27954,24907,3047,10.9
37071,2010,101249,87571,13678,13.5
37073,2010,5460,5025,435,8
37075,2010,3702,3052,650,17.6
37077,2010,27384,24716,2668,9.7
37079,2010,9428,8474,954,10.1
37081,2010,252010,224039,27971,11.1
37083,2010,22791,19435,3356,14.7
37085,2010,48774,43251,5523,11.3
37087,2010,27600,24762,2838,10.3
37089,2010,48301,43901,4400,9.1
37091,2010,9830,8787,1043,10.6
37093,2010,18577,16695,1882,10.1
37095,2010,2235,1987,248,11.1
37097,2010,78671,68532,10139,12.9
37099,2010,18434,16422,2012,10.9
37101,2010,81701,73591,8110,9.9
37103,2010,4598,4083,515,11.2
37105,2010,27095,23633,3462,12.8
37107,2010,26874,23686,3188,11.9
37109,2010,39984,34893,5091,12.7
37111,2010,20610,17864,2746,13.3
37113,2010,15461,13679,1782,11.5
37115,2010,9389,8415,974,10.4
37117,2010,10479,9144,1335,12.7
37119,2010,502428,448844,53584,10.7
37121,2010,6807,5964,843,12.4
37123,2010,11443,10032,1411,12.3
37125,2010,36325,32650,3675,10.1
37127,2010,47453,41495,5958,12.6
37129,2010,107583,97140,10443,9.7
37131,2010,8703,7690,1013,11.6
37133,2010,63342,58102,5240,8.3
37135,2010,69962,65345,4617,6.6
37137,2010,5502,4941,561,10.2
37139,2010,18498,16657,1841,10
37141,2010,24446,21650,2796,11.4
37143,2010,5334,4766,568,10.6
37145,2010,18704,16386,2318,12.4
37147,2010,85917,77174,8743,10.2
37149,2010,8561,7692,869,10.2
37151,2010,69399,61084,8315,12
37153,2010,18927,16113,2814,14.9
37155,2010,53853,46478,7375,13.7
37157,2010,44210,38369,5841,13.2
37159,2010,64328,55278,9050,14.1
37161,2010,26979,22464,4515,16.7
37163,2010,29558,26703,2855,9.7
37165,2010,13098,10789,2309,17.6
37167,2010,29064,25232,3832,13.2
37169,2010,22847,20244,2603,11.4
37171,2010,34423,30290,4133,12
37173,2010,6269,5345,924,14.7
37175,2010,13805,12456,1349,9.8
37177,2010,1659,1414,245,14.8
37179,2010,101154,91016,10138,10
37181,2010,19018,16332,2686,14.1
37183,2010,480565,440710,39855,8.3
37185,2010,7550,6514,1036,13.7
37187,2010,5692,4880,812,14.3
37189,2010,26883,24773,2110,7.8
37191,2010,54808,49787,5021,9.2
37193,2010,31081,26905,4176,13.4
37195,2010,38233,32918,5315,13.9
37197,2010,18198,16203,1995,11
37199,2010,7810,6884,926,11.9
38001,2010,1202,1167,35,2.9
38003,2010,6187,5911,276,4.5
38005,2010,2915,2757,158,5.4
38007,2010,426,412,14,3.3
38009,2010,3397,3262,135,4
38011,2010,1772,1726,46,2.6
38013,2010,1130,1099,31,2.7
38015,2010,46337,44662,1675,3.6
38017,2010,88824,85680,3144,3.5
38019,2010,2260,2191,69,3.1
38021,2010,2856,2764,92,3.2
38023,2010,1383,1354,29,2.1
38025,2010,2301,2227,74,3.2
38027,2010,1297,1235,62,4.8
38029,2010,1826,1700,126,6.9
38031,2010,1802,1740,62,3.4
38033,2010,982,956,26,2.6
38035,2010,37866,36549,1317,3.5
38037,2010,1423,1370,53,3.7
38039,2010,1320,1281,39,3
38041,2010,1479,1434,45,3
38043,2010,1408,1333,75,5.3
38045,2010,2481,2393,88,3.5
38047,2010,1001,965,36,3.6
38049,2010,3283,3125,158,4.8
38051,2010,1342,1283,59,4.4
38053,2010,3586,3508,78,2.2
38055,2010,5101,4844,257,5
38057,2010,4325,4098,227,5.2
38059,2010,15993,15263,730,4.6
38061,2010,5510,5366,144,2.6
38063,2010,1691,1623,68,4
38065,2010,927,874,53,5.7
38067,2010,4024,3768,256,6.4
38069,2010,1997,1891,106,5.3
38071,2010,6042,5812,230,3.8
38073,2010,2856,2725,131,4.6
38075,2010,1459,1418,41,2.8
38077,2010,9060,8712,348,3.8
38079,2010,5291,4715,576,10.9
38081,2010,2045,1957,88,4.3
38083,2010,811,779,32,3.9
38085,2010,1308,1241,67,5.1
38087,2010,470,459,11,2.3
38089,2010,14546,14142,404,2.8
38091,2010,1100,1070,30,2.7
38093,2010,11264,10797,467,4.1
38095,2010,1396,1358,38,2.7
38097,2010,4562,4393,169,3.7
38099,2010,6222,5905,317,5.1
38101,2010,31526,30436,1090,3.5
38103,2010,2328,2235,93,4
38105,2010,14407,14091,316,2.2
39001,2010,11881,9986,1895,15.9
39003,2010,52009,46442,5567,10.7
39005,2010,26628,23460,3168,11.9
39007,2010,48407,42139,6268,12.9
39009,2010,28627,25591,3036,10.6
39011,2010,24560,22099,2461,10
39013,2010,33462,29682,3780,11.3
39015,2010,21125,18315,2810,13.3
39017,2010,190738,171600,19138,10
39019,2010,14373,12504,1869,13
39021,2010,19979,17673,2306,11.5
39023,2010,68266,60736,7530,11
39025,2010,104819,93967,10852,10.4
39027,2010,19250,15973,3277,17
39029,2010,52880,46218,6662,12.6
39031,2010,17471,15259,2212,12.7
39033,2010,20960,18266,2694,12.9
39035,2010,631675,577866,53809,8.5
39037,2010,27050,24008,3042,11.2
39039,2010,19971,17539,2432,12.2
39041,2010,94233,87407,6826,7.2
39043,2010,40163,35632,4531,11.3
39045,2010,74265,67429,6836,9.2
39047,2010,14903,12951,1952,13.1
39049,2010,626837,571204,55633,8.9
39051,2010,23144,20405,2739,11.8
39053,2010,13585,11981,1604,11.8
39055,2010,48975,45609,3366,6.9
39057,2010,82080,74255,7825,9.5
39059,2010,18856,16452,2404,12.7
39061,2010,413738,372982,40756,9.9
39063,2010,40457,36778,3679,9.1
39065,2010,15479,13745,1734,11.2
39067,2010,7241,6337,904,12.5
39069,2010,14635,12725,1910,13.1
39071,2010,19185,15869,3316,17.3
39073,2010,14036,12399,1637,11.7
39075,2010,19295,17819,1476,7.6
39077,2010,30287,26289,3998,13.2
39079,2010,14300,12513,1787,12.5
39081,2010,33335,28517,4818,14.5
39083,2010,30913,27924,2989,9.7
39085,2010,126272,116301,9971,7.9
39087,2010,27703,24854,2849,10.3
39089,2010,87551,79133,8418,9.6
39091,2010,23346,20589,2757,11.8
39093,2010,151082,137293,13789,9.1
39095,2010,217424,192330,25094,11.5
39097,2010,20665,18800,1865,9
39099,2010,115100,101612,13488,11.7
39101,2010,30255,26938,3317,11
39103,2010,94041,87055,6986,7.4
39105,2010,10050,8580,1470,14.6
39107,2010,22324,20435,1889,8.5
39109,2010,54400,48365,6035,11.1
39111,2010,6675,5858,817,12.2
39113,2010,265355,235205,30150,11.4
39115,2010,6865,5949,916,13.3
39117,2010,17309,15334,1975,11.4
39119,2010,41656,36417,5239,12.6
39121,2010,5223,4387,836,16
39123,2010,22678,19881,2797,12.3
39125,2010,9696,8477,1219,12.6
39127,2010,16646,14414,2232,13.4
39129,2010,26100,23338,2762,10.6
39131,2010,11586,9868,1718,14.8
39133,2010,90710,81357,9353,10.3
39135,2010,22383,19917,2466,11
39137,2010,19332,17531,1801,9.3
39139,2010,59079,51908,7171,12.1
39141,2010,34084,30016,4068,11.9
39143,2010,33204,29627,3577,10.8
39145,2010,32608,28260,4348,13.3
39147,2010,29460,25942,3518,11.9
39149,2010,24971,21866,3105,12.4
39151,2010,191869,170218,21651,11.3
39153,2010,281497,251683,29814,10.6
39155,2010,99834,86624,13210,13.2
39157,2010,46070,40889,5181,11.2
39159,2010,26657,24421,2236,8.4
39161,2010,14954,13147,1807,12.1
39163,2010,5797,5015,782,13.5
39165,2010,110115,100188,9927,9
39167,2010,29799,26397,3402,11.4
39169,2010,60131,54546,5585,9.3
39171,2010,19538,16967,2571,13.2
39173,2010,68548,61753,6795,9.9
39175,2010,12178,10824,1354,11.1
40001,2010,8906,7969,937,10.5
40003,2010,2497,2375,122,4.9
40005,2010,5113,4601,512,10
40007,2010,2889,2774,115,4
40009,2010,10339,9743,596,5.8
40011,2010,4473,4186,287,6.4
40013,2010,18504,17362,1142,6.2
40015,2010,11833,11011,822,6.9
40017,2010,60083,56985,3098,5.2
40019,2010,21187,19683,1504,7.1
40021,2010,19464,17975,1489,7.7
40023,2010,6123,5566,557,9.1
40025,2010,1457,1406,51,3.5
40027,2010,131125,124196,6929,5.3
40029,2010,2294,2085,209,9.1
40031,2010,51497,48534,2963,5.8
40033,2010,3009,2808,201,6.7
40035,2010,6591,6150,441,6.7
40037,2010,31807,29076,2731,8.6
40039,2010,14155,13426,729,5.2
40041,2010,17181,15810,1371,8
40043,2010,2310,2189,121,5.2
40045,2010,2061,1951,110,5.3
40047,2010,28519,26947,1572,5.5
40049,2010,12162,11248,914,7.5
40051,2010,25401,23741,1660,6.5
40053,2010,2573,2458,115,4.5
40055,2010,2191,2023,168,7.7
40057,2010,1314,1237,77,5.9
40059,2010,1866,1782,84,4.5
40061,2010,4789,4321,468,9.8
40063,2010,5572,4964,608,10.9
40065,2010,11466,10787,679,5.9
40067,2010,2681,2479,202,7.5
40069,2010,3747,3359,388,10.4
40071,2010,20938,19007,1931,9.2
40073,2010,7380,7006,374,5.1
40075,2010,4316,4056,260,6
40077,2010,4574,4115,459,10
40079,2010,20766,18804,1962,9.4
40081,2010,15657,14635,1022,6.5
40083,2010,19805,18684,1121,5.7
40085,2010,4772,4500,272,5.7
40087,2010,17180,16223,957,5.6
40089,2010,14544,12882,1662,11.4
40091,2010,7403,6592,811,11
40093,2010,3941,3743,198,5
40095,2010,6512,6043,469,7.2
40097,2010,18110,16516,1594,8.8
40099,2010,6319,5929,390,6.2
40101,2010,29871,27410,2461,8.2
40103,2010,5249,4894,355,6.8
40105,2010,4905,4449,456,9.3
40107,2010,4354,3928,426,9.8
40109,2010,354254,332486,21768,6.1
40111,2010,16887,15235,1652,9.8
40113,2010,21250,19601,1649,7.8
40115,2010,14559,13386,1173,8.1
40117,2010,7675,6975,700,9.1
40119,2010,36872,34758,2114,5.7
40121,2010,18930,17385,1545,8.2
40123,2010,17733,16637,1096,6.2
40125,2010,30998,28845,2153,6.9
40127,2010,4984,4495,489,9.8
40129,2010,1797,1715,82,4.6
40131,2010,43377,40402,2975,6.9
40133,2010,9927,8974,953,9.6
40135,2010,18100,16363,1737,9.6
40137,2010,19981,18420,1561,7.8
40139,2010,8600,8181,419,4.9
40141,2010,3407,3195,212,6.2
40143,2010,306671,285120,21551,7
40145,2010,35268,32877,2391,6.8
40147,2010,24142,22522,1620,6.7
40149,2010,5459,5127,332,6.1
40151,2010,4289,4107,182,4.2
40153,2010,9355,8710,645,6.9
41001,2010,7361,6606,755,10.3
41003,2010,45075,41873,3202,7.1
41005,2010,202654,182280,20374,10.1
41007,2010,19078,17174,1904,10
41009,2010,23649,20599,3050,12.9
41011,2010,27740,24215,3525,12.7
41013,2010,9582,8055,1527,15.9
41015,2010,9395,8209,1186,12.6
41017,2010,81238,69995,11243,13.8
41019,2010,47878,41184,6694,14
41021,2010,959,873,86,9
41023,2010,3398,2933,465,13.7
41025,2010,3836,3290,546,14.2
41027,2010,14196,13023,1173,8.3
41029,2010,100968,88392,12576,12.5
41031,2010,9629,8314,1315,13.7
41033,2010,34491,29652,4839,14
41035,2010,31221,27186,4035,12.9
41037,2010,3720,3219,501,13.5
41039,2010,178303,158655,19648,11
41041,2010,22117,19679,2438,11
41043,2010,57072,49751,7321,12.8
41045,2010,13474,12172,1302,9.7
41047,2010,155350,138026,17324,11.2
41049,2010,5729,5194,535,9.3
41051,2010,418838,378511,40327,9.6
41053,2010,36385,32848,3537,9.7
41055,2010,905,799,106,11.7
41057,2010,11768,10538,1230,10.5
41059,2010,36689,32916,3773,10.3
41061,2010,12486,11196,1290,10.3
41063,2010,3505,3053,452,12.9
41065,2010,13682,12375,1307,9.6
41067,2010,289670,263707,25963,9
41069,2010,777,703,74,9.5
41071,2010,51226,45885,5341,10.4
42001,2010,54590,50375,4215,7.7
42003,2010,636093,587891,48202,7.6
42005,2010,33637,30578,3059,9.1
42007,2010,85611,78263,7348,8.6
42009,2010,25366,22810,2556,10.1
42011,2010,210149,191919,18230,8.7
42013,2010,61780,56832,4948,8
42015,2010,30820,28591,2229,7.2
42017,2010,337150,311423,25727,7.6
42019,2010,95781,88725,7056,7.4
42021,2010,66751,60461,6290,9.4
42023,2010,2555,2233,322,12.6
42025,2010,31786,28421,3365,10.6
42027,2010,77338,72739,4599,5.9
42029,2010,269540,252699,16841,6.2
42031,2010,19574,17571,2003,10.2
42033,2010,38077,34102,3975,10.4
42035,2010,18749,16987,1762,9.4
42037,2010,34737,31497,3240,9.3
42039,2010,41697,37749,3948,9.5
42041,2010,124448,115940,8508,6.8
42043,2010,140566,129291,11275,8
42045,2010,286187,263287,22900,8
42047,2010,16686,15075,1611,9.7
42049,2010,136361,123674,12687,9.3
42051,2010,59533,53134,6399,10.7
42053,2010,2155,1911,244,11.3
42055,2010,75712,69257,6455,8.5
42057,2010,7434,6522,912,12.3
42059,2010,17411,15954,1457,8.4
42061,2010,21117,18852,2265,10.7
42063,2010,44079,40251,3828,8.7
42065,2010,21607,19430,2177,10.1
42067,2010,12087,11126,961,8
42069,2010,106992,97407,9585,9
42071,2010,268014,247925,20089,7.5
42073,2010,43136,39154,3982,9.2
42075,2010,70062,64826,5236,7.5
42077,2010,177159,160875,16284,9.2
42079,2010,159767,143867,15900,10
42081,2010,59485,54172,5313,8.9
42083,2010,20048,18031,2017,10.1
42085,2010,53629,48518,5111,9.5
42087,2010,21266,19087,2179,10.2
42089,2010,82713,74664,8049,9.7
42091,2010,430386,400493,29893,6.9
42093,2010,9079,8469,610,6.7
42095,2010,151846,138521,13325,8.8
42097,2010,45372,40860,4512,9.9
42099,2010,24988,22965,2023,8.1
42101,2010,687809,615073,72736,10.6
42103,2010,26078,23539,2539,9.7
42105,2010,7802,6991,811,10.4
42107,2010,70689,63197,7492,10.6
42109,2010,20112,18424,1688,8.4
42111,2010,37152,33594,3558,9.6
42113,2010,2960,2723,237,8
42115,2010,21624,19738,1886,8.7
42117,2010,20194,18516,1678,8.3
42119,2010,19192,17711,1481,7.7
42121,2010,26428,24182,2246,8.5
42123,2010,20899,19171,1728,8.3
42125,2010,105280,96765,8515,8.1
42127,2010,23615,21698,1917,8.1
42129,2010,185276,170025,15251,8.2
42131,2010,14335,13078,1257,8.8
42133,2010,230402,211058,19344,8.4
44001,2010,26957,24339,2618,9.7
44003,2010,94263,83796,10467,11.1
44005,2010,45055,40564,4491,10
44007,2010,328921,290209,38712,11.8
44009,2010,71508,64308,7200,10.1
45001,2010,10925,9439,1486,13.6
45003,2010,72368,65639,6729,9.3
45005,2010,3318,2685,633,19.1
45007,2010,85234,75380,9854,11.6
45009,2010,6509,5460,1049,16.1
45011,2010,9489,7913,1576,16.6
45013,2010,65336,59684,5652,8.7
45015,2010,82740,74452,8288,10
45017,2010,7044,6178,866,12.3
45019,2010,178847,163111,15736,8.8
45021,2010,23683,19956,3727,15.7
45023,2010,14689,11860,2829,19.3
45025,2010,21289,18229,3060,14.4
45027,2010,13881,11937,1944,14
45029,2010,16827,14513,2314,13.8
45031,2010,30590,26555,4035,13.2
45033,2010,14014,11783,2231,15.9
45035,2010,65563,59321,6242,9.5
45037,2010,10986,9893,1093,9.9
45039,2010,10672,9113,1559,14.6
45041,2010,64173,56905,7268,11.3
45043,2010,26045,22271,3774,14.5
45045,2010,220209,199005,21204,9.6
45047,2010,31869,28091,3778,11.9
45049,2010,8785,7659,1126,12.8
45051,2010,130946,114859,16087,12.3
45053,2010,10896,9823,1073,9.8
45055,2010,28136,24898,3238,11.5
45057,2010,33952,28955,4997,14.7
45059,2010,30190,26481,3709,12.3
45061,2010,6953,5826,1127,16.2
45063,2010,132937,122033,10904,8.2
45065,2010,3624,3115,509,14
45067,2010,14407,11774,2633,18.3
45069,2010,10871,8567,2304,21.2
45071,2010,18575,16571,2004,10.8
45073,2010,33314,29522,3792,11.4
45075,2010,40102,33722,6380,15.9
45077,2010,54434,48509,5925,10.9
45079,2010,184934,167558,17376,9.4
45081,2010,8684,7813,871,10
45083,2010,131818,116205,15613,11.8
45085,2010,44419,38887,5532,12.5
45087,2010,12392,10202,2190,17.7
45089,2010,13351,11048,2303,17.2
45091,2010,115647,101643,14004,12.1
46003,2010,1677,1618,59,3.5
46005,2010,9427,9033,394,4.2
46007,2010,1195,1109,86,7.2
46009,2010,3189,3055,134,4.2
46011,2010,17847,17013,834,4.7
46013,2010,20882,20078,804,3.9
46015,2010,2733,2632,101,3.7
46017,2010,693,615,78,11.3
46019,2010,5110,4851,259,5.1
46021,2010,907,868,39,4.3
46023,2010,4144,3941,203,4.9
46025,2010,1976,1874,102,5.2
46027,2010,7387,7075,312,4.2
46029,2010,15053,14272,781,5.2
46031,2010,1542,1435,107,6.9
46033,2010,4070,3832,238,5.8
46035,2010,10922,10438,484,4.4
46037,2010,3073,2868,205,6.7
46039,2010,2478,2311,167,6.7
46041,2010,2356,2006,350,14.9
46043,2010,1761,1683,78,4.4
46045,2010,2383,2309,74,3.1
46047,2010,3262,3059,203,6.2
46049,2010,1174,1128,46,3.9
46051,2010,4796,4573,223,4.6
46053,2010,2181,2086,95,4.4
46055,2010,1123,1085,38,3.4
46057,2010,3133,2976,157,5
46059,2010,1903,1841,62,3.3
46061,2010,1768,1675,93,5.3
46063,2010,796,768,28,3.5
46065,2010,10050,9701,349,3.5
46067,2010,3804,3652,152,4
46069,2010,795,765,30,3.8
46071,2010,1393,1298,95,6.8
46073,2010,1198,1154,44,3.7
46075,2010,677,657,20,3
46077,2010,2868,2713,155,5.4
46079,2010,6158,5810,348,5.7
46081,2010,13155,12534,621,4.7
46083,2010,26317,25287,1030,3.9
46085,2010,1947,1821,126,6.5
46087,2010,3241,3081,160,4.9
46089,2010,1207,1148,59,4.9
46091,2010,2467,2334,133,5.4
46093,2010,13148,12457,691,5.3
46095,2010,872,817,55,6.3
46097,2010,1371,1302,69,5
46099,2010,99177,94240,4937,5
46101,2010,4154,3863,291,7
46102,2010,3715,3234,481,12.9
46103,2010,52839,50081,2758,5.2
46105,2010,1612,1545,67,4.2
46107,2010,1276,1214,62,4.9
46109,2010,5050,4757,293,5.8
46111,2010,1345,1289,56,4.2
46115,2010,3591,3456,135,3.8
46117,2010,1955,1881,74,3.8
46119,2010,886,854,32,3.6
46121,2010,3385,3126,259,7.7
46123,2010,3284,3165,119,3.6
46125,2010,4850,4629,221,4.6
46127,2010,7743,7295,448,5.8
46129,2010,2393,2229,164,6.9
46135,2010,11427,10868,559,4.9
46137,2010,1054,993,61,5.8
47001,2010,34926,31675,3251,9.3
47003,2010,21082,18436,2646,12.6
47005,2010,7200,6314,886,12.3
47007,2010,4470,3879,591,13.2
47009,2010,61408,55826,5582,9.1
47011,2010,46448,42086,4362,9.4
47013,2010,16131,14115,2016,12.5
47015,2010,6082,5405,677,11.1
47017,2010,13837,11813,2024,14.6
47019,2010,26226,23359,2867,10.9
47021,2010,20210,18400,1810,9
47023,2010,8363,7529,834,10
47025,2010,13619,12149,1470,10.8
47027,2010,3312,2912,400,12.1
47029,2010,15881,13717,2164,13.6
47031,2010,24263,21647,2616,10.8
47033,2010,7278,6434,844,11.6
47035,2010,23083,20605,2478,10.7
47037,2010,342404,314469,27935,8.2
47039,2010,5299,4603,696,13.1
47041,2010,8159,7206,953,11.7
47043,2010,23958,21512,2446,10.2
47045,2010,17828,15676,2152,12.1
47047,2010,18830,16959,1871,9.9
47049,2010,7407,6489,918,12.4
47051,2010,19306,17357,1949,10.1
47053,2010,23743,20890,2853,12
47055,2010,14243,12525,1718,12.1
47057,2010,10040,8760,1280,12.7
47059,2010,30986,27011,3975,12.8
47061,2010,5635,4923,712,12.6
47063,2010,28403,25120,3283,11.6
47065,2010,169043,154963,14080,8.3
47067,2010,2575,2168,407,15.8
47069,2010,10349,8981,1368,13.2
47071,2010,11429,10053,1376,12
47073,2010,25559,22782,2777,10.9
47075,2010,8960,7561,1399,15.6
47077,2010,12999,11146,1853,14.3
47079,2010,14467,12820,1647,11.4
47081,2010,10980,9757,1223,11.1
47083,2010,3535,3112,423,12
47085,2010,8882,7890,992,11.2
47087,2010,4788,4184,604,12.6
47089,2010,24414,21612,2802,11.5
47091,2010,7446,6491,955,12.8
47093,2010,229800,212757,17043,7.4
47095,2010,2175,1934,241,11.1
47097,2010,10782,9251,1531,14.2
47099,2010,19340,16962,2378,12.3
47101,2010,5407,4595,812,15
47103,2010,15705,14581,1124,7.2
47105,2010,22352,20280,2072,9.3
47107,2010,22839,19978,2861,12.5
47109,2010,10497,9149,1348,12.8
47111,2010,10245,9095,1150,11.2
47113,2010,48201,43363,4838,10
47115,2010,12542,11145,1397,11.1
47117,2010,14400,12382,2018,14
47119,2010,41469,36374,5095,12.3
47121,2010,4971,4320,651,13.1
47123,2010,19493,17014,2479,12.7
47125,2010,75637,69181,6456,8.5
47127,2010,3257,3000,257,7.9
47129,2010,8403,7448,955,11.4
47131,2010,15546,14050,1496,9.6
47133,2010,10246,9151,1095,10.7
47135,2010,3164,2738,426,13.5
47137,2010,2407,2139,268,11.1
47139,2010,7336,6514,822,11.2
47141,2010,34011,30819,3192,9.4
47143,2010,13562,11892,1670,12.3
47145,2010,24323,22089,2234,9.2
47147,2010,33768,30654,3114,9.2
47149,2010,140219,127797,12422,8.9
47151,2010,9253,7680,1573,17
47153,2010,6101,5364,737,12.1
47155,2010,49081,43961,5120,10.4
47157,2010,448829,405047,43782,9.8
47159,2010,8934,7838,1096,12.3
47161,2010,5669,4966,703,12.4
47163,2010,73637,66974,6663,9
47165,2010,83250,75868,7382,8.9
47167,2010,29054,25761,3293,11.3
47169,2010,3742,3336,406,10.8
47171,2010,7919,6973,946,11.9
47173,2010,7763,6927,836,10.8
47175,2010,2342,2033,309,13.2
47177,2010,17750,15815,1935,10.9
47179,2010,60672,55393,5279,8.7
47181,2010,6935,6144,791,11.4
47183,2010,16934,15072,1862,11
47185,2010,12333,11036,1297,10.5
47187,2010,94495,88285,6210,6.6
47189,2010,58517,53617,4900,8.4
48001,2010,21711,19956,1755,8.1
48003,2010,7120,6681,439,6.2
48005,2010,38067,34825,3242,8.5
48007,2010,9686,8796,890,9.2
48009,2010,4601,4295,306,6.7
48011,2010,1012,962,50,4.9
48013,2010,19631,18030,1601,8.2
48015,2010,13920,12801,1119,8
48017,2010,3258,3001,257,7.9
48019,2010,9176,8460,716,7.8
48021,2010,35289,32382,2907,8.2
48023,2010,1733,1611,122,7
48025,2010,10522,9582,940,8.9
48027,2010,131835,121669,10166,7.7
48029,2010,812516,753313,59203,7.3
48031,2010,5419,5096,323,6
48033,2010,357,334,23,6.4
48035,2010,8450,7706,744,8.8
48037,2010,42211,38648,3563,8.4
48039,2010,155227,142043,13184,8.5
48041,2010,100017,93723,6294,6.3
48043,2010,4912,4644,268,5.5
48045,2010,734,689,45,6.1
48047,2010,2592,2282,310,12
48049,2010,16432,15084,1348,8.2
48051,2010,7870,7251,619,7.9
48053,2010,20289,18915,1374,6.8
48055,2010,16661,15225,1436,8.6
48057,2010,10182,9285,897,8.8
48059,2010,6002,5566,436,7.3
48061,2010,162316,144171,18145,11.2
48063,2010,5697,5181,516,9.1
48065,2010,3353,3171,182,5.4
48067,2010,13337,11844,1493,11.2
48069,2010,4138,3915,223,5.4
48071,2010,16607,14999,1608,9.7
48073,2010,21893,19961,1932,8.8
48075,2010,3157,2979,178,5.6
48077,2010,5539,5124,415,7.5
48079,2010,1524,1400,124,8.1
48081,2010,1575,1479,96,6.1
48083,2010,3484,3168,316,9.1
48085,2010,425252,394597,30655,7.2
48087,2010,1341,1266,75,5.6
48089,2010,9596,8816,780,8.1
48091,2010,53489,49723,3766,7
48093,2010,6025,5570,455,7.6
48095,2010,1566,1476,90,5.7
48097,2010,19539,18119,1420,7.3
48099,2010,25338,23441,1897,7.5
48101,2010,669,622,47,7
48103,2010,1819,1681,138,7.6
48105,2010,1721,1575,146,8.5
48107,2010,2951,2716,235,8
48109,2010,1032,959,73,7.1
48111,2010,3880,3673,207,5.3
48113,2010,1194015,1091493,102522,8.6
48115,2010,5136,4741,395,7.7
48117,2010,9504,8957,547,5.8
48119,2010,2596,2391,205,7.9
48121,2010,369088,342972,26116,7.1
48123,2010,9076,8371,705,7.8
48125,2010,871,773,98,11.3
48127,2010,3856,3450,406,10.5
48129,2010,1810,1685,125,6.9
48131,2010,5038,4453,585,11.6
48133,2010,8113,7412,701,8.6
48135,2010,68186,62525,5661,8.3
48137,2010,1037,963,74,7.1
48139,2010,75674,69611,6063,8
48141,2010,340841,309629,31212,9.2
48143,2010,20499,19179,1320,6.4
48145,2010,7242,6626,616,8.5
48147,2010,15341,14092,1249,8.1
48149,2010,12029,11295,734,6.1
48151,2010,1925,1790,135,7
48153,2010,3372,3105,267,7.9
48155,2010,662,618,44,6.6
48157,2010,298162,275453,22709,7.6
48159,2010,4811,4397,414,8.6
48161,2010,8149,7478,671,8.2
48163,2010,7584,7031,553,7.3
48165,2010,7935,7464,471,5.9
48167,2010,147321,133867,13454,9.1
48169,2010,2143,2017,126,5.9
48171,2010,12199,11533,666,5.5
48173,2010,704,670,34,4.8
48175,2010,3356,3108,248,7.4
48177,2010,9304,8670,634,6.8
48179,2010,9282,8485,797,8.6
48181,2010,59489,54620,4869,8.2
48183,2010,60363,55568,4795,7.9
48185,2010,11320,10312,1008,8.9
48187,2010,64924,60560,4364,6.7
48189,2010,16180,14982,1198,7.4
48191,2010,1421,1292,129,9.1
48193,2010,3939,3671,268,6.8
48195,2010,3030,2899,131,4.3
48197,2010,1941,1780,161,8.3
48199,2010,25839,23282,2557,9.9
48201,2010,2064026,1892849,171177,8.3
48203,2010,30822,27934,2888,9.4
48205,2010,2695,2583,112,4.2
48207,2010,2994,2831,163,5.4
48209,2010,80387,74737,5650,7
48211,2010,2130,2046,84,3.9
48213,2010,34752,31691,3061,8.8
48215,2010,318302,280884,37418,11.8
48217,2010,15940,14604,1336,8.4
48219,2010,11030,10252,778,7.1
48221,2010,23352,21363,1989,8.5
48223,2010,16624,15386,1238,7.4
48225,2010,10538,9730,808,7.7
48227,2010,13223,12275,948,7.2
48229,2010,1413,1301,112,7.9
48231,2010,38126,34732,3394,8.9
48233,2010,9707,8887,820,8.4
48235,2010,873,827,46,5.3
48237,2010,3664,3377,287,7.8
48239,2010,7131,6629,502,7
48241,2010,14841,13004,1837,12.4
48243,2010,1273,1210,63,4.9
48245,2010,113217,100371,12846,11.3
48247,2010,2329,2089,240,10.3
48249,2010,18257,16437,1820,10
48251,2010,71940,65703,6237,8.7
48253,2010,6161,5621,540,8.8
48255,2010,4869,4427,442,9.1
48257,2010,50807,46496,4311,8.5
48259,2010,16412,15391,1021,6.2
48261,2010,219,204,15,6.8
48263,2010,559,532,27,4.8
48265,2010,21919,20457,1462,6.7
48267,2010,2276,2140,136,6
48269,2010,278,266,12,4.3
48271,2010,1270,1128,142,11.2
48273,2010,15030,13774,1256,8.4
48275,2010,1909,1797,112,5.9
48277,2010,23300,21135,2165,9.3
48279,2010,6797,6283,514,7.6
48281,2010,9020,8379,641,7.1
48283,2010,2722,2479,243,8.9
48285,2010,9703,9033,670,6.9
48287,2010,8227,7631,596,7.2
48289,2010,7263,6620,643,8.9
48291,2010,30614,27040,3574,11.7
48293,2010,9938,9155,783,7.9
48295,2010,1665,1567,98,5.9
48297,2010,4631,4292,339,7.3
48299,2010,7994,7350,644,8.1
48301,2010,71,67,4,5.6
48303,2010,143339,134372,8967,6.3
48305,2010,3069,2867,202,6.6
48307,2010,4097,3810,287,7
48309,2010,112900,104593,8307,7.4
48311,2010,487,466,21,4.3
48313,2010,4753,4353,400,8.4
48315,2010,4503,3972,531,11.8
48317,2010,2196,2064,132,6
48319,2010,1991,1866,125,6.3
48321,2010,18158,16075,2083,11.5
48323,2010,23525,19959,3566,15.2
48325,2010,20017,18509,1508,7.5
48327,2010,1004,930,74,7.4
48329,2010,71331,67155,4176,5.9
48331,2010,10539,9362,1177,11.2
48333,2010,2190,2051,139,6.3
48335,2010,2971,2727,244,8.2
48337,2010,9424,8670,754,8
48339,2010,224426,207496,16930,7.5
48341,2010,11549,10930,619,5.4
48343,2010,5769,4975,794,13.8
48345,2010,624,585,39,6.3
48347,2010,30782,28593,2189,7.1
48349,2010,22776,20878,1898,8.3
48351,2010,5939,5185,754,12.7
48353,2010,7331,6781,550,7.5
48355,2010,162502,149312,13190,8.1
48357,2010,4868,4580,288,5.9
48359,2010,961,917,44,4.6
48361,2010,38466,33983,4483,11.7
48363,2010,13254,12111,1143,8.6
48365,2010,11404,10373,1031,9
48367,2010,56408,52113,4295,7.6
48369,2010,5353,5117,236,4.4
48371,2010,7180,6653,527,7.3
48373,2010,17563,15861,1702,9.7
48375,2010,58038,54385,3653,6.3
48377,2010,3743,3052,691,18.5
48379,2010,5166,4712,454,8.8
48381,2010,66245,62819,3426,5.2
48383,2010,1912,1806,106,5.5
48385,2010,1137,1033,104,9.1
48387,2010,5580,4936,644,11.5
48389,2010,5748,5239,509,8.9
48391,2010,3328,3037,291,8.7
48393,2010,480,454,26,5.4
48395,2010,7561,6865,696,9.2
48397,2010,39439,36524,2915,7.4
48399,2010,5129,4702,427,8.3
48401,2010,23961,22091,1870,7.8
48403,2010,3654,3058,596,16.3
48405,2010,3193,2779,414,13
48407,2010,11230,10110,1120,10
48409,2010,30434,27243,3191,10.5
48411,2010,2559,2401,158,6.2
48413,2010,1634,1510,124,7.6
48415,2010,7101,6619,482,6.8
48417,2010,1904,1798,106,5.6
48419,2010,11839,10837,1002,8.5
48421,2010,1555,1484,71,4.6
48423,2010,101151,93110,8041,7.9
48425,2010,4043,3721,322,8
48427,2010,26074,21565,4509,17.3
48429,2010,4245,3928,317,7.5
48431,2010,675,643,32,4.7
48433,2010,746,703,43,5.8
48435,2010,1990,1799,191,9.6
48437,2010,3182,2973,209,6.6
48439,2010,924951,849576,75375,8.1
48441,2010,64285,59931,4354,6.8
48443,2010,501,467,34,6.8
48445,2010,5756,5328,428,7.4
48447,2010,877,824,53,6
48449,2010,13988,12795,1193,8.5
48451,2010,52595,49149,3446,6.6
48453,2010,575630,536660,38970,6.8
48455,2010,5783,5232,551,9.5
48457,2010,7904,6973,931,11.8
48459,2010,18283,16675,1608,8.8
48461,2010,1552,1457,95,6.1
48463,2010,11826,10769,1057,8.9
48465,2010,20619,18704,1915,9.3
48467,2010,23601,21620,1981,8.4
48469,2010,43079,39778,3301,7.7
48471,2010,23234,21436,1798,7.7
48473,2010,19960,18234,1726,8.6
48475,2010,4631,4239,392,8.5
48477,2010,15561,14439,1122,7.2
48479,2010,105016,96364,8652,8.2
48481,2010,21279,19431,1848,8.7
48483,2010,2732,2565,167,6.1
48485,2010,59280,54681,4599,7.8
48487,2010,6140,5657,483,7.9
48489,2010,7781,6656,1125,14.5
48491,2010,222584,206458,16126,7.2
48493,2010,21235,19785,1450,6.8
48495,2010,2898,2632,266,9.2
48497,2010,27668,25269,2399,8.7
48499,2010,16969,15432,1537,9.1
48501,2010,3690,3433,257,7
48503,2010,8646,7982,664,7.7
48505,2010,5761,5162,599,10.4
48507,2010,4557,3924,633,13.9
49001,2010,3157,2843,314,9.9
49003,2010,23644,21640,2004,8.5
49005,2010,57249,53768,3481,6.1
49007,2010,9910,9057,853,8.6
49009,2010,495,459,36,7.3
49011,2010,146959,136698,10261,7
49013,2010,8166,7385,781,9.6
49015,2010,5290,4906,384,7.3
49017,2010,3074,2760,314,10.2
49019,2010,5323,4764,559,10.5
49021,2010,20414,18457,1957,9.6
49023,2010,4612,4191,421,9.1
49025,2010,3561,3278,283,7.9
49027,2010,6421,6023,398,6.2
49029,2010,4274,3980,294,6.9
49031,2010,572,514,58,10.1
49033,2010,1039,964,75,7.2
49035,2010,548378,506309,42069,7.7
49037,2010,6087,5424,663,10.9
49039,2010,11461,10426,1035,9
49041,2010,9727,8917,810,8.3
49043,2010,20857,19313,1544,7.4
49045,2010,27454,25163,2291,8.3
49047,2010,15189,13896,1293,8.5
49049,2010,229820,212729,17091,7.4
49051,2010,11360,10405,955,8.4
49053,2010,56776,50821,5955,10.5
49055,2010,1576,1441,135,8.6
49057,2010,113259,103288,9971,8.8
50001,2010,21241,20005,1236,5.8
50003,2010,20339,18932,1407,6.9
50005,2010,16785,15649,1136,6.8
50007,2010,94581,90040,4541,4.8
50009,2010,3171,2855,316,10
50011,2010,27686,26107,1579,5.7
50013,2010,4134,3848,286,6.9
50015,2010,14496,13392,1104,7.6
50017,2010,16725,15743,982,5.9
50019,2010,14213,12948,1265,8.9
50021,2010,33590,31105,2485,7.4
50023,2010,35117,33049,2068,5.9
50025,2010,25435,23873,1562,6.1
50027,2010,31889,29942,1947,6.1
51001,2010,16805,15479,1326,7.9
51003,2010,50987,47937,3050,6
51005,2010,7951,7264,687,8.6
51007,2010,6227,5699,528,8.5
51009,2010,16352,15030,1322,8.1
51011,2010,7343,6711,632,8.6
51013,2010,137368,131701,5667,4.1
51015,2010,37130,34481,2649,7.1
51017,2010,2509,2320,189,7.5
51019,2010,39053,36302,2751,7
51021,2010,2895,2646,249,8.6
51023,2010,17700,16559,1141,6.4
51025,2010,6953,6168,785,11.3
51027,2010,8326,7497,829,10
51029,2010,6568,5868,700,10.7
51031,2010,27756,25614,2142,7.7
51033,2010,14342,12972,1370,9.6
51035,2010,14004,12388,1616,11.5
51036,2010,3901,3527,374,9.6
51037,2010,5356,4820,536,10
51041,2010,168602,156307,12295,7.3
51043,2010,7695,7181,514,6.7
51045,2010,2441,2247,194,7.9
51047,2010,23263,21591,1672,7.2
51049,2010,4523,4141,382,8.4
51051,2010,5513,4934,579,10.5
51053,2010,13566,12367,1199,8.8
51057,2010,5715,5196,519,9.1
51059,2010,610521,579499,31022,5.1
51061,2010,35763,33552,2211,6.2
51063,2010,8134,7567,567,7
51065,2010,13078,12253,825,6.3
51067,2010,27622,25216,2406,8.7
51069,2010,41981,38832,3149,7.5
51071,2010,8302,7507,795,9.6
51073,2010,19553,18219,1334,6.8
51075,2010,10483,9733,750,7.2
51077,2010,7373,6455,918,12.5
51079,2010,9655,9007,648,6.7
51081,2010,4562,4124,438,9.6
51083,2010,16686,14651,2035,12.2
51085,2010,54430,50855,3575,6.6
51087,2010,167701,155452,12249,7.3
51089,2010,24007,20467,3540,14.7
51091,2010,1445,1355,90,6.2
51093,2010,18800,17458,1342,7.1
51095,2010,32243,30205,2038,6.3
51097,2010,3592,3302,290,8.1
51099,2010,11413,10573,840,7.4
51101,2010,8656,8011,645,7.5
51103,2010,5570,5024,546,9.8
51105,2010,10127,9325,802,7.9
51107,2010,175439,166487,8952,5.1
51109,2010,17858,16513,1345,7.5
51111,2010,5547,5020,527,9.5
51113,2010,7169,6717,452,6.3
51115,2010,4224,3956,268,6.3
51117,2010,14158,12552,1606,11.3
51119,2010,5160,4789,371,7.2
51121,2010,47497,44140,3357,7.1
51125,2010,7574,7034,540,7.1
51127,2010,10294,9550,744,7.2
51131,2010,6335,5799,536,8.5
51133,2010,6150,5617,533,8.7
51135,2010,6859,6338,521,7.6
51137,2010,15456,14178,1278,8.3
51139,2010,12336,10900,1436,11.6
51141,2010,8321,7265,1056,12.7
51143,2010,30911,27543,3368,10.9
51145,2010,13510,12557,953,7.1
51147,2010,10279,9284,995,9.7
51149,2010,13962,12838,1124,8.1
51153,2010,218394,205097,13297,6.1
51155,2010,16975,15091,1884,11.1
51157,2010,4025,3771,254,6.3
51159,2010,4366,4058,308,7.1
51161,2010,49258,46137,3121,6.3
51163,2010,11142,10303,839,7.5
51165,2010,40373,37656,2717,6.7
51167,2010,12081,10844,1237,10.2
51169,2010,10072,9219,853,8.5
51171,2010,20831,19117,1714,8.2
51173,2010,13707,12046,1661,12.1
51175,2010,9495,8679,816,8.6
51177,2010,63357,58922,4435,7
51179,2010,63904,59748,4156,6.5
51181,2010,3694,3363,331,9
51183,2010,4281,3792,489,11.4
51185,2010,18394,16779,1615,8.8
51187,2010,20103,18480,1623,8.1
51191,2010,27416,25239,2177,7.9
51193,2010,9178,8436,742,8.1
51195,2010,16977,15561,1416,8.3
51197,2010,14277,12687,1590,11.1
51199,2010,31289,29377,1912,6.1
51510,2010,90361,85915,4446,4.9
51520,2010,7977,7274,703,8.8
51530,2010,3248,2925,323,9.9
51540,2010,23203,21790,1413,6.1
51550,2010,113319,105173,8146,7.2
51570,2010,8533,7828,705,8.3
51580,2010,2689,2403,286,10.6
51590,2010,20099,17390,2709,13.5
51595,2010,2570,2251,319,12.4
51600,2010,12663,11974,689,5.4
51610,2010,7382,7022,360,4.9
51620,2010,3708,3241,467,12.6
51630,2010,12423,11304,1119,9
51640,2010,3172,2825,347,10.9
51650,2010,66666,60687,5979,9
51660,2010,23165,21250,1915,8.3
51670,2010,9864,8721,1143,11.6
51678,2010,2300,2086,214,9.3
51680,2010,35841,32798,3043,8.5
51683,2010,20972,19503,1469,7
51685,2010,8066,7563,503,6.2
51690,2010,6136,5066,1070,17.4
51700,2010,90664,83104,7560,8.3
51710,2010,112449,102606,9843,8.8
51720,2010,2079,1928,151,7.3
51730,2010,13877,11939,1938,14
51735,2010,6395,6007,388,6.1
51740,2010,45461,41102,4359,9.6
51750,2010,7787,7060,727,9.3
51760,2010,106456,96347,10109,9.5
51770,2010,49317,45022,4295,8.7
51775,2010,12789,11910,879,6.9
51790,2010,11846,10920,926,7.8
51800,2010,41753,38581,3172,7.6
51810,2010,226894,212145,14749,6.5
51820,2010,10170,9255,915,9
51830,2010,6516,5856,660,10.1
51840,2010,13688,12551,1137,8.3
53001,2010,8440,7555,885,10.5
53003,2010,10333,9361,972,9.4
53005,2010,94253,86846,7407,7.9
53007,2010,42102,38353,3749,8.9
53009,2010,29621,26352,3269,11
53011,2010,216620,188628,27992,12.9
53013,2010,1959,1774,185,9.4
53015,2010,46432,40435,5997,12.9
53017,2010,19876,17945,1931,9.7
53019,2010,2645,2181,464,17.5
53021,2010,38254,34884,3370,8.8
53023,2010,1061,973,88,8.3
53025,2010,43212,38522,4690,10.9
53027,2010,31046,26723,4323,13.9
53029,2010,33812,30665,3147,9.3
53031,2010,12750,11436,1314,10.3
53033,2010,1105830,1006061,99769,9
53035,2010,120592,110230,10362,8.6
53037,2010,21306,19221,2085,9.8
53039,2010,10328,9069,1259,12.2
53041,2010,33962,29503,4459,13.1
53043,2010,5327,4880,447,8.4
53045,2010,24941,21963,2978,11.9
53047,2010,22347,19950,2397,10.7
53049,2010,8789,7557,1232,14
53051,2010,5148,4359,789,15.3
53053,2010,395844,354576,41268,10.4
53055,2010,8449,7831,618,7.3
53057,2010,59114,52658,6456,10.9
53059,2010,5179,4514,665,12.8
53061,2010,386587,345332,41255,10.7
53063,2010,238125,214109,24016,10.1
53065,2010,19104,16603,2501,13.1
53067,2010,126948,115550,11398,9
53069,2010,1472,1247,225,15.3
53071,2010,30530,28085,2445,8
53073,2010,104359,94467,9892,9.5
53075,2010,22489,20977,1512,6.7
53077,2010,122140,109168,12972,10.6
54001,2010,6870,6180,690,10
54003,2010,51020,46642,4378,8.6
54005,2010,8812,8035,777,8.8
54007,2010,5686,5056,630,11.1
54009,2010,10917,9672,1245,11.4
54011,2010,43292,40164,3128,7.2
54013,2010,2906,2499,407,14
54015,2010,3647,3131,516,14.1
54017,2010,3315,3078,237,7.1
54019,2010,17567,15817,1750,10
54021,2010,2775,2528,247,8.9
54023,2010,6124,5525,599,9.8
54025,2010,15430,14080,1350,8.7
54027,2010,9765,8877,888,9.1
54029,2010,14174,12456,1718,12.1
54031,2010,5710,5048,662,11.6
54033,2010,31254,28872,2382,7.6
54035,2010,12313,10911,1402,11.4
54037,2010,26869,25077,1792,6.7
54039,2010,92603,85765,6838,7.4
54041,2010,6990,6376,614,8.8
54043,2010,7873,6948,925,11.7
54045,2010,12687,11404,1283,10.1
54047,2010,6362,5521,841,13.2
54049,2010,26641,24703,1938,7.3
54051,2010,14680,13261,1419,9.7
54053,2010,11282,9980,1302,11.5
54055,2010,24076,22035,2041,8.5
54057,2010,12362,11208,1154,9.3
54059,2010,9168,8266,902,9.8
54061,2010,48354,45653,2701,5.6
54063,2010,5764,5303,461,8
54065,2010,7677,6975,702,9.1
54067,2010,10937,9841,1096,10
54069,2010,21826,20093,1733,7.9
54071,2010,3658,3343,315,8.6
54073,2010,2937,2627,310,10.6
54075,2010,3800,3363,437,11.5
54077,2010,14935,13687,1248,8.4
54079,2010,26390,24389,2001,7.6
54081,2010,32470,29824,2646,8.1
54083,2010,12208,10927,1281,10.5
54085,2010,4295,3878,417,9.7
54087,2010,5510,4759,751,13.6
54089,2010,4783,4330,453,9.5
54091,2010,7446,6872,574,7.7
54093,2010,3301,2937,364,11
54095,2010,3551,3145,406,11.4
54097,2010,10369,9409,960,9.3
54099,2010,16938,15493,1445,8.5
54101,2010,3739,3360,379,10.1
54103,2010,7016,6193,823,11.7
54105,2010,2292,2005,287,12.5
54107,2010,39348,35850,3498,8.9
54109,2010,8414,7540,874,10.4
55001,2010,9137,8005,1132,12.4
55003,2010,8411,7478,933,11.1
55005,2010,23791,21586,2205,9.3
55007,2010,7688,6836,852,11.1
55009,2010,137150,126334,10816,7.9
55011,2010,7197,6639,558,7.8
55013,2010,7578,6737,841,11.1
55015,2010,27304,25420,1884,6.9
55017,2010,33182,30385,2797,8.4
55019,2010,17258,15478,1780,10.3
55021,2010,32090,29361,2729,8.5
55023,2010,8367,7489,878,10.5
55025,2010,293224,275819,17405,5.9
55027,2010,47350,43073,4277,9
55029,2010,15758,13985,1773,11.3
55031,2010,23737,21759,1978,8.3
55033,2010,23243,21409,1834,7.9
55035,2010,57107,53137,3970,7
55037,2010,2247,2014,233,10.4
55039,2010,56516,51715,4801,8.5
55041,2010,4253,3755,498,11.7
55043,2010,27778,25663,2115,7.6
55045,2010,21274,19572,1702,8
55047,2010,10308,9347,961,9.3
55049,2010,13772,12636,1136,8.2
55051,2010,2881,2554,327,11.4
55053,2010,10123,9238,885,8.7
55055,2010,46472,42414,4058,8.7
55057,2010,13697,12330,1367,10
55059,2010,85868,77044,8824,10.3
55061,2010,11178,10262,916,8.2
55063,2010,65593,61237,4356,6.6
55065,2010,9489,8810,679,7.2
55067,2010,10181,9062,1119,11
55069,2010,15661,13888,1773,11.3
55071,2010,44631,40203,4428,9.9
55073,2010,73520,66691,6829,9.3
55075,2010,21380,19013,2367,11.1
55077,2010,7691,6855,836,10.9
55078,2010,1550,1279,271,17.5
55079,2010,476449,428834,47615,10
55081,2010,23123,21282,1841,8
55083,2010,21331,19041,2290,10.7
55085,2010,19065,17122,1943,10.2
55087,2010,100596,92454,8142,8.1
55089,2010,47415,44056,3359,7.1
55091,2010,4095,3790,305,7.4
55093,2010,23984,22317,1667,7
55095,2010,24046,21653,2393,10
55097,2010,39855,36669,3186,8
55099,2010,7563,6736,827,10.9
55101,2010,100314,90121,10193,10.2
55103,2010,9631,8764,867,9
55105,2010,82698,73383,9315,11.3
55107,2010,7141,6264,877,12.3
55109,2010,47067,43467,3600,7.6
55111,2010,35853,32832,3021,8.4
55113,2010,8393,7446,947,11.3
55115,2010,21884,19645,2239,10.2
55117,2010,62238,56456,5782,9.3
55119,2010,11449,10273,1176,10.3
55121,2010,15984,14777,1207,7.6
55123,2010,15161,13965,1196,7.9
55125,2010,10345,9176,1169,11.3
55127,2010,56360,51276,5084,9
55129,2010,8043,7262,781,9.7
55131,2010,75604,69491,6113,8.1
55133,2010,218009,201996,16013,7.3
55135,2010,27744,25123,2621,9.4
55137,2010,12026,10731,1295,10.8
55139,2010,92450,85226,7224,7.8
55141,2010,39965,36255,3710,9.3
56001,2010,21381,20425,956,4.5
56003,2010,5631,5255,376,6.7
56005,2010,26296,24709,1587,6
56007,2010,8254,7698,556,6.7
56009,2010,7568,7155,413,5.5
56011,2010,3910,3715,195,5
56013,2010,20971,19514,1457,6.9
56015,2010,7500,7132,368,4.9
56017,2010,2569,2435,134,5.2
56019,2010,4535,4226,309,6.8
56021,2010,46182,43092,3090,6.7
56023,2010,8675,7947,728,8.4
56025,2010,39894,37110,2784,7
56027,2010,1387,1323,64,4.6
56029,2010,15849,14876,973,6.1
56031,2010,4965,4690,275,5.5
56033,2010,16132,14951,1181,7.3
56035,2010,5691,5358,333,5.9
56037,2010,23134,21608,1526,6.6
56039,2010,13611,12569,1042,7.7
56041,2010,10557,9815,742,7
56043,2010,4589,4318,271,5.9
56045,2010,4016,3822,194,4.8
72001,2010,5185,4169,1016,19.6
72003,2010,13495,10869,2626,19.5
72005,2010,17419,13863,3556,20.4
72007,2010,7969,6202,1767,22.2
72009,2010,7547,6080,1467,19.4
72011,2010,9997,8064,1933,19.3
72013,2010,27909,22893,5016,18
72015,2010,6189,4766,1423,23
72017,2010,6632,5007,1625,24.5
72019,2010,8137,6694,1443,17.7
72021,2010,76813,66891,9922,12.9
72023,2010,15462,12898,2564,16.6
72025,2010,54812,46287,8525,15.6
72027,2010,10858,9067,1791,16.5
72029,2010,17699,14543,3156,17.8
72031,2010,71411,62139,9272,13
72033,2010,9287,7879,1408,15.2
72035,2010,18187,15305,2882,15.8
72037,2010,4676,3706,970,20.7
72039,2010,4792,3500,1292,27
72041,2010,17487,14742,2745,15.7
72043,2010,12174,9506,2668,21.9
72045,2010,5863,4560,1303,22.2
72047,2010,10186,8424,1762,17.3
72049,2010,816,733,83,10.2
72051,2010,13550,11926,1624,12
72053,2010,13682,10938,2744,20.1
72054,2010,3851,3000,851,22.1
72055,2010,5116,3808,1308,25.6
72057,2010,15004,11483,3521,23.5
72059,2010,6274,4744,1530,24.4
72061,2010,41252,37746,3506,8.5
72063,2010,17666,15191,2475,14
72065,2010,14036,11738,2298,16.4
72067,2010,6255,5232,1023,16.4
72069,2010,20230,15958,4272,21.1
72071,2010,13404,10725,2679,20
72073,2010,5099,4103,996,19.5
72075,2010,17199,14100,3099,18
72077,2010,13390,10882,2508,18.7
72079,2010,6571,5070,1501,22.8
72081,2010,8052,6446,1606,19.9
72083,2010,3670,2997,673,18.3
72085,2010,12271,9883,2388,19.5
72087,2010,10240,8523,1717,16.8
72089,2010,7256,5767,1489,20.5
72091,2010,13527,10982,2545,18.8
72093,2010,2324,1898,426,18.3
72095,2010,3546,2671,875,24.7
72097,2010,27839,22633,5206,18.7
72099,2010,12051,9598,2453,20.4
72101,2010,9287,7168,2119,22.8
72103,2010,9099,7152,1947,21.4
72105,2010,8239,6570,1669,20.3
72107,2010,6089,4728,1361,22.4
72109,2010,6024,4441,1583,26.3
72111,2010,7505,5686,1819,24.2
72113,2010,55611,46076,9535,17.1
72115,2010,6840,5499,1341,19.6
72117,2010,4986,4066,920,18.5
72119,2010,18875,15999,2876,15.2
72121,2010,7532,5908,1624,21.6
72123,2010,9174,6787,2387,26
72125,2010,11980,9773,2207,18.4
72127,2010,155408,139469,15939,10.3
72129,2010,13327,11002,2325,17.4
72131,2010,11855,9218,2637,22.2
72133,2010,10393,8241,2152,20.7
72135,2010,27302,24016,3286,12
72137,2010,33982,29678,4304,12.7
72139,2010,30302,27126,3176,10.5
72141,2010,8113,6422,1691,20.8
72143,2010,10822,8963,1859,17.2
72145,2010,16228,12856,3372,20.8
72147,2010,3401,2767,634,18.6
72149,2010,8841,6892,1949,22
72151,2010,11003,8210,2793,25.4
72153,2010,12098,9514,2584,21.4
01001,2011,25836,23677,2159,8.4
01003,2011,85045,77418,7627,9
01005,2011,9849,8712,1137,11.5
01007,2011,8933,7996,937,10.5
01009,2011,25123,22939,2184,8.7
01011,2011,4833,4272,561,11.6
01013,2011,9188,8042,1146,12.5
01015,2011,51268,45963,5305,10.3
01017,2011,15200,13380,1820,12
01019,2011,11476,10364,1112,9.7
01021,2011,19539,17753,1786,9.1
01023,2011,4764,4138,626,13.1
01025,2011,8843,7181,1662,18.8
01027,2011,5598,4935,663,11.8
01029,2011,5939,5365,574,9.7
01031,2011,20749,19059,1690,8.1
01033,2011,24386,21905,2481,10.2
01035,2011,4785,4057,728,15.2
01037,2011,4477,3918,559,12.5
01039,2011,16367,14764,1603,9.8
01041,2011,6432,5798,634,9.9
01043,2011,35669,32279,3390,9.5
01045,2011,22017,20188,1829,8.3
01047,2011,17514,14866,2648,15.1
01049,2011,29809,26279,3530,11.8
01051,2011,36597,33521,3076,8.4
01053,2011,14978,13355,1623,10.8
01055,2011,44722,40238,4484,10
01057,2011,6632,5896,736,11.1
01059,2011,14362,12986,1376,9.6
01061,2011,11486,10429,1057,9.2
01063,2011,3226,2668,558,17.3
01065,2011,6296,5426,870,13.8
01067,2011,7270,6563,707,9.7
01069,2011,46778,42747,4031,8.6
01071,2011,24163,21682,2481,10.3
01073,2011,319652,289916,29736,9.3
01075,2011,5826,5260,566,9.7
01077,2011,44048,40026,4022,9.1
01079,2011,14788,13177,1611,10.9
01081,2011,68316,62812,5504,8.1
01083,2011,38990,35631,3359,8.6
01085,2011,4239,3489,750,17.7
01087,2011,8512,7317,1195,14
01089,2011,171726,157512,14214,8.3
01091,2011,7875,6884,991,12.6
01093,2011,12556,11149,1407,11.2
01095,2011,41085,37216,3869,9.4
01097,2011,193851,172971,20880,10.8
01099,2011,8325,7017,1308,15.7
01101,2011,109092,98491,10601,9.7
01103,2011,58319,52810,5509,9.4
01105,2011,3866,3227,639,16.5
01107,2011,7570,6663,907,12
01109,2011,15438,14070,1368,8.9
01111,2011,9447,8374,1073,11.4
01113,2011,24604,22077,2527,10.3
01115,2011,38509,35135,3374,8.8
01117,2011,104214,97727,6487,6.2
01119,2011,5560,4829,731,13.1
01121,2011,35293,31192,4101,11.6
01123,2011,18363,16266,2097,11.4
01125,2011,95463,87532,7931,8.3
01127,2011,27092,24034,3058,11.3
01129,2011,7106,6070,1036,14.6
01131,2011,2979,2289,690,23.2
01133,2011,9819,8492,1327,13.5
02013,2011,2183,2048,135,6.2
02016,2011,4255,4007,248,5.8
02020,2011,159006,149542,9464,6
02050,2011,7221,6137,1084,15
02060,2011,518,472,46,8.9
02068,2011,1018,879,139,13.7
02070,2011,2106,1883,223,10.6
02090,2011,48354,45238,3116,6.4
02100,2011,1167,1050,117,10
02105,2011,1099,933,166,15.1
02110,2011,17907,16913,994,5.6
02122,2011,27273,24675,2598,9.5
02130,2011,7180,6560,620,8.6
02150,2011,6783,6281,502,7.4
02158,2011,2759,2177,582,21.1
02164,2011,638,542,96,15
02170,2011,43368,39390,3978,9.2
02180,2011,4127,3619,508,12.3
02185,2011,3993,3690,303,7.6
02188,2011,2987,2524,463,15.5
02195,2011,1856,1701,155,8.4
02198,2011,2572,2254,318,12.4
02220,2011,4632,4348,284,6.1
02230,2011,716,600,116,16.2
02240,2011,3202,2804,398,12.4
02261,2011,4938,4449,489,9.9
02275,2011,1051,972,79,7.5
02282,2011,301,269,32,10.6
02290,2011,2706,2208,498,18.4
04001,2011,23040,18788,4252,18.5
04003,2011,55917,50589,5328,9.5
04005,2011,71682,64846,6836,9.5
04007,2011,21171,18725,2446,11.6
04009,2011,14345,12916,1429,10
04011,2011,3352,2982,370,11
04012,2011,7827,7057,770,9.8
04013,2011,1894633,1732510,162123,8.6
04015,2011,79594,69823,9771,12.3
04017,2011,43344,36914,6430,14.8
04019,2011,466908,427335,39573,8.5
04021,2011,149658,135043,14615,9.8
04023,2011,20478,17311,3167,15.5
04025,2011,93132,83953,9179,9.9
04027,2011,91935,69677,22258,24.2
05001,2011,10589,9297,1292,12.2
05003,2011,9886,8780,1106,11.2
05005,2011,16602,15061,1541,9.3
05007,2011,109574,102441,7133,6.5
05009,2011,16697,15367,1330,8
05011,2011,4560,3988,572,12.5
05013,2011,2639,2385,254,9.6
05015,2011,12896,11964,932,7.2
05017,2011,4282,3718,564,13.2
05019,2011,10335,9261,1074,10.4
05021,2011,7304,6419,885,12.1
05023,2011,10551,9579,972,9.2
05025,2011,3885,3554,331,8.5
05027,2011,10445,9401,1044,10
05029,2011,9038,8145,893,9.9
05031,2011,49190,45556,3634,7.4
05033,2011,28020,25539,2481,8.9
05035,2011,22778,20293,2485,10.9
05037,2011,8832,8092,740,8.4
05039,2011,3322,2908,414,12.5
05041,2011,6151,5464,687,11.2
05043,2011,8656,7651,1005,11.6
05045,2011,59482,55206,4276,7.2
05047,2011,7799,7201,598,7.7
05049,2011,5127,4729,398,7.8
05051,2011,41787,38127,3660,8.8
05053,2011,8560,7928,632,7.4
05055,2011,20147,18189,1958,9.7
05057,2011,11024,10049,975,8.8
05059,2011,14527,13320,1207,8.3
05061,2011,6746,6240,506,7.5
05063,2011,16711,15149,1562,9.3
05065,2011,5232,4713,519,9.9
05067,2011,6714,5935,779,11.6
05069,2011,33727,29978,3749,11.1
05071,2011,11134,10256,878,7.9
05073,2011,3007,2716,291,9.7
05075,2011,7471,6731,740,9.9
05077,2011,3678,3326,352,9.6
05079,2011,4782,4335,447,9.3
05081,2011,6143,5662,481,7.8
05083,2011,9641,8790,851,8.8
05085,2011,33448,31123,2325,7
05087,2011,7244,6753,491,6.8
05089,2011,6758,6120,638,9.4
05091,2011,20808,19484,1324,6.4
05093,2011,20984,18454,2530,12.1
05095,2011,3390,3067,323,9.5
05097,2011,3826,3470,356,9.3
05099,2011,4180,3784,396,9.5
05101,2011,3803,3518,285,7.5
05103,2011,11066,9900,1166,10.5
05105,2011,4520,4098,422,9.3
05107,2011,8447,7421,1026,12.1
05109,2011,4654,4186,468,10.1
05111,2011,10817,9783,1034,9.6
05113,2011,8947,8226,721,8.1
05115,2011,30517,28125,2392,7.8
05117,2011,3937,3596,341,8.7
05119,2011,190083,175884,14199,7.5
05121,2011,7186,6375,811,11.3
05123,2011,9824,8729,1095,11.1
05125,2011,54212,50604,3608,6.7
05127,2011,4832,4489,343,7.1
05129,2011,3336,3030,306,9.2
05131,2011,59600,54442,5158,8.7
05133,2011,6402,5812,590,9.2
05135,2011,6294,5619,675,10.7
05137,2011,5402,4919,483,8.9
05139,2011,16977,15187,1790,10.5
05141,2011,6756,6010,746,11
05143,2011,104823,98216,6607,6.3
05145,2011,36768,33580,3188,8.7
05147,2011,3571,3179,392,11
05149,2011,9605,8886,719,7.5
06001,2011,786756,707381,79375,10.1
06003,2011,593,517,76,12.8
06005,2011,15095,13040,2055,13.6
06007,2011,100647,86891,13756,13.7
06009,2011,20668,17769,2899,14
06011,2011,11376,8959,2417,21.2
06013,2011,529551,475011,54540,10.3
06015,2011,10895,9446,1449,13.3
06017,2011,89690,79188,10502,11.7
06019,2011,443509,370224,73285,16.5
06021,2011,13167,11124,2043,15.5
06023,2011,65106,58228,6878,10.6
06025,2011,79456,56524,22932,28.9
06027,2011,9682,8741,941,9.7
06029,2011,382367,325712,56655,14.8
06031,2011,59123,49718,9405,15.9
06033,2011,29611,25310,4301,14.5
06035,2011,11785,10190,1595,13.5
06037,2011,4928464,4327923,600541,12.2
06039,2011,62014,51990,10024,16.2
06041,2011,134576,124801,9775,7.3
06043,2011,8661,7520,1141,13.2
06045,2011,40953,36284,4669,11.4
06047,2011,114735,94500,20235,17.6
06049,2011,3620,3042,578,16
06051,2011,8832,7944,888,10.1
06053,2011,216558,189146,27412,12.7
06055,2011,70760,63846,6914,9.8
06057,2011,49021,43590,5431,11.1
06059,2011,1546389,1406411,139978,9.1
06061,2011,173744,154923,18821,10.8
06063,2011,8890,7326,1564,17.6
06065,2011,978514,849635,128879,13.2
06067,2011,679995,597683,82312,12.1
06069,2011,28281,24179,4102,14.5
06071,2011,888513,774166,114347,12.9
06073,2011,1524582,1367250,157332,10.3
06075,2011,494760,454861,39899,8.1
06077,2011,311363,260997,50366,16.2
06079,2011,134374,121509,12865,9.6
06081,2011,399859,369827,30032,7.5
06083,2011,213005,193023,19982,9.4
06085,2011,939851,852426,87425,9.3
06087,2011,141335,122865,18470,13.1
06089,2011,77044,64762,12282,15.9
06091,2011,1601,1363,238,14.9
06093,2011,19435,16134,3301,17
06095,2011,202241,177619,24622,12.2
06097,2011,246171,220958,25213,10.2
06099,2011,242320,202360,39960,16.5
06101,2011,45939,37596,8343,18.2
06103,2011,25574,21744,3830,15
06105,2011,5385,4486,899,16.7
06107,2011,203474,168687,34787,17.1
06109,2011,22725,19440,3285,14.5
06111,2011,431718,387495,44223,10.2
06113,2011,101806,89818,11988,11.8
06115,2011,28948,24035,4913,17
08001,2011,236385,212931,23454,9.9
08003,2011,7684,6942,742,9.7
08005,2011,319253,292867,26386,8.3
08007,2011,5748,5169,579,10.1
08009,2011,2068,1969,99,4.8
08011,2011,1929,1770,159,8.2
08013,2011,172002,160904,11098,6.5
08014,2011,31768,29539,2229,7
08015,2011,8301,7702,599,7.2
08017,2011,1050,1006,44,4.2
08019,2011,5500,5094,406,7.4
08021,2011,3728,3338,390,10.5
08023,2011,1582,1397,185,11.7
08025,2011,1488,1356,132,8.9
08027,2011,2017,1889,128,6.3
08029,2011,14409,12905,1504,10.4
08031,2011,352226,321953,30273,8.6
08033,2011,947,826,121,12.8
08035,2011,158279,148154,10125,6.4
08037,2011,32147,29624,2523,7.8
08039,2011,12674,11724,950,7.5
08041,2011,307563,279542,28021,9.1
08043,2011,15916,14005,1911,12
08045,2011,31376,28404,2972,9.5
08047,2011,3269,3033,236,7.2
08049,2011,8795,8087,708,8.1
08051,2011,9935,9336,599,6
08053,2011,473,449,24,5.1
08055,2011,2659,2298,361,13.6
08057,2011,893,839,54,6
08059,2011,302402,278353,24049,8
08061,2011,836,794,42,5
08063,2011,4265,4065,200,4.7
08065,2011,4377,3936,441,10.1
08067,2011,29476,27408,2068,7
08069,2011,170942,158704,12238,7.2
08071,2011,6977,6208,769,11
08073,2011,2193,2054,139,6.3
08075,2011,11081,10388,693,6.3
08077,2011,75475,67738,7737,10.3
08079,2011,426,403,23,5.4
08081,2011,7861,7130,731,9.3
08083,2011,12986,11850,1136,8.7
08085,2011,20017,17805,2212,11.1
08087,2011,15043,14040,1003,6.7
08089,2011,8473,7629,844,10
08091,2011,2023,1817,206,10.2
08093,2011,9406,8683,723,7.7
08095,2011,2154,2039,115,5.3
08097,2011,10926,10072,854,7.8
08099,2011,6242,5829,413,6.6
08101,2011,75117,67211,7906,10.5
08103,2011,3119,2874,245,7.9
08105,2011,5152,4519,633,12.3
08107,2011,14288,13111,1177,8.2
08109,2011,3015,2679,336,11.1
08111,2011,522,461,61,11.7
08113,2011,4885,4492,393,8
08115,2011,1096,1009,87,7.9
08117,2011,19255,18003,1252,6.5
08119,2011,12154,11024,1130,9.3
08121,2011,2589,2448,141,5.4
08123,2011,134285,122737,11548,8.6
08125,2011,4962,4701,261,5.3
09001,2011,476985,437853,39132,8.2
09003,2011,480133,436750,43383,9
09005,2011,108071,99279,8792,8.1
09007,2011,93628,86485,7143,7.6
09009,2011,461844,417051,44793,9.7
09011,2011,143131,130445,12686,8.9
09013,2011,86415,79909,6506,7.5
09015,2011,64567,58193,6374,9.9
10001,2011,74064,67996,6068,8.2
10003,2011,277387,257260,20127,7.3
10005,2011,91896,84830,7066,7.7
11001,2011,350778,315171,35607,10.2
12001,2011,129027,119251,9776,7.6
12003,2011,11506,10333,1173,10.2
12005,2011,87205,78311,8894,10.2
12007,2011,11507,10462,1045,9.1
12009,2011,265213,236336,28877,10.9
12011,2011,951445,861686,89759,9.4
12013,2011,5242,4698,544,10.4
12015,2011,65722,58308,7414,11.3
12017,2011,52057,45546,6511,12.5
12019,2011,96166,87408,8758,9.1
12021,2011,148810,133729,15081,10.1
12023,2011,28242,25337,2905,10.3
12027,2011,13884,12447,1437,10.4
12029,2011,5754,5047,707,12.3
12031,2011,456441,409556,46885,10.3
12033,2011,140774,127131,13643,9.7
12035,2011,41940,37167,4773,11.4
12037,2011,5051,4665,386,7.6
12039,2011,19614,17342,2272,11.6
12041,2011,6857,6151,706,10.3
12043,2011,5292,4788,504,9.5
12045,2011,6241,5638,603,9.7
12047,2011,4898,4389,509,10.4
12049,2011,11916,10718,1198,10.1
12051,2011,17971,15482,2489,13.9
12053,2011,66199,57925,8274,12.5
12055,2011,38151,33773,4378,11.5
12057,2011,661540,598119,63421,9.6
12059,2011,7195,6488,707,9.8
12061,2011,61940,54097,7843,12.7
12063,2011,18260,16531,1729,9.5
12065,2011,5918,5323,595,10.1
12067,2011,3636,3409,227,6.2
12069,2011,133860,119672,14188,10.6
12071,2011,287064,255884,31180,10.9
12073,2011,149969,138321,11648,7.8
12075,2011,16974,15125,1849,10.9
12077,2011,2862,2600,262,9.2
12079,2011,8078,7303,775,9.6
12081,2011,148173,133384,14789,10
12083,2011,131031,114905,16126,12.3
12085,2011,66822,60208,6614,9.9
12086,2011,1255105,1137041,118064,9.4
12087,2011,42781,39791,2990,7
12089,2011,36018,32556,3462,9.6
12091,2011,90913,83806,7107,7.8
12093,2011,17822,15695,2127,11.9
12095,2011,642178,579251,62927,9.8
12097,2011,140286,124469,15817,11.3
12099,2011,652697,587173,65524,10
12101,2011,206715,184347,22368,10.8
12103,2011,463993,418950,45043,9.7
12105,2011,276920,245740,31180,11.3
12107,2011,29776,25968,3808,12.8
12109,2011,101402,93552,7850,7.7
12111,2011,128670,112473,16197,12.6
12113,2011,72675,66399,6276,8.6
12115,2011,166864,149796,17068,10.2
12117,2011,230621,208447,22174,9.6
12119,2011,26041,22876,3165,12.2
12121,2011,18870,17125,1745,9.2
12123,2011,9444,8493,951,10.1
12125,2011,5178,4754,424,8.2
12127,2011,237832,211132,26700,11.2
12129,2011,14604,13398,1206,8.3
12131,2011,26285,24050,2235,8.5
12133,2011,10412,9369,1043,10
13001,2011,8875,7778,1097,12.4
13003,2011,3495,3047,448,12.8
13005,2011,4508,4035,473,10.5
13007,2011,1172,1036,136,11.6
13009,2011,18617,16054,2563,13.8
13011,2011,8506,7720,786,9.2
13013,2011,34618,31174,3444,9.9
13015,2011,47746,42279,5467,11.5
13017,2011,6254,5279,975,15.6
13019,2011,7868,6886,982,12.5
13021,2011,71223,63035,8188,11.5
13023,2011,5492,4759,733,13.3
13025,2011,7463,6480,983,13.2
13027,2011,7066,6359,707,10
13029,2011,14722,13344,1378,9.4
13031,2011,33499,29978,3521,10.5
13033,2011,9953,8690,1263,12.7
13035,2011,10458,9270,1188,11.4
13037,2011,2522,2310,212,8.4
13039,2011,21154,19133,2021,9.6
13043,2011,5033,4549,484,9.6
13045,2011,51917,46021,5896,11.4
13047,2011,32062,29433,2629,8.2
13049,2011,4965,4437,528,10.6
13051,2011,129639,116650,12989,10
13053,2011,2369,2095,274,11.6
13055,2011,10578,9411,1167,11
13057,2011,113843,104542,9301,8.2
13059,2011,57177,51856,5321,9.3
13061,2011,1066,935,131,12.3
13063,2011,126983,109948,17035,13.4
13065,2011,2889,2572,317,11
13067,2011,384688,350725,33963,8.8
13069,2011,17605,15336,2269,12.9
13071,2011,21236,19217,2019,9.5
13073,2011,63320,58667,4653,7.3
13075,2011,7602,6746,856,11.3
13077,2011,65009,59123,5886,9.1
13079,2011,5807,5181,626,10.8
13081,2011,9203,7923,1280,13.9
13083,2011,8365,7697,668,8
13085,2011,10882,9779,1103,10.1
13087,2011,12066,10619,1447,12
13089,2011,366603,327936,38667,10.5
13091,2011,8292,7274,1018,12.3
13093,2011,4789,4164,625,13.1
13095,2011,41256,36235,5021,12.2
13097,2011,66989,59707,7282,10.9
13099,2011,4449,3938,511,11.5
13101,2011,1879,1727,152,8.1
13103,2011,25639,23251,2388,9.3
13105,2011,8796,7378,1418,16.1
13107,2011,9162,7944,1218,13.3
13109,2011,4809,4370,439,9.1
13111,2011,10273,9113,1160,11.3
13113,2011,53224,48960,4264,8
13115,2011,44852,39440,5412,12.1
13117,2011,91061,84314,6747,7.4
13119,2011,9751,8566,1185,12.2
13121,2011,498861,448034,50827,10.2
13123,2011,12372,10917,1455,11.8
13125,2011,1335,1193,142,10.6
13127,2011,38256,34267,3989,10.4
13129,2011,26267,23198,3069,11.7
13131,2011,10847,9817,1030,9.5
13133,2011,6379,5592,787,12.3
13135,2011,427145,389936,37209,8.7
13137,2011,18337,16411,1926,10.5
13139,2011,87726,79953,7773,8.9
13141,2011,2961,2375,586,19.8
13143,2011,12255,10833,1422,11.6
13145,2011,16399,15184,1215,7.4
13147,2011,11146,9898,1248,11.2
13149,2011,5169,4584,585,11.3
13151,2011,102687,92085,10602,10.3
13153,2011,68352,62512,5840,8.5
13155,2011,3541,3054,487,13.8
13157,2011,28906,26135,2771,9.6
13159,2011,6796,6047,749,11
13161,2011,6512,5692,820,12.6
13163,2011,7121,6177,944,13.3
13165,2011,3206,2746,460,14.3
13167,2011,4165,3703,462,11.1
13169,2011,13817,12544,1273,9.2
13171,2011,8116,7002,1114,13.7
13173,2011,3951,3536,415,10.5
13175,2011,20302,17493,2809,13.8
13177,2011,14330,13119,1211,8.5
13179,2011,27588,25015,2573,9.3
13181,2011,3636,3216,420,11.6
13183,2011,6375,5809,566,8.9
13185,2011,51359,46277,5082,9.9
13187,2011,14884,13429,1455,9.8
13189,2011,9405,8150,1255,13.3
13191,2011,6188,5530,658,10.6
13193,2011,5281,4550,731,13.8
13195,2011,13222,11885,1337,10.1
13197,2011,3681,3297,384,10.4
13199,2011,9244,8009,1235,13.4
13201,2011,2737,2486,251,9.2
13205,2011,9523,8568,955,10
13207,2011,12739,11503,1236,9.7
13209,2011,3913,3397,516,13.2
13211,2011,8639,7771,868,10
13213,2011,17062,14692,2370,13.9
13215,2011,82863,74559,8304,10
13217,2011,48399,42424,5975,12.3
13219,2011,16910,15727,1183,7
13221,2011,6999,6319,680,9.7
13223,2011,74316,67219,7097,9.5
13225,2011,12693,11189,1504,11.8
13227,2011,14063,12582,1481,10.5
13229,2011,8099,7236,863,10.7
13231,2011,8437,7577,860,10.2
13233,2011,18679,16532,2147,11.5
13235,2011,4486,4055,431,9.6
13237,2011,8667,7541,1126,13
13239,2011,979,879,100,10.2
13241,2011,7034,6163,871,12.4
13243,2011,2945,2569,376,12.8
13245,2011,88510,78559,9951,11.2
13247,2011,42258,37516,4742,11.2
13249,2011,2162,1914,248,11.5
13251,2011,5768,4857,911,15.8
13253,2011,3272,2860,412,12.6
13255,2011,28573,24569,4004,14
13257,2011,11743,10340,1403,11.9
13259,2011,2337,2108,229,9.8
13261,2011,13933,12183,1750,12.6
13263,2011,2918,2611,307,10.5
13265,2011,618,521,97,15.7
13267,2011,9874,9005,869,8.8
13269,2011,3179,2720,459,14.4
13271,2011,5282,4583,699,13.2
13273,2011,3850,3388,462,12
13275,2011,18338,16437,1901,10.4
13277,2011,18942,16652,2290,12.1
13279,2011,12433,10766,1667,13.4
13281,2011,4357,3811,546,12.5
13283,2011,2989,2592,397,13.3
13285,2011,34505,30705,3800,11
13287,2011,3598,3084,514,14.3
13289,2011,3255,2751,504,15.5
13291,2011,9480,8517,963,10.2
13293,2011,12013,10621,1392,11.6
13295,2011,31064,28025,3039,9.8
13297,2011,41220,36929,4291,10.4
13299,2011,15280,13556,1724,11.3
13301,2011,2648,2209,439,16.6
13303,2011,8116,7082,1034,12.7
13305,2011,12504,10985,1519,12.1
13307,2011,1067,945,122,11.4
13309,2011,1981,1690,291,14.7
13311,2011,13169,11861,1308,9.9
13313,2011,47462,41846,5616,11.8
13315,2011,2933,2558,375,12.8
13317,2011,3931,3384,547,13.9
13319,2011,3775,3288,487,12.9
13321,2011,9795,8669,1126,11.5
15001,2011,88675,79952,8723,9.8
15003,2011,456169,429374,26795,5.9
15007,2011,34904,31869,3035,8.7
15009,2011,80507,74125,6382,7.9
16001,2011,200304,185600,14704,7.3
16003,2011,1745,1433,312,17.9
16005,2011,41065,37980,3085,7.5
16007,2011,2922,2744,178,6.1
16009,2011,4152,3600,552,13.3
16011,2011,22849,21220,1629,7.1
16013,2011,11877,10847,1030,8.7
16015,2011,3060,2748,312,10.2
16017,2011,19047,16695,2352,12.3
16019,2011,49344,45925,3419,6.9
16021,2011,5386,4763,623,11.6
16023,2011,1325,1217,108,8.2
16025,2011,639,560,79,12.4
16027,2011,85518,76495,9023,10.6
16029,2011,3885,3595,290,7.5
16031,2011,11198,10460,738,6.6
16033,2011,516,470,46,8.9
16035,2011,3356,2897,459,13.7
16037,2011,2302,2119,183,7.9
16039,2011,11004,10092,912,8.3
16041,2011,6251,5912,339,5.4
16043,2011,6707,6188,519,7.7
16045,2011,7708,6875,833,10.8
16047,2011,8355,7790,565,6.8
16049,2011,6686,5862,824,12.3
16051,2011,12513,11645,868,6.9
16053,2011,11031,10198,833,7.6
16055,2011,69335,62302,7033,10.1
16057,2011,19256,18044,1212,6.3
16059,2011,3668,3291,377,10.3
16061,2011,1554,1457,97,6.2
16063,2011,2682,2362,320,11.9
16065,2011,17907,16961,946,5.3
16067,2011,10566,9832,734,6.9
16069,2011,20095,18817,1278,6.4
16071,2011,2017,1900,117,5.8
16073,2011,4888,4676,212,4.3
16075,2011,11165,10162,1003,9
16077,2011,3929,3584,345,8.8
16079,2011,5514,4715,799,14.5
16081,2011,5328,4969,359,6.7
16083,2011,37138,34191,2947,7.9
16085,2011,4656,3999,657,14.1
16087,2011,4736,4274,462,9.8
17001,2011,34381,32008,2373,6.9
17003,2011,2889,2516,373,12.9
17005,2011,8486,7696,790,9.3
17007,2011,27171,23975,3196,11.8
17009,2011,2590,2429,161,6.2
17011,2011,18737,16884,1853,9.9
17013,2011,2497,2254,243,9.7
17015,2011,8301,7555,746,9
17017,2011,6910,6345,565,8.2
17019,2011,105692,97471,8221,7.8
17021,2011,16890,15272,1618,9.6
17023,2011,8114,7273,841,10.4
17025,2011,6689,5979,710,10.6
17027,2011,20700,19306,1394,6.7
17029,2011,24781,22456,2325,9.4
17031,2011,2636431,2360931,275500,10.4
17033,2011,10816,10029,787,7.3
17035,2011,5940,5427,513,8.6
17037,2011,55679,50500,5179,9.3
17039,2011,8698,7959,739,8.5
17041,2011,10127,9305,822,8.1
17043,2011,501986,460854,41132,8.2
17045,2011,9328,8350,978,10.5
17047,2011,3136,2881,255,8.1
17049,2011,18648,17366,1282,6.9
17051,2011,11158,10127,1031,9.2
17053,2011,6984,6375,609,8.7
17055,2011,17605,15641,1964,11.2
17057,2011,17421,15595,1826,10.5
17059,2011,2576,2347,229,8.9
17061,2011,6703,6117,586,8.7
17063,2011,25752,22470,3282,12.7
17065,2011,3914,3576,338,8.6
17067,2011,9623,8741,882,9.2
17069,2011,1749,1560,189,10.8
17071,2011,3854,3547,307,8
17073,2011,26574,24495,2079,7.8
17075,2011,15692,14247,1445,9.2
17077,2011,29631,27267,2364,8
17079,2011,5001,4609,392,7.8
17081,2011,18172,16478,1694,9.3
17083,2011,11581,10546,1035,8.9
17085,2011,12129,11169,960,7.9
17087,2011,4391,3877,514,11.7
17089,2011,267273,241204,26069,9.8
17091,2011,56470,49983,6487,11.5
17093,2011,62635,56794,5841,9.3
17095,2011,24852,22666,2186,8.8
17097,2011,368462,335935,32527,8.8
17099,2011,60829,54345,6484,10.7
17101,2011,6572,5873,699,10.6
17103,2011,18830,17123,1707,9.1
17105,2011,18825,17237,1588,8.4
17107,2011,13715,12651,1064,7.8
17109,2011,15142,13944,1198,7.9
17111,2011,166760,150286,16474,9.9
17113,2011,95321,89012,6309,6.6
17115,2011,54898,49412,5486,10
17117,2011,24752,22350,2402,9.7
17119,2011,137716,125391,12325,8.9
17121,2011,19112,17200,1912,10
17123,2011,6341,5778,563,8.9
17125,2011,7168,6406,762,10.6
17127,2011,7116,6487,629,8.8
17129,2011,7137,6622,515,7.2
17131,2011,8859,8121,738,8.3
17133,2011,18116,16897,1219,6.7
17135,2011,13650,12029,1621,11.9
17137,2011,18131,16675,1456,8
17139,2011,7455,6887,568,7.6
17141,2011,27426,24291,3135,11.4
17143,2011,96178,87312,8866,9.2
17145,2011,9461,8498,963,10.2
17147,2011,8818,8194,624,7.1
17149,2011,7914,7279,635,8
17151,2011,1971,1796,175,8.9
17153,2011,2357,2075,282,12
17155,2011,3198,2870,328,10.3
17157,2011,14796,13576,1220,8.2
17159,2011,7805,7162,643,8.2
17161,2011,76200,69724,6476,8.5
17163,2011,132784,119871,12913,9.7
17165,2011,11652,10545,1107,9.5
17167,2011,108896,100812,8084,7.4
17169,2011,3769,3467,302,8
17171,2011,2847,2613,234,8.2
17173,2011,11015,10013,1002,9.1
17175,2011,2973,2713,260,8.7
17177,2011,24199,21834,2365,9.8
17179,2011,71533,65591,5942,8.3
17181,2011,7755,6853,902,11.6
17183,2011,37473,33751,3722,9.9
17185,2011,5809,5293,516,8.9
17187,2011,9126,8466,660,7.2
17189,2011,8714,8140,574,6.6
17191,2011,8205,7548,657,8
17193,2011,7421,6835,586,7.9
17195,2011,29656,26850,2806,9.5
17197,2011,354428,316756,37672,10.6
17199,2011,32313,29392,2921,9
17201,2011,147447,129958,17489,11.9
17203,2011,20501,19179,1322,6.4
18001,2011,16154,14891,1263,7.8
18003,2011,176121,159784,16337,9.3
18005,2011,40024,36981,3043,7.6
18007,2011,4643,4276,367,7.9
18009,2011,5623,4932,691,12.3
18011,2011,29815,27812,2003,6.7
18013,2011,7430,6746,684,9.2
18015,2011,10125,9282,843,8.3
18017,2011,18181,16467,1714,9.4
18019,2011,55550,50606,4944,8.9
18021,2011,12995,11646,1349,10.4
18023,2011,16748,15304,1444,8.6
18025,2011,4866,4289,577,11.9
18027,2011,14887,13978,909,6.1
18029,2011,25339,22898,2441,9.6
18031,2011,13013,11740,1273,9.8
18033,2011,20488,18501,1987,9.7
18035,2011,54649,49102,5547,10.2
18037,2011,21938,20606,1332,6.1
18039,2011,95375,85121,10254,10.8
18041,2011,9512,8317,1195,12.6
18043,2011,37766,34752,3014,8
18045,2011,8630,7802,828,9.6
18047,2011,11221,10094,1127,10
18049,2011,10200,9258,942,9.2
18051,2011,17282,16015,1267,7.3
18053,2011,33438,29968,3470,10.4
18055,2011,14179,12709,1470,10.4
18057,2011,148119,139510,8609,5.8
18059,2011,35797,32847,2950,8.2
18061,2011,18773,17095,1678,8.9
18063,2011,76016,70711,5305,7
18065,2011,21288,18838,2450,11.5
18067,2011,36050,32288,3762,10.4
18069,2011,19150,17270,1880,9.8
18071,2011,20549,18752,1797,8.7
18073,2011,16095,14635,1460,9.1
18075,2011,10528,9583,945,9
18077,2011,15170,13687,1483,9.8
18079,2011,13340,11803,1537,11.5
18081,2011,72052,66469,5583,7.7
18083,2011,18459,17084,1375,7.4
18085,2011,38972,35490,3482,8.9
18087,2011,16665,15167,1498,9
18089,2011,229337,207371,21966,9.6
18091,2011,50456,45218,5238,10.4
18093,2011,20791,18375,2416,11.6
18095,2011,58818,52408,6410,10.9
18097,2011,456009,410956,45053,9.9
18099,2011,23452,21230,2222,9.5
18101,2011,5344,4943,401,7.5
18103,2011,15937,14272,1665,10.4
18105,2011,67561,62473,5088,7.5
18107,2011,18713,17054,1659,8.9
18109,2011,34902,31637,3265,9.4
18111,2011,6990,6300,690,9.9
18113,2011,23132,20801,2331,10.1
18115,2011,3210,2905,305,9.5
18117,2011,8865,7816,1049,11.8
18119,2011,10137,8999,1138,11.2
18121,2011,7195,6443,752,10.5
18123,2011,9062,8237,825,9.1
18125,2011,6231,5744,487,7.8
18127,2011,82290,75568,6722,8.2
18129,2011,13421,12498,923,6.9
18131,2011,6401,5884,517,8.1
18133,2011,16596,14799,1797,10.8
18135,2011,13023,11672,1351,10.4
18137,2011,14938,13526,1412,9.5
18139,2011,8584,7766,818,9.5
18141,2011,130604,117384,13220,10.1
18143,2011,10378,9146,1232,11.9
18145,2011,22512,20380,2132,9.5
18147,2011,11031,10185,846,7.7
18149,2011,10332,9153,1179,11.4
18151,2011,18565,16902,1663,9
18153,2011,8891,8064,827,9.3
18155,2011,4987,4580,407,8.2
18157,2011,87455,80922,6533,7.5
18159,2011,7956,7240,716,9
18161,2011,3667,3343,324,8.8
18163,2011,92759,85341,7418,8
18165,2011,7647,6749,898,11.7
18167,2011,50514,45310,5204,10.3
18169,2011,15706,14204,1502,9.6
18171,2011,4271,3924,347,8.1
18173,2011,31119,28911,2208,7.1
18175,2011,13514,12080,1434,10.6
18177,2011,30992,27547,3445,11.1
18179,2011,14049,12892,1157,8.2
18181,2011,13108,11974,1134,8.7
18183,2011,17325,15709,1616,9.3
19001,2011,4095,3896,199,4.9
19003,2011,2208,2110,98,4.4
19005,2011,7743,7187,556,7.2
19007,2011,6052,5633,419,6.9
19009,2011,3362,3169,193,5.7
19011,2011,14115,13296,819,5.8
19013,2011,70905,66770,4135,5.8
19015,2011,14655,13928,727,5
19017,2011,13840,13236,604,4.4
19019,2011,11165,10533,632,5.7
19021,2011,11335,10824,511,4.5
19023,2011,8170,7759,411,5
19025,2011,4508,4251,257,5.7
19027,2011,11609,11141,468,4
19029,2011,7287,6853,434,6
19031,2011,10871,10310,561,5.2
19033,2011,24156,22675,1481,6.1
19035,2011,6934,6605,329,4.7
19037,2011,6489,6083,406,6.3
19039,2011,4685,4356,329,7
19041,2011,9250,8747,503,5.4
19043,2011,10340,9701,639,6.2
19045,2011,25847,24137,1710,6.6
19047,2011,8816,8399,417,4.7
19049,2011,38209,36578,1631,4.3
19051,2011,4186,3931,255,6.1
19053,2011,4342,4125,217,5
19055,2011,10249,9690,559,5.5
19057,2011,20301,18932,1369,6.7
19059,2011,9255,8672,583,6.3
19061,2011,54369,51621,2748,5.1
19063,2011,5786,5462,324,5.6
19065,2011,11038,10352,686,6.2
19067,2011,8290,7753,537,6.5
19069,2011,5969,5663,306,5.1
19071,2011,3966,3737,229,5.8
19073,2011,5188,4898,290,5.6
19075,2011,6702,6368,334,5
19077,2011,5689,5341,348,6.1
19079,2011,7467,6810,657,8.8
19081,2011,5937,5605,332,5.6
19083,2011,8984,8456,528,5.9
19085,2011,7816,7383,433,5.5
19087,2011,9827,9159,668,6.8
19089,2011,5319,5035,284,5.3
19091,2011,5169,4909,260,5
19093,2011,3792,3608,184,4.9
19095,2011,9607,9126,481,5
19097,2011,10989,10275,714,6.5
19099,2011,18601,17355,1246,6.7
19101,2011,8815,8287,528,6
19103,2011,79657,76443,3214,4
19105,2011,10913,10279,634,5.8
19107,2011,5471,5136,335,6.1
19109,2011,8352,7988,364,4.4
19111,2011,17437,16017,1420,8.1
19113,2011,119358,112579,6779,5.7
19115,2011,5904,5544,360,6.1
19117,2011,4184,3963,221,5.3
19119,2011,6774,6563,211,3.1
19121,2011,8272,7779,493,6
19123,2011,11832,11142,690,5.8
19125,2011,17160,16226,934,5.4
19127,2011,20044,18726,1318,6.6
19129,2011,7446,7078,368,4.9
19131,2011,5651,5383,268,4.7
19133,2011,4773,4442,331,6.9
19135,2011,4033,3762,271,6.7
19137,2011,5033,4738,295,5.9
19139,2011,21406,19998,1408,6.6
19141,2011,8103,7764,339,4.2
19143,2011,3527,3370,157,4.5
19145,2011,6855,6464,391,5.7
19147,2011,4773,4549,224,4.7
19149,2011,14245,13610,635,4.5
19151,2011,4080,3901,179,4.4
19153,2011,242931,229164,13767,5.7
19155,2011,49529,46761,2768,5.6
19157,2011,10394,9815,579,5.6
19159,2011,2600,2481,119,4.6
19161,2011,5616,5368,248,4.4
19163,2011,87011,81669,5342,6.1
19165,2011,6715,6425,290,4.3
19167,2011,19526,18807,719,3.7
19169,2011,53198,51102,2096,3.9
19171,2011,9188,8627,561,6.1
19173,2011,3150,3001,149,4.7
19175,2011,6957,6591,366,5.3
19177,2011,3848,3605,243,6.3
19179,2011,18114,16818,1296,7.2
19181,2011,25947,24602,1345,5.2
19183,2011,12311,11734,577,4.7
19185,2011,2823,2667,156,5.5
19187,2011,19771,18393,1378,7
19189,2011,5444,5116,328,6
19191,2011,12110,11507,603,5
19193,2011,54549,51421,3128,5.7
19195,2011,4287,4013,274,6.4
19197,2011,6786,6321,465,6.9
20001,2011,7032,6468,564,8
20003,2011,4490,4148,342,7.6
20005,2011,7926,7209,717,9
20007,2011,2778,2667,111,4
20009,2011,15036,14252,784,5.2
20011,2011,6876,6259,617,9
20013,2011,5186,4877,309,6
20015,2011,32445,30171,2274,7
20017,2011,1338,1265,73,5.5
20019,2011,1699,1559,140,8.2
20021,2011,10801,9924,877,8.1
20023,2011,1346,1288,58,4.3
20025,2011,1211,1165,46,3.8
20027,2011,4389,4141,248,5.7
20029,2011,4527,4279,248,5.5
20031,2011,4649,4285,364,7.8
20033,2011,980,937,43,4.4
20035,2011,17096,15896,1200,7
20037,2011,19169,17652,1517,7.9
20039,2011,1415,1347,68,4.8
20041,2011,10109,9442,667,6.6
20043,2011,4453,4105,348,7.8
20045,2011,63747,60141,3606,5.7
20047,2011,1664,1589,75,4.5
20049,2011,1382,1277,105,7.6
20051,2011,17841,17209,632,3.5
20053,2011,3491,3349,142,4.1
20055,2011,20743,19857,886,4.3
20057,2011,18271,17483,788,4.3
20059,2011,13989,12817,1172,8.4
20061,2011,13174,11964,1210,9.2
20063,2011,1498,1448,50,3.3
20065,2011,1416,1357,59,4.2
20067,2011,4104,3932,172,4.2
20069,2011,3585,3466,119,3.3
20071,2011,842,816,26,3.1
20073,2011,3466,3236,230,6.6
20075,2011,1746,1697,49,2.8
20077,2011,2895,2731,164,5.7
20079,2011,17387,16330,1057,6.1
20081,2011,2414,2329,85,3.5
20083,2011,1109,1067,42,3.8
20085,2011,7419,6973,446,6
20087,2011,10450,9707,743,7.1
20089,2011,1528,1456,72,4.7
20091,2011,308303,291774,16529,5.4
20093,2011,2179,2083,96,4.4
20095,2011,3823,3579,244,6.4
20097,2011,1344,1287,57,4.2
20099,2011,11038,10039,999,9.1
20101,2011,959,915,44,4.6
20103,2011,34425,31917,2508,7.3
20105,2011,1877,1780,97,5.2
20107,2011,4501,3999,502,11.2
20109,2011,1774,1716,58,3.3
20111,2011,17333,16222,1111,6.4
20113,2011,16652,15892,760,4.6
20115,2011,6471,6104,367,5.7
20117,2011,5992,5713,279,4.7
20119,2011,2534,2440,94,3.7
20121,2011,16914,15696,1218,7.2
20123,2011,3893,3753,140,3.6
20125,2011,18272,16458,1814,9.9
20127,2011,3289,3069,220,6.7
20129,2011,1674,1612,62,3.7
20131,2011,5900,5672,228,3.9
20133,2011,7400,6713,687,9.3
20135,2011,1623,1568,55,3.4
20137,2011,3138,3028,110,3.5
20139,2011,8568,7857,711,8.3
20141,2011,2261,2160,101,4.5
20143,2011,3270,3082,188,5.7
20145,2011,3481,3322,159,4.6
20147,2011,3019,2866,153,5.1
20149,2011,11564,10986,578,5
20151,2011,5362,5091,271,5.1
20153,2011,1518,1465,53,3.5
20155,2011,32636,30664,1972,6
20157,2011,2683,2580,103,3.8
20159,2011,5388,5109,279,5.2
20161,2011,35427,33724,1703,4.8
20163,2011,2726,2581,145,5.3
20165,2011,1841,1760,81,4.4
20167,2011,3784,3607,177,4.7
20169,2011,30761,28891,1870,6.1
20171,2011,2725,2623,102,3.7
20173,2011,249217,229352,19865,8
20175,2011,10820,10321,499,4.6
20177,2011,92932,86630,6302,6.8
20179,2011,1526,1477,49,3.2
20181,2011,3205,3076,129,4
20183,2011,2265,2174,91,4
20185,2011,2317,2198,119,5.1
20187,2011,1064,1021,43,4
20189,2011,2765,2653,112,4.1
20191,2011,11573,10687,886,7.7
20193,2011,4600,4431,169,3.7
20195,2011,1494,1424,70,4.7
20197,2011,3837,3597,240,6.3
20199,2011,882,834,48,5.4
20201,2011,3309,3158,151,4.6
20203,2011,1329,1278,51,3.8
20205,2011,4270,3782,488,11.4
20207,2011,1718,1602,116,6.8
20209,2011,74544,67430,7114,9.5
21001,2011,7747,6834,913,11.8
21003,2011,9111,8215,896,9.8
21005,2011,11567,10603,964,8.3
21007,2011,3884,3497,387,10
21009,2011,19890,17940,1950,9.8
21011,2011,4835,4224,611,12.6
21013,2011,10190,8976,1214,11.9
21015,2011,64221,59178,5043,7.9
21017,2011,10046,9198,848,8.4
21019,2011,20244,18162,2082,10.3
21021,2011,13157,11743,1414,10.7
21023,2011,3981,3553,428,10.8
21025,2011,4410,3847,563,12.8
21027,2011,8280,7323,957,11.6
21029,2011,38954,35079,3875,9.9
21031,2011,5452,4867,585,10.7
21033,2011,5695,5149,546,9.6
21035,2011,19019,17593,1426,7.5
21037,2011,48811,44758,4053,8.3
21039,2011,2305,2101,204,8.9
21041,2011,5110,4487,623,12.2
21043,2011,11696,10079,1617,13.8
21045,2011,6980,6283,697,10
21047,2011,26810,23916,2894,10.8
21049,2011,17537,15804,1733,9.9
21051,2011,6052,5142,910,15
21053,2011,4281,3794,487,11.4
21055,2011,4174,3819,355,8.5
21057,2011,3118,2775,343,11
21059,2011,47742,43754,3988,8.4
21061,2011,5122,4523,599,11.7
21063,2011,2331,1963,368,15.8
21065,2011,5607,4910,697,12.4
21067,2011,164926,153602,11324,6.9
21069,2011,6466,5779,687,10.6
21071,2011,13716,12183,1533,11.2
21073,2011,24611,22664,1947,7.9
21075,2011,2659,2327,332,12.5
21077,2011,4004,3574,430,10.7
21079,2011,7810,7026,784,10
21081,2011,11623,10385,1238,10.7
21083,2011,16903,15367,1536,9.1
21085,2011,11397,9999,1398,12.3
21087,2011,5452,4925,527,9.7
21089,2011,15208,13502,1706,11.2
21091,2011,4080,3738,342,8.4
21093,2011,47443,43077,4366,9.2
21095,2011,10025,8904,1121,11.2
21097,2011,8950,8050,900,10.1
21099,2011,8196,7387,809,9.9
21101,2011,22865,20810,2055,9
21103,2011,7752,7070,682,8.8
21105,2011,2282,2078,204,8.9
21107,2011,21545,19720,1825,8.5
21109,2011,5294,4576,718,13.6
21111,2011,378781,342935,35846,9.5
21113,2011,24650,22732,1918,7.8
21115,2011,8691,7747,944,10.9
21117,2011,83780,76372,7408,8.8
21119,2011,5849,5157,692,11.8
21121,2011,10634,9220,1414,13.3
21123,2011,6046,5441,605,10
21125,2011,24978,22114,2864,11.5
21127,2011,5774,5097,677,11.7
21129,2011,2512,2195,317,12.6
21131,2011,3632,3173,459,12.6
21133,2011,8883,7974,909,10.2
21135,2011,5517,4799,718,13
21137,2011,10405,9129,1276,12.3
21139,2011,4024,3583,441,11
21141,2011,12440,11327,1113,8.9
21143,2011,3078,2759,319,10.4
21145,2011,30974,28299,2675,8.6
21147,2011,5690,4858,832,14.6
21149,2011,4564,4159,405,8.9
21151,2011,44056,40587,3469,7.9
21153,2011,4150,3439,711,17.1
21155,2011,9200,8203,997,10.8
21157,2011,15441,14012,1429,9.3
21159,2011,3870,3522,348,9
21161,2011,7660,6871,789,10.3
21163,2011,12815,11370,1445,11.3
21165,2011,2543,2185,358,14.1
21167,2011,10234,9173,1061,10.4
21169,2011,4611,4093,518,11.2
21171,2011,4834,4398,436,9
21173,2011,12080,10727,1353,11.2
21175,2011,5232,4656,576,11
21177,2011,12942,11614,1328,10.3
21179,2011,21806,19488,2318,10.6
21181,2011,3585,3260,325,9.1
21183,2011,10352,9332,1020,9.9
21185,2011,29260,27225,2035,7
21187,2011,5701,5266,435,7.6
21189,2011,1389,1206,183,13.2
21191,2011,7201,6421,780,10.8
21193,2011,11020,9875,1145,10.4
21195,2011,24323,22094,2229,9.2
21197,2011,5153,4487,666,12.9
21199,2011,27525,24591,2934,10.7
21201,2011,859,763,96,11.2
21203,2011,7193,6369,824,11.5
21205,2011,11237,10168,1069,9.5
21207,2011,7350,6488,862,11.7
21209,2011,25543,23511,2032,8
21211,2011,21968,20222,1746,7.9
21213,2011,8612,7662,950,11
21215,2011,9248,8411,837,9.1
21217,2011,11925,10634,1291,10.8
21219,2011,5708,5210,498,8.7
21221,2011,6190,5487,703,11.4
21223,2011,4016,3559,457,11.4
21225,2011,7598,6914,684,9
21227,2011,58969,54095,4874,8.3
21229,2011,6125,5557,568,9.3
21231,2011,7888,6763,1125,14.3
21233,2011,6212,5713,499,8
21235,2011,13901,12228,1673,12
21237,2011,2104,1791,313,14.9
21239,2011,14326,13393,933,6.5
22001,2011,25791,24068,1723,6.7
22003,2011,9214,8375,839,9.1
22005,2011,53941,50141,3800,7
22007,2011,9974,8770,1204,12.1
22009,2011,16638,15240,1398,8.4
22011,2011,14269,13098,1171,8.2
22013,2011,5860,5266,594,10.1
22015,2011,56901,53561,3340,5.9
22017,2011,115609,106425,9184,7.9
22019,2011,87010,80317,6693,7.7
22021,2011,4103,3693,410,10
22023,2011,3250,3063,187,5.8
22025,2011,4060,3641,419,10.3
22027,2011,6866,6295,571,8.3
22029,2011,7813,7063,750,9.6
22031,2011,11228,10278,950,8.5
22033,2011,221086,204338,16748,7.6
22035,2011,2342,1918,424,18.1
22037,2011,8049,7366,683,8.5
22039,2011,13026,11930,1096,8.4
22041,2011,7961,7032,929,11.7
22043,2011,8358,7655,703,8.4
22045,2011,31877,29358,2519,7.9
22047,2011,13976,12529,1447,10.4
22049,2011,6945,6431,514,7.4
22051,2011,213027,197665,15362,7.2
22053,2011,12907,11976,931,7.2
22055,2011,113869,107117,6752,5.9
22057,2011,44381,41664,2717,6.1
22059,2011,6689,6306,383,5.7
22061,2011,20086,18229,1857,9.2
22063,2011,61455,56967,4488,7.3
22065,2011,3980,3476,504,12.7
22067,2011,11062,9466,1596,14.4
22069,2011,16143,14652,1491,9.2
22071,2011,165726,151413,14313,8.6
22073,2011,69852,64029,5823,8.3
22075,2011,10086,9448,638,6.3
22077,2011,9980,9068,912,9.1
22079,2011,58206,53753,4453,7.7
22081,2011,4049,3737,312,7.7
22083,2011,8796,7839,957,10.9
22085,2011,9460,8785,675,7.1
22087,2011,16856,15424,1432,8.5
22089,2011,24836,23044,1792,7.2
22091,2011,4637,4002,635,13.7
22093,2011,9943,8738,1205,12.1
22095,2011,20953,18736,2217,10.6
22097,2011,33637,30471,3166,9.4
22099,2011,24085,22309,1776,7.4
22101,2011,25136,22898,2238,8.9
22103,2011,107963,101175,6788,6.3
22105,2011,53286,48168,5118,9.6
22107,2011,1979,1723,256,12.9
22109,2011,49902,46798,3104,6.2
22111,2011,9345,8464,881,9.4
22113,2011,25357,23684,1673,6.6
22115,2011,19235,17501,1734,9
22117,2011,16615,15039,1576,9.5
22119,2011,16569,14900,1669,10.1
22121,2011,11927,10999,928,7.8
22123,2011,4268,3590,678,15.9
22125,2011,5138,4799,339,6.6
22127,2011,5651,5119,532,9.4
23001,2011,56041,51497,4544,8.1
23003,2011,34531,31148,3383,9.8
23005,2011,158118,148107,10011,6.3
23007,2011,15477,14076,1401,9.1
23009,2011,30097,27430,2667,8.9
23011,2011,63279,58540,4739,7.5
23013,2011,20451,18948,1503,7.3
23015,2011,17130,15797,1333,7.8
23017,2011,27867,24942,2925,10.5
23019,2011,79566,72972,6594,8.3
23021,2011,7944,7137,807,10.2
23023,2011,19145,17851,1294,6.8
23025,2011,24691,22008,2683,10.9
23027,2011,20395,18709,1686,8.3
23029,2011,14889,13312,1577,10.6
23031,2011,109659,101611,8048,7.3
24001,2011,34089,31003,3086,9.1
24003,2011,289348,271057,18291,6.3
24005,2011,435564,402076,33488,7.7
24009,2011,47715,44614,3101,6.5
24011,2011,17483,15974,1509,8.6
24013,2011,92842,87145,5697,6.1
24015,2011,52101,47474,4627,8.9
24017,2011,78999,73700,5299,6.7
24019,2011,16523,14686,1837,11.1
24021,2011,128573,120301,8272,6.4
24023,2011,15810,14483,1327,8.4
24025,2011,133830,124175,9655,7.2
24027,2011,163953,155441,8512,5.2
24029,2011,10768,9900,868,8.1
24031,2011,536858,508575,28283,5.3
24033,2011,482936,446880,36056,7.5
24035,2011,26609,24801,1808,6.8
24037,2011,54268,50845,3423,6.3
24039,2011,9876,8721,1155,11.7
24041,2011,19451,18002,1449,7.4
24043,2011,76485,69775,6710,8.8
24045,2011,50546,45581,4965,9.8
24047,2011,26345,22729,3616,13.7
24510,2011,295593,264148,31445,10.6
25001,2011,109680,99725,9955,9.1
25003,2011,67269,62021,5248,7.8
25005,2011,284753,257881,26872,9.4
25007,2011,9163,8302,861,9.4
25009,2011,392484,362554,29930,7.6
25011,2011,39531,36944,2587,6.5
25013,2011,219117,198670,20447,9.3
25015,2011,84966,79721,5245,6.2
25017,2011,823918,775312,48606,5.9
25019,2011,6210,5674,536,8.6
25021,2011,357267,334789,22478,6.3
25023,2011,260725,240464,20261,7.8
25025,2011,396266,369968,26298,6.6
25027,2011,417963,385732,32231,7.7
26001,2011,3807,3261,546,14.3
26003,2011,3475,3035,440,12.7
26005,2011,56816,51848,4968,8.7
26007,2011,13684,12200,1484,10.8
26009,2011,10165,8817,1348,13.3
26011,2011,6688,5747,941,14.1
26013,2011,3661,3060,601,16.4
26015,2011,28877,26517,2360,8.2
26017,2011,53317,48064,5253,9.9
26019,2011,8693,7646,1047,12
26021,2011,74551,66972,7579,10.2
26023,2011,19173,17165,2008,10.5
26025,2011,63216,57020,6196,9.8
26027,2011,24419,22057,2362,9.7
26029,2011,12925,11352,1573,12.2
26031,2011,10839,9507,1332,12.3
26033,2011,17390,15503,1887,10.9
26035,2011,12169,10563,1606,13.2
26037,2011,38944,36232,2712,7
26039,2011,5498,4793,705,12.8
26041,2011,17814,15897,1917,10.8
26043,2011,12810,11581,1229,9.6
26045,2011,55660,51191,4469,8
26047,2011,18043,15684,2359,13.1
26049,2011,182814,161919,20895,11.4
26051,2011,10115,8799,1316,13
26053,2011,6947,6122,825,11.9
26055,2011,46656,42083,4573,9.8
26057,2011,19075,17162,1913,10
26059,2011,20651,18454,2197,10.6
26061,2011,17322,15662,1660,9.6
26063,2011,16412,14815,1597,9.7
26065,2011,145123,132289,12834,8.8
26067,2011,29106,26261,2845,9.8
26069,2011,10130,8830,1300,12.8
26071,2011,5170,4634,536,10.4
26073,2011,34911,31986,2925,8.4
26075,2011,72614,65424,7190,9.9
26077,2011,126186,115549,10637,8.4
26079,2011,7595,6606,989,13
26081,2011,315111,289297,25814,8.2
26083,2011,1017,877,140,13.8
26085,2011,3858,3331,527,13.7
26087,2011,39862,34587,5275,13.2
26089,2011,10324,9378,946,9.2
26091,2011,48269,43261,5008,10.4
26093,2011,92626,84286,8340,9
26095,2011,2412,2117,295,12.2
26097,2011,5289,4595,694,13.1
26099,2011,409065,363484,45581,11.1
26101,2011,10684,9406,1278,12
26103,2011,33939,30923,3016,8.9
26105,2011,14263,12694,1569,11
26107,2011,19137,16974,2163,11.3
26109,2011,11815,10736,1079,9.1
26111,2011,40869,37450,3419,8.4
26113,2011,7037,6272,765,10.9
26115,2011,73660,66681,6979,9.5
26117,2011,27300,24140,3160,11.6
26119,2011,3346,2742,604,18.1
26121,2011,75669,67008,8661,11.4
26123,2011,22463,20074,2389,10.6
26125,2011,610881,552660,58221,9.5
26127,2011,12988,11165,1823,14
26129,2011,8786,7663,1123,12.8
26131,2011,2777,2326,451,16.2
26133,2011,10170,9012,1158,11.4
26135,2011,3149,2589,560,17.8
26137,2011,11452,10058,1394,12.2
26139,2011,139598,128452,11146,8
26141,2011,5569,4673,896,16.1
26143,2011,8383,7143,1240,14.8
26145,2011,89803,80647,9156,10.2
26147,2011,74208,64509,9699,13.1
26149,2011,27609,24606,3003,10.9
26151,2011,19505,17119,2386,12.2
26153,2011,3678,3189,489,13.3
26155,2011,33632,30023,3609,10.7
26157,2011,25165,22145,3020,12
26159,2011,36445,32241,4204,11.5
26161,2011,180797,168467,12330,6.8
26163,2011,774443,674177,100266,12.9
26165,2011,14656,12870,1786,12.2
27001,2011,7112,6431,681,9.6
27003,2011,187000,174217,12783,6.8
27005,2011,17715,16451,1264,7.1
27007,2011,22491,20650,1841,8.2
27009,2011,21250,19645,1605,7.6
27011,2011,2902,2715,187,6.4
27013,2011,38315,36245,2070,5.4
27015,2011,15042,14157,885,5.9
27017,2011,17630,16286,1344,7.6
27019,2011,52129,49252,2877,5.5
27021,2011,14149,12730,1419,10
27023,2011,7183,6730,453,6.3
27025,2011,28983,26777,2206,7.6
27027,2011,34623,32703,1920,5.5
27029,2011,4573,4030,543,11.9
27031,2011,3051,2842,209,6.9
27033,2011,6139,5762,377,6.1
27035,2011,31556,28798,2758,8.7
27037,2011,227975,214174,13801,6.1
27039,2011,11235,10559,676,6
27041,2011,19780,18584,1196,6
27043,2011,7794,7242,552,7.1
27045,2011,11224,10479,745,6.6
27047,2011,17051,15919,1132,6.6
27049,2011,26931,25318,1613,6
27051,2011,3375,3142,233,6.9
27053,2011,656063,616331,39732,6.1
27055,2011,10665,9930,735,6.9
27057,2011,9512,8638,874,9.2
27059,2011,20589,18874,1715,8.3
27061,2011,22519,20478,2041,9.1
27063,2011,6090,5760,330,5.4
27065,2011,8709,7834,875,10
27067,2011,23643,22229,1414,6
27069,2011,2604,2426,178,6.8
27071,2011,6811,6242,569,8.4
27073,2011,3974,3733,241,6.1
27075,2011,5814,5414,400,6.9
27077,2011,2339,2194,145,6.2
27079,2011,15684,14494,1190,7.6
27081,2011,3448,3270,178,5.2
27083,2011,15396,14586,810,5.3
27085,2011,20344,18789,1555,7.6
27087,2011,2493,2304,189,7.6
27089,2011,5787,5304,483,8.3
27091,2011,11212,10468,744,6.6
27093,2011,12844,11853,991,7.7
27095,2011,12924,11683,1241,9.6
27097,2011,18752,17210,1542,8.2
27099,2011,20818,19641,1177,5.7
27101,2011,5039,4725,314,6.2
27103,2011,19939,18924,1015,5.1
27105,2011,11485,10880,605,5.3
27107,2011,3649,3405,244,6.7
27109,2011,81313,77037,4276,5.3
27111,2011,30890,28916,1974,6.4
27113,2011,8559,7903,656,7.7
27115,2011,15150,13817,1333,8.8
27117,2011,5031,4704,327,6.5
27119,2011,17420,16196,1224,7
27121,2011,5860,5515,345,5.9
27123,2011,272394,254310,18084,6.6
27125,2011,2424,2228,196,8.1
27127,2011,8385,7878,507,6
27129,2011,8545,7919,626,7.3
27131,2011,34771,32464,2307,6.6
27133,2011,5617,5380,237,4.2
27135,2011,8528,8072,456,5.3
27137,2011,102271,94758,7513,7.3
27139,2011,74896,70578,4318,5.8
27141,2011,48872,45383,3489,7.1
27143,2011,8500,7915,585,6.9
27145,2011,85989,80611,5378,6.3
27147,2011,21118,19753,1365,6.5
27149,2011,5587,5315,272,4.9
27151,2011,5194,4823,371,7.1
27153,2011,13296,12393,903,6.8
27155,2011,1843,1733,110,6
27157,2011,11954,11217,737,6.2
27159,2011,6319,5750,569,9
27161,2011,10582,9916,666,6.3
27163,2011,133063,125221,7842,5.9
27165,2011,6267,5871,396,6.3
27167,2011,3818,3605,213,5.6
27169,2011,29435,27721,1714,5.8
27171,2011,70299,65495,4804,6.8
27173,2011,5743,5415,328,5.7
28001,2011,12915,11523,1392,10.8
28003,2011,16192,14435,1757,10.9
28005,2011,4993,4421,572,11.5
28007,2011,7982,7090,892,11.2
28009,2011,3388,2969,419,12.4
28011,2011,15023,13348,1675,11.1
28013,2011,7115,6495,620,8.7
28015,2011,3804,3341,463,12.2
28017,2011,8255,7312,943,11.4
28019,2011,3807,3419,388,10.2
28021,2011,3690,3102,588,15.9
28023,2011,6755,5958,797,11.8
28025,2011,8696,7401,1295,14.9
28027,2011,10686,9206,1480,13.8
28029,2011,12254,10840,1414,11.5
28031,2011,8535,7738,797,9.3
28033,2011,83144,77164,5980,7.2
28035,2011,35065,31522,3543,10.1
28037,2011,3218,2870,348,10.8
28039,2011,9052,7954,1098,12.1
28041,2011,4692,4125,567,12.1
28043,2011,9709,8715,994,10.2
28045,2011,20060,18157,1903,9.5
28047,2011,90572,82496,8076,8.9
28049,2011,118305,107045,11260,9.5
28051,2011,6895,5661,1234,17.9
28053,2011,3422,2789,633,18.5
28055,2011,516,412,104,20.2
28057,2011,10572,9516,1056,10
28059,2011,65563,58738,6825,10.4
28061,2011,7184,6359,825,11.5
28063,2011,2539,2067,472,18.6
28065,2011,4636,3991,645,13.9
28067,2011,29123,26630,2493,8.6
28069,2011,3916,3358,558,14.2
28071,2011,22931,20961,1970,8.6
28073,2011,28508,26473,2035,7.1
28075,2011,34382,30858,3524,10.2
28077,2011,5076,4487,589,11.6
28079,2011,8871,8007,864,9.7
28081,2011,41068,37105,3963,9.6
28083,2011,11626,9895,1731,14.9
28085,2011,14829,13383,1446,9.8
28087,2011,27321,24446,2875,10.5
28089,2011,50716,47222,3494,6.9
28091,2011,10922,9756,1166,10.7
28093,2011,15773,13927,1846,11.7
28095,2011,16576,14580,1996,12
28097,2011,4677,4097,580,12.4
28099,2011,11969,10855,1114,9.3
28101,2011,9393,8526,867,9.2
28103,2011,4379,3742,637,14.5
28105,2011,22769,20594,2175,9.6
28107,2011,14708,12768,1940,13.2
28109,2011,24313,22044,2269,9.3
28111,2011,4671,4054,617,13.2
28113,2011,15766,13942,1824,11.6
28115,2011,14019,12710,1309,9.3
28117,2011,11731,10511,1220,10.4
28119,2011,3123,2658,465,14.9
28121,2011,73498,68814,4684,6.4
28123,2011,13667,12513,1154,8.4
28125,2011,2024,1729,295,14.6
28127,2011,11579,10522,1057,9.1
28129,2011,7400,6792,608,8.2
28131,2011,7040,6283,757,10.8
28133,2011,9849,8363,1486,15.1
28135,2011,6078,5341,737,12.1
28137,2011,12835,11504,1331,10.4
28139,2011,9290,8191,1099,11.8
28141,2011,8070,7097,973,12.1
28143,2011,5140,4396,744,14.5
28145,2011,13295,11980,1315,9.9
28147,2011,5826,5124,702,12
28149,2011,23541,21148,2393,10.2
28151,2011,21179,17894,3285,15.5
28153,2011,8743,7745,998,11.4
28155,2011,4399,3941,458,10.4
28157,2011,3457,3008,449,13
28159,2011,8003,6936,1067,13.3
28161,2011,5372,4740,632,11.8
28163,2011,10139,8920,1219,12
29001,2011,10917,9981,936,8.6
29003,2011,9753,9077,676,6.9
29005,2011,2894,2657,237,8.2
29007,2011,11294,10368,926,8.2
29009,2011,15264,13895,1369,9
29011,2011,5636,5140,496,8.8
29013,2011,8385,7539,846,10.1
29015,2011,7228,6439,789,10.9
29017,2011,5757,5239,518,9
29019,2011,94108,88736,5372,5.7
29021,2011,46473,42713,3760,8.1
29023,2011,18816,17122,1694,9
29025,2011,4450,4064,386,8.7
29027,2011,22085,20405,1680,7.6
29029,2011,19150,17015,2135,11.1
29031,2011,40687,37944,2743,6.7
29033,2011,4743,4247,496,10.5
29035,2011,2640,2342,298,11.3
29037,2011,53085,48586,4499,8.5
29039,2011,6002,5480,522,8.7
29041,2011,4098,3731,367,9
29043,2011,40908,37869,3039,7.4
29045,2011,3405,3064,341,10
29047,2011,125652,116366,9286,7.4
29049,2011,11033,10050,983,8.9
29051,2011,40384,37846,2538,6.3
29053,2011,7948,7231,717,9
29055,2011,10856,9676,1180,10.9
29057,2011,3433,3114,319,9.3
29059,2011,7226,6429,797,11
29061,2011,4056,3695,361,8.9
29063,2011,5035,4632,403,8
29065,2011,6418,5796,622,9.7
29067,2011,5196,4666,530,10.2
29069,2011,12350,10853,1497,12.1
29071,2011,52944,47965,4979,9.4
29073,2011,7633,6958,675,8.8
29075,2011,3587,3338,249,6.9
29077,2011,144414,133822,10592,7.3
29079,2011,4955,4604,351,7.1
29081,2011,4021,3679,342,8.5
29083,2011,9923,8965,958,9.7
29085,2011,3572,3155,417,11.7
29087,2011,2701,2506,195,7.2
29089,2011,4866,4465,401,8.2
29091,2011,16532,14948,1584,9.6
29093,2011,3570,3068,502,14.1
29095,2011,358230,324169,34061,9.5
29097,2011,58850,54387,4463,7.6
29099,2011,116930,106665,10265,8.8
29101,2011,23500,21356,2144,9.1
29103,2011,1979,1837,142,7.2
29105,2011,15921,14122,1799,11.3
29107,2011,17464,15875,1589,9.1
29109,2011,17396,15949,1447,8.3
29111,2011,5142,4784,358,7
29113,2011,26691,24003,2688,10.1
29115,2011,5335,4701,634,11.9
29117,2011,7090,6553,537,7.6
29119,2011,10239,9384,855,8.4
29121,2011,7489,6870,619,8.3
29123,2011,5361,4803,558,10.4
29125,2011,4207,3852,355,8.4
29127,2011,14547,13459,1088,7.5
29129,2011,1838,1715,123,6.7
29131,2011,11381,10077,1304,11.5
29133,2011,6072,5488,584,9.6
29135,2011,7374,6809,565,7.7
29137,2011,4093,3689,404,9.9
29139,2011,5954,5363,591,9.9
29141,2011,7874,6878,996,12.6
29143,2011,8236,7436,800,9.7
29145,2011,28981,26668,2313,8
29147,2011,11602,10805,797,6.9
29149,2011,4063,3665,398,9.8
29151,2011,7424,6965,459,6.2
29153,2011,3580,3157,423,11.8
29155,2011,7193,6355,838,11.7
29157,2011,9873,9216,657,6.7
29159,2011,20169,18505,1664,8.3
29161,2011,19933,18252,1681,8.4
29163,2011,8208,7524,684,8.3
29165,2011,52035,48433,3602,6.9
29167,2011,14326,12989,1337,9.3
29169,2011,16671,15222,1449,8.7
29171,2011,2372,2211,161,6.8
29173,2011,5648,5225,423,7.5
29175,2011,10817,9682,1135,10.5
29177,2011,11438,10376,1062,9.3
29179,2011,2319,2013,306,13.2
29181,2011,5487,4831,656,12
29183,2011,206298,192073,14225,6.9
29185,2011,4023,3617,406,10.1
29186,2011,9316,8454,862,9.3
29187,2011,26794,23899,2895,10.8
29189,2011,534224,492327,41897,7.8
29195,2011,11121,10231,890,8
29197,2011,1908,1734,174,9.1
29199,2011,2332,2178,154,6.6
29201,2011,19679,17950,1729,8.8
29203,2011,3134,2722,412,13.1
29205,2011,3205,2975,230,7.2
29207,2011,13700,12326,1374,10
29209,2011,14181,12399,1782,12.6
29211,2011,2837,2600,237,8.4
29213,2011,26143,22699,3444,13.2
29215,2011,9767,8817,950,9.7
29217,2011,9598,8904,694,7.2
29219,2011,17114,15559,1555,9.1
29221,2011,10139,8901,1238,12.2
29223,2011,5500,4942,558,10.1
29225,2011,16180,14736,1444,8.9
29227,2011,1241,1170,71,5.7
29229,2011,7605,6859,746,9.8
29510,2011,164340,147357,16983,10.3
30001,2011,4934,4633,301,6.1
30003,2011,5638,4961,677,12
30005,2011,2486,2309,177,7.1
30007,2011,2494,2310,184,7.4
30009,2011,5292,4988,304,5.7
30011,2011,684,657,27,3.9
30013,2011,38333,35882,2451,6.4
30015,2011,2652,2531,121,4.6
30017,2011,6367,6108,259,4.1
30019,2011,943,910,33,3.5
30021,2011,4547,4381,166,3.7
30023,2011,5156,4837,319,6.2
30025,2011,1952,1901,51,2.6
30027,2011,5906,5546,360,6.1
30029,2011,43591,38821,4770,10.9
30031,2011,51559,48461,3098,6
30033,2011,777,747,30,3.9
30035,2011,6061,5372,689,11.4
30037,2011,391,371,20,5.1
30039,2011,1457,1325,132,9.1
30041,2011,7986,7486,500,6.3
30043,2011,5619,5267,352,6.3
30045,2011,968,908,60,6.2
30047,2011,12553,11409,1144,9.1
30049,2011,34503,32668,1835,5.3
30051,2011,1018,977,41,4
30053,2011,8212,6996,1216,14.8
30055,2011,1098,1065,33,3
30057,2011,4178,3872,306,7.3
30059,2011,910,843,67,7.4
30061,2011,1791,1574,217,12.1
30063,2011,58780,54816,3964,6.7
30065,2011,2329,2175,154,6.6
30067,2011,7883,7229,654,8.3
30069,2011,280,264,16,5.7
30071,2011,2126,1979,147,6.9
30073,2011,2930,2753,177,6
30075,2011,1058,1008,50,4.7
30077,2011,2990,2761,229,7.7
30079,2011,531,502,29,5.5
30081,2011,18660,16985,1675,9
30083,2011,6151,5961,190,3.1
30085,2011,4629,4301,328,7.1
30087,2011,4445,4121,324,7.3
30089,2011,4861,4212,649,13.4
30091,2011,1885,1818,67,3.6
30093,2011,16956,15838,1118,6.6
30095,2011,4824,4573,251,5.2
30097,2011,1703,1623,80,4.7
30099,2011,2941,2774,167,5.7
30101,2011,2387,2276,111,4.7
30103,2011,378,357,21,5.6
30105,2011,3937,3752,185,4.7
30107,2011,837,770,67,8
30109,2011,526,504,22,4.2
30111,2011,77147,72938,4209,5.5
31001,2011,16487,15777,710,4.3
31003,2011,3598,3467,131,3.6
31005,2011,231,217,14,6.1
31007,2011,433,413,20,4.6
31009,2011,280,265,15,5.4
31011,2011,3041,2930,111,3.7
31013,2011,5981,5728,253,4.2
31015,2011,1149,1105,44,3.8
31017,2011,1464,1397,67,4.6
31019,2011,26864,25922,942,3.5
31021,2011,3638,3429,209,5.7
31023,2011,4745,4566,179,3.8
31025,2011,13380,12679,701,5.2
31027,2011,4709,4554,155,3.3
31029,2011,2346,2289,57,2.4
31031,2011,3453,3348,105,3
31033,2011,5684,5511,173,3
31035,2011,3483,3339,144,4.1
31037,2011,5684,5464,220,3.9
31039,2011,4924,4756,168,3.4
31041,2011,6048,5842,206,3.4
31043,2011,11014,10366,648,5.9
31045,2011,5473,5261,212,3.9
31047,2011,13190,12531,659,5
31049,2011,1068,1031,37,3.5
31051,2011,3161,3017,144,4.6
31053,2011,19131,18190,941,4.9
31055,2011,282043,268236,13807,4.9
31057,2011,1275,1238,37,2.9
31059,2011,3324,3209,115,3.5
31061,2011,1671,1601,70,4.2
31063,2011,1602,1545,57,3.6
31065,2011,2712,2613,99,3.7
31067,2011,11191,10544,647,5.8
31069,2011,1260,1215,45,3.6
31071,2011,1206,1165,41,3.4
31073,2011,1130,1090,40,3.5
31075,2011,454,439,15,3.3
31077,2011,1361,1308,53,3.9
31079,2011,32013,30581,1432,4.5
31081,2011,4833,4650,183,3.8
31083,2011,1894,1832,62,3.3
31085,2011,679,658,21,3.1
31087,2011,1376,1309,67,4.9
31089,2011,5941,5737,204,3.4
31091,2011,447,426,21,4.7
31093,2011,3395,3257,138,4.1
31095,2011,4375,4186,189,4.3
31097,2011,2215,2108,107,4.8
31099,2011,3904,3778,126,3.2
31101,2011,4655,4465,190,4.1
31103,2011,602,584,18,3
31105,2011,2181,2102,79,3.6
31107,2011,4762,4577,185,3.9
31109,2011,164156,157591,6565,4
31111,2011,19422,18571,851,4.4
31113,2011,509,491,18,3.5
31115,2011,378,360,18,4.8
31117,2011,366,357,9,2.5
31119,2011,19091,18314,777,4.1
31121,2011,4174,3996,178,4.3
31123,2011,2658,2568,90,3.4
31125,2011,2063,1987,76,3.7
31127,2011,3961,3764,197,5
31129,2011,2496,2406,90,3.6
31131,2011,8555,8121,434,5.1
31133,2011,1653,1591,62,3.8
31135,2011,1803,1751,52,2.9
31137,2011,5013,4830,183,3.7
31139,2011,4212,4063,149,3.5
31141,2011,17825,17083,742,4.2
31143,2011,3000,2897,103,3.4
31145,2011,6287,6069,218,3.5
31147,2011,4405,4139,266,6
31149,2011,899,875,24,2.7
31151,2011,7344,6998,346,4.7
31153,2011,86350,82692,3658,4.2
31155,2011,11202,10688,514,4.6
31157,2011,19209,18245,964,5
31159,2011,8767,8430,337,3.8
31161,2011,2831,2730,101,3.6
31163,2011,1759,1683,76,4.3
31165,2011,844,815,29,3.4
31167,2011,3628,3493,135,3.7
31169,2011,2926,2830,96,3.3
31171,2011,426,404,22,5.2
31173,2011,3122,2804,318,10.2
31175,2011,2149,2063,86,4
31177,2011,11240,10751,489,4.4
31179,2011,5608,5414,194,3.5
31181,2011,1736,1656,80,4.6
31183,2011,524,507,17,3.2
31185,2011,7515,7189,326,4.3
32001,2011,11319,9915,1404,12.4
32003,2011,995119,863498,131621,13.2
32005,2011,23178,20109,3069,13.2
32007,2011,28174,26136,2038,7.2
32009,2011,416,383,33,7.9
32011,2011,1072,998,74,6.9
32013,2011,8738,8054,684,7.8
32015,2011,3219,2936,283,8.8
32017,2011,2069,1838,231,11.2
32019,2011,23013,19165,3848,16.7
32021,2011,2229,1917,312,14
32023,2011,16826,13997,2829,16.8
32027,2011,2471,2204,267,10.8
32029,2011,1974,1664,310,15.7
32031,2011,221688,193787,27901,12.6
32033,2011,5099,4656,443,8.7
32510,2011,26513,23008,3505,13.2
33001,2011,32049,30285,1764,5.5
33003,2011,24764,23415,1349,5.4
33005,2011,42545,40409,2136,5
33007,2011,16347,15156,1191,7.3
33009,2011,48734,46562,2172,4.5
33011,2011,225079,212340,12739,5.7
33013,2011,81097,77105,3992,4.9
33015,2011,172122,162479,9643,5.6
33017,2011,69613,65926,3687,5.3
33019,2011,23952,22855,1097,4.6
34001,2011,139577,122104,17473,12.5
34003,2011,481715,444591,37124,7.7
34005,2011,236043,215513,20530,8.7
34007,2011,263211,234675,28536,10.8
34009,2011,49591,42240,7351,14.8
34011,2011,71923,62610,9313,12.9
34013,2011,382913,341465,41448,10.8
34015,2011,152130,136663,15467,10.2
34017,2011,357354,324656,32698,9.2
34019,2011,67734,63055,4679,6.9
34021,2011,193401,177384,16017,8.3
34023,2011,426827,389567,37260,8.7
34025,2011,329845,301573,28272,8.6
34027,2011,265458,246701,18757,7.1
34029,2011,266042,238334,27708,10.4
34031,2011,253663,225744,27919,11
34033,2011,32453,28681,3772,11.6
34035,2011,174327,161446,12881,7.4
34037,2011,81750,74189,7561,9.2
34039,2011,280496,253788,26708,9.5
34041,2011,58820,53486,5334,9.1
35001,2011,323703,300392,23311,7.2
35003,2011,1161,1032,129,11.1
35005,2011,27596,25732,1864,6.8
35006,2011,9275,8397,878,9.5
35007,2011,6319,5806,513,8.1
35009,2011,21478,20388,1090,5.1
35011,2011,818,776,42,5.1
35013,2011,93392,86338,7054,7.6
35015,2011,26492,25144,1348,5.1
35017,2011,12775,11845,930,7.3
35019,2011,1656,1481,175,10.6
35021,2011,297,278,19,6.4
35023,2011,2285,2112,173,7.6
35025,2011,27249,25729,1520,5.6
35027,2011,9110,8493,617,6.8
35028,2011,9277,8949,328,3.5
35029,2011,11495,9169,2326,20.2
35031,2011,24976,22496,2480,9.9
35033,2011,2379,2085,294,12.4
35035,2011,24688,23004,1684,6.8
35037,2011,3391,3065,326,9.6
35039,2011,17254,15654,1600,9.3
35041,2011,8327,7850,477,5.7
35043,2011,60822,55935,4887,8
35045,2011,55028,50701,4327,7.9
35047,2011,11097,10043,1054,9.5
35049,2011,73631,69047,4584,6.2
35051,2011,3888,3505,383,9.9
35053,2011,6841,6318,523,7.6
35055,2011,15172,13580,1592,10.5
35057,2011,5875,5202,673,11.5
35059,2011,1941,1850,91,4.7
35061,2011,30667,27909,2758,9
36001,2011,158289,147330,10959,6.9
36003,2011,23657,21545,2112,8.9
36005,2011,584353,514635,69718,11.9
36007,2011,94727,86579,8148,8.6
36009,2011,38540,34943,3597,9.3
36011,2011,39068,35899,3169,8.1
36013,2011,61661,56616,5045,8.2
36015,2011,40803,37606,3197,7.8
36017,2011,23830,21760,2070,8.7
36019,2011,38413,34729,3684,9.6
36021,2011,31452,29216,2236,7.1
36023,2011,24341,22284,2057,8.5
36025,2011,21717,19833,1884,8.7
36027,2011,146309,135325,10984,7.5
36029,2011,458769,422123,36646,8
36031,2011,18201,16546,1655,9.1
36033,2011,21725,19744,1981,9.1
36035,2011,25552,22854,2698,10.6
36037,2011,30922,28516,2406,7.8
36039,2011,21576,19552,2024,9.4
36041,2011,2442,2201,241,9.9
36043,2011,30723,28048,2675,8.7
36045,2011,48934,44154,4780,9.8
36047,2011,1170616,1058657,111959,9.6
36049,2011,12393,11197,1196,9.7
36051,2011,32007,29560,2447,7.6
36053,2011,34733,31896,2837,8.2
36055,2011,373786,345099,28687,7.7
36057,2011,23432,21034,2398,10.2
36059,2011,683283,636681,46602,6.8
36061,2011,882224,813275,68949,7.8
36063,2011,105602,95951,9651,9.1
36065,2011,108979,100271,8708,8
36067,2011,232622,214674,17948,7.7
36069,2011,55756,51805,3951,7.1
36071,2011,178868,165070,13798,7.7
36073,2011,18812,17075,1737,9.2
36075,2011,57994,51752,6242,10.8
36077,2011,31375,28950,2425,7.7
36079,2011,51607,47980,3627,7
36081,2011,1108920,1019249,89671,8.1
36083,2011,82767,76480,6287,7.6
36085,2011,216722,196872,19850,9.2
36087,2011,148873,138245,10628,7.1
36089,2011,48900,43824,5076,10.4
36091,2011,115669,107973,7696,6.7
36093,2011,77068,71293,5775,7.5
36095,2011,15557,14163,1394,9
36097,2011,9008,8212,796,8.8
36099,2011,16104,14829,1275,7.9
36101,2011,46123,41919,4204,9.1
36103,2011,770533,711930,58603,7.6
36105,2011,35480,32335,3145,8.9
36107,2011,25818,23832,1986,7.7
36109,2011,54190,50910,3280,6.1
36111,2011,91289,84123,7166,7.8
36113,2011,33619,30619,3000,8.9
36115,2011,29721,27318,2403,8.1
36117,2011,46445,42533,3912,8.4
36119,2011,473504,440021,33483,7.1
36121,2011,18881,17232,1649,8.7
36123,2011,12086,11181,905,7.5
37001,2011,77265,69803,7462,9.7
37003,2011,17893,15875,2018,11.3
37005,2011,4630,4064,566,12.2
37007,2011,11099,9735,1364,12.3
37009,2011,13245,11795,1450,10.9
37011,2011,7766,6904,862,11.1
37013,2011,21473,19085,2388,11.1
37015,2011,9071,7976,1095,12.1
37017,2011,14863,12871,1992,13.4
37019,2011,47015,41273,5742,12.2
37021,2011,124660,114760,9900,7.9
37023,2011,41196,36483,4713,11.4
37025,2011,89830,80488,9342,10.4
37027,2011,37342,32395,4947,13.2
37029,2011,4591,4198,393,8.6
37031,2011,30966,27960,3006,9.7
37033,2011,10109,8918,1191,11.8
37035,2011,76812,67852,8960,11.7
37037,2011,31120,28595,2525,8.1
37039,2011,11594,10221,1373,11.8
37041,2011,5957,5233,724,12.2
37043,2011,4145,3667,478,11.5
37045,2011,45873,40201,5672,12.4
37047,2011,23939,20734,3205,13.4
37049,2011,41925,37500,4425,10.6
37051,2011,132538,118604,13934,10.5
37053,2011,12350,11232,1118,9.1
37055,2011,20053,17443,2610,13
37057,2011,79406,70659,8747,11
37059,2011,19991,17876,2115,10.6
37061,2011,26233,23751,2482,9.5
37063,2011,145292,133534,11758,8.1
37065,2011,24925,21057,3868,15.5
37067,2011,173621,156559,17062,9.8
37069,2011,27941,24963,2978,10.7
37071,2011,100475,88559,11916,11.9
37073,2011,5426,4981,445,8.2
37075,2011,3617,2964,653,18.1
37077,2011,27862,25380,2482,8.9
37079,2011,9558,8640,918,9.6
37081,2011,253095,226641,26454,10.5
37083,2011,22346,19085,3261,14.6
37085,2011,49138,43552,5586,11.4
37087,2011,27510,24736,2774,10.1
37089,2011,48402,44291,4111,8.5
37091,2011,9632,8539,1093,11.3
37093,2011,19451,17335,2116,10.9
37095,2011,2114,1831,283,13.4
37097,2011,78531,69589,8942,11.4
37099,2011,18070,16059,2011,11.1
37101,2011,82457,74629,7828,9.5
37103,2011,4583,4096,487,10.6
37105,2011,27228,23873,3355,12.3
37107,2011,27601,24596,3005,10.9
37109,2011,39803,35353,4450,11.2
37111,2011,20594,18048,2546,12.4
37113,2011,15483,13729,1754,11.3
37115,2011,9435,8467,968,10.3
37117,2011,10638,9316,1322,12.4
37119,2011,513764,462812,50952,9.9
37121,2011,6738,5938,800,11.9
37123,2011,11505,10149,1356,11.8
37125,2011,37081,33542,3539,9.5
37127,2011,46919,41064,5855,12.5
37129,2011,107501,97230,10271,9.6
37131,2011,8630,7574,1056,12.2
37133,2011,62686,57493,5193,8.3
37135,2011,70173,65582,4591,6.5
37137,2011,5481,4948,533,9.7
37139,2011,18269,16383,1886,10.3
37141,2011,24622,21831,2791,11.3
37143,2011,5303,4721,582,11
37145,2011,18560,16347,2213,11.9
37147,2011,85776,77087,8689,10.1
37149,2011,8444,7657,787,9.3
37151,2011,68708,61191,7517,10.9
37153,2011,18285,15615,2670,14.6
37155,2011,53473,45863,7610,14.2
37157,2011,43567,38210,5357,12.3
37159,2011,63505,55598,7907,12.5
37161,2011,26482,22625,3857,14.6
37163,2011,29686,26786,2900,9.8
37165,2011,12855,10537,2318,18
37167,2011,28833,25440,3393,11.8
37169,2011,22507,20163,2344,10.4
37171,2011,33832,30178,3654,10.8
37173,2011,6484,5470,1014,15.6
37175,2011,13393,12130,1263,9.4
37177,2011,1633,1389,244,14.9
37179,2011,102404,93069,9335,9.1
37181,2011,18646,15867,2779,14.9
37183,2011,487849,449517,38332,7.9
37185,2011,7641,6574,1067,14
37187,2011,4989,4147,842,16.9
37189,2011,27002,24875,2127,7.9
37191,2011,54885,49924,4961,9
37193,2011,31095,27435,3660,11.8
37195,2011,38258,32935,5323,13.9
37197,2011,17963,16113,1850,10.3
37199,2011,7874,6981,893,11.3
38001,2011,1165,1132,33,2.8
38003,2011,6046,5808,238,3.9
38005,2011,2930,2753,177,6
38007,2011,440,423,17,3.9
38009,2011,3436,3307,129,3.8
38011,2011,1876,1835,41,2.2
38013,2011,1235,1206,29,2.3
38015,2011,46730,45210,1520,3.3
38017,2011,89620,86697,2923,3.3
38019,2011,2249,2181,68,3
38021,2011,2823,2741,82,2.9
38023,2011,1579,1551,28,1.8
38025,2011,2929,2868,61,2.1
38027,2011,1273,1210,63,4.9
38029,2011,1771,1664,107,6
38031,2011,1766,1710,56,3.2
38033,2011,980,956,24,2.4
38035,2011,37731,36342,1389,3.7
38037,2011,1392,1343,49,3.5
38039,2011,1267,1229,38,3
38041,2011,1489,1446,43,2.9
38043,2011,1357,1286,71,5.2
38045,2011,2398,2326,72,3
38047,2011,978,948,30,3.1
38049,2011,3326,3172,154,4.6
38051,2011,1309,1260,49,3.7
38053,2011,4620,4537,83,1.8
38055,2011,4982,4746,236,4.7
38057,2011,4142,3918,224,5.4
38059,2011,15833,15197,636,4
38061,2011,6500,6360,140,2.2
38063,2011,1664,1592,72,4.3
38065,2011,925,868,57,6.2
38067,2011,3929,3658,271,6.9
38069,2011,1936,1843,93,4.8
38071,2011,6073,5841,232,3.8
38073,2011,2879,2777,102,3.5
38075,2011,1446,1406,40,2.8
38077,2011,8883,8544,339,3.8
38079,2011,5154,4590,564,10.9
38081,2011,2111,2046,65,3.1
38083,2011,799,767,32,4
38085,2011,1330,1258,72,5.4
38087,2011,493,483,10,2
38089,2011,16072,15719,353,2.2
38091,2011,1114,1085,29,2.6
38093,2011,10840,10428,412,3.8
38095,2011,1350,1309,41,3
38097,2011,4606,4438,168,3.6
38099,2011,5968,5668,300,5
38101,2011,32491,31454,1037,3.2
38103,2011,2311,2210,101,4.4
38105,2011,20091,19807,284,1.4
39001,2011,11524,9871,1653,14.3
39003,2011,50958,46106,4852,9.5
39005,2011,26144,23560,2584,9.9
39007,2011,47581,42405,5176,10.9
39009,2011,27851,25090,2761,9.9
39011,2011,24128,22175,1953,8.1
39013,2011,32286,29203,3083,9.5
39015,2011,20658,18210,2448,11.9
39017,2011,188924,171787,17137,9.1
39019,2011,14111,12672,1439,10.2
39021,2011,19527,17682,1845,9.4
39023,2011,67537,61130,6407,9.5
39025,2011,103615,94143,9472,9.1
39027,2011,18047,15611,2436,13.5
39029,2011,51859,46595,5264,10.2
39031,2011,16799,14872,1927,11.5
39033,2011,20800,18400,2400,11.5
39035,2011,623251,576023,47228,7.6
39037,2011,26655,24188,2467,9.3
39039,2011,19246,17389,1857,9.6
39041,2011,95206,89265,5941,6.2
39043,2011,39811,36025,3786,9.5
39045,2011,73970,68017,5953,8
39047,2011,14367,12857,1510,10.5
39049,2011,627448,578794,48654,7.8
39051,2011,22636,20456,2180,9.6
39053,2011,13034,11573,1461,11.2
39055,2011,48654,45721,2933,6
39057,2011,81800,75046,6754,8.3
39059,2011,18474,16475,1999,10.8
39061,2011,407539,371426,36113,8.9
39063,2011,40075,36960,3115,7.8
39065,2011,15104,13663,1441,9.5
39067,2011,7026,6277,749,10.7
39069,2011,14399,12856,1543,10.7
39071,2011,18111,15675,2436,13.5
39073,2011,13803,12430,1373,9.9
39075,2011,19592,18355,1237,6.3
39077,2011,29709,26329,3380,11.4
39079,2011,13966,12312,1654,11.8
39081,2011,32004,28157,3847,12
39083,2011,30505,27841,2664,8.7
39085,2011,125191,116647,8544,6.8
39087,2011,27088,24518,2570,9.5
39089,2011,86838,79550,7288,8.4
39091,2011,22851,20621,2230,9.8
39093,2011,149725,137981,11744,7.8
39095,2011,213380,192278,21102,9.9
39097,2011,20331,18723,1608,7.9
39099,2011,112957,101863,11094,9.8
39101,2011,29582,26662,2920,9.9
39103,2011,93801,87823,5978,6.4
39105,2011,9814,8524,1290,13.1
39107,2011,22180,20683,1497,6.7
39109,2011,53466,48585,4881,9.1
39111,2011,6600,5949,651,9.9
39113,2011,260110,234828,25282,9.7
39115,2011,6788,6016,772,11.4
39117,2011,17138,15402,1736,10.1
39119,2011,41313,36810,4503,10.9
39121,2011,4989,4323,666,13.3
39123,2011,22475,19987,2488,11.1
39125,2011,9458,8535,923,9.8
39127,2011,16427,14524,1903,11.6
39129,2011,25885,23505,2380,9.2
39131,2011,11035,9357,1678,15.2
39133,2011,89382,81464,7918,8.9
39135,2011,21728,19648,2080,9.6
39137,2011,19252,17820,1432,7.4
39139,2011,58139,51964,6175,10.6
39141,2011,34318,30901,3417,10
39143,2011,32721,29723,2998,9.2
39145,2011,31833,27843,3990,12.5
39147,2011,28806,26029,2777,9.6
39149,2011,24239,21895,2344,9.7
39151,2011,189210,171558,17652,9.3
39153,2011,276591,251471,25120,9.1
39155,2011,97442,87035,10407,10.7
39157,2011,45405,41189,4216,9.3
39159,2011,26723,24807,1916,7.2
39161,2011,14541,13189,1352,9.3
39163,2011,5733,5050,683,11.9
39165,2011,109603,100969,8634,7.9
39167,2011,29041,26123,2918,10
39169,2011,59186,54654,4532,7.7
39171,2011,18932,16895,2037,10.8
39173,2011,68376,62697,5679,8.3
39175,2011,12120,11002,1118,9.2
40001,2011,8849,8039,810,9.2
40003,2011,2558,2453,105,4.1
40005,2011,5013,4585,428,8.5
40007,2011,2952,2845,107,3.6
40009,2011,11336,10918,418,3.7
40011,2011,4355,4123,232,5.3
40013,2011,17508,16471,1037,5.9
40015,2011,11619,10795,824,7.1
40017,2011,61519,58827,2692,4.4
40019,2011,21652,20264,1388,6.4
40021,2011,19236,17835,1401,7.3
40023,2011,6028,5486,542,9
40025,2011,1371,1325,46,3.4
40027,2011,133181,127129,6052,4.5
40029,2011,2352,2154,198,8.4
40031,2011,50693,47787,2906,5.7
40033,2011,2915,2738,177,6.1
40035,2011,6347,5947,400,6.3
40037,2011,31308,29105,2203,7
40039,2011,15181,14571,610,4
40041,2011,17318,16080,1238,7.1
40043,2011,2470,2374,96,3.9
40045,2011,2113,2033,80,3.8
40047,2011,28821,27546,1275,4.4
40049,2011,12203,11494,709,5.8
40051,2011,25282,23942,1340,5.3
40053,2011,2545,2450,95,3.7
40055,2011,2144,2008,136,6.3
40057,2011,1319,1248,71,5.4
40059,2011,1869,1800,69,3.7
40061,2011,4677,4262,415,8.9
40063,2011,5474,4962,512,9.4
40065,2011,11348,10727,621,5.5
40067,2011,2660,2497,163,6.1
40069,2011,3713,3397,316,8.5
40071,2011,20647,19042,1605,7.8
40073,2011,7580,7286,294,3.9
40075,2011,4268,4048,220,5.2
40077,2011,4436,3995,441,9.9
40079,2011,20136,18340,1796,8.9
40081,2011,15504,14658,846,5.5
40083,2011,20211,19228,983,4.9
40085,2011,4915,4668,247,5
40087,2011,17256,16442,814,4.7
40089,2011,14754,13246,1508,10.2
40091,2011,7394,6611,783,10.6
40093,2011,4051,3889,162,4
40095,2011,6687,6285,402,6
40097,2011,18145,16768,1377,7.6
40099,2011,6484,6165,319,4.9
40101,2011,29891,27680,2211,7.4
40103,2011,5340,5066,274,5.1
40105,2011,4910,4518,392,8
40107,2011,4420,4042,378,8.6
40109,2011,357336,338450,18886,5.3
40111,2011,16537,15045,1492,9
40113,2011,21263,19824,1439,6.8
40115,2011,14313,13234,1079,7.5
40117,2011,7606,7010,596,7.8
40119,2011,36823,34988,1835,5
40121,2011,19051,17653,1398,7.3
40123,2011,18124,17141,983,5.4
40125,2011,31369,29492,1877,6
40127,2011,4952,4523,429,8.7
40129,2011,1902,1841,61,3.2
40131,2011,43070,40594,2476,5.7
40133,2011,9974,9144,830,8.3
40135,2011,17481,15871,1610,9.2
40137,2011,20405,19214,1191,5.8
40139,2011,8837,8448,389,4.4
40141,2011,3356,3160,196,5.8
40143,2011,304059,285655,18404,6.1
40145,2011,35134,33069,2065,5.9
40147,2011,24203,22815,1388,5.7
40149,2011,5511,5264,247,4.5
40151,2011,4490,4336,154,3.4
40153,2011,9919,9457,462,4.7
41001,2011,7317,6523,794,10.9
41003,2011,45957,43019,2938,6.4
41005,2011,204119,186047,18072,8.9
41007,2011,19036,17243,1793,9.4
41009,2011,23569,20906,2663,11.3
41011,2011,27968,24726,3242,11.6
41013,2011,9451,8101,1350,14.3
41015,2011,9213,8105,1108,12
41017,2011,80559,70657,9902,12.3
41019,2011,47485,41453,6032,12.7
41021,2011,973,879,94,9.7
41023,2011,3422,2950,472,13.8
41025,2011,3727,3231,496,13.3
41027,2011,14329,13195,1134,7.9
41029,2011,100467,88693,11774,11.7
41031,2011,9598,8375,1223,12.7
41033,2011,34489,30133,4356,12.6
41035,2011,31289,27533,3756,12
41037,2011,3753,3261,492,13.1
41039,2011,177473,160315,17158,9.7
41041,2011,21942,19651,2291,10.4
41043,2011,56637,50197,6440,11.4
41045,2011,13373,12111,1262,9.4
41047,2011,154593,138379,16214,10.5
41049,2011,5792,5316,476,8.2
41051,2011,424717,389294,35423,8.3
41053,2011,36294,32929,3365,9.3
41055,2011,920,818,102,11.1
41057,2011,11647,10493,1154,9.9
41059,2011,37378,33818,3560,9.5
41061,2011,12458,11216,1242,10
41063,2011,3487,3061,426,12.2
41065,2011,13905,12681,1224,8.8
41067,2011,294384,271644,22740,7.7
41069,2011,767,702,65,8.5
41071,2011,51404,46668,4736,9.2
42001,2011,54084,50472,3612,6.7
42003,2011,643099,597444,45655,7.1
42005,2011,33636,30876,2760,8.2
42007,2011,85923,79212,6711,7.8
42009,2011,24974,22705,2269,9.1
42011,2011,210162,193589,16573,7.9
42013,2011,61524,57041,4483,7.3
42015,2011,32016,29943,2073,6.5
42017,2011,336345,311783,24562,7.3
42019,2011,96649,90204,6445,6.7
42021,2011,66183,60429,5754,8.7
42023,2011,2510,2242,268,10.7
42025,2011,31872,28669,3203,10
42027,2011,77399,73198,4201,5.4
42029,2011,270053,254461,15592,5.8
42031,2011,19104,17208,1896,9.9
42033,2011,38042,34475,3567,9.4
42035,2011,19181,17576,1605,8.4
42037,2011,34787,31780,3007,8.6
42039,2011,41532,38208,3324,8
42041,2011,124441,116527,7914,6.4
42043,2011,140468,129837,10631,7.6
42045,2011,286908,264657,22251,7.8
42047,2011,16867,15621,1246,7.4
42049,2011,137287,126100,11187,8.1
42051,2011,59675,53677,5998,10.1
42053,2011,2035,1843,192,9.4
42055,2011,75529,69998,5531,7.3
42057,2011,7352,6609,743,10.1
42059,2011,18192,16803,1389,7.6
42061,2011,21006,18886,2120,10.1
42063,2011,44025,40571,3454,7.8
42065,2011,21792,19890,1902,8.7
42067,2011,12010,11126,884,7.4
42069,2011,107276,97816,9460,8.8
42071,2011,266002,247732,18270,6.9
42073,2011,43051,39435,3616,8.4
42075,2011,69837,65004,4833,6.9
42077,2011,179458,163937,15521,8.6
42079,2011,159846,144503,15343,9.6
42081,2011,61092,56365,4727,7.7
42083,2011,20113,18357,1756,8.7
42085,2011,53350,49144,4206,7.9
42087,2011,20998,19129,1869,8.9
42089,2011,82201,74223,7978,9.7
42091,2011,430375,402423,27952,6.5
42093,2011,9191,8617,574,6.2
42095,2011,152612,140025,12587,8.2
42097,2011,44957,40835,4122,9.2
42099,2011,24723,22896,1827,7.4
42101,2011,690937,617219,73718,10.7
42103,2011,26043,23459,2584,9.9
42105,2011,7834,7117,717,9.2
42107,2011,70054,63221,6833,9.8
42109,2011,19813,18288,1525,7.7
42111,2011,36950,33654,3296,8.9
42113,2011,3039,2818,221,7.3
42115,2011,21927,20185,1742,7.9
42117,2011,21194,19712,1482,7
42119,2011,19063,17775,1288,6.8
42121,2011,26398,24448,1950,7.4
42123,2011,20446,18911,1535,7.5
42125,2011,105892,98109,7783,7.3
42127,2011,23277,21389,1888,8.1
42129,2011,185898,171896,14002,7.5
42131,2011,14330,13070,1260,8.8
42133,2011,230666,213373,17293,7.5
44001,2011,26290,23765,2525,9.6
44003,2011,92731,82873,9858,10.6
44005,2011,44448,39980,4468,10.1
44007,2011,326163,288284,37879,11.6
44009,2011,70425,63346,7079,10.1
45001,2011,10780,9437,1343,12.5
45003,2011,73303,66504,6799,9.3
45005,2011,3279,2677,602,18.4
45007,2011,85900,77037,8863,10.3
45009,2011,6316,5290,1026,16.2
45011,2011,9203,7802,1401,15.2
45013,2011,65469,59777,5692,8.7
45015,2011,85778,77572,8206,9.6
45017,2011,7092,6215,877,12.4
45019,2011,183009,167780,15229,8.3
45021,2011,23644,20162,3482,14.7
45023,2011,14411,11914,2497,17.3
45025,2011,21164,18443,2721,12.9
45027,2011,13640,11661,1979,14.5
45029,2011,16662,14309,2353,14.1
45031,2011,30450,26517,3933,12.9
45033,2011,13654,11495,2159,15.8
45035,2011,67006,60998,6008,9
45037,2011,10913,9829,1084,9.9
45039,2011,10547,9016,1531,14.5
45041,2011,64430,57197,7233,11.2
45043,2011,25531,22063,3468,13.6
45045,2011,224175,204795,19380,8.6
45047,2011,32039,28403,3636,11.3
45049,2011,8634,7516,1118,12.9
45051,2011,132344,116578,15766,11.9
45053,2011,10993,9904,1089,9.9
45055,2011,28181,25074,3107,11
45057,2011,34152,29600,4552,13.3
45059,2011,30350,26823,3527,11.6
45061,2011,6880,5765,1115,16.2
45063,2011,134344,123621,10723,8
45065,2011,3632,3137,495,13.6
45067,2011,14164,11654,2510,17.7
45069,2011,10748,8632,2116,19.7
45071,2011,18577,16653,1924,10.4
45073,2011,33272,29935,3337,10
45075,2011,40241,33877,6364,15.8
45077,2011,54730,49326,5404,9.9
45079,2011,186481,169282,17199,9.2
45081,2011,8672,7826,846,9.8
45083,2011,133260,118717,14543,10.9
45085,2011,44814,39405,5409,12.1
45087,2011,12232,10271,1961,16
45089,2011,13427,11185,2242,16.7
45091,2011,117004,104225,12779,10.9
46003,2011,1667,1614,53,3.2
46005,2011,9484,9125,359,3.8
46007,2011,1178,1092,86,7.3
46009,2011,3115,2960,155,5
46011,2011,17871,17079,792,4.4
46013,2011,20751,19951,800,3.9
46015,2011,2709,2600,109,4
46017,2011,735,659,76,10.3
46019,2011,5018,4772,246,4.9
46021,2011,870,836,34,3.9
46023,2011,4124,3919,205,5
46025,2011,1944,1851,93,4.8
46027,2011,7482,7179,303,4
46029,2011,15337,14638,699,4.6
46031,2011,1533,1418,115,7.5
46033,2011,4073,3845,228,5.6
46035,2011,11047,10611,436,3.9
46037,2011,3045,2846,199,6.5
46039,2011,2513,2360,153,6.1
46041,2011,2410,2019,391,16.2
46043,2011,1751,1680,71,4.1
46045,2011,2352,2274,78,3.3
46047,2011,3186,2995,191,6
46049,2011,1170,1121,49,4.2
46051,2011,4615,4393,222,4.8
46053,2011,2158,2059,99,4.6
46055,2011,1109,1068,41,3.7
46057,2011,3094,2956,138,4.5
46059,2011,1861,1799,62,3.3
46061,2011,1799,1712,87,4.8
46063,2011,820,787,33,4
46065,2011,9961,9598,363,3.6
46067,2011,3779,3634,145,3.8
46069,2011,784,755,29,3.7
46071,2011,1383,1279,104,7.5
46073,2011,1230,1186,44,3.6
46075,2011,671,649,22,3.3
46077,2011,2874,2747,127,4.4
46079,2011,6186,5879,307,5
46081,2011,12807,12188,619,4.8
46083,2011,26932,25963,969,3.6
46085,2011,1905,1783,122,6.4
46087,2011,3178,3037,141,4.4
46089,2011,1162,1110,52,4.5
46091,2011,2496,2356,140,5.6
46093,2011,13076,12441,635,4.9
46095,2011,862,807,55,6.4
46097,2011,1294,1236,58,4.5
46099,2011,99359,94899,4460,4.5
46101,2011,4124,3860,264,6.4
46102,2011,3726,3198,528,14.2
46103,2011,52984,50421,2563,4.8
46105,2011,1569,1501,68,4.3
46107,2011,1237,1171,66,5.3
46109,2011,5030,4692,338,6.7
46111,2011,1332,1276,56,4.2
46115,2011,3486,3341,145,4.2
46117,2011,1915,1839,76,4
46119,2011,873,840,33,3.8
46121,2011,3369,3081,288,8.5
46123,2011,3245,3123,122,3.8
46125,2011,4812,4614,198,4.1
46127,2011,7644,7246,398,5.2
46129,2011,2360,2194,166,7
46135,2011,11411,10902,509,4.5
46137,2011,1059,991,68,6.4
47001,2011,35172,32094,3078,8.8
47003,2011,20906,18553,2353,11.3
47005,2011,7132,6319,813,11.4
47007,2011,4496,3989,507,11.3
47009,2011,61745,56702,5043,8.2
47011,2011,47447,43224,4223,8.9
47013,2011,16122,14233,1889,11.7
47015,2011,6093,5465,628,10.3
47017,2011,13684,12026,1658,12.1
47019,2011,26279,23643,2636,10
47021,2011,20332,18608,1724,8.5
47023,2011,8531,7756,775,9.1
47025,2011,13685,12173,1512,11
47027,2011,3416,3054,362,10.6
47029,2011,15778,13699,2079,13.2
47031,2011,24717,22264,2453,9.9
47033,2011,7327,6555,772,10.5
47035,2011,23832,21413,2419,10.2
47037,2011,350092,323712,26380,7.5
47039,2011,5331,4711,620,11.6
47041,2011,8223,7311,912,11.1
47043,2011,24323,22002,2321,9.5
47045,2011,17698,15500,2198,12.4
47047,2011,18773,16987,1786,9.5
47049,2011,7504,6648,856,11.4
47051,2011,19291,17486,1805,9.4
47053,2011,23852,21129,2723,11.4
47055,2011,14313,12886,1427,10
47057,2011,10004,8837,1167,11.7
47059,2011,30708,27208,3500,11.4
47061,2011,5534,4847,687,12.4
47063,2011,28311,25244,3067,10.8
47065,2011,171726,158391,13335,7.8
47067,2011,2429,2092,337,13.9
47069,2011,10176,8946,1230,12.1
47071,2011,11456,10167,1289,11.3
47073,2011,25738,23191,2547,9.9
47075,2011,8503,7327,1176,13.8
47077,2011,13586,12071,1515,11.2
47079,2011,14448,12884,1564,10.8
47081,2011,10894,9777,1117,10.3
47083,2011,3568,3170,398,11.2
47085,2011,8849,7923,926,10.5
47087,2011,4749,4194,555,11.7
47089,2011,24314,21765,2549,10.5
47091,2011,7529,6660,869,11.5
47093,2011,233360,217245,16115,6.9
47095,2011,2198,1933,265,12.1
47097,2011,10648,9325,1323,12.4
47099,2011,19253,17245,2008,10.4
47101,2011,5255,4576,679,12.9
47103,2011,15771,14722,1049,6.7
47105,2011,22586,20633,1953,8.6
47107,2011,23065,20491,2574,11.2
47109,2011,10403,9226,1177,11.3
47111,2011,10338,9277,1061,10.3
47113,2011,49066,44498,4568,9.3
47115,2011,12513,11205,1308,10.5
47117,2011,14431,12781,1650,11.4
47119,2011,41313,37081,4232,10.2
47121,2011,4984,4388,596,12
47123,2011,19588,17345,2243,11.5
47125,2011,77267,70667,6600,8.5
47127,2011,3341,3111,230,6.9
47129,2011,8475,7560,915,10.8
47131,2011,15287,13433,1854,12.1
47133,2011,10016,8992,1024,10.2
47135,2011,3030,2676,354,11.7
47137,2011,2434,2159,275,11.3
47139,2011,7427,6600,827,11.1
47141,2011,34387,31327,3060,8.9
47143,2011,13854,12294,1560,11.3
47145,2011,24447,22232,2215,9.1
47147,2011,34127,31263,2864,8.4
47149,2011,144110,132654,11456,7.9
47151,2011,9144,7539,1605,17.6
47153,2011,6093,5471,622,10.2
47155,2011,49713,44746,4967,10
47157,2011,451309,408345,42964,9.5
47159,2011,8861,7954,907,10.2
47161,2011,5657,4955,702,12.4
47163,2011,74647,68445,6202,8.3
47165,2011,84927,78236,6691,7.9
47167,2011,28855,25878,2977,10.3
47169,2011,3762,3370,392,10.4
47171,2011,7904,7032,872,11
47173,2011,7846,7048,798,10.2
47175,2011,2297,2028,269,11.7
47177,2011,17934,16102,1832,10.2
47179,2011,61291,56366,4925,8
47181,2011,6812,6080,732,10.7
47183,2011,16711,14806,1905,11.4
47185,2011,12485,11254,1231,9.9
47187,2011,97414,91713,5701,5.9
47189,2011,60063,55525,4538,7.6
48001,2011,22194,20570,1624,7.3
48003,2011,7794,7405,389,5
48005,2011,38118,35107,3011,7.9
48007,2011,9815,8954,861,8.8
48009,2011,4484,4212,272,6.1
48011,2011,1037,987,50,4.8
48013,2011,19891,18303,1588,8
48015,2011,14153,13036,1117,7.9
48017,2011,3290,3044,246,7.5
48019,2011,9179,8491,688,7.5
48021,2011,35719,32884,2835,7.9
48023,2011,1862,1751,111,6
48025,2011,10591,9683,908,8.6
48027,2011,133465,122763,10702,8
48029,2011,829870,770139,59731,7.2
48031,2011,5420,5112,308,5.7
48033,2011,389,368,21,5.4
48035,2011,8408,7709,699,8.3
48037,2011,42338,38833,3505,8.3
48039,2011,158581,145857,12724,8
48041,2011,99772,93755,6017,6
48043,2011,4862,4592,270,5.6
48045,2011,722,678,44,6.1
48047,2011,2689,2405,284,10.6
48049,2011,16378,15067,1311,8
48051,2011,7764,7199,565,7.3
48053,2011,20659,19265,1394,6.7
48055,2011,16857,15437,1420,8.4
48057,2011,10602,9698,904,8.5
48059,2011,6018,5587,431,7.2
48061,2011,165823,146773,19050,11.5
48063,2011,5679,5171,508,8.9
48065,2011,3425,3254,171,5
48067,2011,13305,11888,1417,10.7
48069,2011,4091,3886,205,5
48071,2011,16802,15242,1560,9.3
48073,2011,22209,20404,1805,8.1
48075,2011,3084,2925,159,5.2
48077,2011,5516,5159,357,6.5
48079,2011,1498,1371,127,8.5
48081,2011,1536,1448,88,5.7
48083,2011,3400,3101,299,8.8
48085,2011,438645,409063,29582,6.7
48087,2011,1307,1231,76,5.8
48089,2011,10108,9326,782,7.7
48091,2011,54641,50881,3760,6.9
48093,2011,5946,5505,441,7.4
48095,2011,1576,1503,73,4.6
48097,2011,20367,19137,1230,6
48099,2011,25663,23687,1976,7.7
48101,2011,667,617,50,7.5
48103,2011,1919,1792,127,6.6
48105,2011,1715,1602,113,6.6
48107,2011,3005,2753,252,8.4
48109,2011,1018,948,70,6.9
48111,2011,4054,3877,177,4.4
48113,2011,1212288,1113577,98711,8.1
48115,2011,5223,4832,391,7.5
48117,2011,9633,9109,524,5.4
48119,2011,2632,2420,212,8.1
48121,2011,379534,354648,24886,6.6
48123,2011,9475,8864,611,6.4
48125,2011,910,771,139,15.3
48127,2011,4913,4533,380,7.7
48129,2011,1814,1697,117,6.4
48131,2011,5210,4721,489,9.4
48133,2011,8421,7775,646,7.7
48135,2011,72809,68356,4453,6.1
48137,2011,991,926,65,6.6
48139,2011,76874,70912,5962,7.8
48141,2011,346748,313903,32845,9.5
48143,2011,20688,19438,1250,6
48145,2011,7185,6591,594,8.3
48147,2011,15277,14016,1261,8.3
48149,2011,12510,11788,722,5.8
48151,2011,1941,1812,129,6.6
48153,2011,3328,3072,256,7.7
48155,2011,667,618,49,7.3
48157,2011,308363,286479,21884,7.1
48159,2011,4756,4368,388,8.2
48161,2011,8079,7447,632,7.8
48163,2011,7973,7455,518,6.5
48165,2011,8508,8076,432,5.1
48167,2011,149857,136627,13230,8.8
48169,2011,2225,2091,134,6
48171,2011,12447,11785,662,5.3
48173,2011,748,716,32,4.3
48175,2011,3377,3158,219,6.5
48177,2011,9474,8891,583,6.2
48179,2011,9634,8979,655,6.8
48181,2011,60176,55436,4740,7.9
48183,2011,61082,56722,4360,7.1
48185,2011,11618,10714,904,7.8
48187,2011,66766,62439,4327,6.5
48189,2011,16238,15023,1215,7.5
48191,2011,1401,1279,122,8.7
48193,2011,3880,3634,246,6.3
48195,2011,3047,2923,124,4.1
48197,2011,1873,1743,130,6.9
48199,2011,26253,23766,2487,9.5
48201,2011,2110507,1944945,165562,7.8
48203,2011,31521,28848,2673,8.5
48205,2011,2813,2702,111,3.9
48207,2011,3039,2876,163,5.4
48209,2011,83333,77746,5587,6.7
48211,2011,2390,2307,83,3.5
48213,2011,35053,32068,2985,8.5
48215,2011,326443,288558,37885,11.6
48217,2011,15891,14582,1309,8.2
48219,2011,11360,10641,719,6.3
48221,2011,23627,21752,1875,7.9
48223,2011,16864,15625,1239,7.3
48225,2011,10660,9830,830,7.8
48227,2011,13256,12390,866,6.5
48229,2011,1388,1277,111,8
48231,2011,38438,35040,3398,8.8
48233,2011,9914,9132,782,7.9
48235,2011,877,830,47,5.4
48237,2011,3715,3457,258,6.9
48239,2011,7355,6897,458,6.2
48241,2011,15035,13180,1855,12.3
48243,2011,1251,1189,62,5
48245,2011,115463,102305,13158,11.4
48247,2011,2330,2129,201,8.6
48249,2011,19762,18201,1561,7.9
48251,2011,72762,67105,5657,7.8
48253,2011,6138,5630,508,8.3
48255,2011,4887,4508,379,7.8
48257,2011,51525,47390,4135,8
48259,2011,16921,15894,1027,6.1
48261,2011,238,223,15,6.3
48263,2011,554,528,26,4.7
48265,2011,21830,20375,1455,6.7
48267,2011,2234,2095,139,6.2
48269,2011,288,277,11,3.8
48271,2011,1271,1142,129,10.1
48273,2011,15389,14156,1233,8
48275,2011,1906,1796,110,5.8
48277,2011,23383,21095,2288,9.8
48279,2011,6730,6221,509,7.6
48281,2011,9139,8448,691,7.6
48283,2011,3136,2926,210,6.7
48285,2011,9621,9049,572,5.9
48287,2011,8870,8297,573,6.5
48289,2011,7158,6537,621,8.7
48291,2011,30785,27372,3413,11.1
48293,2011,9576,8783,793,8.3
48295,2011,1743,1663,80,4.6
48297,2011,5234,4923,311,5.9
48299,2011,8014,7394,620,7.7
48301,2011,66,62,4,6.1
48303,2011,145820,137065,8755,6
48305,2011,3084,2881,203,6.6
48307,2011,4360,4102,258,5.9
48309,2011,113365,104945,8420,7.4
48311,2011,660,640,20,3
48313,2011,4682,4295,387,8.3
48315,2011,4423,3962,461,10.4
48317,2011,2351,2220,131,5.6
48319,2011,1965,1847,118,6
48321,2011,17794,15732,2062,11.6
48323,2011,23914,20560,3354,14
48325,2011,20245,18733,1512,7.5
48327,2011,945,877,68,7.2
48329,2011,76676,73030,3646,4.8
48331,2011,10409,9350,1059,10.2
48333,2011,2173,2036,137,6.3
48335,2011,2943,2722,221,7.5
48337,2011,9602,8978,624,6.5
48339,2011,231782,215406,16376,7.1
48341,2011,11759,11192,567,4.8
48343,2011,5814,5116,698,12
48345,2011,594,553,41,6.9
48347,2011,30628,28488,2140,7
48349,2011,23085,21215,1870,8.1
48351,2011,6040,5271,769,12.7
48353,2011,7352,6837,515,7
48355,2011,164278,151227,13051,7.9
48357,2011,5108,4862,246,4.8
48359,2011,980,938,42,4.3
48361,2011,39187,34675,4512,11.5
48363,2011,13481,12414,1067,7.9
48365,2011,11944,10968,976,8.2
48367,2011,57353,53403,3950,6.9
48369,2011,5292,5057,235,4.4
48371,2011,7199,6767,432,6
48373,2011,17651,16004,1647,9.3
48375,2011,58757,55265,3492,5.9
48377,2011,3781,3207,574,15.2
48379,2011,5168,4744,424,8.2
48381,2011,68124,64749,3375,5
48383,2011,2018,1930,88,4.4
48385,2011,1136,1024,112,9.9
48387,2011,5493,4829,664,12.1
48389,2011,5543,5098,445,8
48391,2011,3419,3160,259,7.6
48393,2011,480,456,24,5
48395,2011,7544,6851,693,9.2
48397,2011,40616,37737,2879,7.1
48399,2011,5108,4734,374,7.3
48401,2011,24286,22576,1710,7
48403,2011,3462,2917,545,15.7
48405,2011,3154,2708,446,14.1
48407,2011,11367,10270,1097,9.7
48409,2011,30231,27295,2936,9.7
48411,2011,2522,2369,153,6.1
48413,2011,1699,1603,96,5.7
48415,2011,7407,6987,420,5.7
48417,2011,2007,1912,95,4.7
48419,2011,11977,10952,1025,8.6
48421,2011,1578,1506,72,4.6
48423,2011,102136,94189,7947,7.8
48425,2011,4084,3767,317,7.8
48427,2011,26168,21930,4238,16.2
48429,2011,4440,4095,345,7.8
48431,2011,682,649,33,4.8
48433,2011,746,705,41,5.5
48435,2011,1947,1815,132,6.8
48437,2011,3152,2940,212,6.7
48439,2011,950514,878726,71788,7.6
48441,2011,64678,60429,4249,6.6
48443,2011,518,486,32,6.2
48445,2011,5853,5437,416,7.1
48447,2011,873,812,61,7
48449,2011,13719,12590,1129,8.2
48451,2011,53262,49931,3331,6.3
48453,2011,594040,556184,37856,6.4
48455,2011,5719,5173,546,9.5
48457,2011,7842,6898,944,12
48459,2011,18615,17133,1482,8
48461,2011,1571,1488,83,5.3
48463,2011,12144,11066,1078,8.9
48465,2011,20461,18625,1836,9
48467,2011,23741,21848,1893,8
48469,2011,43741,40791,2950,6.7
48471,2011,23171,21352,1819,7.9
48473,2011,20344,18677,1667,8.2
48475,2011,4940,4619,321,6.5
48477,2011,15682,14646,1036,6.6
48479,2011,107892,99885,8007,7.4
48481,2011,21498,19723,1775,8.3
48483,2011,2856,2715,141,4.9
48485,2011,59026,54960,4066,6.9
48487,2011,6039,5601,438,7.3
48489,2011,7721,6450,1271,16.5
48491,2011,230895,215239,15656,6.8
48493,2011,21547,20142,1405,6.5
48495,2011,3051,2834,217,7.1
48497,2011,28152,26022,2130,7.6
48499,2011,16973,15506,1467,8.6
48501,2011,4165,3948,217,5.2
48503,2011,8593,7978,615,7.2
48505,2011,6467,5944,523,8.1
48507,2011,4590,3944,646,14.1
49001,2011,3044,2800,244,8
49003,2011,23186,21444,1742,7.5
49005,2011,56612,53638,2974,5.3
49007,2011,9547,8824,723,7.6
49009,2011,471,442,29,6.2
49011,2011,146629,137787,8842,6
49013,2011,8445,7882,563,6.7
49015,2011,5070,4698,372,7.3
49017,2011,2962,2646,316,10.7
49019,2011,5317,4797,520,9.8
49021,2011,19868,18227,1641,8.3
49023,2011,4595,4219,376,8.2
49025,2011,3492,3232,260,7.4
49027,2011,6169,5842,327,5.3
49029,2011,4245,4002,243,5.7
49031,2011,530,477,53,10
49033,2011,982,911,71,7.2
49035,2011,546296,510115,36181,6.6
49037,2011,5954,5359,595,10
49039,2011,11110,10235,875,7.9
49041,2011,9502,8796,706,7.4
49043,2011,21205,19912,1293,6.1
49045,2011,27279,25330,1949,7.1
49047,2011,15518,14585,933,6
49049,2011,231181,216636,14545,6.3
49051,2011,11381,10584,797,7
49053,2011,55996,51025,4971,8.9
49055,2011,1430,1286,144,10.1
49057,2011,112431,103607,8824,7.8
50001,2011,21098,20057,1041,4.9
50003,2011,19961,18687,1274,6.4
50005,2011,16597,15551,1046,6.3
50007,2011,95502,91483,4019,4.2
50009,2011,3059,2803,256,8.4
50011,2011,27902,26462,1440,5.2
50013,2011,4167,3901,266,6.4
50015,2011,14552,13541,1011,6.9
50017,2011,16597,15711,886,5.3
50019,2011,14169,12973,1196,8.4
50021,2011,33287,31025,2262,6.8
50023,2011,34863,33028,1835,5.3
50025,2011,24980,23580,1400,5.6
50027,2011,31373,29660,1713,5.5
51001,2011,16591,15198,1393,8.4
51003,2011,52161,49252,2909,5.6
51005,2011,7908,7286,622,7.9
51007,2011,6262,5793,469,7.5
51009,2011,16181,15003,1178,7.3
51011,2011,7262,6684,578,8
51013,2011,141853,136519,5334,3.8
51015,2011,37430,35060,2370,6.3
51017,2011,2576,2413,163,6.3
51019,2011,38817,36307,2510,6.5
51021,2011,2859,2647,212,7.4
51023,2011,17729,16689,1040,5.9
51025,2011,6818,6098,720,10.6
51027,2011,8475,7750,725,8.6
51029,2011,6594,5963,631,9.6
51031,2011,27607,25629,1978,7.2
51033,2011,14477,13175,1302,9
51035,2011,13629,12284,1345,9.9
51036,2011,3937,3583,354,9
51037,2011,5399,4871,528,9.8
51041,2011,171539,159940,11599,6.8
51043,2011,7773,7328,445,5.7
51045,2011,2481,2294,187,7.5
51047,2011,23397,21908,1489,6.4
51049,2011,4561,4212,349,7.7
51051,2011,5459,4920,539,9.9
51053,2011,13643,12555,1088,8
51057,2011,5699,5226,473,8.3
51059,2011,620197,590687,29510,4.8
51061,2011,36128,34138,1990,5.5
51063,2011,8334,7806,528,6.3
51065,2011,13266,12494,772,5.8
51067,2011,27679,25608,2071,7.5
51069,2011,43199,40397,2802,6.5
51071,2011,8274,7613,661,8
51073,2011,19550,18323,1227,6.3
51075,2011,10374,9716,658,6.3
51077,2011,7206,6424,782,10.9
51079,2011,9792,9201,591,6
51081,2011,4581,4179,402,8.8
51083,2011,16361,14564,1797,11
51085,2011,54957,51675,3282,6
51087,2011,170535,159037,11498,6.7
51089,2011,22821,19949,2872,12.6
51091,2011,1460,1378,82,5.6
51093,2011,18880,17569,1311,6.9
51095,2011,32605,30618,1987,6.1
51097,2011,3664,3394,270,7.4
51099,2011,11721,10904,817,7
51101,2011,8703,8104,599,6.9
51103,2011,5590,5072,518,9.3
51105,2011,10229,9451,778,7.6
51107,2011,181515,173042,8473,4.7
51109,2011,17943,16717,1226,6.8
51111,2011,5511,5039,472,8.6
51113,2011,7223,6844,379,5.2
51115,2011,4244,3967,277,6.5
51117,2011,14059,12599,1460,10.4
51119,2011,5138,4805,333,6.5
51121,2011,48374,45309,3065,6.3
51125,2011,7604,7123,481,6.3
51127,2011,10439,9770,669,6.4
51131,2011,6364,5799,565,8.9
51133,2011,6031,5489,542,9
51135,2011,6893,6400,493,7.2
51137,2011,15788,14606,1182,7.5
51139,2011,12491,11106,1385,11.1
51141,2011,8047,7178,869,10.8
51143,2011,31169,28329,2840,9.1
51145,2011,13555,12708,847,6.2
51147,2011,10386,9450,936,9
51149,2011,14530,13396,1134,7.8
51153,2011,225195,212446,12749,5.7
51155,2011,16880,15413,1467,8.7
51157,2011,4003,3778,225,5.6
51159,2011,4267,3982,285,6.7
51161,2011,49724,46896,2828,5.7
51163,2011,11010,10263,747,6.8
51165,2011,41314,38822,2492,6
51167,2011,11942,10809,1133,9.5
51169,2011,10156,9411,745,7.3
51171,2011,21084,19597,1487,7.1
51173,2011,13750,12250,1500,10.9
51175,2011,9441,8715,726,7.7
51177,2011,64277,59971,4306,6.7
51179,2011,65148,61126,4022,6.2
51181,2011,3760,3442,318,8.5
51183,2011,4381,3922,459,10.5
51185,2011,18195,16749,1446,7.9
51187,2011,20119,18629,1490,7.4
51191,2011,27899,25914,1985,7.1
51193,2011,9402,8695,707,7.5
51195,2011,17257,15933,1324,7.7
51197,2011,14385,13062,1323,9.2
51199,2011,31907,29945,1962,6.1
51510,2011,92505,88377,4128,4.5
51520,2011,8098,7426,672,8.3
51530,2011,3240,2944,296,9.1
51540,2011,23247,21947,1300,5.6
51550,2011,114650,106720,7930,6.9
51570,2011,8560,7915,645,7.5
51580,2011,2663,2413,250,9.4
51590,2011,20279,17918,2361,11.6
51595,2011,2557,2280,277,10.8
51600,2011,12712,12087,625,4.9
51610,2011,7517,7198,319,4.2
51620,2011,3672,3255,417,11.4
51630,2011,13068,12022,1046,8
51640,2011,3105,2784,321,10.3
51650,2011,66445,60507,5938,8.9
51660,2011,23788,21933,1855,7.8
51670,2011,9911,8791,1120,11.3
51678,2011,2293,2083,210,9.2
51680,2011,35762,32878,2884,8.1
51683,2011,21403,20099,1304,6.1
51685,2011,8634,8151,483,5.6
51690,2011,5902,5005,897,15.2
51700,2011,90697,83305,7392,8.2
51710,2011,112932,103527,9405,8.3
51720,2011,2113,1966,147,7
51730,2011,13714,11950,1764,12.9
51735,2011,6369,6005,364,5.7
51740,2011,45777,41496,4281,9.4
51750,2011,8082,7401,681,8.4
51760,2011,107647,98520,9127,8.5
51770,2011,49488,45492,3996,8.1
51775,2011,12834,12017,817,6.4
51790,2011,12005,11154,851,7.1
51800,2011,41913,38790,3123,7.5
51810,2011,229211,215118,14093,6.1
51820,2011,10176,9355,821,8.1
51830,2011,6745,6138,607,9
51840,2011,14078,13032,1046,7.4
53001,2011,8257,7425,832,10.1
53003,2011,10051,9158,893,8.9
53005,2011,92903,85275,7628,8.2
53007,2011,41402,37911,3491,8.4
53009,2011,28488,25371,3117,10.9
53011,2011,211482,186816,24666,11.7
53013,2011,1854,1680,174,9.4
53015,2011,44774,39434,5340,11.9
53017,2011,19281,17473,1808,9.4
53019,2011,2528,2088,440,17.4
53021,2011,38700,35199,3501,9
53023,2011,1030,952,78,7.6
53025,2011,42786,38460,4326,10.1
53027,2011,29705,25667,4038,13.6
53029,2011,32640,29678,2962,9.1
53031,2011,12072,10810,1262,10.5
53033,2011,1108889,1021048,87841,7.9
53035,2011,117324,107470,9854,8.4
53037,2011,20765,18841,1924,9.3
53039,2011,10157,8958,1199,11.8
53041,2011,32542,28390,4152,12.8
53043,2011,5298,4868,430,8.1
53045,2011,23792,21005,2787,11.7
53047,2011,21338,19145,2193,10.3
53049,2011,8220,7114,1106,13.5
53051,2011,4862,4181,681,14
53053,2011,386867,347772,39095,10.1
53055,2011,8063,7479,584,7.2
53057,2011,57143,51131,6012,10.5
53059,2011,5083,4463,620,12.2
53061,2011,384100,347747,36353,9.5
53063,2011,230795,208508,22287,9.7
53065,2011,18296,16036,2260,12.4
53067,2011,123314,112238,11076,9
53069,2011,1429,1224,205,14.3
53071,2011,29623,27252,2371,8
53073,2011,102742,93482,9260,9
53075,2011,22511,21051,1460,6.5
53077,2011,120326,107392,12934,10.7
54001,2011,6777,6142,635,9.4
54003,2011,51211,47258,3953,7.7
54005,2011,8680,7980,700,8.1
54007,2011,5497,4885,612,11.1
54009,2011,10713,9667,1046,9.8
54011,2011,42919,39853,3066,7.1
54013,2011,2867,2504,363,12.7
54015,2011,3573,3132,441,12.3
54017,2011,3325,3088,237,7.1
54019,2011,17734,16146,1588,9
54021,2011,2815,2586,229,8.1
54023,2011,6190,5634,556,9
54025,2011,15567,14268,1299,8.3
54027,2011,9800,8934,866,8.8
54029,2011,13894,12420,1474,10.6
54031,2011,5693,5095,598,10.5
54033,2011,31381,29143,2238,7.1
54035,2011,12018,10783,1235,10.3
54037,2011,27221,25523,1698,6.2
54039,2011,91673,85161,6512,7.1
54041,2011,7171,6636,535,7.5
54043,2011,7678,6860,818,10.7
54045,2011,12913,11764,1149,8.9
54047,2011,6671,5875,796,11.9
54049,2011,26740,24902,1838,6.9
54051,2011,14338,13056,1282,8.9
54053,2011,11051,9846,1205,10.9
54055,2011,23732,21694,2038,8.6
54057,2011,12183,11106,1077,8.8
54059,2011,9201,8410,791,8.6
54061,2011,48549,45850,2699,5.6
54063,2011,5781,5322,459,7.9
54065,2011,7588,6958,630,8.3
54067,2011,10952,9954,998,9.1
54069,2011,21324,19763,1561,7.3
54071,2011,3648,3385,263,7.2
54073,2011,2918,2633,285,9.8
54075,2011,3684,3275,409,11.1
54077,2011,14635,13519,1116,7.6
54079,2011,26290,24366,1924,7.3
54081,2011,33020,30644,2376,7.2
54083,2011,12083,10906,1177,9.7
54085,2011,4310,3918,392,9.1
54087,2011,5412,4712,700,12.9
54089,2011,4693,4258,435,9.3
54091,2011,7430,6878,552,7.4
54093,2011,3225,2922,303,9.4
54095,2011,3601,3222,379,10.5
54097,2011,10239,9351,888,8.7
54099,2011,16504,15157,1347,8.2
54101,2011,3632,3289,343,9.4
54103,2011,7043,6297,746,10.6
54105,2011,2278,2015,263,11.5
54107,2011,38647,35451,3196,8.3
54109,2011,8313,7581,732,8.8
55001,2011,9062,7993,1069,11.8
55003,2011,8310,7465,845,10.2
55005,2011,23752,21737,2015,8.5
55007,2011,7747,6912,835,10.8
55009,2011,137590,127686,9904,7.2
55011,2011,6954,6474,480,6.9
55013,2011,7584,6804,780,10.3
55015,2011,27520,25885,1635,5.9
55017,2011,33384,30796,2588,7.8
55019,2011,17320,15865,1455,8.4
55021,2011,31789,29280,2509,7.9
55023,2011,8456,7674,782,9.2
55025,2011,295302,279620,15682,5.3
55027,2011,47632,43910,3722,7.8
55029,2011,15610,13741,1869,12
55031,2011,23617,21839,1778,7.5
55033,2011,23373,21662,1711,7.3
55035,2011,57741,54032,3709,6.4
55037,2011,2211,1991,220,10
55039,2011,56212,52103,4109,7.3
55041,2011,4187,3701,486,11.6
55043,2011,27924,26027,1897,6.8
55045,2011,21131,19673,1458,6.9
55047,2011,10385,9534,851,8.2
55049,2011,13754,12742,1012,7.4
55051,2011,2756,2460,296,10.7
55053,2011,10225,9408,817,8
55055,2011,46444,42918,3526,7.6
55057,2011,13713,12450,1263,9.2
55059,2011,86384,78580,7804,9
55061,2011,11178,10350,828,7.4
55063,2011,65558,61638,3920,6
55065,2011,9481,8875,606,6.4
55067,2011,10063,9044,1019,10.1
55069,2011,15332,13823,1509,9.8
55071,2011,44506,40752,3754,8.4
55073,2011,72715,66982,5733,7.9
55075,2011,21527,19440,2087,9.7
55077,2011,7609,6851,758,10
55078,2011,1603,1328,275,17.2
55079,2011,477606,433270,44336,9.3
55081,2011,23183,21479,1704,7.4
55083,2011,21121,19092,2029,9.6
55085,2011,18897,17117,1780,9.4
55087,2011,100375,93283,7092,7.1
55089,2011,47451,44545,2906,6.1
55091,2011,4100,3839,261,6.4
55093,2011,23999,22549,1450,6
55095,2011,24147,22069,2078,8.6
55097,2011,39010,36073,2937,7.5
55099,2011,7228,6581,647,9
55101,2011,100520,91429,9091,9
55103,2011,9676,8955,721,7.5
55105,2011,81186,73448,7738,9.5
55107,2011,6888,6127,761,11
55109,2011,47519,44472,3047,6.4
55111,2011,36009,33270,2739,7.6
55113,2011,8185,7275,910,11.1
55115,2011,21775,19790,1985,9.1
55117,2011,61054,56061,4993,8.2
55119,2011,11298,10340,958,8.5
55121,2011,16198,15123,1075,6.6
55123,2011,15178,14121,1057,7
55125,2011,10164,9048,1116,11
55127,2011,56263,51769,4494,8
55129,2011,7985,7274,711,8.9
55131,2011,75295,70128,5167,6.9
55133,2011,217773,203714,14059,6.5
55135,2011,27712,25400,2312,8.3
55137,2011,11919,10752,1167,9.8
55139,2011,92401,85889,6512,7
55141,2011,40010,36674,3336,8.3
56001,2011,21832,20915,917,4.2
56003,2011,5741,5391,350,6.1
56005,2011,25872,24605,1267,4.9
56007,2011,8158,7670,488,6
56009,2011,7659,7289,370,4.8
56011,2011,3885,3696,189,4.9
56013,2011,21212,19844,1368,6.4
56015,2011,7641,7275,366,4.8
56017,2011,2600,2468,132,5.1
56019,2011,4517,4233,284,6.3
56021,2011,47167,44249,2918,6.2
56023,2011,8740,8054,686,7.8
56025,2011,41123,38628,2495,6.1
56027,2011,1395,1337,58,4.2
56029,2011,16094,15164,930,5.8
56031,2011,4963,4714,249,5
56033,2011,16062,14951,1111,6.9
56035,2011,5902,5632,270,4.6
56037,2011,23891,22633,1258,5.3
56039,2011,13637,12614,1023,7.5
56041,2011,10167,9537,630,6.2
56043,2011,4591,4335,256,5.6
56045,2011,3966,3785,181,4.6
72001,2011,5084,4009,1075,21.1
72003,2011,13118,10516,2602,19.8
72005,2011,16679,13369,3310,19.8
72007,2011,7569,5990,1579,20.9
72009,2011,7345,5879,1466,20
72011,2011,9608,7828,1780,18.5
72013,2011,26613,21888,4725,17.8
72015,2011,5945,4561,1384,23.3
72017,2011,6338,4909,1429,22.5
72019,2011,7952,6574,1378,17.3
72021,2011,73797,64479,9318,12.6
72023,2011,14928,12452,2476,16.6
72025,2011,52920,44964,7956,15
72027,2011,10345,8695,1650,15.9
72029,2011,17012,14218,2794,16.4
72031,2011,68174,59923,8251,12.1
72033,2011,8929,7578,1351,15.1
72035,2011,17621,14826,2795,15.9
72037,2011,4490,3559,931,20.7
72039,2011,4472,3382,1090,24.4
72041,2011,16957,14318,2639,15.6
72043,2011,12180,9471,2709,22.2
72045,2011,5611,4421,1190,21.2
72047,2011,10047,8267,1780,17.7
72049,2011,767,705,62,8.1
72051,2011,13086,11672,1414,10.8
72053,2011,13186,10512,2674,20.3
72054,2011,3680,2918,762,20.7
72055,2011,4929,3671,1258,25.5
72057,2011,14057,10882,3175,22.6
72059,2011,5910,4568,1342,22.7
72061,2011,39582,36423,3159,8
72063,2011,17302,15026,2276,13.2
72065,2011,13700,11388,2312,16.9
72067,2011,5949,5019,930,15.6
72069,2011,19629,15429,4200,21.4
72071,2011,12943,10411,2532,19.6
72073,2011,4733,3820,913,19.3
72075,2011,16785,13807,2978,17.7
72077,2011,13055,10653,2402,18.4
72079,2011,6258,4797,1461,23.3
72081,2011,7920,6278,1642,20.7
72083,2011,3928,3269,659,16.8
72085,2011,11997,9691,2306,19.2
72087,2011,9656,8200,1456,15.1
72089,2011,7072,5600,1472,20.8
72091,2011,12833,10595,2238,17.4
72093,2011,2201,1794,407,18.5
72095,2011,3444,2577,867,25.2
72097,2011,26408,21525,4883,18.5
72099,2011,11686,9294,2392,20.5
72101,2011,8854,7013,1841,20.8
72103,2011,8709,7033,1676,19.2
72105,2011,7935,6415,1520,19.2
72107,2011,5788,4591,1197,20.7
72109,2011,5692,4222,1470,25.8
72111,2011,7126,5514,1612,22.6
72113,2011,53626,44602,9024,16.8
72115,2011,6548,5273,1275,19.5
72117,2011,4907,3942,965,19.7
72119,2011,18180,15547,2633,14.5
72121,2011,7233,5661,1572,21.7
72123,2011,9069,6704,2365,26.1
72125,2011,11455,9321,2134,18.6
72127,2011,148387,133606,14781,10
72129,2011,12964,10677,2287,17.6
72131,2011,11581,8911,2670,23.1
72133,2011,9783,7633,2150,22
72135,2011,26694,23589,3105,11.6
72137,2011,32616,28600,4016,12.3
72139,2011,29102,26226,2876,9.9
72141,2011,7720,6159,1561,20.2
72143,2011,10505,8752,1753,16.7
72145,2011,15293,12430,2863,18.7
72147,2011,3174,2671,503,15.8
72149,2011,8485,6681,1804,21.3
72151,2011,10630,7924,2706,25.5
72153,2011,11760,9263,2497,21.2
01001,2012,25740,23961,1779,6.9
01003,2012,84414,78065,6349,7.5
01005,2012,9362,8283,1079,11.5
01007,2012,8798,8047,751,8.5
01009,2012,24960,23244,1716,6.9
01011,2012,4736,4245,491,10.4
01013,2012,9088,8039,1049,11.5
01015,2012,49649,45252,4397,8.9
01017,2012,15140,13646,1494,9.9
01019,2012,11268,10363,905,8
01021,2012,19383,17982,1401,7.2
01023,2012,4791,4297,494,10.3
01025,2012,8374,7116,1258,15
01027,2012,5413,4905,508,9.4
01029,2012,5838,5358,480,8.2
01031,2012,20612,19159,1453,7
01033,2012,24026,21922,2104,8.8
01035,2012,4635,4082,553,11.9
01037,2012,4445,4029,416,9.4
01039,2012,16345,14978,1367,8.4
01041,2012,6251,5732,519,8.3
01043,2012,35568,32835,2733,7.7
01045,2012,21370,19781,1589,7.4
01047,2012,16746,14583,2163,12.9
01049,2012,28833,26224,2609,9
01051,2012,36629,34087,2542,6.9
01053,2012,14732,13374,1358,9.2
01055,2012,44232,40589,3643,8.2
01057,2012,6503,5943,560,8.6
01059,2012,13976,12806,1170,8.4
01061,2012,11274,10421,853,7.6
01063,2012,3125,2701,424,13.6
01065,2012,6212,5499,713,11.5
01067,2012,7030,6447,583,8.3
01069,2012,46054,42578,3476,7.5
01071,2012,23731,21695,2036,8.6
01073,2012,316511,293020,23491,7.4
01075,2012,5806,5369,437,7.5
01077,2012,43409,40084,3325,7.7
01079,2012,14391,13094,1297,9
01081,2012,68918,64247,4671,6.8
01083,2012,38990,36311,2679,6.9
01085,2012,4081,3452,629,15.4
01087,2012,8286,7397,889,10.7
01089,2012,170209,158399,11810,6.9
01091,2012,7650,6873,777,10.2
01093,2012,12451,11340,1111,8.9
01095,2012,40686,37523,3163,7.8
01097,2012,188626,171312,17314,9.2
01099,2012,7971,6971,1000,12.5
01101,2012,107320,98666,8654,8.1
01103,2012,57410,52931,4479,7.8
01105,2012,3683,3192,491,13.3
01107,2012,7467,6709,758,10.2
01109,2012,15017,13819,1198,8
01111,2012,9143,8304,839,9.2
01113,2012,24911,22725,2186,8.8
01115,2012,38516,35871,2645,6.9
01117,2012,105458,100158,5300,5
01119,2012,5417,4848,569,10.5
01121,2012,35013,31731,3282,9.4
01123,2012,18441,16850,1591,8.6
01125,2012,95340,88683,6657,7
01127,2012,26574,24136,2438,9.2
01129,2012,6875,6054,821,11.9
01131,2012,2883,2308,575,19.9
01133,2012,9607,8647,960,10
02013,2012,2138,1993,145,6.8
02016,2012,4268,3972,296,6.9
02020,2012,158380,149897,8483,5.4
02050,2012,7211,6103,1108,15.4
02060,2012,481,434,47,9.8
02068,2012,1047,903,144,13.8
02070,2012,2132,1921,211,9.9
02090,2012,48197,45264,2933,6.1
02100,2012,1108,997,111,10
02105,2012,1109,950,159,14.3
02110,2012,17904,16991,913,5.1
02122,2012,27367,25003,2364,8.6
02130,2012,7177,6594,583,8.1
02150,2012,6717,6268,449,6.7
02158,2012,2768,2156,612,22.1
02164,2012,637,540,97,15.2
02170,2012,43757,39968,3789,8.7
02180,2012,4178,3690,488,11.7
02185,2012,4027,3715,312,7.7
02188,2012,3031,2554,477,15.7
02195,2012,1878,1725,153,8.1
02198,2012,2591,2247,344,13.3
02220,2012,4647,4384,263,5.7
02230,2012,754,648,106,14.1
02240,2012,3038,2647,391,12.9
02261,2012,4894,4419,475,9.7
02275,2012,1026,942,84,8.2
02282,2012,288,260,28,9.7
02290,2012,2773,2291,482,17.4
04001,2012,22806,18482,4324,19
04003,2012,53898,49027,4871,9
04005,2012,71032,64922,6110,8.6
04007,2012,20923,18786,2137,10.2
04009,2012,14472,13242,1230,8.5
04011,2012,3553,3261,292,8.2
04012,2012,8137,7441,696,8.6
04013,2012,1895634,1757601,138033,7.3
04015,2012,77570,69021,8549,11
04017,2012,42957,36890,6067,14.1
04019,2012,462896,428796,34100,7.4
04021,2012,148689,135995,12694,8.5
04023,2012,20121,17014,3107,15.4
04025,2012,92384,84442,7942,8.6
04027,2012,93806,71429,22377,23.9
05001,2012,9913,9044,869,8.8
05003,2012,9298,8158,1140,12.3
05005,2012,16373,14994,1379,8.4
05007,2012,110768,104109,6659,6
05009,2012,16523,15264,1259,7.6
05011,2012,4371,3886,485,11.1
05013,2012,2511,2282,229,9.1
05015,2012,12479,11690,789,6.3
05017,2012,4062,3600,462,11.4
05019,2012,10140,9118,1022,10.1
05021,2012,6869,6115,754,11
05023,2012,10390,9504,886,8.5
05025,2012,3751,3475,276,7.4
05027,2012,10115,9205,910,9
05029,2012,8704,7902,802,9.2
05031,2012,49059,45688,3371,6.9
05033,2012,27610,25412,2198,8
05035,2012,22103,19987,2116,9.6
05037,2012,8531,7854,677,7.9
05039,2012,3182,2815,367,11.5
05041,2012,5930,5343,587,9.9
05043,2012,8369,7477,892,10.7
05045,2012,59723,55766,3957,6.6
05047,2012,7669,7125,544,7.1
05049,2012,5110,4743,367,7.2
05051,2012,41203,37949,3254,7.9
05053,2012,8425,7852,573,6.8
05055,2012,20006,18275,1731,8.7
05057,2012,10851,10060,791,7.3
05059,2012,14485,13441,1044,7.2
05061,2012,6434,6003,431,6.7
05063,2012,16041,14563,1478,9.2
05065,2012,5163,4709,454,8.8
05067,2012,6470,5774,696,10.8
05069,2012,32469,29222,3247,10
05071,2012,10807,10011,796,7.4
05073,2012,2886,2612,274,9.5
05075,2012,7235,6576,659,9.1
05077,2012,3521,3187,334,9.5
05079,2012,4586,4185,401,8.7
05081,2012,5979,5543,436,7.3
05083,2012,9627,8858,769,8
05085,2012,33083,30982,2101,6.4
05087,2012,6971,6563,408,5.9
05089,2012,6608,6065,543,8.2
05091,2012,20260,19055,1205,5.9
05093,2012,20267,18046,2221,11
05095,2012,3270,2974,296,9.1
05097,2012,3586,3282,304,8.5
05099,2012,4129,3808,321,7.8
05101,2012,3628,3362,266,7.3
05103,2012,10498,9395,1103,10.5
05105,2012,4416,4015,401,9.1
05107,2012,7970,7048,922,11.6
05109,2012,4366,3969,397,9.1
05111,2012,10387,9486,901,8.7
05113,2012,8701,8054,647,7.4
05115,2012,29999,27815,2184,7.3
05117,2012,3825,3536,289,7.6
05119,2012,188484,175552,12932,6.9
05121,2012,6867,6124,743,10.8
05123,2012,9498,8471,1027,10.8
05125,2012,54388,51067,3321,6.1
05127,2012,4647,4335,312,6.7
05129,2012,3219,2955,264,8.2
05131,2012,59025,54392,4633,7.8
05133,2012,6131,5593,538,8.8
05135,2012,6105,5486,619,10.1
05137,2012,5052,4636,416,8.2
05139,2012,16755,15211,1544,9.2
05141,2012,6604,5935,669,10.1
05143,2012,105383,99464,5919,5.6
05145,2012,36246,33396,2850,7.9
05147,2012,3383,3038,345,10.2
05149,2012,9266,8642,624,6.7
06001,2012,798416,729049,69367,8.7
06003,2012,544,483,61,11.2
06005,2012,14672,12873,1799,12.3
06007,2012,100990,88718,12272,12.2
06009,2012,20201,17705,2496,12.4
06011,2012,11272,8935,2337,20.7
06013,2012,535786,487887,47899,8.9
06015,2012,10496,9076,1420,13.5
06017,2012,89051,79958,9093,10.2
06019,2012,440031,373457,66574,15.1
06021,2012,13148,11283,1865,14.2
06023,2012,64279,58120,6159,9.6
06025,2012,79265,57586,21679,27.4
06027,2012,9557,8690,867,9.1
06029,2012,391888,340355,51533,13.1
06031,2012,58807,50049,8758,14.9
06033,2012,29509,25738,3771,12.8
06035,2012,11471,10042,1429,12.5
06037,2012,4915263,4378392,536871,10.9
06039,2012,62530,53495,9035,14.4
06041,2012,136911,128310,8601,6.3
06043,2012,8375,7352,1023,12.2
06045,2012,40953,36841,4112,10
06047,2012,115016,96236,18780,16.3
06049,2012,3612,3092,520,14.4
06051,2012,8401,7532,869,10.3
06053,2012,217796,192600,25196,11.6
06055,2012,71816,65755,6061,8.4
06057,2012,48363,43649,4714,9.7
06059,2012,1562136,1439270,122866,7.9
06061,2012,174919,158545,16374,9.4
06063,2012,8485,7115,1370,16.1
06065,2012,987076,872251,114825,11.6
06067,2012,681281,609691,71590,10.5
06069,2012,28677,24936,3741,13
06071,2012,892212,790420,101792,11.4
06073,2012,1540441,1399879,140562,9.1
06075,2012,509444,474933,34511,6.8
06077,2012,311818,267059,44759,14.4
06079,2012,137362,126037,11325,8.2
06081,2012,412056,385661,26395,6.4
06083,2012,216005,197919,18086,8.4
06085,2012,958281,882982,75299,7.9
06087,2012,142063,125257,16806,11.8
06089,2012,76009,65229,10780,14.2
06091,2012,1469,1258,211,14.4
06093,2012,18876,15929,2947,15.6
06095,2012,202661,180984,21677,10.7
06097,2012,246281,224462,21819,8.9
06099,2012,241965,205940,36025,14.9
06101,2012,45557,37901,7656,16.8
06103,2012,25248,21780,3468,13.7
06105,2012,5330,4550,780,14.6
06107,2012,201287,168764,32523,16.2
06109,2012,22315,19419,2896,13
06111,2012,434681,395158,39523,9.1
06113,2012,102610,91689,10921,10.6
06115,2012,28832,24395,4437,15.4
08001,2012,239471,216923,22548,9.4
08003,2012,7753,6943,810,10.4
08005,2012,322881,297947,24934,7.7
08007,2012,5736,5160,576,10
08009,2012,2015,1924,91,4.5
08011,2012,1722,1578,144,8.4
08013,2012,174313,163471,10842,6.2
08014,2012,32275,30129,2146,6.6
08015,2012,8367,7796,571,6.8
08017,2012,1010,964,46,4.6
08019,2012,5486,5100,386,7
08021,2012,3711,3317,394,10.6
08023,2012,1603,1420,183,11.4
08025,2012,1362,1252,110,8.1
08027,2012,1986,1860,126,6.3
08029,2012,14406,13010,1396,9.7
08031,2012,357670,329577,28093,7.9
08033,2012,949,852,97,10.2
08035,2012,160907,151248,9659,6
08037,2012,32349,30032,2317,7.2
08039,2012,12692,11789,903,7.1
08041,2012,307002,279826,27176,8.9
08043,2012,15633,13810,1823,11.7
08045,2012,31490,28813,2677,8.5
08047,2012,3267,3049,218,6.7
08049,2012,8747,8113,634,7.2
08051,2012,9832,9244,588,6
08053,2012,436,415,21,4.8
08055,2012,2634,2259,375,14.2
08057,2012,826,783,43,5.2
08059,2012,304298,281809,22489,7.4
08061,2012,817,780,37,4.5
08063,2012,4229,4041,188,4.4
08065,2012,4523,4133,390,8.6
08067,2012,29663,27693,1970,6.6
08069,2012,172883,161287,11596,6.7
08071,2012,6963,6127,836,12
08073,2012,2157,2017,140,6.5
08075,2012,11067,10405,662,6
08077,2012,74945,67680,7265,9.7
08079,2012,444,420,24,5.4
08081,2012,7743,7104,639,8.3
08083,2012,12917,11813,1104,8.5
08085,2012,19836,17787,2049,10.3
08087,2012,14981,13967,1014,6.8
08089,2012,8401,7538,863,10.3
08091,2012,2085,1890,195,9.4
08093,2012,9302,8662,640,6.9
08095,2012,2141,2031,110,5.1
08097,2012,10911,10126,785,7.2
08099,2012,6097,5671,426,7
08101,2012,74490,66523,7967,10.7
08103,2012,3091,2833,258,8.3
08105,2012,5104,4481,623,12.2
08107,2012,14373,13338,1035,7.2
08109,2012,3055,2716,339,11.1
08111,2012,535,482,53,9.9
08113,2012,4856,4475,381,7.8
08115,2012,1119,1041,78,7
08117,2012,19325,18158,1167,6
08119,2012,11912,10912,1000,8.4
08121,2012,2636,2507,129,4.9
08123,2012,136906,126256,10650,7.8
08125,2012,4884,4633,251,5.1
09001,2012,472641,435831,36810,7.8
09003,2012,472917,432601,40316,8.5
09005,2012,106179,98110,8069,7.6
09007,2012,92000,85416,6584,7.2
09009,2012,456070,414528,41542,9.1
09011,2012,139621,127534,12087,8.7
09013,2012,84759,78545,6214,7.3
09015,2012,63231,57271,5960,9.4
10001,2012,74287,68394,5893,7.9
10003,2012,278342,258855,19487,7
10005,2012,92942,86207,6735,7.2
11001,2012,364989,331984,33005,9
12001,2012,130007,121373,8634,6.6
12003,2012,11347,10374,973,8.6
12005,2012,86694,79206,7488,8.6
12007,2012,11152,10307,845,7.6
12009,2012,262648,237972,24676,9.4
12011,2012,963563,886780,76783,8
12013,2012,5093,4627,466,9.1
12015,2012,65886,59621,6265,9.5
12017,2012,51550,46006,5544,10.8
12019,2012,96340,89002,7338,7.6
12021,2012,152762,139883,12879,8.4
12023,2012,28041,25567,2474,8.8
12027,2012,12899,11616,1283,9.9
12029,2012,5809,5215,594,10.2
12031,2012,456398,416680,39718,8.7
12033,2012,139701,127948,11753,8.4
12035,2012,42156,37998,4158,9.9
12037,2012,5051,4724,327,6.5
12039,2012,18900,16952,1948,10.3
12041,2012,6717,6108,609,9.1
12043,2012,5701,5262,439,7.7
12045,2012,6091,5598,493,8.1
12047,2012,5175,4717,458,8.9
12049,2012,11844,10792,1052,8.9
12051,2012,17004,14830,2174,12.8
12053,2012,66289,59281,7008,10.6
12055,2012,37385,33542,3843,10.3
12057,2012,668540,615740,52800,7.9
12059,2012,7166,6534,632,8.8
12061,2012,62012,55217,6795,11
12063,2012,18067,16502,1565,8.7
12065,2012,5505,4996,509,9.2
12067,2012,3485,3286,199,5.7
12069,2012,134048,122203,11845,8.8
12071,2012,292354,266535,25819,8.8
12073,2012,149342,138903,10439,7
12075,2012,16732,15176,1556,9.3
12077,2012,2747,2529,218,7.9
12079,2012,7999,7313,686,8.6
12081,2012,150763,138509,12254,8.1
12083,2012,130450,117140,13310,10.2
12085,2012,67147,61568,5579,8.3
12086,2012,1282458,1176385,106073,8.3
12087,2012,43928,41431,2497,5.7
12089,2012,35950,33059,2891,8
12091,2012,91453,85311,6142,6.7
12093,2012,18321,16495,1826,10
12095,2012,653886,600251,53635,8.2
12097,2012,143550,129979,13571,9.5
12099,2012,660634,604549,56085,8.5
12101,2012,208712,189824,18888,9
12103,2012,467029,429860,37169,8
12105,2012,277091,250458,26633,9.6
12107,2012,28930,25513,3417,11.8
12109,2012,104055,97255,6800,6.5
12111,2012,129091,114967,14124,10.9
12113,2012,72665,67192,5473,7.5
12115,2012,168019,153858,14161,8.4
12117,2012,231131,212462,18669,8.1
12119,2012,26860,24028,2832,10.5
12121,2012,18342,16871,1471,8
12123,2012,9408,8564,844,9
12125,2012,5087,4720,367,7.2
12127,2012,237385,214879,22506,9.5
12129,2012,14121,13092,1029,7.3
12131,2012,26271,24360,1911,7.3
12133,2012,10064,9176,888,8.8
13001,2012,8982,7975,1007,11.2
13003,2012,3446,3048,398,11.5
13005,2012,4557,4116,441,9.7
13007,2012,1172,1043,129,11
13009,2012,18881,16689,2192,11.6
13011,2012,8591,7885,706,8.2
13013,2012,34566,31581,2985,8.6
13015,2012,47422,42716,4706,9.9
13017,2012,6183,5321,862,13.9
13019,2012,7859,7054,805,10.2
13021,2012,71737,64176,7561,10.5
13023,2012,5282,4617,665,12.6
13025,2012,7440,6546,894,12
13027,2012,6808,6184,624,9.2
13029,2012,15153,13896,1257,8.3
13031,2012,33926,30602,3324,9.8
13033,2012,9718,8517,1201,12.4
13035,2012,10375,9311,1064,10.3
13037,2012,2375,2190,185,7.8
13039,2012,21882,20003,1879,8.6
13043,2012,5187,4737,450,8.7
13045,2012,52013,46676,5337,10.3
13047,2012,32250,29840,2410,7.5
13049,2012,4980,4515,465,9.3
13051,2012,131983,119798,12185,9.2
13053,2012,2601,2296,305,11.7
13055,2012,10642,9552,1090,10.2
13057,2012,115046,106895,8151,7.1
13059,2012,58146,53081,5065,8.7
13061,2012,1009,883,126,12.5
13063,2012,127655,112298,15357,12
13065,2012,2917,2634,283,9.7
13067,2012,388649,358646,30003,7.7
13069,2012,17477,15483,1994,11.4
13071,2012,21009,19162,1847,8.8
13073,2012,64708,60188,4520,7
13075,2012,7534,6821,713,9.5
13077,2012,65493,60271,5222,8
13079,2012,5831,5259,572,9.8
13081,2012,9177,8030,1147,12.5
13083,2012,8386,7747,639,7.6
13085,2012,10859,9928,931,8.6
13087,2012,12246,11006,1240,10.1
13089,2012,370150,335318,34832,9.4
13091,2012,8152,7212,940,11.5
13093,2012,4813,4260,553,11.5
13095,2012,40905,36288,4617,11.3
13097,2012,66984,60547,6437,9.6
13099,2012,4489,4033,456,10.2
13101,2012,1807,1674,133,7.4
13103,2012,25958,23786,2172,8.4
13105,2012,8557,7481,1076,12.6
13107,2012,9090,7967,1123,12.4
13109,2012,4804,4393,411,8.6
13111,2012,10020,8996,1024,10.2
13113,2012,53498,49458,4040,7.6
13115,2012,44808,39913,4895,10.9
13117,2012,93750,87542,6208,6.6
13119,2012,9543,8466,1077,11.3
13121,2012,511185,464673,46512,9.1
13123,2012,12158,10874,1284,10.6
13125,2012,1322,1194,128,9.7
13127,2012,38791,35114,3677,9.5
13129,2012,26845,24216,2629,9.8
13131,2012,10831,9902,929,8.6
13133,2012,6420,5708,712,11.1
13135,2012,434145,400458,33687,7.8
13137,2012,18427,16673,1754,9.5
13139,2012,89115,82180,6935,7.8
13141,2012,2758,2290,468,17
13143,2012,12101,10863,1238,10.2
13145,2012,16275,15102,1173,7.2
13147,2012,10823,9709,1114,10.3
13149,2012,5122,4593,529,10.3
13151,2012,103207,93513,9694,9.4
13153,2012,68742,63212,5530,8
13155,2012,3543,3127,416,11.7
13157,2012,29412,26995,2417,8.2
13159,2012,6666,6013,653,9.8
13161,2012,6382,5645,737,11.5
13163,2012,7085,6148,937,13.2
13165,2012,3364,2902,462,13.7
13167,2012,4065,3660,405,10
13169,2012,13879,12700,1179,8.5
13171,2012,7968,7005,963,12.1
13173,2012,3910,3544,366,9.4
13175,2012,19799,17372,2427,12.3
13177,2012,14324,13227,1097,7.7
13179,2012,27156,24736,2420,8.9
13181,2012,3538,3156,382,10.8
13183,2012,6647,6079,568,8.5
13185,2012,52459,47676,4783,9.1
13187,2012,15178,13910,1268,8.4
13189,2012,9332,8154,1178,12.6
13191,2012,6033,5444,589,9.8
13193,2012,5173,4485,688,13.3
13195,2012,13127,11955,1172,8.9
13197,2012,3612,3251,361,10
13199,2012,9031,7946,1085,12
13201,2012,2700,2479,221,8.2
13205,2012,9615,8761,854,8.9
13207,2012,12821,11712,1109,8.6
13209,2012,3900,3447,453,11.6
13211,2012,8541,7770,771,9
13213,2012,16406,14306,2100,12.8
13215,2012,83617,75432,8185,9.8
13217,2012,48311,42993,5318,11
13219,2012,17068,15992,1076,6.3
13221,2012,6893,6305,588,8.5
13223,2012,74473,68282,6191,8.3
13225,2012,12548,11149,1399,11.1
13227,2012,13899,12637,1262,9.1
13229,2012,8338,7550,788,9.5
13231,2012,8422,7643,779,9.2
13233,2012,18793,16917,1876,10
13235,2012,4380,3987,393,9
13237,2012,8292,7336,956,11.5
13239,2012,943,853,90,9.5
13241,2012,6939,6144,795,11.5
13243,2012,2836,2481,355,12.5
13245,2012,88450,79050,9400,10.6
13247,2012,42138,37844,4294,10.2
13249,2012,2176,1949,227,10.4
13251,2012,5694,4908,786,13.8
13253,2012,3254,2899,355,10.9
13255,2012,28196,24658,3538,12.5
13257,2012,11763,10528,1235,10.5
13259,2012,2320,2105,215,9.3
13261,2012,13960,12300,1660,11.9
13263,2012,2922,2628,294,10.1
13265,2012,607,521,86,14.2
13267,2012,9814,8997,817,8.3
13269,2012,3116,2699,417,13.4
13271,2012,5344,4715,629,11.8
13273,2012,3755,3345,410,10.9
13275,2012,18487,16696,1791,9.7
13277,2012,19159,17226,1933,10.1
13279,2012,12517,11045,1472,11.8
13281,2012,4440,3939,501,11.3
13283,2012,2905,2514,391,13.5
13285,2012,35610,32110,3500,9.8
13287,2012,3460,3055,405,11.7
13289,2012,3174,2702,472,14.9
13291,2012,9661,8807,854,8.8
13293,2012,11994,10713,1281,10.7
13295,2012,30923,28145,2778,9
13297,2012,41141,37400,3741,9.1
13299,2012,15485,13915,1570,10.1
13301,2012,2653,2256,397,15
13303,2012,8083,7247,836,10.3
13305,2012,12611,11262,1349,10.7
13307,2012,1061,956,105,9.9
13309,2012,1958,1697,261,13.3
13311,2012,13570,12396,1174,8.7
13313,2012,45754,40886,4868,10.6
13315,2012,2867,2533,334,11.6
13317,2012,3841,3372,469,12.2
13319,2012,3738,3308,430,11.5
13321,2012,9622,8643,979,10.2
15001,2012,86114,78944,7170,8.3
15003,2012,448023,423881,24142,5.4
15007,2012,33878,31393,2485,7.3
15009,2012,79171,74084,5087,6.4
16001,2012,204353,191714,12639,6.2
16003,2012,1743,1483,260,14.9
16005,2012,41203,38349,2854,6.9
16007,2012,2882,2721,161,5.6
16009,2012,4159,3653,506,12.2
16011,2012,22774,21319,1455,6.4
16013,2012,11726,10903,823,7
16015,2012,2968,2685,283,9.5
16017,2012,18610,16662,1948,10.5
16019,2012,49127,46022,3105,6.3
16021,2012,5221,4729,492,9.4
16023,2012,1336,1227,109,8.2
16025,2012,668,607,61,9.1
16027,2012,86977,79059,7918,9.1
16029,2012,3973,3731,242,6.1
16031,2012,11116,10472,644,5.8
16033,2012,424,392,32,7.5
16035,2012,3272,2860,412,12.6
16037,2012,2336,2147,189,8.1
16039,2012,10678,9874,804,7.5
16041,2012,6311,6020,291,4.6
16043,2012,6928,6500,428,6.2
16045,2012,7614,6898,716,9.4
16047,2012,8093,7631,462,5.7
16049,2012,6650,5922,728,10.9
16051,2012,12197,11447,750,6.1
16053,2012,10878,10173,705,6.5
16055,2012,68654,62636,6018,8.8
16057,2012,19634,18489,1145,5.8
16059,2012,3569,3218,351,9.8
16061,2012,1597,1511,86,5.4
16063,2012,2699,2452,247,9.2
16065,2012,18434,17593,841,4.6
16067,2012,10383,9752,631,6.1
16069,2012,19881,18737,1144,5.8
16071,2012,2093,1990,103,4.9
16073,2012,5104,4893,211,4.1
16075,2012,10843,9991,852,7.9
16077,2012,4089,3771,318,7.8
16079,2012,5609,4873,736,13.1
16081,2012,5315,5002,313,5.9
16083,2012,37673,35064,2609,6.9
16085,2012,4674,4150,524,11.2
16087,2012,4786,4383,403,8.4
17001,2012,33909,31697,2212,6.5
17003,2012,2761,2432,329,11.9
17005,2012,8283,7542,741,8.9
17007,2012,26899,24104,2795,10.4
17009,2012,2630,2474,156,5.9
17011,2012,18218,16545,1673,9.2
17013,2012,2449,2204,245,10
17015,2012,8068,7409,659,8.2
17017,2012,6628,6069,559,8.4
17019,2012,104109,96508,7601,7.3
17021,2012,16577,15034,1543,9.3
17023,2012,8037,7267,770,9.6
17025,2012,6655,6015,640,9.6
17027,2012,20381,19028,1353,6.6
17029,2012,24860,22682,2178,8.8
17031,2012,2653324,2397790,255534,9.6
17033,2012,10450,9646,804,7.7
17035,2012,5966,5503,463,7.8
17037,2012,55619,50926,4693,8.4
17039,2012,8487,7802,685,8.1
17041,2012,9936,9216,720,7.2
17043,2012,506425,468487,37938,7.5
17045,2012,9132,8249,883,9.7
17047,2012,3061,2822,239,7.8
17049,2012,18530,17319,1211,6.5
17051,2012,10702,9742,960,9
17053,2012,6786,6266,520,7.7
17055,2012,17413,15563,1850,10.6
17057,2012,16964,15285,1679,9.9
17059,2012,2527,2315,212,8.4
17061,2012,6487,5941,546,8.4
17063,2012,25754,22796,2958,11.5
17065,2012,3926,3614,312,7.9
17067,2012,9281,8513,768,8.3
17069,2012,1737,1554,183,10.5
17071,2012,3733,3436,297,8
17073,2012,26261,24321,1940,7.4
17075,2012,15294,13989,1305,8.5
17077,2012,29216,26933,2283,7.8
17079,2012,4942,4565,377,7.6
17081,2012,17904,16259,1645,9.2
17083,2012,11405,10378,1027,9
17085,2012,11890,10992,898,7.6
17087,2012,4307,3809,498,11.6
17089,2012,267647,243849,23798,8.9
17091,2012,56267,50392,5875,10.4
17093,2012,63486,58179,5307,8.4
17095,2012,24415,22386,2029,8.3
17097,2012,368148,338367,29781,8.1
17099,2012,59584,53608,5976,10
17101,2012,6484,5824,660,10.2
17103,2012,18246,16735,1511,8.3
17105,2012,18227,16818,1409,7.7
17107,2012,13545,12532,1013,7.5
17109,2012,15024,13875,1149,7.6
17111,2012,167014,152016,14998,9
17113,2012,94554,88522,6032,6.4
17115,2012,54309,48924,5385,9.9
17117,2012,24079,21797,2282,9.5
17119,2012,135745,123807,11938,8.8
17121,2012,18682,16856,1826,9.8
17123,2012,6227,5711,516,8.3
17125,2012,7018,6315,703,10
17127,2012,6578,5947,631,9.6
17129,2012,7012,6521,491,7
17131,2012,8671,8002,669,7.7
17133,2012,17952,16744,1208,6.7
17135,2012,13201,11726,1475,11.2
17137,2012,17792,16425,1367,7.7
17139,2012,7394,6867,527,7.1
17141,2012,26670,23982,2688,10.1
17143,2012,96283,88227,8056,8.4
17145,2012,9236,8258,978,10.6
17147,2012,8571,7976,595,6.9
17149,2012,7802,7214,588,7.5
17151,2012,1893,1731,162,8.6
17153,2012,2378,2108,270,11.4
17155,2012,3138,2846,292,9.3
17157,2012,14621,13398,1223,8.4
17159,2012,7553,6948,605,8
17161,2012,75652,69602,6050,8
17163,2012,130469,118026,12443,9.5
17165,2012,11658,10601,1057,9.1
17167,2012,107433,99648,7785,7.2
17169,2012,3629,3344,285,7.9
17171,2012,2713,2478,235,8.7
17173,2012,10796,9872,924,8.6
17175,2012,3005,2761,244,8.1
17177,2012,23532,21412,2120,9
17179,2012,71546,66205,5341,7.5
17181,2012,7586,6758,828,10.9
17183,2012,37030,33604,3426,9.3
17185,2012,5777,5319,458,7.9
17187,2012,8939,8305,634,7.1
17189,2012,9156,8576,580,6.3
17191,2012,8037,7421,616,7.7
17193,2012,7283,6733,550,7.6
17195,2012,29517,26925,2592,8.8
17197,2012,356094,321291,34803,9.8
17199,2012,31879,29129,2750,8.6
17201,2012,146251,130867,15384,10.5
17203,2012,20524,19297,1227,6
18001,2012,15884,14765,1119,7
18003,2012,173799,159246,14553,8.4
18005,2012,41408,38762,2646,6.4
18007,2012,4550,4211,339,7.5
18009,2012,5461,4836,625,11.4
18011,2012,30227,28388,1839,6.1
18013,2012,7322,6736,586,8
18015,2012,9985,9251,734,7.4
18017,2012,17781,16249,1532,8.6
18019,2012,55404,51070,4334,7.8
18021,2012,12808,11545,1263,9.9
18023,2012,16568,15239,1329,8
18025,2012,4791,4282,509,10.6
18027,2012,14790,13900,890,6
18029,2012,24979,22755,2224,8.9
18031,2012,13583,12481,1102,8.1
18033,2012,20569,18852,1717,8.3
18035,2012,54898,49755,5143,9.4
18037,2012,21582,20351,1231,5.7
18039,2012,96847,88194,8653,8.9
18041,2012,9164,8143,1021,11.1
18043,2012,37784,35095,2689,7.1
18045,2012,8538,7821,717,8.4
18047,2012,10558,9553,1005,9.5
18049,2012,10083,9238,845,8.4
18051,2012,17396,16205,1191,6.8
18053,2012,32336,29189,3147,9.7
18055,2012,13811,12367,1444,10.5
18057,2012,151112,143091,8021,5.3
18059,2012,35729,33107,2622,7.3
18061,2012,18557,17124,1433,7.7
18063,2012,76893,72027,4866,6.3
18065,2012,21143,19018,2125,10.1
18067,2012,35916,32658,3258,9.1
18069,2012,18587,16950,1637,8.8
18071,2012,20486,18957,1529,7.5
18073,2012,15969,14673,1296,8.1
18075,2012,10084,9285,799,7.9
18077,2012,15221,13930,1291,8.5
18079,2012,13111,11760,1351,10.3
18081,2012,72543,67491,5052,7
18083,2012,18717,17381,1336,7.1
18085,2012,38740,35758,2982,7.7
18087,2012,17001,15792,1209,7.1
18089,2012,228899,208026,20873,9.1
18091,2012,49697,44849,4848,9.8
18093,2012,20554,18301,2253,11
18095,2012,57995,52201,5794,10
18097,2012,458377,416087,42290,9.2
18099,2012,22963,21074,1889,8.2
18101,2012,5077,4717,360,7.1
18103,2012,15633,14113,1520,9.7
18105,2012,66747,61899,4848,7.3
18107,2012,18594,17072,1522,8.2
18109,2012,34688,31769,2919,8.4
18111,2012,6923,6258,665,9.6
18113,2012,22618,20671,1947,8.6
18115,2012,3181,2898,283,8.9
18117,2012,8776,7831,945,10.8
18119,2012,9827,8762,1065,10.8
18121,2012,6990,6274,716,10.2
18123,2012,8873,8128,745,8.4
18125,2012,6130,5679,451,7.4
18127,2012,82380,76114,6266,7.6
18129,2012,13190,12299,891,6.8
18131,2012,6271,5808,463,7.4
18133,2012,16338,14721,1617,9.9
18135,2012,12761,11541,1220,9.6
18137,2012,13847,12602,1245,9
18139,2012,8377,7665,712,8.5
18141,2012,127769,115689,12080,9.5
18143,2012,10181,9133,1048,10.3
18145,2012,22318,20453,1865,8.4
18147,2012,10791,10012,779,7.2
18149,2012,10108,9036,1072,10.6
18151,2012,18914,17536,1378,7.3
18153,2012,8803,7982,821,9.3
18155,2012,4890,4512,378,7.7
18157,2012,88448,82294,6154,7
18159,2012,8009,7387,622,7.8
18161,2012,3557,3270,287,8.1
18163,2012,91824,84785,7039,7.7
18165,2012,7468,6617,851,11.4
18167,2012,50132,45160,4972,9.9
18169,2012,15693,14361,1332,8.5
18171,2012,4198,3888,310,7.4
18173,2012,30814,28718,2096,6.8
18175,2012,13174,11930,1244,9.4
18177,2012,30691,27655,3036,9.9
18179,2012,13711,12727,984,7.2
18181,2012,13028,12013,1015,7.8
18183,2012,16903,15557,1346,8
19001,2012,4047,3870,177,4.4
19003,2012,2183,2096,87,4
19005,2012,7594,7105,489,6.4
19007,2012,5987,5597,390,6.5
19009,2012,3215,3061,154,4.8
19011,2012,13771,13040,731,5.3
19013,2012,71212,67343,3869,5.4
19015,2012,14569,13938,631,4.3
19017,2012,13864,13332,532,3.8
19019,2012,11023,10493,530,4.8
19021,2012,11224,10757,467,4.2
19023,2012,8211,7840,371,4.5
19025,2012,4427,4183,244,5.5
19027,2012,11335,10910,425,3.7
19029,2012,7193,6819,374,5.2
19031,2012,10662,10177,485,4.5
19033,2012,23719,22394,1325,5.6
19035,2012,6856,6559,297,4.3
19037,2012,6294,5967,327,5.2
19039,2012,4609,4332,277,6
19041,2012,8882,8434,448,5
19043,2012,10164,9586,578,5.7
19045,2012,25088,23546,1542,6.1
19047,2012,8755,8364,391,4.5
19049,2012,39158,37628,1530,3.9
19051,2012,4090,3854,236,5.8
19053,2012,4242,4054,188,4.4
19055,2012,10255,9796,459,4.5
19057,2012,20089,18854,1235,6.1
19059,2012,9177,8659,518,5.6
19061,2012,54613,52140,2473,4.5
19063,2012,5713,5458,255,4.5
19065,2012,10792,10205,587,5.4
19067,2012,8123,7616,507,6.2
19069,2012,5811,5551,260,4.5
19071,2012,4009,3804,205,5.1
19073,2012,5116,4862,254,5
19075,2012,6650,6347,303,4.6
19077,2012,5554,5242,312,5.6
19079,2012,7047,6561,486,6.9
19081,2012,5980,5707,273,4.6
19083,2012,8756,8288,468,5.3
19085,2012,7536,7156,380,5
19087,2012,9619,9048,571,5.9
19089,2012,5199,4959,240,4.6
19091,2012,5156,4938,218,4.2
19093,2012,3772,3620,152,4
19095,2012,9593,9161,432,4.5
19097,2012,10816,10225,591,5.5
19099,2012,18540,17437,1103,5.9
19101,2012,8760,8300,460,5.3
19103,2012,80281,77326,2955,3.7
19105,2012,10674,10112,562,5.3
19107,2012,5423,5126,297,5.5
19109,2012,8383,8058,325,3.9
19111,2012,17477,16219,1258,7.2
19113,2012,118869,112665,6204,5.2
19115,2012,5787,5470,317,5.5
19117,2012,4183,3984,199,4.8
19119,2012,6833,6631,202,3
19121,2012,8134,7681,453,5.6
19123,2012,11636,11033,603,5.2
19125,2012,17062,16242,820,4.8
19127,2012,19797,18526,1271,6.4
19129,2012,7263,6929,334,4.6
19131,2012,5551,5298,253,4.6
19133,2012,4534,4244,290,6.4
19135,2012,3978,3749,229,5.8
19137,2012,5031,4775,256,5.1
19139,2012,21235,20019,1216,5.7
19141,2012,8040,7734,306,3.8
19143,2012,3383,3243,140,4.1
19145,2012,6674,6315,359,5.4
19147,2012,4756,4553,203,4.3
19149,2012,14190,13609,581,4.1
19151,2012,4162,3994,168,4
19153,2012,244099,231450,12649,5.2
19155,2012,48453,46002,2451,5.1
19157,2012,10155,9661,494,4.9
19159,2012,2537,2425,112,4.4
19161,2012,5502,5269,233,4.2
19163,2012,87193,82190,5003,5.7
19165,2012,6990,6727,263,3.8
19167,2012,19372,18703,669,3.5
19169,2012,53318,51416,1902,3.6
19171,2012,9087,8542,545,6
19173,2012,3142,3014,128,4.1
19175,2012,6852,6505,347,5.1
19177,2012,3799,3579,220,5.8
19179,2012,17888,16645,1243,6.9
19181,2012,25880,24645,1235,4.8
19183,2012,12148,11637,511,4.2
19185,2012,2792,2640,152,5.4
19187,2012,19273,18056,1217,6.3
19189,2012,5115,4842,273,5.3
19191,2012,11884,11336,548,4.6
19193,2012,54273,51437,2836,5.2
19195,2012,4220,3990,230,5.5
19197,2012,6791,6427,364,5.4
20001,2012,6863,6372,491,7.2
20003,2012,4300,4020,280,6.5
20005,2012,7836,7229,607,7.7
20007,2012,2730,2624,106,3.9
20009,2012,14963,14289,674,4.5
20011,2012,6715,6199,516,7.7
20013,2012,5236,4955,281,5.4
20015,2012,31996,30002,1994,6.2
20017,2012,1325,1255,70,5.3
20019,2012,1695,1584,111,6.5
20021,2012,10571,9745,826,7.8
20023,2012,1330,1282,48,3.6
20025,2012,1201,1159,42,3.5
20027,2012,4246,4027,219,5.2
20029,2012,4573,4345,228,5
20031,2012,4519,4203,316,7
20033,2012,999,960,39,3.9
20035,2012,17215,16152,1063,6.2
20037,2012,19284,18004,1280,6.6
20039,2012,1401,1339,62,4.4
20041,2012,10060,9452,608,6
20043,2012,4392,4117,275,6.3
20045,2012,63496,60235,3261,5.1
20047,2012,1642,1576,66,4
20049,2012,1348,1256,92,6.8
20051,2012,18020,17403,617,3.4
20053,2012,3487,3365,122,3.5
20055,2012,20154,19254,900,4.5
20057,2012,18822,18095,727,3.9
20059,2012,13977,12960,1017,7.3
20061,2012,12807,11697,1110,8.7
20063,2012,1513,1468,45,3
20065,2012,1386,1339,47,3.4
20067,2012,3987,3832,155,3.9
20069,2012,3562,3451,111,3.1
20071,2012,884,857,27,3.1
20073,2012,3426,3234,192,5.6
20075,2012,1825,1776,49,2.7
20077,2012,3107,2972,135,4.3
20079,2012,17249,16312,937,5.4
20081,2012,2462,2379,83,3.4
20083,2012,1111,1073,38,3.4
20085,2012,7345,6932,413,5.6
20087,2012,10240,9620,620,6.1
20089,2012,1449,1387,62,4.3
20091,2012,310263,296014,14249,4.6
20093,2012,2170,2084,86,4
20095,2012,3768,3537,231,6.1
20097,2012,1407,1354,53,3.8
20099,2012,10711,9858,853,8
20101,2012,900,859,41,4.6
20103,2012,34446,32240,2206,6.4
20105,2012,1847,1757,90,4.9
20107,2012,4382,3949,433,9.9
20109,2012,1754,1701,53,3
20111,2012,17227,16227,1000,5.8
20113,2012,16654,15969,685,4.1
20115,2012,6344,6019,325,5.1
20117,2012,6084,5830,254,4.2
20119,2012,2470,2387,83,3.4
20121,2012,16755,15694,1061,6.3
20123,2012,3868,3752,116,3
20125,2012,18407,16984,1423,7.7
20127,2012,3203,3008,195,6.1
20129,2012,1655,1594,61,3.7
20131,2012,5997,5780,217,3.6
20133,2012,6895,6288,607,8.8
20135,2012,1626,1573,53,3.3
20137,2012,3144,3046,98,3.1
20139,2012,8343,7738,605,7.3
20141,2012,2172,2079,93,4.3
20143,2012,3220,3046,174,5.4
20145,2012,3421,3281,140,4.1
20147,2012,3012,2877,135,4.5
20149,2012,11582,11038,544,4.7
20151,2012,5436,5192,244,4.5
20153,2012,1569,1526,43,2.7
20155,2012,32067,30318,1749,5.5
20157,2012,2611,2511,100,3.8
20159,2012,5403,5162,241,4.5
20161,2012,36247,34667,1580,4.4
20163,2012,2767,2639,128,4.6
20165,2012,1891,1803,88,4.7
20167,2012,3808,3652,156,4.1
20169,2012,30708,28940,1768,5.8
20171,2012,2775,2690,85,3.1
20173,2012,246743,229760,16983,6.9
20175,2012,10828,10383,445,4.1
20177,2012,91978,86288,5690,6.2
20179,2012,1546,1503,43,2.8
20181,2012,3217,3094,123,3.8
20183,2012,2215,2128,87,3.9
20185,2012,2218,2115,103,4.6
20187,2012,1048,1011,37,3.5
20189,2012,2886,2784,102,3.5
20191,2012,11298,10578,720,6.4
20193,2012,4542,4385,157,3.5
20195,2012,1509,1444,65,4.3
20197,2012,3786,3581,205,5.4
20199,2012,872,835,37,4.2
20201,2012,3248,3113,135,4.2
20203,2012,1332,1262,70,5.3
20205,2012,4188,3772,416,9.9
20207,2012,1644,1542,102,6.2
20209,2012,74381,68103,6278,8.4
21001,2012,7826,7083,743,9.5
21003,2012,9024,8302,722,8
21005,2012,11540,10744,796,6.9
21007,2012,3881,3527,354,9.1
21009,2012,19833,18273,1560,7.9
21011,2012,4890,4382,508,10.4
21013,2012,10269,9043,1226,11.9
21015,2012,65398,60924,4474,6.8
21017,2012,9847,9132,715,7.3
21019,2012,20080,18210,1870,9.3
21021,2012,13074,11900,1174,9
21023,2012,3950,3577,373,9.4
21025,2012,4538,3882,656,14.5
21027,2012,8282,7482,800,9.7
21029,2012,39265,36099,3166,8.1
21031,2012,5411,4925,486,9
21033,2012,5677,5205,472,8.3
21035,2012,18306,17014,1292,7.1
21037,2012,48813,45437,3376,6.9
21039,2012,2341,2154,187,8
21041,2012,5065,4547,518,10.2
21043,2012,11492,10056,1436,12.5
21045,2012,6861,6287,574,8.4
21047,2012,26742,24249,2493,9.3
21049,2012,17416,15998,1418,8.1
21051,2012,5956,5123,833,14
21053,2012,4250,3788,462,10.9
21055,2012,4159,3839,320,7.7
21057,2012,3119,2783,336,10.8
21059,2012,48254,44882,3372,7
21061,2012,5033,4532,501,10
21063,2012,2304,1973,331,14.4
21065,2012,5619,5058,561,10
21067,2012,166267,156579,9688,5.8
21069,2012,6478,5892,586,9
21071,2012,13738,12144,1594,11.6
21073,2012,24555,22914,1641,6.7
21075,2012,2483,2202,281,11.3
21077,2012,3944,3576,368,9.3
21079,2012,7752,7098,654,8.4
21081,2012,11501,10462,1039,9
21083,2012,16667,15293,1374,8.2
21085,2012,11312,10150,1162,10.3
21087,2012,5454,5000,454,8.3
21089,2012,15042,13553,1489,9.9
21091,2012,4150,3853,297,7.2
21093,2012,47576,43682,3894,8.2
21095,2012,9926,8527,1399,14.1
21097,2012,8901,8199,702,7.9
21099,2012,8138,7464,674,8.3
21101,2012,22636,20932,1704,7.5
21103,2012,7700,7138,562,7.3
21105,2012,2165,1990,175,8.1
21107,2012,21582,19918,1664,7.7
21109,2012,5177,4568,609,11.8
21111,2012,382602,352234,30368,7.9
21113,2012,24812,23151,1661,6.7
21115,2012,8597,7724,873,10.2
21117,2012,84380,78150,6230,7.4
21119,2012,5829,5025,804,13.8
21121,2012,10555,9201,1354,12.8
21123,2012,5950,5440,510,8.6
21125,2012,24895,22361,2534,10.2
21127,2012,5636,5039,597,10.6
21129,2012,2431,2124,307,12.6
21131,2012,3594,3081,513,14.3
21133,2012,8582,7425,1157,13.5
21135,2012,5382,4755,627,11.6
21137,2012,10102,9062,1040,10.3
21139,2012,3973,3588,385,9.7
21141,2012,12192,11271,921,7.6
21143,2012,3102,2817,285,9.2
21145,2012,30912,28451,2461,8
21147,2012,5475,4753,722,13.2
21149,2012,4560,4212,348,7.6
21151,2012,44628,41617,3011,6.7
21153,2012,4036,3343,693,17.2
21155,2012,9175,8363,812,8.9
21157,2012,15369,14125,1244,8.1
21159,2012,3768,3424,344,9.1
21161,2012,7619,6901,718,9.4
21163,2012,12631,11398,1233,9.8
21165,2012,2545,2249,296,11.6
21167,2012,10246,9401,845,8.2
21169,2012,4426,4074,352,8
21171,2012,4800,4454,346,7.2
21173,2012,12326,11237,1089,8.8
21175,2012,5221,4666,555,10.6
21177,2012,12413,11198,1215,9.8
21179,2012,21897,20086,1811,8.3
21181,2012,3535,3244,291,8.2
21183,2012,10383,9482,901,8.7
21185,2012,29797,28045,1752,5.9
21187,2012,5750,5373,377,6.6
21189,2012,1327,1157,170,12.8
21191,2012,7064,6440,624,8.8
21193,2012,10957,9582,1375,12.5
21195,2012,24197,21855,2342,9.7
21197,2012,5069,4516,553,10.9
21199,2012,27305,24725,2580,9.4
21201,2012,849,762,87,10.2
21203,2012,7190,6457,733,10.2
21205,2012,11189,10258,931,8.3
21207,2012,7224,6478,746,10.3
21209,2012,25810,24124,1686,6.5
21211,2012,22277,20888,1389,6.2
21213,2012,8965,8200,765,8.5
21215,2012,9263,8611,652,7
21217,2012,11685,10565,1120,9.6
21219,2012,5674,5243,431,7.6
21221,2012,6034,5469,565,9.4
21223,2012,3988,3628,360,9
21225,2012,7024,6476,548,7.8
21227,2012,59961,55795,4166,6.9
21229,2012,6211,5746,465,7.5
21231,2012,7733,6730,1003,13
21233,2012,6252,5808,444,7.1
21235,2012,13879,12400,1479,10.7
21237,2012,2103,1804,299,14.2
21239,2012,14127,13369,758,5.4
22001,2012,26135,24571,1564,6
22003,2012,9098,8372,726,8
22005,2012,54849,51502,3347,6.1
22007,2012,9950,8988,962,9.7
22009,2012,16369,15130,1239,7.6
22011,2012,14413,13327,1086,7.5
22013,2012,5954,5417,537,9
22015,2012,57312,54006,3306,5.8
22017,2012,113533,104787,8746,7.7
22019,2012,87905,81839,6066,6.9
22021,2012,4003,3653,350,8.7
22023,2012,3226,3057,169,5.2
22025,2012,3918,3568,350,8.9
22027,2012,7021,6498,523,7.4
22029,2012,7827,7137,690,8.8
22031,2012,11195,10188,1007,9
22033,2012,222248,207284,14964,6.7
22035,2012,2190,1751,439,20
22037,2012,7960,7361,599,7.5
22039,2012,12833,11882,951,7.4
22041,2012,7696,6896,800,10.4
22043,2012,8224,7574,650,7.9
22045,2012,32236,30056,2180,6.8
22047,2012,13892,12589,1303,9.4
22049,2012,6831,6366,465,6.8
22051,2012,212225,198018,14207,6.7
22053,2012,12975,12131,844,6.5
22055,2012,116591,110733,5858,5
22057,2012,45425,43027,2398,5.3
22059,2012,6737,6395,342,5.1
22061,2012,19485,17806,1679,8.6
22063,2012,62147,58167,3980,6.4
22065,2012,3891,3422,469,12.1
22067,2012,11243,9778,1465,13
22069,2012,16036,14601,1435,8.9
22071,2012,168791,155488,13303,7.9
22073,2012,70713,65263,5450,7.7
22075,2012,10126,9525,601,5.9
22077,2012,9883,9074,809,8.2
22079,2012,57231,53206,4025,7
22081,2012,3946,3657,289,7.3
22083,2012,8666,7823,843,9.7
22085,2012,9213,8572,641,7
22087,2012,17640,16235,1405,8
22089,2012,24715,23094,1621,6.6
22091,2012,4600,4045,555,12.1
22093,2012,9661,8684,977,10.1
22095,2012,20513,18611,1902,9.3
22097,2012,33401,30626,2775,8.3
22099,2012,24223,22716,1507,6.2
22101,2012,25413,23510,1903,7.5
22103,2012,108755,102332,6423,5.9
22105,2012,53029,48506,4523,8.5
22107,2012,1815,1619,196,10.8
22109,2012,51017,48306,2711,5.3
22111,2012,9220,8457,763,8.3
22113,2012,25807,24326,1481,5.7
22115,2012,18881,17320,1561,8.3
22117,2012,16478,15026,1452,8.8
22119,2012,16084,14536,1548,9.6
22121,2012,11908,11088,820,6.9
22123,2012,4160,3594,566,13.6
22125,2012,5131,4820,311,6.1
22127,2012,5690,5205,485,8.5
23001,2012,56388,52019,4369,7.7
23003,2012,34192,31008,3184,9.3
23005,2012,159792,150251,9541,6
23007,2012,15486,14145,1341,8.7
23009,2012,29970,27377,2593,8.7
23011,2012,63164,58636,4528,7.2
23013,2012,20617,19190,1427,6.9
23015,2012,17256,15993,1263,7.3
23017,2012,27903,25196,2707,9.7
23019,2012,79928,73723,6205,7.8
23021,2012,7880,7132,748,9.5
23023,2012,19210,17941,1269,6.6
23025,2012,24628,22162,2466,10
23027,2012,20684,18977,1707,8.3
23029,2012,14751,13227,1524,10.3
23031,2012,110789,103143,7646,6.9
24001,2012,33848,30831,3017,8.9
24003,2012,293697,276068,17629,6
24005,2012,440264,407899,32365,7.4
24009,2012,47708,44717,2991,6.3
24011,2012,17611,16248,1363,7.7
24013,2012,93264,87757,5507,5.9
24015,2012,51886,47561,4325,8.3
24017,2012,79556,74251,5305,6.7
24019,2012,16173,14420,1753,10.8
24021,2012,128608,120759,7849,6.1
24023,2012,15829,14517,1312,8.3
24025,2012,135560,126145,9415,6.9
24027,2012,168218,159781,8437,5
24029,2012,10629,9819,810,7.6
24031,2012,540440,512451,27989,5.2
24033,2012,484976,449677,35299,7.3
24035,2012,26732,25042,1690,6.3
24037,2012,54491,51103,3388,6.2
24039,2012,9740,8643,1097,11.3
24041,2012,19414,18016,1398,7.2
24043,2012,77166,71120,6046,7.8
24045,2012,50475,45732,4743,9.4
24047,2012,26118,22743,3375,12.9
24510,2012,297246,267009,30237,10.2
25001,2012,108240,99066,9174,8.5
25003,2012,66255,61399,4856,7.3
25005,2012,285229,260377,24852,8.7
25007,2012,9329,8502,827,8.9
25009,2012,395470,367511,27959,7.1
25011,2012,39592,37187,2405,6.1
25013,2012,219167,200394,18773,8.6
25015,2012,85258,80311,4947,5.8
25017,2012,831746,786722,45024,5.4
25019,2012,6385,5886,499,7.8
25021,2012,358841,338415,20426,5.7
25023,2012,260287,242055,18232,7
25025,2012,401378,376766,24612,6.1
25027,2012,417983,387939,30044,7.2
26001,2012,3711,3240,471,12.7
26003,2012,3433,3024,409,11.9
26005,2012,56649,52482,4167,7.4
26007,2012,13386,12084,1302,9.7
26009,2012,10001,8848,1153,11.5
26011,2012,6528,5694,834,12.8
26013,2012,3533,3036,497,14.1
26015,2012,28950,26968,1982,6.8
26017,2012,52851,48230,4621,8.7
26019,2012,8523,7631,892,10.5
26021,2012,73289,66664,6625,9
26023,2012,18642,16992,1650,8.9
26025,2012,62221,57015,5206,8.4
26027,2012,23748,21744,2004,8.4
26029,2012,12909,11515,1394,10.8
26031,2012,10499,9255,1244,11.8
26033,2012,17105,15386,1719,10
26035,2012,11961,10545,1416,11.8
26037,2012,38504,36153,2351,6.1
26039,2012,5368,4736,632,11.8
26041,2012,17505,15777,1728,9.9
26043,2012,12633,11566,1067,8.4
26045,2012,54878,51079,3799,6.9
26047,2012,17792,15666,2126,11.9
26049,2012,181201,163066,18135,10
26051,2012,9926,8752,1174,11.8
26053,2012,6786,6033,753,11.1
26055,2012,46358,42529,3829,8.3
26057,2012,18575,16905,1670,9
26059,2012,20458,18586,1872,9.2
26061,2012,16904,15390,1514,9
26063,2012,16389,15069,1320,8.1
26065,2012,143174,131953,11221,7.8
26067,2012,28620,26190,2430,8.5
26069,2012,10148,9010,1138,11.2
26071,2012,5079,4594,485,9.5
26073,2012,34701,32136,2565,7.4
26075,2012,71562,65453,6109,8.5
26077,2012,124591,115564,9027,7.2
26079,2012,7429,6588,841,11.3
26081,2012,319697,297920,21777,6.8
26083,2012,984,859,125,12.7
26085,2012,3661,3183,478,13.1
26087,2012,39714,35095,4619,11.6
26089,2012,10163,9347,816,8
26091,2012,47498,43522,3976,8.4
26093,2012,93153,85806,7347,7.9
26095,2012,2366,2107,259,10.9
26097,2012,5187,4560,627,12.1
26099,2012,411719,371286,40433,9.8
26101,2012,10494,9359,1135,10.8
26103,2012,33986,31240,2746,8.1
26105,2012,14338,12952,1386,9.7
26107,2012,18822,16916,1906,10.1
26109,2012,11755,10809,946,8
26111,2012,40668,37507,3161,7.8
26113,2012,6910,6242,668,9.7
26115,2012,73606,67904,5702,7.7
26117,2012,27253,24473,2780,10.2
26119,2012,3234,2709,525,16.2
26121,2012,75633,68034,7599,10
26123,2012,22013,19993,2020,9.2
26125,2012,616205,565454,50751,8.2
26127,2012,12824,11202,1622,12.6
26129,2012,8623,7639,984,11.4
26131,2012,2578,2233,345,13.4
26133,2012,9968,8975,993,10
26135,2012,2985,2518,467,15.6
26137,2012,11187,9989,1198,10.7
26139,2012,141570,132241,9329,6.6
26141,2012,5536,4734,802,14.5
26143,2012,8101,7012,1089,13.4
26145,2012,88770,80580,8190,9.2
26147,2012,73736,65066,8670,11.8
26149,2012,27438,24989,2449,8.9
26151,2012,19300,17274,2026,10.5
26153,2012,3534,3090,444,12.6
26155,2012,33156,29986,3170,9.6
26157,2012,24683,22078,2605,10.6
26159,2012,35208,31496,3712,10.5
26161,2012,181611,170803,10808,6
26163,2012,771845,681453,90392,11.7
26165,2012,14469,12876,1593,11
27001,2012,6904,6345,559,8.1
27003,2012,187260,176226,11034,5.9
27005,2012,17873,16836,1037,5.8
27007,2012,22840,21245,1595,7
27009,2012,21197,19844,1353,6.4
27011,2012,2830,2682,148,5.2
27013,2012,38316,36479,1837,4.8
27015,2012,14817,13982,835,5.6
27017,2012,17472,16272,1200,6.9
27019,2012,52427,49897,2530,4.8
27021,2012,13852,12623,1229,8.9
27023,2012,7058,6685,373,5.3
27025,2012,28561,26684,1877,6.6
27027,2012,35023,33334,1689,4.8
27029,2012,4409,3944,465,10.5
27031,2012,3048,2858,190,6.2
27033,2012,5947,5561,386,6.5
27035,2012,30912,28538,2374,7.7
27037,2012,228036,216129,11907,5.2
27039,2012,11339,10768,571,5
27041,2012,19810,18812,998,5
27043,2012,7771,7318,453,5.8
27045,2012,11274,10650,624,5.5
27047,2012,16675,15707,968,5.8
27049,2012,26709,25333,1376,5.2
27051,2012,3337,3133,204,6.1
27053,2012,659812,625310,34502,5.2
27055,2012,10571,9957,614,5.8
27057,2012,9540,8773,767,8
27059,2012,20351,18929,1422,7
27061,2012,22248,20502,1746,7.8
27063,2012,6206,5924,282,4.5
27065,2012,8732,7947,785,9
27067,2012,23494,22267,1227,5.2
27069,2012,2563,2414,149,5.8
27071,2012,6702,6167,535,8
27073,2012,3856,3662,194,5
27075,2012,5828,5478,350,6
27077,2012,2347,2204,143,6.1
27079,2012,15488,14482,1006,6.5
27081,2012,3422,3260,162,4.7
27083,2012,15230,14558,672,4.4
27085,2012,19931,18580,1351,6.8
27087,2012,2478,2306,172,6.9
27089,2012,5746,5306,440,7.7
27091,2012,10873,10263,610,5.6
27093,2012,12736,11897,839,6.6
27095,2012,12693,11634,1059,8.3
27097,2012,17936,16670,1266,7.1
27099,2012,20661,19630,1031,5
27101,2012,4995,4735,260,5.2
27103,2012,19739,18839,900,4.6
27105,2012,11289,10799,490,4.3
27107,2012,3522,3314,208,5.9
27109,2012,82541,78892,3649,4.4
27111,2012,30777,29067,1710,5.6
27113,2012,8589,8022,567,6.6
27115,2012,14881,13761,1120,7.5
27117,2012,4906,4662,244,5
27119,2012,17506,16418,1088,6.2
27121,2012,5944,5667,277,4.7
27123,2012,272944,257259,15685,5.7
27125,2012,2340,2171,169,7.2
27127,2012,8205,7752,453,5.5
27129,2012,8426,7855,571,6.8
27131,2012,34862,32836,2026,5.8
27133,2012,5546,5344,202,3.6
27135,2012,8537,8134,403,4.7
27137,2012,101564,94964,6600,6.5
27139,2012,75799,72024,3775,5
27141,2012,48620,45611,3009,6.2
27143,2012,8418,7915,503,6
27145,2012,86268,81613,4655,5.4
27147,2012,21570,20400,1170,5.4
27149,2012,5606,5369,237,4.2
27151,2012,5084,4771,313,6.2
27153,2012,13033,12277,756,5.8
27155,2012,1775,1686,89,5
27157,2012,11959,11340,619,5.2
27159,2012,6229,5743,486,7.8
27161,2012,10213,9625,588,5.8
27163,2012,133686,126811,6875,5.1
27165,2012,6285,5932,353,5.6
27167,2012,3781,3603,178,4.7
27169,2012,29823,28363,1460,4.9
27171,2012,70288,66174,4114,5.9
27173,2012,5679,5394,285,5
28001,2012,12366,11141,1225,9.9
28003,2012,16001,14608,1393,8.7
28005,2012,4762,4284,478,10
28007,2012,7585,6841,744,9.8
28009,2012,3290,2941,349,10.6
28011,2012,14400,12871,1529,10.6
28013,2012,6746,6185,561,8.3
28015,2012,3676,3271,405,11
28017,2012,7992,7174,818,10.2
28019,2012,3724,3386,338,9.1
28021,2012,3530,2986,544,15.4
28023,2012,6729,6005,724,10.8
28025,2012,8587,7379,1208,14.1
28027,2012,10217,8931,1286,12.6
28029,2012,11873,10562,1311,11
28031,2012,8359,7651,708,8.5
28033,2012,83109,77739,5370,6.5
28035,2012,34419,31315,3104,9
28037,2012,3071,2771,300,9.8
28039,2012,8823,7919,904,10.2
28041,2012,4568,4055,513,11.2
28043,2012,9612,8726,886,9.2
28045,2012,19597,17941,1656,8.5
28047,2012,88960,81688,7272,8.2
28049,2012,115704,105543,10161,8.8
28051,2012,6618,5524,1094,16.5
28053,2012,3171,2567,604,19
28055,2012,471,388,83,17.6
28057,2012,10415,9540,875,8.4
28059,2012,63232,57255,5977,9.5
28061,2012,6893,6193,700,10.2
28063,2012,2517,2080,437,17.4
28065,2012,4459,3883,576,12.9
28067,2012,28735,26560,2175,7.6
28069,2012,3971,3450,521,13.1
28071,2012,23351,21550,1801,7.7
28073,2012,28145,26328,1817,6.5
28075,2012,34574,31447,3127,9
28077,2012,4941,4433,508,10.3
28079,2012,8405,7629,776,9.2
28081,2012,41050,37628,3422,8.3
28083,2012,11210,9637,1573,14
28085,2012,14412,13168,1244,8.6
28087,2012,27522,25005,2517,9.1
28089,2012,50411,47262,3149,6.2
28091,2012,10334,9276,1058,10.2
28093,2012,15396,13725,1671,10.9
28095,2012,16142,14356,1786,11.1
28097,2012,4544,4014,530,11.7
28099,2012,11654,10680,974,8.4
28101,2012,9262,8524,738,8
28103,2012,4211,3659,552,13.1
28105,2012,22784,20874,1910,8.4
28107,2012,14307,12570,1737,12.1
28109,2012,23776,21819,1957,8.2
28111,2012,4436,3927,509,11.5
28113,2012,15271,13663,1608,10.5
28115,2012,14081,12980,1101,7.8
28117,2012,11423,10438,985,8.6
28119,2012,2971,2557,414,13.9
28121,2012,72785,68604,4181,5.7
28123,2012,13093,12096,997,7.6
28125,2012,1938,1675,263,13.6
28127,2012,11285,10355,930,8.2
28129,2012,7096,6580,516,7.3
28131,2012,6694,6004,690,10.3
28133,2012,9485,8123,1362,14.4
28135,2012,5775,5124,651,11.3
28137,2012,12430,11281,1149,9.2
28139,2012,9038,8127,911,10.1
28141,2012,7890,7076,814,10.3
28143,2012,4902,4297,605,12.3
28145,2012,13548,12460,1088,8
28147,2012,5574,4948,626,11.2
28149,2012,23257,21161,2096,9
28151,2012,20027,17118,2909,14.5
28153,2012,8443,7504,939,11.1
28155,2012,4233,3846,387,9.1
28157,2012,3263,2862,401,12.3
28159,2012,7724,6837,887,11.5
28161,2012,5433,4885,548,10.1
28163,2012,9844,8739,1105,11.2
29001,2012,10749,9994,755,7
29003,2012,9908,9378,530,5.3
29005,2012,2879,2696,183,6.4
29007,2012,11355,10616,739,6.5
29009,2012,15129,14059,1070,7.1
29011,2012,5544,5133,411,7.4
29013,2012,8185,7511,674,8.2
29015,2012,7146,6499,647,9.1
29017,2012,5724,5322,402,7
29019,2012,96446,92078,4368,4.5
29021,2012,46745,43810,2935,6.3
29023,2012,18688,17157,1531,8.2
29025,2012,4401,4093,308,7
29027,2012,21834,20482,1352,6.2
29029,2012,18967,17154,1813,9.6
29031,2012,40815,38558,2257,5.5
29033,2012,4598,4215,383,8.3
29035,2012,2547,2306,241,9.5
29037,2012,52827,49305,3522,6.7
29039,2012,5799,5368,431,7.4
29041,2012,4033,3769,264,6.5
29043,2012,40817,38442,2375,5.8
29045,2012,3346,3076,270,8.1
29047,2012,126525,118815,7710,6.1
29049,2012,10855,10094,761,7
29051,2012,39901,37846,2055,5.2
29053,2012,7814,7255,559,7.2
29055,2012,10740,9794,946,8.8
29057,2012,3368,3116,252,7.5
29059,2012,7110,6463,647,9.1
29061,2012,4068,3786,282,6.9
29063,2012,5055,4755,300,5.9
29065,2012,6010,5519,491,8.2
29067,2012,5151,4645,506,9.8
29069,2012,12199,10931,1268,10.4
29071,2012,52013,47919,4094,7.9
29073,2012,7542,7010,532,7.1
29075,2012,3593,3402,191,5.3
29077,2012,144032,135502,8530,5.9
29079,2012,4948,4629,319,6.4
29081,2012,3970,3682,288,7.3
29083,2012,9849,9084,765,7.8
29085,2012,3622,3188,434,12
29087,2012,2693,2552,141,5.2
29089,2012,4844,4516,328,6.8
29091,2012,16554,15206,1348,8.1
29093,2012,3748,3321,427,11.4
29095,2012,355862,328189,27673,7.8
29097,2012,58257,54818,3439,5.9
29099,2012,115282,107002,8280,7.2
29101,2012,23079,21311,1768,7.7
29103,2012,1970,1859,111,5.6
29105,2012,15794,14334,1460,9.2
29107,2012,17249,16025,1224,7.1
29109,2012,17317,16189,1128,6.5
29111,2012,5166,4881,285,5.5
29113,2012,26361,24169,2192,8.3
29115,2012,5179,4700,479,9.2
29117,2012,7228,6780,448,6.2
29119,2012,10186,9507,679,6.7
29121,2012,7509,7004,505,6.7
29123,2012,5379,4935,444,8.3
29125,2012,4152,3852,300,7.2
29127,2012,14494,13611,883,6.1
29129,2012,1835,1740,95,5.2
29131,2012,11373,10346,1027,9
29133,2012,6154,5667,487,7.9
29135,2012,7325,6841,484,6.6
29137,2012,4060,3749,311,7.7
29139,2012,5806,5350,456,7.9
29141,2012,7810,7034,776,9.9
29143,2012,8134,7479,655,8.1
29145,2012,29400,27590,1810,6.2
29147,2012,11730,11077,653,5.6
29149,2012,4052,3733,319,7.9
29151,2012,7334,6965,369,5
29153,2012,3595,3230,365,10.2
29155,2012,7109,6425,684,9.6
29157,2012,10008,9495,513,5.1
29159,2012,19995,18584,1411,7.1
29161,2012,19677,18286,1391,7.1
29163,2012,8136,7579,557,6.8
29165,2012,52486,49603,2883,5.5
29167,2012,14083,12998,1085,7.7
29169,2012,15884,14591,1293,8.1
29171,2012,2353,2213,140,5.9
29173,2012,5631,5271,360,6.4
29175,2012,10673,9744,929,8.7
29177,2012,11313,10383,930,8.2
29179,2012,2268,2020,248,10.9
29181,2012,5511,4935,576,10.5
29183,2012,205708,194204,11504,5.6
29185,2012,3918,3608,310,7.9
29186,2012,9034,8375,659,7.3
29187,2012,26004,23694,2310,8.9
29189,2012,527539,493385,34154,6.5
29195,2012,11030,10302,728,6.6
29197,2012,1891,1752,139,7.4
29199,2012,2347,2229,118,5
29201,2012,19858,18474,1384,7
29203,2012,3062,2725,337,11
29205,2012,3126,2938,188,6
29207,2012,13488,12319,1169,8.7
29209,2012,13690,12164,1526,11.1
29211,2012,2780,2590,190,6.8
29213,2012,25475,22601,2874,11.3
29215,2012,9649,8859,790,8.2
29217,2012,9622,9059,563,5.9
29219,2012,16945,15678,1267,7.5
29221,2012,9981,8924,1057,10.6
29223,2012,5329,4848,481,9
29225,2012,15944,14812,1132,7.1
29227,2012,1246,1194,52,4.2
29229,2012,7588,6950,638,8.4
29510,2012,161177,147450,13727,8.5
30001,2012,4908,4643,265,5.4
30003,2012,5531,4862,669,12.1
30005,2012,2486,2327,159,6.4
30007,2012,2481,2295,186,7.5
30009,2012,5331,5081,250,4.7
30011,2012,685,663,22,3.2
30013,2012,38376,36245,2131,5.6
30015,2012,2668,2563,105,3.9
30017,2012,6538,6304,234,3.6
30019,2012,941,911,30,3.2
30021,2012,4647,4494,153,3.3
30023,2012,5189,4901,288,5.6
30025,2012,2033,1991,42,2.1
30027,2012,5855,5541,314,5.4
30029,2012,43332,39419,3913,9
30031,2012,52488,49805,2683,5.1
30033,2012,768,744,24,3.1
30035,2012,6347,5720,627,9.9
30037,2012,390,372,18,4.6
30039,2012,1473,1353,120,8.1
30041,2012,8035,7567,468,5.8
30043,2012,5601,5292,309,5.5
30045,2012,991,939,52,5.2
30047,2012,12437,11480,957,7.7
30049,2012,34919,33225,1694,4.9
30051,2012,1036,993,43,4.2
30053,2012,8210,7181,1029,12.5
30055,2012,1089,1057,32,2.9
30057,2012,4113,3856,257,6.2
30059,2012,930,879,51,5.5
30061,2012,1768,1575,193,10.9
30063,2012,59139,55667,3472,5.9
30065,2012,2416,2286,130,5.4
30067,2012,8025,7465,560,7
30069,2012,299,286,13,4.3
30071,2012,2060,1937,123,6
30073,2012,2940,2796,144,4.9
30075,2012,1077,1037,40,3.7
30077,2012,3015,2820,195,6.5
30079,2012,529,506,23,4.3
30081,2012,18716,17290,1426,7.6
30083,2012,6714,6526,188,2.8
30085,2012,4821,4503,318,6.6
30087,2012,4454,4152,302,6.8
30089,2012,4795,4244,551,11.5
30091,2012,2059,1998,61,3
30093,2012,17215,16170,1045,6.1
30095,2012,4954,4732,222,4.5
30097,2012,1747,1679,68,3.9
30099,2012,2940,2797,143,4.9
30101,2012,2501,2395,106,4.2
30103,2012,379,360,19,5
30105,2012,4024,3857,167,4.2
30107,2012,838,785,53,6.3
30109,2012,561,543,18,3.2
30111,2012,78680,75067,3613,4.6
31001,2012,16887,16242,645,3.8
31003,2012,3581,3464,117,3.3
31005,2012,230,215,15,6.5
31007,2012,438,418,20,4.6
31009,2012,284,269,15,5.3
31011,2012,3042,2948,94,3.1
31013,2012,5977,5737,240,4
31015,2012,1147,1102,45,3.9
31017,2012,1453,1394,59,4.1
31019,2012,27306,26405,901,3.3
31021,2012,3678,3504,174,4.7
31023,2012,4744,4586,158,3.3
31025,2012,13313,12694,619,4.6
31027,2012,4741,4603,138,2.9
31029,2012,2374,2317,57,2.4
31031,2012,3482,3382,100,2.9
31033,2012,5789,5628,161,2.8
31035,2012,3486,3356,130,3.7
31037,2012,5664,5463,201,3.5
31039,2012,4915,4763,152,3.1
31041,2012,6109,5934,175,2.9
31043,2012,11197,10550,647,5.8
31045,2012,5415,5218,197,3.6
31047,2012,13279,12698,581,4.4
31049,2012,1192,1153,39,3.3
31051,2012,3141,3011,130,4.1
31053,2012,19272,18400,872,4.5
31055,2012,285676,272913,12763,4.5
31057,2012,1282,1244,38,3
31059,2012,3320,3212,108,3.3
31061,2012,1644,1584,60,3.6
31063,2012,1613,1561,52,3.2
31065,2012,2688,2593,95,3.5
31067,2012,11179,10624,555,5
31069,2012,1262,1221,41,3.2
31071,2012,1220,1183,37,3
31073,2012,1145,1111,34,3
31075,2012,439,424,15,3.4
31077,2012,1299,1252,47,3.6
31079,2012,32657,31357,1300,4
31081,2012,4844,4682,162,3.3
31083,2012,1878,1817,61,3.2
31085,2012,664,644,20,3
31087,2012,1359,1303,56,4.1
31089,2012,5972,5781,191,3.2
31091,2012,438,418,20,4.6
31093,2012,3423,3299,124,3.6
31095,2012,4321,4158,163,3.8
31097,2012,2193,2098,95,4.3
31099,2012,3934,3821,113,2.9
31101,2012,4664,4491,173,3.7
31103,2012,607,588,19,3.1
31105,2012,2223,2150,73,3.3
31107,2012,4791,4630,161,3.4
31109,2012,167607,161556,6051,3.6
31111,2012,19276,18517,759,3.9
31113,2012,506,490,16,3.2
31115,2012,392,377,15,3.8
31117,2012,361,348,13,3.6
31119,2012,19209,18500,709,3.7
31121,2012,4232,4077,155,3.7
31123,2012,2703,2617,86,3.2
31125,2012,2099,2029,70,3.3
31127,2012,3886,3698,188,4.8
31129,2012,2477,2391,86,3.5
31131,2012,8512,8128,384,4.5
31133,2012,1640,1586,54,3.3
31135,2012,1830,1781,49,2.7
31137,2012,5049,4897,152,3
31139,2012,4197,4057,140,3.3
31141,2012,18047,17387,660,3.7
31143,2012,2993,2901,92,3.1
31145,2012,6357,6150,207,3.3
31147,2012,4408,4182,226,5.1
31149,2012,880,858,22,2.5
31151,2012,7364,7044,320,4.3
31153,2012,88075,84673,3402,3.9
31155,2012,11191,10717,474,4.2
31157,2012,19236,18334,902,4.7
31159,2012,8957,8642,315,3.5
31161,2012,2807,2707,100,3.6
31163,2012,1751,1685,66,3.8
31165,2012,841,811,30,3.6
31167,2012,3675,3547,128,3.5
31169,2012,3008,2916,92,3.1
31171,2012,428,411,17,4
31173,2012,3146,2872,274,8.7
31175,2012,2152,2077,75,3.5
31177,2012,11230,10806,424,3.8
31179,2012,5727,5543,184,3.2
31181,2012,1747,1683,64,3.7
31183,2012,523,505,18,3.4
31185,2012,7601,7320,281,3.7
32001,2012,11092,9868,1224,11
32003,2012,999472,886972,112500,11.3
32005,2012,22763,20154,2609,11.5
32007,2012,29205,27355,1850,6.3
32009,2012,476,443,33,6.9
32011,2012,1104,1037,67,6.1
32013,2012,9096,8494,602,6.6
32015,2012,3434,3181,253,7.4
32017,2012,2098,1878,220,10.5
32019,2012,22495,19170,3325,14.8
32021,2012,1910,1651,259,13.6
32023,2012,16635,14227,2408,14.5
32027,2012,2606,2354,252,9.7
32029,2012,1917,1662,255,13.3
32031,2012,221156,196768,24388,11
32033,2012,5014,4627,387,7.7
32510,2012,25911,22870,3041,11.7
33001,2012,32057,30320,1737,5.4
33003,2012,24673,23373,1300,5.3
33005,2012,42615,40450,2165,5.1
33007,2012,16095,14904,1191,7.4
33009,2012,48731,46564,2167,4.4
33011,2012,226905,213782,13123,5.8
33013,2012,81158,77143,4015,4.9
33015,2012,174767,164607,10160,5.8
33017,2012,70054,66264,3790,5.4
33019,2012,24042,22963,1079,4.5
34001,2012,140718,122847,17871,12.7
34003,2012,484699,447462,37237,7.7
34005,2012,236082,215621,20461,8.7
34007,2012,262541,234387,28154,10.7
34009,2012,49960,42251,7709,15.4
34011,2012,71417,62044,9373,13.1
34013,2012,384092,342808,41284,10.7
34015,2012,152000,136643,15357,10.1
34017,2012,360706,328634,32072,8.9
34019,2012,67533,62907,4626,6.8
34021,2012,194177,178129,16048,8.3
34023,2012,431380,394215,37165,8.6
34025,2012,331413,302512,28901,8.7
34027,2012,267446,248414,19032,7.1
34029,2012,268625,240095,28530,10.6
34031,2012,254010,225913,28097,11.1
34033,2012,32237,28434,3803,11.8
34035,2012,175899,162799,13100,7.4
34037,2012,81245,73919,7326,9
34039,2012,283098,256325,26773,9.5
34041,2012,58756,53626,5130,8.7
35001,2012,321012,299201,21811,6.8
35003,2012,1247,1128,119,9.5
35005,2012,26971,25219,1752,6.5
35006,2012,9290,8493,797,8.6
35007,2012,6129,5649,480,7.8
35009,2012,21579,20510,1069,5
35011,2012,822,787,35,4.3
35013,2012,93767,86906,6861,7.3
35015,2012,26831,25576,1255,4.7
35017,2012,13006,12141,865,6.7
35019,2012,1646,1481,165,10
35021,2012,293,274,19,6.5
35023,2012,2338,2166,172,7.4
35025,2012,28325,26988,1337,4.7
35027,2012,8964,8379,585,6.5
35028,2012,8999,8649,350,3.9
35029,2012,11461,9171,2290,20
35031,2012,24915,22523,2392,9.6
35033,2012,2316,2061,255,11
35035,2012,25049,23419,1630,6.5
35037,2012,3389,3115,274,8.1
35039,2012,16860,15291,1569,9.3
35041,2012,8344,7878,466,5.6
35043,2012,60524,55816,4708,7.8
35045,2012,55309,51384,3925,7.1
35047,2012,11103,10115,988,8.9
35049,2012,73658,69401,4257,5.8
35051,2012,3973,3583,390,9.8
35053,2012,6819,6343,476,7
35055,2012,15003,13434,1569,10.5
35057,2012,5764,5152,612,10.6
35059,2012,1872,1790,82,4.4
35061,2012,30216,27595,2621,8.7
36001,2012,160657,149260,11397,7.1
36003,2012,23691,21697,1994,8.4
36005,2012,594943,520987,73956,12.4
36007,2012,94012,85835,8177,8.7
36009,2012,38308,34733,3575,9.3
36011,2012,39113,35884,3229,8.3
36013,2012,61278,56055,5223,8.5
36015,2012,40553,37142,3411,8.4
36017,2012,24127,22044,2083,8.6
36019,2012,37998,34424,3574,9.4
36021,2012,31681,29451,2230,7
36023,2012,24476,22365,2111,8.6
36025,2012,21589,19702,1887,8.7
36027,2012,146383,134988,11395,7.8
36029,2012,461760,423403,38357,8.3
36031,2012,18176,16437,1739,9.6
36033,2012,21796,19712,2084,9.6
36035,2012,25392,22595,2797,11
36037,2012,30885,28443,2442,7.9
36039,2012,21547,19406,2141,9.9
36041,2012,2449,2187,262,10.7
36043,2012,30538,27861,2677,8.8
36045,2012,48426,43648,4778,9.9
36047,2012,1190125,1073762,116363,9.8
36049,2012,12269,11043,1226,10
36051,2012,32147,29625,2522,7.8
36053,2012,34620,31675,2945,8.5
36055,2012,376288,346636,29652,7.9
36057,2012,23451,21011,2440,10.4
36059,2012,693607,644803,48804,7
36061,2012,894987,823126,71861,8
36063,2012,105750,95894,9856,9.3
36065,2012,108562,99615,8947,8.2
36067,2012,232973,214624,18349,7.9
36069,2012,56046,51971,4075,7.3
36071,2012,179621,165414,14207,7.9
36073,2012,18873,17045,1828,9.7
36075,2012,57942,51585,6357,11
36077,2012,31460,28988,2472,7.9
36079,2012,51603,47899,3704,7.2
36081,2012,1124169,1031021,93148,8.3
36083,2012,83602,77126,6476,7.7
36085,2012,218237,197583,20654,9.5
36087,2012,150454,139454,11000,7.3
36089,2012,48589,43627,4962,10.2
36091,2012,117525,109520,8005,6.8
36093,2012,78052,72058,5994,7.7
36095,2012,15455,14034,1421,9.2
36097,2012,9032,8184,848,9.4
36099,2012,16242,14946,1296,8
36101,2012,45823,41544,4279,9.3
36103,2012,779400,718733,60667,7.8
36105,2012,35311,32093,3218,9.1
36107,2012,25466,23457,2009,7.9
36109,2012,55074,51699,3375,6.1
36111,2012,91045,83508,7537,8.3
36113,2012,33761,30660,3101,9.2
36115,2012,29899,27426,2473,8.3
36117,2012,46529,42536,3993,8.6
36119,2012,477481,442827,34654,7.3
36121,2012,18902,17229,1673,8.9
36123,2012,12090,11147,943,7.8
37001,2012,78000,71344,6656,8.5
37003,2012,17674,15981,1693,9.6
37005,2012,4604,4123,481,10.4
37007,2012,11057,9850,1207,10.9
37009,2012,13186,11810,1376,10.4
37011,2012,7743,6920,823,10.6
37013,2012,21047,18820,2227,10.6
37015,2012,8668,7679,989,11.4
37017,2012,14450,12615,1835,12.7
37019,2012,47348,42027,5321,11.2
37021,2012,126437,117278,9159,7.2
37023,2012,40692,36687,4005,9.8
37025,2012,91361,83139,8222,9
37027,2012,36895,32613,4282,11.6
37029,2012,4521,4166,355,7.9
37031,2012,31502,28685,2817,8.9
37033,2012,9961,8901,1060,10.6
37035,2012,76572,68806,7766,10.1
37037,2012,31617,29137,2480,7.8
37039,2012,11423,10171,1252,11
37041,2012,5905,5262,643,10.9
37043,2012,4168,3736,432,10.4
37045,2012,45749,40700,5049,11
37047,2012,23183,20341,2842,12.3
37049,2012,41875,37905,3970,9.5
37051,2012,132432,118538,13894,10.5
37053,2012,12460,11395,1065,8.5
37055,2012,20718,18156,2562,12.4
37057,2012,79611,71892,7719,9.7
37059,2012,19996,18183,1813,9.1
37061,2012,26421,24011,2410,9.1
37063,2012,148700,137697,11003,7.4
37065,2012,24358,20871,3487,14.3
37067,2012,176410,160794,15616,8.9
37069,2012,28165,25436,2729,9.7
37071,2012,100997,90442,10555,10.5
37073,2012,5357,4946,411,7.7
37075,2012,3576,2944,632,17.7
37077,2012,28301,26036,2265,8
37079,2012,9652,8822,830,8.6
37081,2012,254739,230428,24311,9.5
37083,2012,21942,18972,2970,13.5
37085,2012,49719,44443,5276,10.6
37087,2012,27515,25008,2507,9.1
37089,2012,48589,44949,3640,7.5
37091,2012,9574,8543,1031,10.8
37093,2012,19831,17715,2116,10.7
37095,2012,2131,1845,286,13.4
37097,2012,79259,71394,7865,9.9
37099,2012,18073,16161,1912,10.6
37101,2012,83522,76485,7037,8.4
37103,2012,4589,4134,455,9.9
37105,2012,27094,24014,3080,11.4
37107,2012,28489,25696,2793,9.8
37109,2012,39941,36103,3838,9.6
37111,2012,20596,18366,2230,10.8
37113,2012,15483,13840,1643,10.6
37115,2012,9489,8563,926,9.8
37117,2012,10431,9179,1252,12
37119,2012,527788,481623,46165,8.7
37121,2012,6649,5836,813,12.2
37123,2012,11554,10331,1223,10.6
37125,2012,37474,34181,3293,8.8
37127,2012,46110,40796,5314,11.5
37129,2012,108852,99450,9402,8.6
37131,2012,8297,7345,952,11.5
37133,2012,63599,58505,5094,8
37135,2012,72076,67675,4401,6.1
37137,2012,5371,4887,484,9
37139,2012,18123,16303,1820,10
37141,2012,24880,22285,2595,10.4
37143,2012,5266,4717,549,10.4
37145,2012,18394,16365,2029,11
37147,2012,87721,79725,7996,9.1
37149,2012,8349,7640,709,8.5
37151,2012,68475,61672,6803,9.9
37153,2012,17929,15530,2399,13.4
37155,2012,52819,45822,6997,13.2
37157,2012,43033,38186,4847,11.3
37159,2012,63310,56426,6884,10.9
37161,2012,26780,23245,3535,13.2
37163,2012,29697,26932,2765,9.3
37165,2012,12462,10324,2138,17.2
37167,2012,28752,25893,2859,9.9
37169,2012,22391,20309,2082,9.3
37171,2012,33651,30410,3241,9.6
37173,2012,6522,5562,960,14.7
37175,2012,13456,12286,1170,8.7
37177,2012,1583,1367,216,13.6
37179,2012,104230,96045,8185,7.9
37181,2012,18486,15985,2501,13.5
37183,2012,502454,466623,35831,7.1
37185,2012,7578,6635,943,12.4
37187,2012,4871,4124,747,15.3
37189,2012,27059,25062,1997,7.4
37191,2012,55377,50689,4688,8.5
37193,2012,30585,27411,3174,10.4
37195,2012,38327,33345,4982,13
37197,2012,17964,16315,1649,9.2
37199,2012,7975,7123,852,10.7
38001,2012,1112,1080,32,2.9
38003,2012,5753,5556,197,3.4
38005,2012,2775,2581,194,7
38007,2012,474,458,16,3.4
38009,2012,3409,3293,116,3.4
38011,2012,1918,1883,35,1.8
38013,2012,1375,1348,27,2
38015,2012,46608,45293,1315,2.8
38017,2012,89610,86980,2630,2.9
38019,2012,2148,2080,68,3.2
38021,2012,2709,2635,74,2.7
38023,2012,1787,1760,27,1.5
38025,2012,3680,3622,58,1.6
38027,2012,1250,1186,64,5.1
38029,2012,1648,1559,89,5.4
38031,2012,1684,1631,53,3.1
38033,2012,981,957,24,2.4
38035,2012,37306,36043,1263,3.4
38037,2012,1300,1259,41,3.2
38039,2012,1225,1192,33,2.7
38041,2012,1454,1415,39,2.7
38043,2012,1264,1199,65,5.1
38045,2012,2277,2220,57,2.5
38047,2012,908,880,28,3.1
38049,2012,3284,3143,141,4.3
38051,2012,1248,1208,40,3.2
38053,2012,6098,6005,93,1.5
38055,2012,4755,4546,209,4.4
38057,2012,4037,3822,215,5.3
38059,2012,15505,14950,555,3.6
38061,2012,7412,7291,121,1.6
38063,2012,1547,1483,64,4.1
38065,2012,891,831,60,6.7
38067,2012,3709,3471,238,6.4
38069,2012,1875,1794,81,4.3
38071,2012,5827,5586,241,4.1
38073,2012,2799,2715,84,3
38075,2012,1445,1412,33,2.3
38077,2012,8565,8253,312,3.6
38079,2012,5022,4493,529,10.5
38081,2012,2147,2090,57,2.7
38083,2012,737,710,27,3.7
38085,2012,1307,1239,68,5.2
38087,2012,529,518,11,2.1
38089,2012,18262,17929,333,1.8
38091,2012,1049,1021,28,2.7
38093,2012,10425,10067,358,3.4
38095,2012,1260,1218,42,3.3
38097,2012,4532,4389,143,3.2
38099,2012,5666,5389,277,4.9
38101,2012,33955,33055,900,2.7
38103,2012,2228,2139,89,4
38105,2012,27098,26795,303,1.1
39001,2012,10770,9416,1354,12.6
39003,2012,49937,46089,3848,7.7
39005,2012,25820,23745,2075,8
39007,2012,46433,42062,4371,9.4
39009,2012,27585,25235,2350,8.5
39011,2012,23945,22465,1480,6.2
39013,2012,31728,29111,2617,8.2
39015,2012,20144,18130,2014,10
39017,2012,186468,172183,14285,7.7
39019,2012,13791,12696,1095,7.9
39021,2012,19372,17942,1430,7.4
39023,2012,65847,60730,5117,7.8
39025,2012,102086,94484,7602,7.4
39027,2012,17282,15425,1857,10.7
39029,2012,50892,46694,4198,8.2
39031,2012,16205,14575,1630,10.1
39033,2012,20305,18466,1839,9.1
39035,2012,619168,577178,41990,6.8
39037,2012,26561,24638,1923,7.2
39039,2012,18986,17531,1455,7.7
39041,2012,95949,90968,4981,5.2
39043,2012,38623,35530,3093,8
39045,2012,73311,68444,4867,6.6
39047,2012,14112,12942,1170,8.3
39049,2012,630055,589581,40474,6.4
39051,2012,22419,20685,1734,7.7
39053,2012,12647,11424,1223,9.7
39055,2012,48839,46234,2605,5.3
39057,2012,80619,75067,5552,6.9
39059,2012,18227,16592,1635,9
39061,2012,401987,372343,29644,7.4
39063,2012,39785,37240,2545,6.4
39065,2012,14887,13776,1111,7.5
39067,2012,6973,6377,596,8.5
39069,2012,14117,12882,1235,8.7
39071,2012,17605,15771,1834,10.4
39073,2012,13547,12427,1120,8.3
39075,2012,19745,18730,1015,5.1
39077,2012,28946,26079,2867,9.9
39079,2012,13718,12301,1417,10.3
39081,2012,31258,27863,3395,10.9
39083,2012,30142,28047,2095,7
39085,2012,124495,117089,7406,5.9
39087,2012,26501,24251,2250,8.5
39089,2012,86002,80186,5816,6.8
39091,2012,22594,20979,1615,7.1
39093,2012,149175,138642,10533,7.1
39095,2012,210372,192835,17537,8.3
39097,2012,20082,18800,1282,6.4
39099,2012,110705,101514,9191,8.3
39101,2012,28880,26595,2285,7.9
39103,2012,93623,88480,5143,5.5
39105,2012,9502,8404,1098,11.6
39107,2012,22129,20999,1130,5.1
39109,2012,52314,48510,3804,7.3
39111,2012,6492,5947,545,8.4
39113,2012,254447,233575,20872,8.2
39115,2012,6698,6035,663,9.9
39117,2012,16894,15521,1373,8.1
39119,2012,40358,36657,3701,9.2
39121,2012,4779,4253,526,11
39123,2012,21991,19896,2095,9.5
39125,2012,9210,8502,708,7.7
39127,2012,16086,14512,1574,9.8
39129,2012,25692,23779,1913,7.4
39131,2012,10566,9188,1378,13
39133,2012,87954,81546,6408,7.3
39135,2012,21470,19811,1659,7.7
39137,2012,18791,17700,1091,5.8
39139,2012,55858,50987,4871,8.7
39141,2012,34037,31175,2862,8.4
39143,2012,31758,29368,2390,7.5
39145,2012,31080,27567,3513,11.3
39147,2012,27788,25575,2213,8
39149,2012,23834,22097,1737,7.3
39151,2012,187871,173824,14047,7.5
39153,2012,272305,251990,20315,7.5
39155,2012,95305,86681,8624,9
39157,2012,44972,41665,3307,7.4
39159,2012,26329,24816,1513,5.7
39161,2012,14150,13082,1068,7.5
39163,2012,5548,4948,600,10.8
39165,2012,109019,101929,7090,6.5
39167,2012,28412,25954,2458,8.7
39169,2012,59042,55431,3611,6.1
39171,2012,18853,17363,1490,7.9
39173,2012,68668,63951,4717,6.9
39175,2012,12133,11303,830,6.8
40001,2012,8503,7727,776,9.1
40003,2012,2919,2836,83,2.8
40005,2012,5004,4665,339,6.8
40007,2012,3129,3035,94,3
40009,2012,12561,12181,380,3
40011,2012,4378,4208,170,3.9
40013,2012,17629,16684,945,5.4
40015,2012,11713,11012,701,6
40017,2012,63528,61050,2478,3.9
40019,2012,21939,20727,1212,5.5
40021,2012,18987,17652,1335,7
40023,2012,5834,5341,493,8.5
40025,2012,1292,1250,42,3.3
40027,2012,136363,130724,5639,4.1
40029,2012,2368,2200,168,7.1
40031,2012,50862,47845,3017,5.9
40033,2012,2887,2724,163,5.6
40035,2012,6365,6006,359,5.6
40037,2012,31618,29712,1906,6
40039,2012,15691,15132,559,3.6
40041,2012,17140,16010,1130,6.6
40043,2012,2383,2307,76,3.2
40045,2012,2282,2217,65,2.8
40047,2012,29555,28358,1197,4.1
40049,2012,12526,11904,622,5
40051,2012,25585,24367,1218,4.8
40053,2012,2653,2563,90,3.4
40055,2012,2076,1965,111,5.3
40057,2012,1415,1349,66,4.7
40059,2012,1920,1859,61,3.2
40061,2012,4624,4213,411,8.9
40063,2012,5778,5314,464,8
40065,2012,11084,10516,568,5.1
40067,2012,2605,2477,128,4.9
40069,2012,3652,3368,284,7.8
40071,2012,20316,18874,1442,7.1
40073,2012,7704,7446,258,3.3
40075,2012,4275,4074,201,4.7
40077,2012,4555,4168,387,8.5
40079,2012,20119,18383,1736,8.6
40081,2012,15570,14796,774,5
40083,2012,20619,19718,901,4.4
40085,2012,5116,4899,217,4.2
40087,2012,17588,16852,736,4.2
40089,2012,14471,13096,1375,9.5
40091,2012,7432,6677,755,10.2
40093,2012,4078,3935,143,3.5
40095,2012,6820,6423,397,5.8
40097,2012,18499,17368,1131,6.1
40099,2012,6682,6374,308,4.6
40101,2012,30141,28116,2025,6.7
40103,2012,5497,5254,243,4.4
40105,2012,4921,4585,336,6.8
40107,2012,4416,4079,337,7.6
40109,2012,365892,348402,17490,4.8
40111,2012,16557,15245,1312,7.9
40113,2012,21335,20089,1246,5.8
40115,2012,14573,13429,1144,7.9
40117,2012,7508,7015,493,6.6
40119,2012,37929,36149,1780,4.7
40121,2012,19047,17719,1328,7
40123,2012,18279,17351,928,5.1
40125,2012,32072,30370,1702,5.3
40127,2012,4866,4514,352,7.2
40129,2012,2107,2047,60,2.8
40131,2012,43833,41652,2181,5
40133,2012,10003,9219,784,7.8
40135,2012,17245,15807,1438,8.3
40137,2012,20591,19580,1011,4.9
40139,2012,8991,8617,374,4.2
40141,2012,3415,3250,165,4.8
40143,2012,310018,294043,15975,5.2
40145,2012,36015,34148,1867,5.2
40147,2012,24602,23416,1186,4.8
40149,2012,5651,5426,225,4
40151,2012,5075,4934,141,2.8
40153,2012,10597,10225,372,3.5
41001,2012,7096,6347,749,10.6
41003,2012,44962,42263,2699,6
41005,2012,200407,184288,16119,8
41007,2012,18539,16918,1621,8.7
41009,2012,22920,20464,2456,10.7
41011,2012,27096,24091,3005,11.1
41013,2012,9226,7975,1251,13.6
41015,2012,8951,7897,1054,11.8
41017,2012,78730,69871,8859,11.3
41019,2012,45703,40242,5461,11.9
41021,2012,937,842,95,10.1
41023,2012,3306,2843,463,14
41025,2012,3516,3102,414,11.8
41027,2012,14039,13021,1018,7.3
41029,2012,98382,87465,10917,11.1
41031,2012,9588,8456,1132,11.8
41033,2012,33355,29299,4056,12.2
41035,2012,29978,26465,3513,11.7
41037,2012,3627,3157,470,13
41039,2012,172255,156906,15349,8.9
41041,2012,21344,19226,2118,9.9
41043,2012,55287,49347,5940,10.7
41045,2012,12825,11624,1201,9.4
41047,2012,150568,135549,15019,10
41049,2012,5642,5185,457,8.1
41051,2012,419500,387585,31915,7.6
41053,2012,35226,32092,3134,8.9
41055,2012,895,799,96,10.7
41057,2012,11169,10085,1084,9.7
41059,2012,36674,33354,3320,9.1
41061,2012,12211,11060,1151,9.4
41063,2012,3351,2966,385,11.5
41065,2012,13801,12639,1162,8.4
41067,2012,291013,270395,20618,7.1
41069,2012,781,727,54,6.9
41071,2012,50544,46248,4296,8.5
42001,2012,54757,51253,3504,6.4
42003,2012,653230,607825,45405,7
42005,2012,33904,31182,2722,8
42007,2012,86891,80348,6543,7.5
42009,2012,25078,22915,2163,8.6
42011,2012,211799,195566,16233,7.7
42013,2012,61849,57250,4599,7.4
42015,2012,32637,30393,2244,6.9
42017,2012,338749,314432,24317,7.2
42019,2012,97983,91690,6293,6.4
42021,2012,65983,60187,5796,8.8
42023,2012,2454,2202,252,10.3
42025,2012,32308,29076,3232,10
42027,2012,77567,73313,4254,5.5
42029,2012,272982,257629,15353,5.6
42031,2012,19002,17297,1705,9
42033,2012,38233,34658,3575,9.4
42035,2012,19462,17742,1720,8.8
42037,2012,35513,32551,2962,8.3
42039,2012,41985,38783,3202,7.6
42041,2012,125782,117992,7790,6.2
42043,2012,141155,130686,10469,7.4
42045,2012,289584,267294,22290,7.7
42047,2012,16887,15712,1175,7
42049,2012,137424,126709,10715,7.8
42051,2012,60257,54273,5984,9.9
42053,2012,2015,1817,198,9.8
42055,2012,76336,70983,5353,7
42057,2012,7442,6756,686,9.2
42059,2012,19075,17684,1391,7.3
42061,2012,20774,18711,2063,9.9
42063,2012,44758,41131,3627,8.1
42065,2012,21756,19946,1810,8.3
42067,2012,12048,11174,874,7.3
42069,2012,107642,98123,9519,8.8
42071,2012,269195,251661,17534,6.5
42073,2012,43331,39906,3425,7.9
42075,2012,70908,66177,4731,6.7
42077,2012,182830,167319,15511,8.5
42079,2012,160859,145107,15752,9.8
42081,2012,62753,57816,4937,7.9
42083,2012,20271,18571,1700,8.4
42085,2012,53940,49864,4076,7.6
42087,2012,21130,19302,1828,8.7
42089,2012,82408,74360,8048,9.8
42091,2012,435606,407910,27696,6.4
42093,2012,9444,8894,550,5.8
42095,2012,155392,142799,12593,8.1
42097,2012,45087,40981,4106,9.1
42099,2012,24659,22871,1788,7.3
42101,2012,699340,623262,76078,10.9
42103,2012,26007,23374,2633,10.1
42105,2012,7929,7206,723,9.1
42107,2012,70985,64079,6906,9.7
42109,2012,19836,18329,1507,7.6
42111,2012,36585,33344,3241,8.9
42113,2012,3102,2860,242,7.8
42115,2012,22508,20797,1711,7.6
42117,2012,21728,20072,1656,7.6
42119,2012,19130,17901,1229,6.4
42121,2012,26300,24284,2016,7.7
42123,2012,20589,19180,1409,6.8
42125,2012,107442,99720,7722,7.2
42127,2012,23119,21258,1861,8
42129,2012,187628,173806,13822,7.4
42131,2012,14394,13106,1288,8.9
42133,2012,233209,215917,17292,7.4
44001,2012,26197,23845,2352,9
44003,2012,92214,83043,9171,9.9
44005,2012,44228,40119,4109,9.3
44007,2012,325798,290149,35649,10.9
44009,2012,70052,63279,6773,9.7
45001,2012,10684,9549,1135,10.6
45003,2012,72956,66682,6274,8.6
45005,2012,3133,2603,530,16.9
45007,2012,85577,77998,7579,8.9
45009,2012,5800,4877,923,15.9
45011,2012,8959,7716,1243,13.9
45013,2012,65919,60939,4980,7.6
45015,2012,88403,80977,7426,8.4
45017,2012,6951,6173,778,11.2
45019,2012,186506,173166,13340,7.2
45021,2012,23751,20705,3046,12.8
45023,2012,14035,11961,2074,14.8
45025,2012,21047,18655,2392,11.4
45027,2012,13282,11578,1704,12.8
45029,2012,16455,14465,1990,12.1
45031,2012,30412,27048,3364,11.1
45033,2012,13203,11338,1865,14.1
45035,2012,68192,62864,5328,7.8
45037,2012,10643,9638,1005,9.4
45039,2012,10392,9039,1353,13
45041,2012,64973,58697,6276,9.7
45043,2012,24672,21718,2954,12
45045,2012,226950,210086,16864,7.4
45047,2012,32049,28798,3251,10.1
45049,2012,8421,7480,941,11.2
45051,2012,132681,118938,13743,10.4
45053,2012,10962,10033,929,8.5
45055,2012,28126,25448,2678,9.5
45057,2012,34350,30478,3872,11.3
45059,2012,30028,26938,3090,10.3
45061,2012,6728,5782,946,14.1
45063,2012,136586,127020,9566,7
45065,2012,3571,3150,421,11.8
45067,2012,13509,11361,2148,15.9
45069,2012,10799,8900,1899,17.6
45071,2012,18232,16622,1610,8.8
45073,2012,33388,30452,2936,8.8
45075,2012,39379,33761,5618,14.3
45077,2012,54754,49844,4910,9
45079,2012,189352,173861,15491,8.2
45081,2012,8595,7866,729,8.5
45083,2012,134781,122074,12707,9.4
45085,2012,44730,39963,4767,10.7
45087,2012,11963,10332,1631,13.6
45089,2012,12435,10471,1964,15.8
45091,2012,118566,107576,10990,9.3
46003,2012,1683,1633,50,3
46005,2012,9567,9234,333,3.5
46007,2012,1199,1118,81,6.8
46009,2012,3036,2917,119,3.9
46011,2012,17682,16990,692,3.9
46013,2012,20860,20115,745,3.6
46015,2012,2648,2552,96,3.6
46017,2012,746,674,72,9.7
46019,2012,4974,4742,232,4.7
46021,2012,860,829,31,3.6
46023,2012,4056,3855,201,5
46025,2012,1921,1838,83,4.3
46027,2012,7426,7142,284,3.8
46029,2012,15486,14884,602,3.9
46031,2012,1512,1391,121,8
46033,2012,4017,3801,216,5.4
46035,2012,11204,10830,374,3.3
46037,2012,2948,2778,170,5.8
46039,2012,2479,2332,147,5.9
46041,2012,2414,2027,387,16
46043,2012,1693,1636,57,3.4
46045,2012,2305,2236,69,3
46047,2012,3121,2943,178,5.7
46049,2012,1144,1098,46,4
46051,2012,4516,4317,199,4.4
46053,2012,2130,2037,93,4.4
46055,2012,1097,1062,35,3.2
46057,2012,3125,3002,123,3.9
46059,2012,1832,1776,56,3.1
46061,2012,1809,1725,84,4.6
46063,2012,807,777,30,3.7
46065,2012,9916,9588,328,3.3
46067,2012,3712,3583,129,3.5
46069,2012,765,738,27,3.5
46071,2012,1340,1246,94,7
46073,2012,1216,1178,38,3.1
46075,2012,626,602,24,3.8
46077,2012,2971,2865,106,3.6
46079,2012,6263,5997,266,4.2
46081,2012,12643,12075,568,4.5
46083,2012,27813,26913,900,3.2
46085,2012,1879,1768,111,5.9
46087,2012,3169,3049,120,3.8
46089,2012,1144,1091,53,4.6
46091,2012,2499,2379,120,4.8
46093,2012,13173,12595,578,4.4
46095,2012,856,789,67,7.8
46097,2012,1260,1214,46,3.7
46099,2012,100905,96904,4001,4
46101,2012,4004,3785,219,5.5
46102,2012,3756,3221,535,14.2
46103,2012,53290,50948,2342,4.4
46105,2012,1533,1472,61,4
46107,2012,1210,1161,49,4
46109,2012,4922,4640,282,5.7
46111,2012,1295,1250,45,3.5
46115,2012,3397,3258,139,4.1
46117,2012,1858,1802,56,3
46119,2012,880,853,27,3.1
46121,2012,3230,2917,313,9.7
46123,2012,3145,3028,117,3.7
46125,2012,4730,4565,165,3.5
46127,2012,7803,7432,371,4.8
46129,2012,2325,2182,143,6.2
46135,2012,11567,11142,425,3.7
46137,2012,1055,982,73,6.9
47001,2012,34512,31781,2731,7.9
47003,2012,20297,18313,1984,9.8
47005,2012,6963,6280,683,9.8
47007,2012,4309,3862,447,10.4
47009,2012,60433,56162,4271,7.1
47011,2012,48773,45184,3589,7.4
47013,2012,15736,13996,1740,11.1
47015,2012,6029,5517,512,8.5
47017,2012,13384,11920,1464,10.9
47019,2012,25500,23225,2275,8.9
47021,2012,20176,18721,1455,7.2
47023,2012,8376,7720,656,7.8
47025,2012,13333,12019,1314,9.9
47027,2012,3321,2989,332,10
47029,2012,15470,13697,1773,11.5
47031,2012,24650,22623,2027,8.2
47033,2012,7215,6554,661,9.2
47035,2012,23834,21689,2145,9
47037,2012,353385,331459,21926,6.2
47039,2012,5214,4676,538,10.3
47041,2012,8043,7272,771,9.6
47043,2012,24197,22185,2012,8.3
47045,2012,17486,15564,1922,11
47047,2012,18417,16858,1559,8.5
47049,2012,7474,6746,728,9.7
47051,2012,19475,17961,1514,7.8
47053,2012,22887,20532,2355,10.3
47055,2012,14038,12856,1182,8.4
47057,2012,9686,8690,996,10.3
47059,2012,30080,27025,3055,10.2
47061,2012,5532,4976,556,10.1
47063,2012,27603,25007,2596,9.4
47065,2012,171034,159238,11796,6.9
47067,2012,2257,1991,266,11.8
47069,2012,9999,8909,1090,10.9
47071,2012,11148,10027,1121,10.1
47073,2012,25096,22883,2213,8.8
47075,2012,8229,7279,950,11.5
47077,2012,13206,11930,1276,9.7
47079,2012,14296,12950,1346,9.4
47081,2012,10652,9707,945,8.9
47083,2012,3519,3126,393,11.2
47085,2012,8660,7837,823,9.5
47087,2012,4588,4108,480,10.5
47089,2012,24000,21752,2248,9.4
47091,2012,7353,6658,695,9.5
47093,2012,230959,216796,14163,6.1
47095,2012,2208,1978,230,10.4
47097,2012,10525,9377,1148,10.9
47099,2012,18710,16927,1783,9.5
47101,2012,5046,4501,545,10.8
47103,2012,15595,14645,950,6.1
47105,2012,22335,20646,1689,7.6
47107,2012,23623,21462,2161,9.1
47109,2012,9768,8766,1002,10.3
47111,2012,10139,9299,840,8.3
47113,2012,48531,44585,3946,8.1
47115,2012,12282,11163,1119,9.1
47117,2012,14300,12959,1341,9.4
47119,2012,40673,37487,3186,7.8
47121,2012,5063,4541,522,10.3
47123,2012,19478,17540,1938,9.9
47125,2012,78041,72126,5915,7.6
47127,2012,3395,3198,197,5.8
47129,2012,8325,7472,853,10.2
47131,2012,14349,12422,1927,13.4
47133,2012,9738,8870,868,8.9
47135,2012,3115,2811,304,9.8
47137,2012,2448,2218,230,9.4
47139,2012,7486,6752,734,9.8
47141,2012,32924,30279,2645,8
47143,2012,13503,12120,1383,10.2
47145,2012,23894,21834,2060,8.6
47147,2012,33744,31371,2373,7
47149,2012,145170,135724,9446,6.5
47151,2012,8774,7411,1363,15.5
47153,2012,5960,5460,500,8.4
47155,2012,49488,45160,4328,8.7
47157,2012,446126,407723,38403,8.6
47159,2012,8670,7963,707,8.2
47161,2012,5542,4931,611,11
47163,2012,72944,67447,5497,7.5
47165,2012,85031,79493,5538,6.5
47167,2012,28320,25811,2509,8.9
47169,2012,3684,3366,318,8.6
47171,2012,7710,6916,794,10.3
47173,2012,7627,6907,720,9.4
47175,2012,2245,1987,258,11.5
47177,2012,17498,15964,1534,8.8
47179,2012,60304,56033,4271,7.1
47181,2012,6662,6031,631,9.5
47183,2012,16946,15094,1852,10.9
47185,2012,12213,11020,1193,9.8
47187,2012,99015,94106,4909,5
47189,2012,60691,56806,3885,6.4
48001,2012,22391,20974,1417,6.3
48003,2012,8544,8203,341,4
48005,2012,37870,35257,2613,6.9
48007,2012,9944,9251,693,7
48009,2012,4370,4131,239,5.5
48011,2012,1027,981,46,4.5
48013,2012,20072,18719,1353,6.7
48015,2012,14093,13192,901,6.4
48017,2012,3183,2963,220,6.9
48019,2012,9128,8530,598,6.6
48021,2012,35304,32944,2360,6.7
48023,2012,1866,1771,95,5.1
48025,2012,10853,10090,763,7
48027,2012,134133,124194,9939,7.4
48029,2012,840497,787214,53283,6.3
48031,2012,5493,5210,283,5.2
48033,2012,419,401,18,4.3
48035,2012,8191,7599,592,7.2
48037,2012,41556,38465,3091,7.4
48039,2012,161209,150457,10752,6.7
48041,2012,99833,94566,5267,5.3
48043,2012,4563,4331,232,5.1
48045,2012,643,608,35,5.4
48047,2012,2721,2484,237,8.7
48049,2012,16071,14981,1090,6.8
48051,2012,7666,7184,482,6.3
48053,2012,20426,19209,1217,6
48055,2012,16844,15636,1208,7.2
48057,2012,10423,9658,765,7.3
48059,2012,5933,5572,361,6.1
48061,2012,166314,149171,17143,10.3
48063,2012,5505,5064,441,8
48065,2012,3291,3141,150,4.6
48067,2012,12827,11650,1177,9.2
48069,2012,4060,3882,178,4.4
48071,2012,17150,15771,1379,8
48073,2012,21979,20388,1591,7.2
48075,2012,2969,2838,131,4.4
48077,2012,5319,5021,298,5.6
48079,2012,1447,1338,109,7.5
48081,2012,1473,1398,75,5.1
48083,2012,3316,3067,249,7.5
48085,2012,446733,420419,26314,5.9
48087,2012,1248,1186,62,5
48089,2012,10184,9536,648,6.4
48091,2012,55918,52535,3383,6
48093,2012,5790,5421,369,6.4
48095,2012,1512,1448,64,4.2
48097,2012,20693,19653,1040,5
48099,2012,25396,23528,1868,7.4
48101,2012,666,616,50,7.5
48103,2012,2060,1960,100,4.9
48105,2012,1774,1685,89,5
48107,2012,2911,2702,209,7.2
48109,2012,989,929,60,6.1
48111,2012,4021,3873,148,3.7
48113,2012,1223343,1136230,87113,7.1
48115,2012,5080,4754,326,6.4
48117,2012,9325,8887,438,4.7
48119,2012,2625,2448,177,6.7
48121,2012,388543,366353,22190,5.7
48123,2012,9741,9275,466,4.8
48125,2012,833,744,89,10.7
48127,2012,5764,5428,336,5.8
48129,2012,1710,1609,101,5.9
48131,2012,5431,5050,381,7
48133,2012,8267,7716,551,6.7
48135,2012,77060,73523,3537,4.6
48137,2012,926,867,59,6.4
48139,2012,76794,71601,5193,6.8
48141,2012,347513,317841,29672,8.5
48143,2012,20056,18941,1115,5.6
48145,2012,6917,6410,507,7.3
48147,2012,15068,14004,1064,7.1
48149,2012,12525,11919,606,4.8
48151,2012,1908,1805,103,5.4
48153,2012,3198,2992,206,6.4
48155,2012,622,586,36,5.8
48157,2012,319114,300119,18995,6
48159,2012,4630,4288,342,7.4
48161,2012,8062,7519,543,6.7
48163,2012,8673,8236,437,5
48165,2012,8785,8412,373,4.2
48167,2012,153148,141451,11697,7.6
48169,2012,2196,2087,109,5
48171,2012,12331,11752,579,4.7
48173,2012,763,732,31,4.1
48175,2012,3480,3289,191,5.5
48177,2012,9457,8977,480,5.1
48179,2012,9699,9155,544,5.6
48181,2012,60023,55913,4110,6.8
48183,2012,61643,57824,3819,6.2
48185,2012,11814,11054,760,6.4
48187,2012,68312,64435,3877,5.7
48189,2012,15861,14764,1097,6.9
48191,2012,1343,1239,104,7.7
48193,2012,3750,3532,218,5.8
48195,2012,3055,2951,104,3.4
48197,2012,1763,1659,104,5.9
48199,2012,25880,23700,2180,8.4
48201,2012,2156942,2013828,143114,6.6
48203,2012,31972,29608,2364,7.4
48205,2012,2903,2806,97,3.3
48207,2012,2775,2627,148,5.3
48209,2012,85818,80810,5008,5.8
48211,2012,2547,2473,74,2.9
48213,2012,34547,31932,2615,7.6
48215,2012,328096,293300,34796,10.6
48217,2012,15805,14711,1094,6.9
48219,2012,11790,11167,623,5.3
48221,2012,23783,22233,1550,6.5
48223,2012,17087,15981,1106,6.5
48225,2012,10081,9366,715,7.1
48227,2012,13403,12651,752,5.6
48229,2012,1326,1227,99,7.5
48231,2012,38424,35243,3181,8.3
48233,2012,9828,9190,638,6.5
48235,2012,852,813,39,4.6
48237,2012,3804,3585,219,5.8
48239,2012,7438,7057,381,5.1
48241,2012,14917,13329,1588,10.6
48243,2012,1215,1156,59,4.9
48245,2012,113611,101055,12556,11.1
48247,2012,2351,2196,155,6.6
48249,2012,20652,19378,1274,6.2
48251,2012,73166,68305,4861,6.6
48253,2012,5905,5480,425,7.2
48255,2012,5288,4966,322,6.1
48257,2012,51625,48037,3588,7
48259,2012,17476,16531,945,5.4
48261,2012,254,241,13,5.1
48263,2012,553,531,22,4
48265,2012,21698,20432,1266,5.8
48267,2012,2189,2082,107,4.9
48269,2012,247,236,11,4.5
48271,2012,1263,1152,111,8.8
48273,2012,15418,14358,1060,6.9
48275,2012,1817,1722,95,5.2
48277,2012,22646,20561,2085,9.2
48279,2012,6466,5951,515,8
48281,2012,9092,8445,647,7.1
48283,2012,3670,3507,163,4.4
48285,2012,9482,9024,458,4.8
48287,2012,9138,8645,493,5.4
48289,2012,6955,6442,513,7.4
48291,2012,30881,27924,2957,9.6
48293,2012,9606,8945,661,6.9
48295,2012,1758,1690,68,3.9
48297,2012,5768,5505,263,4.6
48299,2012,8067,7519,548,6.8
48301,2012,67,63,4,6
48303,2012,145628,137841,7787,5.3
48305,2012,2953,2775,178,6
48307,2012,4402,4165,237,5.4
48309,2012,112372,104910,7462,6.6
48311,2012,745,727,18,2.4
48313,2012,4654,4325,329,7.1
48315,2012,4351,3954,397,9.1
48317,2012,2416,2307,109,4.5
48319,2012,1970,1867,103,5.2
48321,2012,17106,15374,1732,10.1
48323,2012,23373,20445,2928,12.5
48325,2012,20208,18884,1324,6.6
48327,2012,972,911,61,6.3
48329,2012,82219,79026,3193,3.9
48331,2012,10280,9398,882,8.6
48333,2012,2101,1987,114,5.4
48335,2012,2878,2706,172,6
48337,2012,9852,9319,533,5.4
48339,2012,239219,225006,14213,5.9
48341,2012,11589,11088,501,4.3
48343,2012,5837,5268,569,9.7
48345,2012,522,491,31,5.9
48347,2012,29573,27609,1964,6.6
48349,2012,23250,21561,1689,7.3
48351,2012,5805,5163,642,11.1
48353,2012,7092,6672,420,5.9
48355,2012,167030,156062,10968,6.6
48357,2012,5320,5115,205,3.9
48359,2012,951,910,41,4.3
48361,2012,38882,34818,4064,10.5
48363,2012,13418,12514,904,6.7
48365,2012,12322,11477,845,6.9
48367,2012,57922,54485,3437,5.9
48369,2012,5006,4800,206,4.1
48371,2012,6993,6635,358,5.1
48373,2012,17542,16136,1406,8
48375,2012,58335,55218,3117,5.3
48377,2012,3827,3319,508,13.3
48379,2012,5232,4866,366,7
48381,2012,68125,65112,3013,4.4
48383,2012,2078,2007,71,3.4
48385,2012,1067,967,100,9.4
48387,2012,5263,4700,563,10.7
48389,2012,5345,4984,361,6.8
48391,2012,3509,3298,211,6
48393,2012,472,448,24,5.1
48395,2012,7290,6704,586,8
48397,2012,41195,38649,2546,6.2
48399,2012,5061,4781,280,5.5
48401,2012,24590,23046,1544,6.3
48403,2012,3388,2895,493,14.6
48405,2012,3027,2660,367,12.1
48407,2012,11474,10529,945,8.2
48409,2012,30435,28129,2306,7.6
48411,2012,2295,2152,143,6.2
48413,2012,1781,1710,71,4
48415,2012,8118,7755,363,4.5
48417,2012,2214,2136,78,3.5
48419,2012,12126,11246,880,7.3
48421,2012,1504,1441,63,4.2
48423,2012,101770,94614,7156,7
48425,2012,4143,3869,274,6.6
48427,2012,26036,22252,3784,14.5
48429,2012,4384,4124,260,5.9
48431,2012,720,695,25,3.5
48433,2012,748,715,33,4.4
48435,2012,2012,1917,95,4.7
48437,2012,3050,2869,181,5.9
48439,2012,966259,903315,62944,6.5
48441,2012,64485,60834,3651,5.7
48443,2012,549,523,26,4.7
48445,2012,5666,5295,371,6.5
48447,2012,830,786,44,5.3
48449,2012,13267,12272,995,7.5
48451,2012,53790,50921,2869,5.3
48453,2012,612264,578608,33656,5.5
48455,2012,5574,5118,456,8.2
48457,2012,7580,6770,810,10.7
48459,2012,18727,17465,1262,6.7
48461,2012,1591,1527,64,4
48463,2012,11952,11004,948,7.9
48465,2012,20013,18489,1524,7.6
48467,2012,23620,21982,1638,6.9
48469,2012,45250,42723,2527,5.6
48471,2012,23153,21545,1608,6.9
48473,2012,20499,19065,1434,7
48475,2012,5356,5098,258,4.8
48477,2012,15646,14766,880,5.6
48479,2012,109145,102072,7073,6.5
48481,2012,21437,19987,1450,6.8
48483,2012,2895,2769,126,4.4
48485,2012,58468,54914,3554,6.1
48487,2012,5924,5568,356,6
48489,2012,7428,6254,1174,15.8
48491,2012,237421,223585,13836,5.8
48493,2012,21732,20528,1204,5.5
48495,2012,3186,3006,180,5.6
48497,2012,28255,26432,1823,6.5
48499,2012,16735,15420,1315,7.9
48501,2012,4336,4162,174,4
48503,2012,8570,8081,489,5.7
48505,2012,6819,6387,432,6.3
48507,2012,4390,3797,593,13.5
49001,2012,2902,2725,177,6.1
49003,2012,22948,21626,1322,5.8
49005,2012,56972,54422,2550,4.5
49007,2012,9263,8610,653,7
49009,2012,436,414,22,5
49011,2012,148630,141372,7258,4.9
49013,2012,9150,8720,430,4.7
49015,2012,4746,4405,341,7.2
49017,2012,2857,2586,271,9.5
49019,2012,5409,4954,455,8.4
49021,2012,19470,18140,1330,6.8
49023,2012,4625,4343,282,6.1
49025,2012,3462,3232,230,6.6
49027,2012,5938,5661,277,4.7
49029,2012,4333,4120,213,4.9
49031,2012,492,451,41,8.3
49033,2012,946,896,50,5.3
49035,2012,556484,527250,29234,5.3
49037,2012,5695,5193,502,8.8
49039,2012,11253,10532,721,6.4
49041,2012,9421,8844,577,6.1
49043,2012,21523,20463,1060,4.9
49045,2012,27746,26087,1659,6
49047,2012,15981,15271,710,4.4
49049,2012,238745,226892,11853,5
49051,2012,11651,10981,670,5.8
49053,2012,57216,53281,3935,6.9
49055,2012,1355,1209,146,10.8
49057,2012,113321,106127,7194,6.3
50001,2012,20868,19926,942,4.5
50003,2012,19663,18506,1157,5.9
50005,2012,16137,15130,1007,6.2
50007,2012,95835,92217,3618,3.8
50009,2012,2933,2697,236,8
50011,2012,27854,26607,1247,4.5
50013,2012,4132,3909,223,5.4
50015,2012,14041,13148,893,6.4
50017,2012,16450,15676,774,4.7
50019,2012,14120,13028,1092,7.7
50021,2012,32799,30755,2044,6.2
50023,2012,34630,32998,1632,4.7
50025,2012,24668,23393,1275,5.2
50027,2012,30725,29295,1430,4.7
51001,2012,16419,15126,1293,7.9
51003,2012,52640,49887,2753,5.2
51005,2012,7802,7249,553,7.1
51007,2012,6219,5813,406,6.5
51009,2012,16069,14993,1076,6.7
51011,2012,7222,6685,537,7.4
51013,2012,144012,139012,5000,3.5
51015,2012,37041,34897,2144,5.8
51017,2012,2587,2436,151,5.8
51019,2012,38326,36038,2288,6
51021,2012,2876,2674,202,7
51023,2012,17727,16756,971,5.5
51025,2012,6732,6052,680,10.1
51027,2012,8589,7807,782,9.1
51029,2012,6474,5922,552,8.5
51031,2012,27088,25336,1752,6.5
51033,2012,14504,13373,1131,7.8
51035,2012,13494,12343,1151,8.5
51036,2012,3854,3552,302,7.8
51037,2012,5365,4898,467,8.7
51041,2012,172990,162433,10557,6.1
51043,2012,7737,7332,405,5.2
51045,2012,2465,2292,173,7
51047,2012,23362,22034,1328,5.7
51049,2012,4528,4205,323,7.1
51051,2012,5217,4661,556,10.7
51053,2012,13637,12603,1034,7.6
51057,2012,5742,5321,421,7.3
51059,2012,623843,595687,28156,4.5
51061,2012,36022,34169,1853,5.1
51063,2012,8378,7903,475,5.7
51065,2012,13178,12486,692,5.3
51067,2012,27427,25623,1804,6.6
51069,2012,43479,40967,2512,5.8
51071,2012,8242,7643,599,7.3
51073,2012,19375,18282,1093,5.6
51075,2012,10281,9707,574,5.6
51077,2012,7000,6330,670,9.6
51079,2012,9800,9256,544,5.6
51081,2012,4468,4083,385,8.6
51083,2012,16051,14528,1523,9.5
51085,2012,55152,52111,3041,5.5
51087,2012,172595,162158,10437,6
51089,2012,22753,20351,2402,10.6
51091,2012,1461,1390,71,4.9
51093,2012,18766,17578,1188,6.3
51095,2012,32988,31101,1887,5.7
51097,2012,3673,3430,243,6.6
51099,2012,11735,10974,761,6.5
51101,2012,8686,8137,549,6.3
51103,2012,5522,5082,440,8
51105,2012,9794,8985,809,8.3
51107,2012,186073,177798,8275,4.4
51109,2012,17965,16845,1120,6.2
51111,2012,5385,4978,407,7.6
51113,2012,7261,6912,349,4.8
51115,2012,4176,3938,238,5.7
51117,2012,13540,12263,1277,9.4
51119,2012,5136,4824,312,6.1
51121,2012,49165,46242,2923,5.9
51125,2012,7465,7030,435,5.8
51127,2012,10615,10023,592,5.6
51131,2012,6198,5624,574,9.3
51133,2012,5893,5412,481,8.2
51135,2012,6879,6441,438,6.4
51137,2012,15878,14817,1061,6.7
51139,2012,12202,10957,1245,10.2
51141,2012,7985,7256,729,9.1
51143,2012,30740,28350,2390,7.8
51145,2012,13559,12794,765,5.6
51147,2012,10285,9411,874,8.5
51149,2012,14664,13577,1087,7.4
51153,2012,228830,216748,12082,5.3
51155,2012,16887,15631,1256,7.4
51157,2012,3963,3748,215,5.4
51159,2012,3926,3675,251,6.4
51161,2012,49569,46975,2594,5.2
51163,2012,10768,10112,656,6.1
51165,2012,40874,38557,2317,5.7
51167,2012,11782,10762,1020,8.7
51169,2012,10087,9326,761,7.5
51171,2012,20834,19508,1326,6.4
51173,2012,13516,12221,1295,9.6
51175,2012,9494,8898,596,6.3
51177,2012,64141,60232,3909,6.1
51179,2012,65515,61724,3791,5.8
51181,2012,3690,3402,288,7.8
51183,2012,4277,3861,416,9.7
51185,2012,17974,16489,1485,8.3
51187,2012,20060,18716,1344,6.7
51191,2012,27772,25902,1870,6.7
51193,2012,9152,8487,665,7.3
51195,2012,16013,14583,1430,8.9
51197,2012,14125,13031,1094,7.7
51199,2012,31718,29883,1835,5.8
51510,2012,93257,89443,3814,4.1
51520,2012,8003,7419,584,7.3
51530,2012,3263,3005,258,7.9
51540,2012,23430,22230,1200,5.1
51550,2012,115188,107798,7390,6.4
51570,2012,8617,8018,599,7
51580,2012,2644,2407,237,9
51590,2012,19971,17906,2065,10.3
51595,2012,2471,2210,261,10.6
51600,2012,12933,12376,557,4.3
51610,2012,7728,7419,309,4
51620,2012,3729,3357,372,10
51630,2012,13600,12641,959,7.1
51640,2012,3058,2787,271,8.9
51650,2012,65983,60542,5441,8.2
51660,2012,24127,22350,1777,7.4
51670,2012,9742,8762,980,10.1
51678,2012,2284,2084,200,8.8
51680,2012,35600,32940,2660,7.5
51683,2012,21926,20699,1227,5.6
51685,2012,8754,8291,463,5.3
51690,2012,5746,5010,736,12.8
51700,2012,90033,83286,6747,7.5
51710,2012,112848,104251,8597,7.6
51720,2012,1994,1841,153,7.7
51730,2012,13623,11995,1628,12
51735,2012,6361,6017,344,5.4
51740,2012,45724,41698,4026,8.8
51750,2012,8109,7465,644,7.9
51760,2012,109323,101135,8188,7.5
51770,2012,49653,46074,3579,7.2
51775,2012,12915,12148,767,5.9
51790,2012,11825,11066,759,6.4
51800,2012,41803,38869,2934,7
51810,2012,229035,215892,13143,5.7
51820,2012,10041,9335,706,7
51830,2012,6845,6274,571,8.3
51840,2012,14246,13294,952,6.7
53001,2012,8230,7482,748,9.1
53003,2012,9763,9003,760,7.8
53005,2012,92041,83467,8574,9.3
53007,2012,41395,38084,3311,8
53009,2012,28153,25210,2943,10.5
53011,2012,209404,189704,19700,9.4
53013,2012,1821,1670,151,8.3
53015,2012,44553,39791,4762,10.7
53017,2012,19262,17512,1750,9.1
53019,2012,2444,2061,383,15.7
53021,2012,39167,35366,3801,9.7
53023,2012,1020,942,78,7.6
53025,2012,43914,39740,4174,9.5
53027,2012,28876,25129,3747,13
53029,2012,32528,29879,2649,8.1
53031,2012,11930,10740,1190,10
53033,2012,1122834,1051837,70997,6.3
53035,2012,116110,106945,9165,7.9
53037,2012,20583,18773,1810,8.8
53039,2012,9939,8921,1018,10.2
53041,2012,32233,28372,3861,12
53043,2012,5245,4863,382,7.3
53045,2012,23551,20983,2568,10.9
53047,2012,21146,19140,2006,9.5
53049,2012,8193,7206,987,12
53051,2012,4813,4199,614,12.8
53053,2012,386969,350908,36061,9.3
53055,2012,8105,7584,521,6.4
53057,2012,57112,51599,5513,9.7
53059,2012,5033,4502,531,10.6
53061,2012,385500,356761,28739,7.5
53063,2012,230421,209506,20915,9.1
53065,2012,18222,16079,2143,11.8
53067,2012,123207,112813,10394,8.4
53069,2012,1376,1201,175,12.7
53071,2012,29564,27361,2203,7.5
53073,2012,103136,94735,8401,8.1
53075,2012,22415,20940,1475,6.6
53077,2012,121082,108267,12815,10.6
54001,2012,6728,6168,560,8.3
54003,2012,52263,48774,3489,6.7
54005,2012,8921,7994,927,10.4
54007,2012,5411,4826,585,10.8
54009,2012,10649,9718,931,8.7
54011,2012,43037,40228,2809,6.5
54013,2012,2843,2527,316,11.1
54015,2012,3530,3105,425,12
54017,2012,3405,3190,215,6.3
54019,2012,17576,16054,1522,8.7
54021,2012,2771,2555,216,7.8
54023,2012,6171,5627,544,8.8
54025,2012,15490,14254,1236,8
54027,2012,9736,8963,773,7.9
54029,2012,13753,12476,1277,9.3
54031,2012,5570,4979,591,10.6
54033,2012,31407,29358,2049,6.5
54035,2012,12015,10988,1027,8.5
54037,2012,27507,26019,1488,5.4
54039,2012,91341,85308,6033,6.6
54041,2012,7381,6861,520,7
54043,2012,7706,6910,796,10.3
54045,2012,12904,11646,1258,9.7
54047,2012,6599,5802,797,12.1
54049,2012,26833,25103,1730,6.4
54051,2012,14325,13170,1155,8.1
54053,2012,10902,9826,1076,9.9
54055,2012,23431,21470,1961,8.4
54057,2012,12095,11071,1024,8.5
54059,2012,8988,8115,873,9.7
54061,2012,49695,47114,2581,5.2
54063,2012,5733,5318,415,7.2
54065,2012,7589,7033,556,7.3
54067,2012,10832,9827,1005,9.3
54069,2012,21355,19994,1361,6.4
54071,2012,3636,3389,247,6.8
54073,2012,2878,2627,251,8.7
54075,2012,3623,3255,368,10.2
54077,2012,14778,13735,1043,7.1
54079,2012,26373,24679,1694,6.4
54081,2012,32843,30456,2387,7.3
54083,2012,12078,11023,1055,8.7
54085,2012,4382,4059,323,7.4
54087,2012,5326,4720,606,11.4
54089,2012,4637,4226,411,8.9
54091,2012,7562,7045,517,6.8
54093,2012,3192,2934,258,8.1
54095,2012,3661,3325,336,9.2
54097,2012,9986,9206,780,7.8
54099,2012,16389,15143,1246,7.6
54101,2012,3604,3218,386,10.7
54103,2012,7262,6582,680,9.4
54105,2012,2297,2045,252,11
54107,2012,38543,35739,2804,7.3
54109,2012,8379,7610,769,9.2
55001,2012,8984,8002,982,10.9
55003,2012,8237,7473,764,9.3
55005,2012,23711,21839,1872,7.9
55007,2012,7796,6955,841,10.8
55009,2012,137667,128636,9031,6.6
55011,2012,6639,6223,416,6.3
55013,2012,7540,6859,681,9
55015,2012,27296,25837,1459,5.3
55017,2012,33263,31011,2252,6.8
55019,2012,17098,15829,1269,7.4
55021,2012,31327,29057,2270,7.2
55023,2012,8302,7599,703,8.5
55025,2012,297434,282937,14497,4.9
55027,2012,47740,44326,3414,7.2
55029,2012,15765,14146,1619,10.3
55031,2012,23432,21826,1606,6.9
55033,2012,23431,21890,1541,6.6
55035,2012,58257,54879,3378,5.8
55037,2012,2211,2027,184,8.3
55039,2012,56122,52478,3644,6.5
55041,2012,4142,3687,455,11
55043,2012,27698,26042,1656,6
55045,2012,20832,19531,1301,6.2
55047,2012,10314,9539,775,7.5
55049,2012,13549,12646,903,6.7
55051,2012,2783,2492,291,10.5
55053,2012,10315,9562,753,7.3
55055,2012,46217,43133,3084,6.7
55057,2012,13584,12444,1140,8.4
55059,2012,87025,79931,7094,8.2
55061,2012,11017,10296,721,6.5
55063,2012,66416,62803,3613,5.4
55065,2012,9399,8872,527,5.6
55067,2012,9974,9047,927,9.3
55069,2012,15111,13730,1381,9.1
55071,2012,43692,40298,3394,7.8
55073,2012,71645,66399,5246,7.3
55075,2012,21448,19658,1790,8.3
55077,2012,7580,6911,669,8.8
55078,2012,1589,1330,259,16.3
55079,2012,476469,435423,41046,8.6
55081,2012,22786,21126,1660,7.3
55083,2012,20661,18927,1734,8.4
55085,2012,19139,17474,1665,8.7
55087,2012,100332,93885,6447,6.4
55089,2012,47379,44775,2604,5.5
55091,2012,4076,3844,232,5.7
55093,2012,23895,22576,1319,5.5
55095,2012,24001,22070,1931,8
55097,2012,38919,36072,2847,7.3
55099,2012,7049,6519,530,7.5
55101,2012,100428,92033,8395,8.4
55103,2012,9709,9102,607,6.3
55105,2012,81435,74652,6783,8.3
55107,2012,6782,6169,613,9
55109,2012,47486,44758,2728,5.7
55111,2012,35637,33178,2459,6.9
55113,2012,8278,7387,891,10.8
55115,2012,21621,19894,1727,8
55117,2012,60308,56177,4131,6.8
55119,2012,11080,10283,797,7.2
55121,2012,16367,15433,934,5.7
55123,2012,15043,14084,959,6.4
55125,2012,10101,9088,1013,10
55127,2012,56034,51975,4059,7.2
55129,2012,8089,7450,639,7.9
55131,2012,75075,70465,4610,6.1
55133,2012,217591,205072,12519,5.8
55135,2012,27389,25311,2078,7.6
55137,2012,12020,10968,1052,8.8
55139,2012,92509,86348,6161,6.7
55141,2012,39716,36722,2994,7.5
56001,2012,20736,19845,891,4.3
56003,2012,5637,5320,317,5.6
56005,2012,26119,24907,1212,4.6
56007,2012,8215,7790,425,5.2
56009,2012,7976,7634,342,4.3
56011,2012,3814,3628,186,4.9
56013,2012,21271,19989,1282,6
56015,2012,7511,7160,351,4.7
56017,2012,2578,2456,122,4.7
56019,2012,4472,4234,238,5.3
56021,2012,47711,44967,2744,5.8
56023,2012,8274,7685,589,7.1
56025,2012,42388,40242,2146,5.1
56027,2012,1381,1328,53,3.8
56029,2012,16262,15360,902,5.5
56031,2012,4787,4553,234,4.9
56033,2012,15903,14916,987,6.2
56035,2012,5572,5300,272,4.9
56037,2012,24138,22986,1152,4.8
56039,2012,13805,12881,924,6.7
56041,2012,10263,9689,574,5.6
56043,2012,4487,4254,233,5.2
56045,2012,3972,3811,161,4.1
72001,2012,4976,3898,1078,21.7
72003,2012,12716,10387,2329,18.3
72005,2012,16155,13142,3013,18.7
72007,2012,7363,5995,1368,18.6
72009,2012,7232,5856,1376,19
72011,2012,9355,7765,1590,17
72013,2012,25539,21489,4050,15.9
72015,2012,5724,4428,1296,22.6
72017,2012,6193,4995,1198,19.3
72019,2012,7863,6589,1274,16.2
72021,2012,72108,64165,7943,11
72023,2012,14582,12333,2249,15.4
72025,2012,52230,45171,7059,13.5
72027,2012,9980,8551,1429,14.3
72029,2012,16726,14402,2324,13.9
72031,2012,66781,59747,7034,10.5
72033,2012,8713,7539,1174,13.5
72035,2012,17454,14860,2594,14.9
72037,2012,4356,3527,829,19
72039,2012,4285,3356,929,21.7
72041,2012,16861,14413,2448,14.5
72043,2012,11816,9339,2477,21
72045,2012,5568,4434,1134,20.4
72047,2012,9832,8260,1572,16
72049,2012,840,792,48,5.7
72051,2012,12971,11790,1181,9.1
72053,2012,12720,10430,2290,18
72054,2012,3665,2962,703,19.2
72055,2012,4759,3577,1182,24.8
72057,2012,13371,10581,2790,20.9
72059,2012,5766,4532,1234,21.4
72061,2012,38890,36304,2586,6.6
72063,2012,17314,15360,1954,11.3
72065,2012,13435,11252,2183,16.2
72067,2012,5916,5036,880,14.9
72069,2012,19211,15422,3789,19.7
72071,2012,12597,10302,2295,18.2
72073,2012,4569,3799,770,16.9
72075,2012,16438,13747,2691,16.4
72077,2012,12888,10785,2103,16.3
72079,2012,6133,4715,1418,23.1
72081,2012,7728,6217,1511,19.6
72083,2012,3709,3108,601,16.2
72085,2012,12063,9790,2273,18.8
72087,2012,9377,8171,1206,12.9
72089,2012,6981,5609,1372,19.7
72091,2012,12481,10606,1875,15
72093,2012,2165,1765,400,18.5
72095,2012,3339,2574,765,22.9
72097,2012,25685,21396,4289,16.7
72099,2012,11402,9200,2202,19.3
72101,2012,8677,7088,1589,18.3
72103,2012,8566,7105,1461,17.1
72105,2012,7774,6460,1314,16.9
72107,2012,5726,4588,1138,19.9
72109,2012,5462,4090,1372,25.1
72111,2012,6843,5444,1399,20.4
72113,2012,52179,43880,8299,15.9
72115,2012,6372,5194,1178,18.5
72117,2012,4811,3912,899,18.7
72119,2012,17927,15704,2223,12.4
72121,2012,7032,5563,1469,20.9
72123,2012,8978,6741,2237,24.9
72125,2012,11171,9128,2043,18.3
72127,2012,145024,132233,12791,8.8
72129,2012,12713,10710,2003,15.8
72131,2012,11317,8813,2504,22.1
72133,2012,9892,7914,1978,20
72135,2012,26636,23951,2685,10.1
72137,2012,31909,28534,3375,10.6
72139,2012,28626,26231,2395,8.4
72141,2012,7551,6088,1463,19.4
72143,2012,10301,8845,1456,14.1
72145,2012,14796,12435,2361,16
72147,2012,3043,2651,392,12.9
72149,2012,8308,6584,1724,20.8
72151,2012,10302,7903,2399,23.3
72153,2012,11531,9140,2391,20.7
01001,2013,25810,24205,1605,6.2
01003,2013,85280,79626,5654,6.6
01005,2013,9099,8168,931,10.2
01007,2013,8705,8016,689,7.9
01009,2013,24887,23325,1562,6.3
01011,2013,4778,4331,447,9.4
01013,2013,9147,8206,941,10.3
01015,2013,48405,44163,4242,8.8
01017,2013,15275,14058,1217,8
01019,2013,11403,10649,754,6.6
01021,2013,19359,18090,1269,6.6
01023,2013,4703,4270,433,9.2
01025,2013,8285,7145,1140,13.8
01027,2013,5393,4943,450,8.3
01029,2013,5830,5383,447,7.7
01031,2013,20516,19105,1411,6.9
01033,2013,23896,21937,1959,8.2
01035,2013,4695,4191,504,10.7
01037,2013,4452,4044,408,9.2
01039,2013,16066,14768,1298,8.1
01041,2013,6311,5828,483,7.7
01043,2013,35783,33402,2381,6.7
01045,2013,20750,19220,1530,7.4
01047,2013,16293,14301,1992,12.2
01049,2013,29033,26823,2210,7.6
01051,2013,36930,34658,2272,6.2
01053,2013,14292,13065,1227,8.6
01055,2013,43862,40538,3324,7.6
01057,2013,6406,5875,531,8.3
01059,2013,13678,12578,1100,8
01061,2013,11044,10276,768,7
01063,2013,2997,2614,383,12.8
01065,2013,6208,5486,722,11.6
01067,2013,6954,6421,533,7.7
01069,2013,45711,42553,3158,6.9
01071,2013,23687,21822,1865,7.9
01073,2013,315405,294426,20979,6.7
01075,2013,5802,5394,408,7
01077,2013,43150,40083,3067,7.1
01079,2013,14282,13093,1189,8.3
01081,2013,70523,66379,4144,5.9
01083,2013,39435,36969,2466,6.3
01085,2013,4009,3443,566,14.1
01087,2013,8414,7603,811,9.6
01089,2013,171363,160551,10812,6.3
01091,2013,7634,6955,679,8.9
01093,2013,12487,11499,988,7.9
01095,2013,40614,37841,2773,6.8
01097,2013,187046,171088,15958,8.5
01099,2013,7766,6843,923,11.9
01101,2013,106360,98613,7747,7.3
01103,2013,57001,53090,3911,6.9
01105,2013,3566,3083,483,13.5
01107,2013,7420,6727,693,9.3
01109,2013,14924,13785,1139,7.6
01111,2013,9212,8498,714,7.8
01113,2013,25018,23208,1810,7.2
01115,2013,38835,36455,2380,6.1
01117,2013,107004,102054,4950,4.6
01119,2013,5463,4969,494,9
01121,2013,35771,32700,3071,8.6
01123,2013,18399,16909,1490,8.1
01125,2013,95678,89602,6076,6.4
01127,2013,26364,24136,2228,8.5
01129,2013,6714,5985,729,10.9
01131,2013,2780,2244,536,19.3
01133,2013,9644,8737,907,9.4
02013,2013,2217,2083,134,6
02016,2013,4272,3976,296,6.9
02020,2013,158401,150169,8232,5.2
02050,2013,7424,6224,1200,16.2
02060,2013,491,448,43,8.8
02068,2013,1078,943,135,12.5
02070,2013,2134,1916,218,10.2
02090,2013,47286,44514,2772,5.9
02100,2013,1142,1026,116,10.2
02105,2013,1124,959,165,14.7
02110,2013,17589,16702,887,5
02122,2013,27831,25592,2239,8
02130,2013,7168,6606,562,7.8
02150,2013,6594,6183,411,6.2
02158,2013,2782,2124,658,23.7
02164,2013,638,539,99,15.5
02170,2013,43925,40253,3672,8.4
02180,2013,4142,3631,511,12.3
02185,2013,4072,3772,300,7.4
02188,2013,3068,2564,504,16.4
02195,2013,1659,1515,144,8.7
02198,2013,2811,2468,343,12.2
02220,2013,4625,4371,254,5.5
02230,2013,794,695,99,12.5
02240,2013,3013,2617,396,13.1
02261,2013,4934,4444,490,9.9
02275,2013,1059,974,85,8
02282,2013,285,258,27,9.5
02290,2013,2736,2234,502,18.3
04001,2013,21829,17813,4016,18.4
04003,2013,51308,46587,4721,9.2
04005,2013,70877,65110,5767,8.1
04007,2013,20901,18890,2011,9.6
04009,2013,14276,13173,1103,7.7
04011,2013,4580,4311,269,5.9
04012,2013,8028,7372,656,8.2
04013,2013,1907171,1781737,125434,6.6
04015,2013,76838,68888,7950,10.3
04017,2013,41925,36283,5642,13.5
04019,2013,456994,426120,30874,6.8
04021,2013,148275,136324,11951,8.1
04023,2013,20111,17023,3088,15.4
04025,2013,91587,84500,7087,7.7
04027,2013,94729,70567,24162,25.5
05001,2013,9589,8884,705,7.4
05003,2013,8923,7953,970,10.9
05005,2013,16067,14775,1292,8
05007,2013,111857,105567,6290,5.6
05009,2013,16048,14922,1126,7
05011,2013,4127,3722,405,9.8
05013,2013,2424,2226,198,8.2
05015,2013,12284,11548,736,6
05017,2013,3843,3397,446,11.6
05019,2013,9923,9030,893,9
05021,2013,6530,5895,635,9.7
05023,2013,10028,9172,856,8.5
05025,2013,3600,3328,272,7.6
05027,2013,9679,8830,849,8.8
05029,2013,8647,7850,797,9.2
05031,2013,49333,46104,3229,6.5
05033,2013,27056,24989,2067,7.6
05035,2013,21541,19737,1804,8.4
05037,2013,8207,7586,621,7.6
05039,2013,2934,2616,318,10.8
05041,2013,5644,5100,544,9.6
05043,2013,8169,7370,799,9.8
05045,2013,59300,55458,3842,6.5
05047,2013,7423,6913,510,6.9
05049,2013,4918,4579,339,6.9
05051,2013,40834,37743,3091,7.6
05053,2013,8273,7733,540,6.5
05055,2013,19420,17889,1531,7.9
05057,2013,10096,9365,731,7.2
05059,2013,14111,13084,1027,7.3
05061,2013,6235,5836,399,6.4
05063,2013,15805,14382,1423,9
05065,2013,5002,4570,432,8.6
05067,2013,6276,5593,683,10.9
05069,2013,31027,27830,3197,10.3
05071,2013,10564,9756,808,7.6
05073,2013,2743,2479,264,9.6
05075,2013,7149,6515,634,8.9
05077,2013,3313,3005,308,9.3
05079,2013,4354,3993,361,8.3
05081,2013,5708,5275,433,7.6
05083,2013,9248,8530,718,7.8
05085,2013,32797,30800,1997,6.1
05087,2013,6857,6461,396,5.8
05089,2013,6514,6013,501,7.7
05091,2013,19556,18303,1253,6.4
05093,2013,19000,16852,2148,11.3
05095,2013,3121,2847,274,8.8
05097,2013,3418,3131,287,8.4
05099,2013,3779,3488,291,7.7
05101,2013,3490,3249,241,6.9
05103,2013,10253,9261,992,9.7
05105,2013,4364,3956,408,9.3
05107,2013,7595,6732,863,11.4
05109,2013,4202,3831,371,8.8
05111,2013,10147,9289,858,8.5
05113,2013,8455,7850,605,7.2
05115,2013,29650,27479,2171,7.3
05117,2013,3803,3535,268,7
05119,2013,186725,174559,12166,6.5
05121,2013,6692,6055,637,9.5
05123,2013,9173,8220,953,10.4
05125,2013,54784,51620,3164,5.8
05127,2013,4591,4303,288,6.3
05129,2013,3125,2877,248,7.9
05131,2013,58153,53824,4329,7.4
05133,2013,5926,5431,495,8.4
05135,2013,6019,5433,586,9.7
05137,2013,4803,4400,403,8.4
05139,2013,16600,15174,1426,8.6
05141,2013,6494,5865,629,9.7
05143,2013,106852,101138,5714,5.3
05145,2013,35094,32359,2735,7.8
05147,2013,3237,2930,307,9.5
05149,2013,9065,8471,594,6.6
06001,2013,802813,744764,58049,7.2
06003,2013,526,475,51,9.7
06005,2013,14449,12959,1490,10.3
06007,2013,101748,91263,10485,10.3
06009,2013,20255,18243,2012,9.9
06011,2013,11292,9156,2136,18.9
06013,2013,538002,497661,40341,7.5
06015,2013,10330,9107,1223,11.8
06017,2013,88598,81063,7535,8.5
06019,2013,437908,379850,58058,13.3
06021,2013,12990,11418,1572,12.1
06023,2013,63055,57947,5108,8.1
06025,2013,78271,58670,19601,25
06027,2013,9390,8654,736,7.8
06029,2013,393440,347213,46227,11.7
06031,2013,58198,50387,7811,13.4
06033,2013,29259,26068,3191,10.9
06035,2013,11005,9838,1167,10.6
06037,2013,4967167,4482594,484573,9.8
06039,2013,62263,54428,7835,12.6
06041,2013,138367,131216,7151,5.2
06043,2013,8229,7363,866,10.5
06045,2013,40837,37425,3412,8.4
06047,2013,114628,98009,16619,14.5
06049,2013,3503,3073,430,12.3
06051,2013,8368,7655,713,8.5
06053,2013,216380,194075,22305,10.3
06055,2013,72809,67766,5043,6.9
06057,2013,48169,44267,3902,8.1
06059,2013,1565334,1462270,103064,6.6
06061,2013,175833,162264,13569,7.7
06063,2013,8256,7114,1142,13.8
06065,2013,996411,897722,98689,9.9
06067,2013,680241,619835,60406,8.9
06069,2013,28904,25696,3208,11.1
06071,2013,896673,809057,87616,9.8
06073,2013,1543189,1422391,120798,7.8
06075,2013,516300,488121,28179,5.5
06077,2013,313101,274562,38539,12.3
06079,2013,138258,128819,9439,6.8
06081,2013,418085,396092,21993,5.3
06083,2013,217331,201680,15651,7.2
06085,2013,971862,909039,62823,6.5
06087,2013,142067,127466,14601,10.3
06089,2013,75285,66385,8900,11.8
06091,2013,1452,1267,185,12.7
06093,2013,18293,15888,2405,13.1
06095,2013,203055,184630,18425,9.1
06097,2013,249962,232197,17765,7.1
06099,2013,240987,209781,31206,12.9
06101,2013,44792,38243,6549,14.6
06103,2013,25086,22171,2915,11.6
06105,2013,5192,4572,620,11.9
06107,2013,201053,172171,28882,14.4
06109,2013,21749,19406,2343,10.8
06111,2013,433914,399769,34145,7.9
06113,2013,101835,92660,9175,9
06115,2013,28250,24531,3719,13.2
08001,2013,241765,222106,19659,8.1
08003,2013,7562,6827,735,9.7
08005,2013,326280,304753,21527,6.6
08007,2013,5699,5200,499,8.8
08009,2013,1895,1817,78,4.1
08011,2013,1646,1519,127,7.7
08013,2013,174782,165184,9598,5.5
08014,2013,32776,30871,1905,5.8
08015,2013,8301,7790,511,6.2
08017,2013,969,928,41,4.2
08019,2013,5440,5099,341,6.3
08021,2013,3610,3226,384,10.6
08023,2013,1596,1417,179,11.2
08025,2013,1322,1227,95,7.2
08027,2013,1919,1797,122,6.4
08029,2013,13852,12617,1235,8.9
08031,2013,362752,338686,24066,6.6
08033,2013,1014,930,84,8.3
08035,2013,164441,155708,8733,5.3
08037,2013,31874,29947,1927,6
08039,2013,12693,11946,747,5.9
08041,2013,306761,282583,24178,7.9
08043,2013,14946,13349,1597,10.7
08045,2013,30944,28635,2309,7.5
08047,2013,3314,3115,199,6
08049,2013,8769,8257,512,5.8
08051,2013,9635,9108,527,5.5
08053,2013,432,412,20,4.6
08055,2013,2541,2193,348,13.7
08057,2013,793,755,38,4.8
08059,2013,305200,286109,19091,6.3
08061,2013,764,730,34,4.5
08063,2013,4081,3921,160,3.9
08065,2013,4440,4120,320,7.2
08067,2013,29559,27873,1686,5.7
08069,2013,174165,164046,10119,5.8
08071,2013,6734,5983,751,11.2
08073,2013,2105,1982,123,5.8
08075,2013,10798,10245,553,5.1
08077,2013,73542,67108,6434,8.7
08079,2013,425,400,25,5.9
08081,2013,7535,7013,522,6.9
08083,2013,12713,11730,983,7.7
08085,2013,19297,17474,1823,9.4
08087,2013,14659,13702,957,6.5
08089,2013,8207,7399,808,9.8
08091,2013,2128,1966,162,7.6
08093,2013,9252,8691,561,6.1
08095,2013,2124,2026,98,4.6
08097,2013,10782,10084,698,6.5
08099,2013,5857,5489,368,6.3
08101,2013,73335,66114,7221,9.8
08103,2013,3072,2831,241,7.8
08105,2013,4878,4313,565,11.6
08107,2013,14494,13632,862,5.9
08109,2013,2953,2620,333,11.3
08111,2013,477,436,41,8.6
08113,2013,4777,4459,318,6.7
08115,2013,1090,1022,68,6.2
08117,2013,19350,18379,971,5
08119,2013,11712,10798,914,7.8
08121,2013,2549,2432,117,4.6
08123,2013,139047,129920,9127,6.6
08125,2013,4736,4511,225,4.8
09001,2013,467863,433839,34024,7.3
09003,2013,467277,430020,37257,8
09005,2013,104547,97109,7438,7.1
09007,2013,90957,84859,6098,6.7
09009,2013,450158,411726,38432,8.5
09011,2013,136843,125701,11142,8.1
09013,2013,83466,77736,5730,6.9
09015,2013,62229,56774,5455,8.8
10001,2013,73824,68405,5419,7.3
10003,2013,276688,258787,17901,6.5
10005,2013,92216,85927,6289,6.8
11001,2013,374126,342351,31775,8.5
12001,2013,129435,122038,7397,5.7
12003,2013,11270,10438,832,7.4
12005,2013,86420,80126,6294,7.3
12007,2013,10985,10293,692,6.3
12009,2013,258685,237228,21457,8.3
12011,2013,974428,908457,65971,6.8
12013,2013,4916,4530,386,7.9
12015,2013,66196,60889,5307,8
12017,2013,49374,44587,4787,9.7
12019,2013,96943,90794,6149,6.3
12021,2013,155575,144588,10987,7.1
12023,2013,27867,25759,2108,7.6
12027,2013,13133,12056,1077,8.2
12029,2013,5846,5348,498,8.5
12031,2013,457588,423256,34332,7.5
12033,2013,138979,128926,10053,7.2
12035,2013,44020,40340,3680,8.4
12037,2013,4992,4716,276,5.5
12039,2013,18866,17138,1728,9.2
12041,2013,6623,6103,520,7.9
12043,2013,5468,5062,406,7.4
12045,2013,6162,5746,416,6.8
12047,2013,4633,4236,397,8.6
12049,2013,11052,10141,911,8.2
12051,2013,16651,14661,1990,12
12053,2013,66338,60381,5957,9
12055,2013,36128,32688,3440,9.5
12057,2013,673420,629073,44347,6.6
12059,2013,7012,6461,551,7.9
12061,2013,61499,55568,5931,9.6
12063,2013,17779,16438,1341,7.5
12065,2013,5469,5045,424,7.8
12067,2013,3501,3319,182,5.2
12069,2013,135456,125441,10015,7.4
12071,2013,299129,277332,21797,7.3
12073,2013,148268,139235,9033,6.1
12075,2013,16335,15001,1334,8.2
12077,2013,2844,2654,190,6.7
12079,2013,7910,7295,615,7.8
12081,2013,155326,144918,10408,6.7
12083,2013,131043,119852,11191,8.5
12085,2013,67497,62628,4869,7.2
12086,2013,1291199,1195237,95962,7.4
12087,2013,44317,42172,2145,4.8
12089,2013,36175,33743,2432,6.7
12091,2013,92170,86899,5271,5.7
12093,2013,18103,16519,1584,8.7
12095,2013,663087,618150,44937,6.8
12097,2013,147899,136197,11702,7.9
12099,2013,672215,624322,47893,7.1
12101,2013,210396,194247,16149,7.7
12103,2013,470232,438997,31235,6.6
12105,2013,278708,255795,22913,8.2
12107,2013,28211,25274,2937,10.4
12109,2013,107375,101542,5833,5.4
12111,2013,129208,116341,12867,10
12113,2013,73045,68373,4672,6.4
12115,2013,170746,158821,11925,7
12117,2013,232955,217434,15521,6.7
12119,2013,27572,25020,2552,9.3
12121,2013,18077,16826,1251,6.9
12123,2013,9484,8742,742,7.8
12125,2013,4984,4669,315,6.3
12127,2013,235627,216323,19304,8.2
12129,2013,14078,13238,840,6
12131,2013,26975,25329,1646,6.1
12133,2013,9853,9094,759,7.7
13001,2013,8673,7741,932,10.7
13003,2013,3485,3159,326,9.4
13005,2013,4628,4237,391,8.4
13007,2013,1129,1010,119,10.5
13009,2013,18527,16649,1878,10.1
13011,2013,7995,7365,630,7.9
13013,2013,34681,32118,2563,7.4
13015,2013,47053,42976,4077,8.7
13017,2013,5775,5055,720,12.5
13019,2013,7410,6703,707,9.5
13021,2013,69888,63407,6481,9.3
13023,2013,4788,4118,670,14
13025,2013,7036,6287,749,10.6
13027,2013,6682,6125,557,8.3
13029,2013,15417,14270,1147,7.4
13031,2013,34177,31209,2968,8.7
13033,2013,9484,8348,1136,12
13035,2013,10197,9250,947,9.3
13037,2013,2105,1934,171,8.1
13039,2013,21579,19904,1675,7.8
13043,2013,5102,4685,417,8.2
13045,2013,51854,46866,4988,9.6
13047,2013,31646,29516,2130,6.7
13049,2013,4919,4504,415,8.4
13051,2013,131360,120499,10861,8.3
13053,2013,2461,2191,270,11
13055,2013,10537,9589,948,9
13057,2013,115674,108567,7107,6.1
13059,2013,57878,53353,4525,7.8
13061,2013,955,846,109,11.4
13063,2013,125018,111547,13471,10.8
13065,2013,2830,2571,259,9.2
13067,2013,388813,362780,26033,6.7
13069,2013,17509,15772,1737,9.9
13071,2013,20328,18545,1783,8.8
13073,2013,65565,61317,4248,6.5
13075,2013,7437,6802,635,8.5
13077,2013,65810,61216,4594,7
13079,2013,5688,5185,503,8.8
13081,2013,9674,8594,1080,11.2
13083,2013,8127,7548,579,7.1
13085,2013,10782,9986,796,7.4
13087,2013,11575,10476,1099,9.5
13089,2013,368650,337594,31056,8.4
13091,2013,7781,6896,885,11.4
13093,2013,4515,3996,519,11.5
13095,2013,39714,35610,4104,10.3
13097,2013,67309,61525,5784,8.6
13099,2013,4375,3975,400,9.1
13101,2013,1780,1667,113,6.3
13103,2013,26177,24303,1874,7.2
13105,2013,8368,7463,905,10.8
13107,2013,8845,7738,1107,12.5
13109,2013,4727,4367,360,7.6
13111,2013,9762,8884,878,9
13113,2013,53405,49826,3579,6.7
13115,2013,43769,39614,4155,9.5
13117,2013,96487,90817,5670,5.9
13119,2013,9331,8420,911,9.8
13121,2013,508273,467197,41076,8.1
13123,2013,11907,10837,1070,9
13125,2013,1289,1167,122,9.5
13127,2013,38055,34821,3234,8.5
13129,2013,26195,23876,2319,8.9
13131,2013,10482,9673,809,7.7
13133,2013,6350,5721,629,9.9
13135,2013,438240,408130,30110,6.9
13137,2013,19316,17768,1548,8
13139,2013,89494,83366,6128,6.8
13141,2013,2641,2253,388,14.7
13143,2013,11968,10859,1109,9.3
13145,2013,15810,14776,1034,6.5
13147,2013,10498,9533,965,9.2
13149,2013,5010,4539,471,9.4
13151,2013,103433,94697,8736,8.4
13153,2013,67462,62389,5073,7.5
13155,2013,3371,3013,358,10.6
13157,2013,29599,27557,2042,6.9
13159,2013,6514,5975,539,8.3
13161,2013,6383,5749,634,9.9
13163,2013,6841,5885,956,14
13165,2013,3324,2914,410,12.3
13167,2013,4000,3607,393,9.8
13169,2013,13610,12619,991,7.3
13171,2013,7822,6939,883,11.3
13173,2013,3844,3514,330,8.6
13175,2013,19422,17331,2091,10.8
13177,2013,14297,13314,983,6.9
13179,2013,26201,23978,2223,8.5
13181,2013,3451,3105,346,10
13183,2013,6697,6152,545,8.1
13185,2013,51098,46998,4100,8
13187,2013,15140,14024,1116,7.4
13189,2013,9079,8053,1026,11.3
13191,2013,5931,5399,532,9
13193,2013,4964,4331,633,12.8
13195,2013,12909,11931,978,7.6
13197,2013,3453,3148,305,8.8
13199,2013,8815,7867,948,10.8
13201,2013,2655,2462,193,7.3
13205,2013,9016,8242,774,8.6
13207,2013,12768,11742,1026,8
13209,2013,4049,3587,462,11.4
13211,2013,8348,7674,674,8.1
13213,2013,15887,14102,1785,11.2
13215,2013,83129,75375,7754,9.3
13217,2013,48066,43403,4663,9.7
13219,2013,17095,16137,958,5.6
13221,2013,6739,6229,510,7.6
13223,2013,74530,69166,5364,7.2
13225,2013,11890,10622,1268,10.7
13227,2013,13809,12710,1099,8
13229,2013,8159,7463,696,8.5
13231,2013,8302,7599,703,8.5
13233,2013,18507,16860,1647,8.9
13235,2013,4197,3826,371,8.8
13237,2013,8143,7303,840,10.3
13239,2013,902,828,74,8.2
13241,2013,6822,6146,676,9.9
13243,2013,2790,2502,288,10.3
13245,2013,86714,78191,8523,9.8
13247,2013,42178,38321,3857,9.1
13249,2013,2131,1934,197,9.2
13251,2013,5563,4863,700,12.6
13253,2013,3138,2817,321,10.2
13255,2013,27777,24587,3190,11.5
13257,2013,11511,10458,1053,9.1
13259,2013,2287,2087,200,8.7
13261,2013,13416,11905,1511,11.3
13263,2013,2861,2596,265,9.3
13265,2013,590,520,70,11.9
13267,2013,9561,8801,760,7.9
13269,2013,3173,2803,370,11.7
13271,2013,5295,4691,604,11.4
13273,2013,3665,3307,358,9.8
13275,2013,17803,16198,1605,9
13277,2013,18694,17106,1588,8.5
13279,2013,12790,11383,1407,11
13281,2013,4159,3719,440,10.6
13283,2013,2828,2480,348,12.3
13285,2013,36163,33048,3115,8.6
13287,2013,3336,3003,333,10
13289,2013,3122,2693,429,13.7
13291,2013,9329,8593,736,7.9
13293,2013,11923,10752,1171,9.8
13295,2013,30158,27725,2433,8.1
13297,2013,41052,37860,3192,7.8
13299,2013,15098,13685,1413,9.4
13301,2013,2728,2400,328,12
13303,2013,7688,6947,741,9.6
13305,2013,12292,11091,1201,9.8
13307,2013,1036,940,96,9.3
13309,2013,1894,1656,238,12.6
13311,2013,13791,12775,1016,7.4
13313,2013,44658,40391,4267,9.6
13315,2013,2819,2506,313,11.1
13317,2013,3738,3320,418,11.2
13319,2013,3717,3333,384,10.3
13321,2013,9246,8393,853,9.2
15001,2013,86180,80410,5770,6.7
15003,2013,451490,431462,20028,4.4
15007,2013,34000,32070,1930,5.7
15009,2013,79886,75748,4138,5.2
16001,2013,206575,195843,10732,5.2
16003,2013,1709,1476,233,13.6
16005,2013,41413,38998,2415,5.8
16007,2013,2884,2736,148,5.1
16009,2013,3990,3588,402,10.1
16011,2013,22302,20995,1307,5.9
16013,2013,11587,10926,661,5.7
16015,2013,2922,2684,238,8.1
16017,2013,18280,16674,1606,8.8
16019,2013,48959,46293,2666,5.4
16021,2013,4907,4516,391,8
16023,2013,1296,1207,89,6.9
16025,2013,634,593,41,6.5
16027,2013,87750,81143,6607,7.5
16029,2013,3899,3693,206,5.3
16031,2013,11119,10538,581,5.2
16033,2013,425,398,27,6.4
16035,2013,3188,2828,360,11.3
16037,2013,2209,2024,185,8.4
16039,2013,10783,10059,724,6.7
16041,2013,6265,6005,260,4.2
16043,2013,6915,6552,363,5.2
16045,2013,7500,6913,587,7.8
16047,2013,8033,7638,395,4.9
16049,2013,6583,5930,653,9.9
16051,2013,12143,11522,621,5.1
16053,2013,10829,10250,579,5.3
16055,2013,69255,64204,5051,7.3
16057,2013,19422,18468,954,4.9
16059,2013,3437,3115,322,9.4
16061,2013,1612,1531,81,5
16063,2013,2647,2446,201,7.6
16065,2013,18447,17695,752,4.1
16067,2013,10383,9809,574,5.5
16069,2013,20223,19217,1006,5
16071,2013,2095,2005,90,4.3
16073,2013,5121,4924,197,3.8
16075,2013,10818,10116,702,6.5
16077,2013,3981,3719,262,6.6
16079,2013,5493,4828,665,12.1
16081,2013,5455,5182,273,5
16083,2013,38044,35863,2181,5.7
16085,2013,4542,4079,463,10.2
16087,2013,4764,4413,351,7.4
17001,2013,32953,30719,2234,6.8
17003,2013,2690,2349,341,12.7
17005,2013,8034,7338,696,8.7
17007,2013,26423,23747,2676,10.1
17009,2013,2614,2453,161,6.2
17011,2013,17731,16104,1627,9.2
17013,2013,2416,2179,237,9.8
17015,2013,7879,7252,627,8
17017,2013,6454,5867,587,9.1
17019,2013,103054,95384,7670,7.4
17021,2013,16051,14497,1554,9.7
17023,2013,7941,7202,739,9.3
17025,2013,6317,5691,626,9.9
17027,2013,19946,18592,1354,6.8
17029,2013,24414,22270,2144,8.8
17031,2013,2671902,2414720,257182,9.6
17033,2013,9963,9134,829,8.3
17035,2013,5818,5363,455,7.8
17037,2013,54789,50304,4485,8.2
17039,2013,8148,7468,680,8.3
17041,2013,9780,9098,682,7
17043,2013,510632,473038,37594,7.4
17045,2013,9032,8178,854,9.5
17047,2013,2868,2622,246,8.6
17049,2013,18068,16818,1250,6.9
17051,2013,10131,9197,934,9.2
17053,2013,6553,6055,498,7.6
17055,2013,16923,14913,2010,11.9
17057,2013,16213,14442,1771,10.9
17059,2013,2480,2246,234,9.4
17061,2013,6318,5772,546,8.6
17063,2013,25906,22898,3008,11.6
17065,2013,4087,3769,318,7.8
17067,2013,8896,8142,754,8.5
17069,2013,1734,1537,197,11.4
17071,2013,3670,3381,289,7.9
17073,2013,25499,23526,1973,7.7
17075,2013,14994,13725,1269,8.5
17077,2013,28529,26263,2266,7.9
17079,2013,4729,4354,375,7.9
17081,2013,17831,16133,1698,9.5
17083,2013,11151,10152,999,9
17085,2013,11592,10708,884,7.6
17087,2013,4286,3763,523,12.2
17089,2013,264832,241797,23035,8.7
17091,2013,55775,49964,5811,10.4
17093,2013,64445,59053,5392,8.4
17095,2013,23671,21574,2097,8.9
17097,2013,364503,335707,28796,7.9
17099,2013,58113,52107,6006,10.3
17101,2013,6328,5682,646,10.2
17103,2013,18093,16643,1450,8
17105,2013,17690,16261,1429,8.1
17107,2013,13093,12036,1057,8.1
17109,2013,14633,13419,1214,8.3
17111,2013,166937,152512,14425,8.6
17113,2013,92339,86242,6097,6.6
17115,2013,52452,46501,5951,11.3
17117,2013,23470,21251,2219,9.5
17119,2013,133216,121382,11834,8.9
17121,2013,18112,16290,1822,10.1
17123,2013,5907,5368,539,9.1
17125,2013,6735,5998,737,10.9
17127,2013,6407,5779,628,9.8
17129,2013,6728,6254,474,7
17131,2013,8423,7763,660,7.8
17133,2013,17729,16543,1186,6.7
17135,2013,12601,11226,1375,10.9
17137,2013,17402,16037,1365,7.8
17139,2013,7094,6583,511,7.2
17141,2013,25785,23245,2540,9.9
17143,2013,93524,84517,9007,9.6
17145,2013,9023,8027,996,11
17147,2013,8376,7776,600,7.2
17149,2013,7692,7114,578,7.5
17151,2013,1831,1662,169,9.2
17153,2013,2217,1939,278,12.5
17155,2013,3054,2751,303,9.9
17157,2013,14376,13173,1203,8.4
17159,2013,7372,6757,615,8.3
17161,2013,73830,67711,6119,8.3
17163,2013,127773,115260,12513,9.8
17165,2013,11279,10086,1193,10.6
17167,2013,103964,96308,7656,7.4
17169,2013,3474,3185,289,8.3
17171,2013,2606,2375,231,8.9
17173,2013,10296,9397,899,8.7
17175,2013,2884,2609,275,9.5
17177,2013,22738,20603,2135,9.4
17179,2013,69097,63125,5972,8.6
17181,2013,7413,6581,832,11.2
17183,2013,35944,32138,3806,10.6
17185,2013,5642,5218,424,7.5
17187,2013,8822,8173,649,7.4
17189,2013,8919,8365,554,6.2
17191,2013,7882,7269,613,7.8
17193,2013,7028,6488,540,7.7
17195,2013,29386,26822,2564,8.7
17197,2013,358409,323348,35061,9.8
17199,2013,31479,28644,2835,9
17201,2013,143267,128239,15028,10.5
17203,2013,19931,18515,1416,7.1
18001,2013,15888,14922,966,6.1
18003,2013,174129,161047,13082,7.5
18005,2013,41587,39102,2485,6
18007,2013,4462,4147,315,7.1
18009,2013,5440,4902,538,9.9
18011,2013,31079,29308,1771,5.7
18013,2013,7316,6773,543,7.4
18015,2013,9906,9209,697,7
18017,2013,17671,16309,1362,7.7
18019,2013,56230,52343,3887,6.9
18021,2013,12582,11459,1123,8.9
18023,2013,16420,15255,1165,7.1
18025,2013,4841,4356,485,10
18027,2013,14869,14028,841,5.7
18029,2013,25174,23043,2131,8.5
18031,2013,13861,12933,928,6.7
18033,2013,20941,19443,1498,7.2
18035,2013,54166,49495,4671,8.6
18037,2013,21629,20480,1149,5.3
18039,2013,98969,91804,7165,7.2
18041,2013,9023,8091,932,10.3
18043,2013,38502,36061,2441,6.3
18045,2013,8320,7504,816,9.8
18047,2013,10769,9835,934,8.7
18049,2013,9884,9067,817,8.3
18051,2013,18014,16959,1055,5.9
18053,2013,32462,29531,2931,9
18055,2013,13758,12352,1406,10.2
18057,2013,155747,147897,7850,5
18059,2013,36064,33672,2392,6.6
18061,2013,18703,17398,1305,7
18063,2013,78648,74095,4553,5.8
18065,2013,21311,19427,1884,8.8
18067,2013,36411,33447,2964,8.1
18069,2013,18520,17092,1428,7.7
18071,2013,20848,19494,1354,6.5
18073,2013,15939,14705,1234,7.7
18075,2013,10047,9271,776,7.7
18077,2013,15307,14101,1206,7.9
18079,2013,13033,11835,1198,9.2
18081,2013,73663,69067,4596,6.2
18083,2013,18625,17371,1254,6.7
18085,2013,39729,37112,2617,6.6
18087,2013,17610,16570,1040,5.9
18089,2013,229961,209117,20844,9.1
18091,2013,48938,44379,4559,9.3
18093,2013,20656,18570,2086,10.1
18095,2013,58068,52652,5416,9.3
18097,2013,463347,423962,39385,8.5
18099,2013,23095,21385,1710,7.4
18101,2013,4950,4637,313,6.3
18103,2013,15605,14250,1355,8.7
18105,2013,66654,62096,4558,6.8
18107,2013,18399,17078,1321,7.2
18109,2013,34826,32193,2633,7.6
18111,2013,6909,6289,620,9
18113,2013,22617,20960,1657,7.3
18115,2013,3165,2902,263,8.3
18117,2013,8755,7887,868,9.9
18119,2013,9637,8667,970,10.1
18121,2013,6931,6292,639,9.2
18123,2013,8931,8237,694,7.8
18125,2013,6261,5836,425,6.8
18127,2013,83168,77169,5999,7.2
18129,2013,12945,12125,820,6.3
18131,2013,6117,5687,430,7
18133,2013,16159,14760,1399,8.7
18135,2013,12576,11488,1088,8.7
18137,2013,13634,12464,1170,8.6
18139,2013,8334,7717,617,7.4
18141,2013,127096,116037,11059,8.7
18143,2013,10238,9324,914,8.9
18145,2013,22345,20705,1640,7.3
18147,2013,10689,9977,712,6.7
18149,2013,10213,9247,966,9.5
18151,2013,19319,18109,1210,6.3
18153,2013,8705,7917,788,9.1
18155,2013,4883,4519,364,7.5
18157,2013,89629,83674,5955,6.6
18159,2013,7958,7423,535,6.7
18161,2013,3519,3266,253,7.2
18163,2013,90898,84412,6486,7.1
18165,2013,7324,6537,787,10.7
18167,2013,49522,44879,4643,9.4
18169,2013,15453,14275,1178,7.6
18171,2013,4152,3787,365,8.8
18173,2013,30709,28777,1932,6.3
18175,2013,13142,11994,1148,8.7
18177,2013,30535,27887,2648,8.7
18179,2013,13650,12784,866,6.3
18181,2013,12930,12042,888,6.9
18183,2013,16760,15590,1170,7
19001,2013,4073,3901,172,4.2
19003,2013,2150,2071,79,3.7
19005,2013,7652,7167,485,6.3
19007,2013,5926,5549,377,6.4
19009,2013,3237,3079,158,4.9
19011,2013,13722,13024,698,5.1
19013,2013,71744,68081,3663,5.1
19015,2013,14881,14278,603,4.1
19017,2013,13998,13468,530,3.8
19019,2013,11166,10637,529,4.7
19021,2013,11307,10860,447,4
19023,2013,8261,7887,374,4.5
19025,2013,4360,4134,226,5.2
19027,2013,11270,10891,379,3.4
19029,2013,7290,6922,368,5
19031,2013,10812,10346,466,4.3
19033,2013,23334,22073,1261,5.4
19035,2013,6840,6546,294,4.3
19037,2013,6366,6049,317,5
19039,2013,4585,4332,253,5.5
19041,2013,8814,8417,397,4.5
19043,2013,10074,9506,568,5.6
19045,2013,24920,23486,1434,5.8
19047,2013,8768,8386,382,4.4
19049,2013,40898,39423,1475,3.6
19051,2013,4120,3893,227,5.5
19053,2013,4301,4107,194,4.5
19055,2013,10388,9941,447,4.3
19057,2013,20495,19258,1237,6
19059,2013,9335,8838,497,5.3
19061,2013,55052,52551,2501,4.5
19063,2013,5683,5450,233,4.1
19065,2013,10667,10104,563,5.3
19067,2013,8272,7815,457,5.5
19069,2013,5914,5651,263,4.4
19071,2013,4127,3953,174,4.2
19073,2013,5124,4884,240,4.7
19075,2013,6599,6311,288,4.4
19077,2013,5532,5247,285,5.2
19079,2013,7038,6655,383,5.4
19081,2013,6209,5961,248,4
19083,2013,8696,8252,444,5.1
19085,2013,7507,7169,338,4.5
19087,2013,9548,9042,506,5.3
19089,2013,5230,4988,242,4.6
19091,2013,5216,5003,213,4.1
19093,2013,3813,3661,152,4
19095,2013,9927,9516,411,4.1
19097,2013,10845,10261,584,5.4
19099,2013,19053,18085,968,5.1
19101,2013,8925,8482,443,5
19103,2013,82736,79915,2821,3.4
19105,2013,10732,10162,570,5.3
19107,2013,5477,5199,278,5.1
19109,2013,8473,8172,301,3.6
19111,2013,17125,15905,1220,7.1
19113,2013,119665,113672,5993,5
19115,2013,5850,5554,296,5.1
19117,2013,4245,4046,199,4.7
19119,2013,6853,6655,198,2.9
19121,2013,8090,7679,411,5.1
19123,2013,11650,11089,561,4.8
19125,2013,17319,16547,772,4.5
19127,2013,19798,18607,1191,6
19129,2013,7326,7004,322,4.4
19131,2013,5508,5271,237,4.3
19133,2013,4624,4359,265,5.7
19135,2013,4025,3796,229,5.7
19137,2013,5122,4872,250,4.9
19139,2013,21695,20563,1132,5.2
19141,2013,8041,7749,292,3.6
19143,2013,3409,3278,131,3.8
19145,2013,6553,6207,346,5.3
19147,2013,4776,4597,179,3.7
19149,2013,14489,13909,580,4
19151,2013,4192,4033,159,3.8
19153,2013,250381,238335,12046,4.8
19155,2013,48628,46406,2222,4.6
19157,2013,10343,9864,479,4.6
19159,2013,2514,2406,108,4.3
19161,2013,5514,5282,232,4.2
19163,2013,88082,83159,4923,5.6
19165,2013,6940,6679,261,3.8
19167,2013,19566,18890,676,3.5
19169,2013,54752,52928,1824,3.3
19171,2013,9107,8601,506,5.6
19173,2013,3165,3045,120,3.8
19175,2013,6896,6559,337,4.9
19177,2013,3833,3622,211,5.5
19179,2013,18132,16985,1147,6.3
19181,2013,26339,25155,1184,4.5
19183,2013,12272,11810,462,3.8
19185,2013,2850,2702,148,5.2
19187,2013,19753,18704,1049,5.3
19189,2013,5166,4918,248,4.8
19191,2013,11891,11340,551,4.6
19193,2013,55212,52569,2643,4.8
19195,2013,4184,3968,216,5.2
19197,2013,6844,6537,307,4.5
20001,2013,6890,6471,419,6.1
20003,2013,4238,3992,246,5.8
20005,2013,7777,7110,667,8.6
20007,2013,2761,2651,110,4
20009,2013,15097,14485,612,4.1
20011,2013,6868,6423,445,6.5
20013,2013,5455,5182,273,5
20015,2013,31823,30062,1761,5.5
20017,2013,1250,1180,70,5.6
20019,2013,1620,1520,100,6.2
20021,2013,10498,9828,670,6.4
20023,2013,1310,1265,45,3.4
20025,2013,1188,1151,37,3.1
20027,2013,4194,3983,211,5
20029,2013,4452,4258,194,4.4
20031,2013,4943,4651,292,5.9
20033,2013,1033,997,36,3.5
20035,2013,17163,16166,997,5.8
20037,2013,19282,18144,1138,5.9
20039,2013,1361,1307,54,4
20041,2013,9859,9278,581,5.9
20043,2013,4337,4102,235,5.4
20045,2013,63535,60479,3056,4.8
20047,2013,1607,1547,60,3.7
20049,2013,1323,1248,75,5.7
20051,2013,18044,17477,567,3.1
20053,2013,3447,3332,115,3.3
20055,2013,19980,19124,856,4.3
20057,2013,18629,17883,746,4
20059,2013,13966,13108,858,6.1
20061,2013,12663,11566,1097,8.7
20063,2013,1488,1439,49,3.3
20065,2013,1351,1295,56,4.1
20067,2013,3991,3847,144,3.6
20069,2013,3487,3383,104,3
20071,2013,908,886,22,2.4
20073,2013,3358,3179,179,5.3
20075,2013,1715,1666,49,2.9
20077,2013,3104,2979,125,4
20079,2013,17110,16278,832,4.9
20081,2013,2389,2319,70,2.9
20083,2013,1116,1073,43,3.9
20085,2013,7286,6916,370,5.1
20087,2013,10187,9604,583,5.7
20089,2013,1422,1370,52,3.7
20091,2013,314173,300633,13540,4.3
20093,2013,2099,2023,76,3.6
20095,2013,3716,3514,202,5.4
20097,2013,1422,1374,48,3.4
20099,2013,10728,9959,769,7.2
20101,2013,883,852,31,3.5
20103,2013,34597,32529,2068,6
20105,2013,1778,1696,82,4.6
20107,2013,4334,3959,375,8.7
20109,2013,1742,1694,48,2.8
20111,2013,16426,15247,1179,7.2
20113,2013,16579,15937,642,3.9
20115,2013,6210,5920,290,4.7
20117,2013,6042,5809,233,3.9
20119,2013,2351,2277,74,3.1
20121,2013,16783,15847,936,5.6
20123,2013,3877,3764,113,2.9
20125,2013,17835,16631,1204,6.8
20127,2013,3100,2931,169,5.5
20129,2013,1593,1531,62,3.9
20131,2013,5823,5622,201,3.5
20133,2013,6733,6160,573,8.5
20135,2013,1602,1553,49,3.1
20137,2013,3085,2999,86,2.8
20139,2013,8278,7727,551,6.7
20141,2013,2121,2031,90,4.2
20143,2013,3238,3092,146,4.5
20145,2013,3414,3265,149,4.4
20147,2013,2965,2839,126,4.2
20149,2013,11923,11375,548,4.6
20151,2013,5439,5223,216,4
20153,2013,1549,1507,42,2.7
20155,2013,31588,29930,1658,5.2
20157,2013,2649,2560,89,3.4
20159,2013,5442,5209,233,4.3
20161,2013,36571,35030,1541,4.2
20163,2013,2779,2663,116,4.2
20165,2013,1810,1732,78,4.3
20167,2013,3849,3697,152,3.9
20169,2013,31098,29550,1548,5
20171,2013,2838,2756,82,2.9
20173,2013,246243,231111,15132,6.1
20175,2013,11082,10628,454,4.1
20177,2013,92035,86721,5314,5.8
20179,2013,1498,1457,41,2.7
20181,2013,3128,3003,125,4
20183,2013,2157,2080,77,3.6
20185,2013,2216,2119,97,4.4
20187,2013,1045,1007,38,3.6
20189,2013,3314,3215,99,3
20191,2013,11144,10516,628,5.6
20193,2013,4465,4309,156,3.5
20195,2013,1491,1436,55,3.7
20197,2013,3769,3579,190,5
20199,2013,852,825,27,3.2
20201,2013,3127,3011,116,3.7
20203,2013,1288,1243,45,3.5
20205,2013,4110,3746,364,8.9
20207,2013,1627,1526,101,6.2
20209,2013,74775,68839,5936,7.9
21001,2013,7559,6792,767,10.1
21003,2013,8950,8284,666,7.4
21005,2013,11531,10788,743,6.4
21007,2013,3825,3474,351,9.2
21009,2013,19575,18070,1505,7.7
21011,2013,4828,4330,498,10.3
21013,2013,9866,8552,1314,13.3
21015,2013,66021,61650,4371,6.6
21017,2013,9824,9136,688,7
21019,2013,19704,17845,1859,9.4
21021,2013,12813,11683,1130,8.8
21023,2013,3932,3547,385,9.8
21025,2013,4484,3816,668,14.9
21027,2013,8243,7487,756,9.2
21029,2013,39671,36740,2931,7.4
21031,2013,5375,4883,492,9.2
21033,2013,5632,5171,461,8.2
21035,2013,18141,16825,1316,7.3
21037,2013,48752,45550,3202,6.6
21039,2013,2375,2205,170,7.2
21041,2013,5167,4695,472,9.1
21043,2013,11034,9637,1397,12.7
21045,2013,6813,6225,588,8.6
21047,2013,26605,24098,2507,9.4
21049,2013,17266,15968,1298,7.5
21051,2013,5752,4930,822,14.3
21053,2013,4113,3683,430,10.5
21055,2013,4099,3795,304,7.4
21057,2013,3038,2714,324,10.7
21059,2013,47636,44363,3273,6.9
21061,2013,4996,4496,500,10
21063,2013,2255,1928,327,14.5
21065,2013,5536,4997,539,9.7
21067,2013,168417,158648,9769,5.8
21069,2013,6521,5903,618,9.5
21071,2013,13134,11392,1742,13.3
21073,2013,24573,22958,1615,6.6
21075,2013,2387,2130,257,10.8
21077,2013,3953,3584,369,9.3
21079,2013,7745,7111,634,8.2
21081,2013,11504,10549,955,8.3
21083,2013,16479,15085,1394,8.5
21085,2013,11242,10085,1157,10.3
21087,2013,5320,4880,440,8.3
21089,2013,14793,13283,1510,10.2
21091,2013,4099,3803,296,7.2
21093,2013,47819,44154,3665,7.7
21095,2013,9510,7793,1717,18.1
21097,2013,8745,8084,661,7.6
21099,2013,8057,7420,637,7.9
21101,2013,22130,20474,1656,7.5
21103,2013,7761,7201,560,7.2
21105,2013,2160,2006,154,7.1
21107,2013,21504,19807,1697,7.9
21109,2013,4834,4274,560,11.6
21111,2013,385274,356481,28793,7.5
21113,2013,25084,23455,1629,6.5
21115,2013,8363,7441,922,11
21117,2013,85069,79105,5964,7
21119,2013,5589,4728,861,15.4
21121,2013,10526,9161,1365,13
21123,2013,5889,5407,482,8.2
21125,2013,24642,22244,2398,9.7
21127,2013,5578,4952,626,11.2
21129,2013,2371,2075,296,12.5
21131,2013,3495,2880,615,17.6
21133,2013,8047,6703,1344,16.7
21135,2013,5293,4650,643,12.1
21137,2013,9918,8861,1057,10.7
21139,2013,3887,3503,384,9.9
21141,2013,12134,11271,863,7.1
21143,2013,3092,2838,254,8.2
21145,2013,30282,27892,2390,7.9
21147,2013,5342,4643,699,13.1
21149,2013,4479,4136,343,7.7
21151,2013,45747,42740,3007,6.6
21153,2013,4002,3299,703,17.6
21155,2013,9297,8539,758,8.2
21157,2013,15323,14079,1244,8.1
21159,2013,3641,3286,355,9.8
21161,2013,7792,7013,779,10
21163,2013,12534,11409,1125,9
21165,2013,2489,2189,300,12.1
21167,2013,10190,9390,800,7.9
21169,2013,4333,3995,338,7.8
21171,2013,4743,4404,339,7.1
21173,2013,12138,11110,1028,8.5
21175,2013,5057,4520,537,10.6
21177,2013,12963,11748,1215,9.4
21179,2013,21683,20046,1637,7.5
21181,2013,3530,3225,305,8.6
21183,2013,9901,8982,919,9.3
21185,2013,30308,28582,1726,5.7
21187,2013,5682,5322,360,6.3
21189,2013,1291,1128,163,12.6
21191,2013,7016,6428,588,8.4
21193,2013,10407,8957,1450,13.9
21195,2013,23294,20527,2767,11.9
21197,2013,5057,4513,544,10.8
21199,2013,27242,24742,2500,9.2
21201,2013,849,756,93,11
21203,2013,7084,6428,656,9.3
21205,2013,10929,10021,908,8.3
21207,2013,7029,6216,813,11.6
21209,2013,26264,24667,1597,6.1
21211,2013,22623,21250,1373,6.1
21213,2013,8854,8189,665,7.5
21215,2013,9341,8740,601,6.4
21217,2013,11389,10313,1076,9.4
21219,2013,5632,5214,418,7.4
21221,2013,6046,5500,546,9
21223,2013,3967,3637,330,8.3
21225,2013,6856,6328,528,7.7
21227,2013,60475,56322,4153,6.9
21229,2013,6139,5716,423,6.9
21231,2013,7461,6572,889,11.9
21233,2013,6182,5742,440,7.1
21235,2013,13850,12382,1468,10.6
21237,2013,2110,1811,299,14.2
21239,2013,14249,13494,755,5.3
22001,2013,26330,24760,1570,6
22003,2013,8745,8086,659,7.5
22005,2013,56781,53609,3172,5.6
22007,2013,9912,9090,822,8.3
22009,2013,16000,14807,1193,7.5
22011,2013,14445,13381,1064,7.4
22013,2013,5947,5431,516,8.7
22015,2013,56863,53437,3426,6
22017,2013,110922,102176,8746,7.9
22019,2013,89356,83592,5764,6.5
22021,2013,3958,3635,323,8.2
22023,2013,3313,3136,177,5.3
22025,2013,3900,3570,330,8.5
22027,2013,6525,6037,488,7.5
22029,2013,7806,7143,663,8.5
22031,2013,11013,10039,974,8.8
22033,2013,225959,211944,14015,6.2
22035,2013,2272,1888,384,16.9
22037,2013,7954,7407,547,6.9
22039,2013,12863,11991,872,6.8
22041,2013,7702,6927,775,10.1
22043,2013,8147,7550,597,7.3
22045,2013,32283,30200,2083,6.5
22047,2013,14039,12869,1170,8.3
22049,2013,7025,6568,457,6.5
22051,2013,213643,200234,13409,6.3
22053,2013,13163,12346,817,6.2
22055,2013,118870,113007,5863,4.9
22057,2013,46823,44522,2301,4.9
22059,2013,6973,6626,347,5
22061,2013,20549,18936,1613,7.8
22063,2013,64070,60324,3746,5.8
22065,2013,3959,3522,437,11
22067,2013,11117,9739,1378,12.4
22069,2013,16827,15425,1402,8.3
22071,2013,173465,160741,12724,7.3
22073,2013,70977,65856,5121,7.2
22075,2013,10057,9486,571,5.7
22077,2013,9910,9158,752,7.6
22079,2013,57207,53286,3921,6.9
22081,2013,3858,3567,291,7.5
22083,2013,8663,7828,835,9.6
22085,2013,9190,8569,621,6.8
22087,2013,18518,17148,1370,7.4
22089,2013,24931,23368,1563,6.3
22091,2013,4574,4056,518,11.3
22093,2013,9680,8781,899,9.3
22095,2013,20104,18361,1743,8.7
22097,2013,33711,31077,2634,7.8
22099,2013,24303,22872,1431,5.9
22101,2013,24985,23343,1642,6.6
22103,2013,111065,104680,6385,5.7
22105,2013,52934,48682,4252,8
22107,2013,1767,1601,166,9.4
22109,2013,53032,50362,2670,5
22111,2013,9166,8451,715,7.8
22113,2013,26113,24652,1461,5.6
22115,2013,17876,16299,1577,8.8
22117,2013,16423,15050,1373,8.4
22119,2013,15713,14210,1503,9.6
22121,2013,12294,11540,754,6.1
22123,2013,4247,3707,540,12.7
22125,2013,5228,4919,309,5.9
22127,2013,5377,4938,439,8.2
23001,2013,56466,52696,3770,6.7
23003,2013,33869,30955,2914,8.6
23005,2013,160923,152393,8530,5.3
23007,2013,15395,14209,1186,7.7
23009,2013,30101,27728,2373,7.9
23011,2013,63868,59883,3985,6.2
23013,2013,20785,19551,1234,5.9
23015,2013,17367,16186,1181,6.8
23017,2013,27768,25469,2299,8.3
23019,2013,80082,74603,5479,6.8
23021,2013,7894,7197,697,8.8
23023,2013,19124,18049,1075,5.6
23025,2013,24811,22538,2273,9.2
23027,2013,21009,19502,1507,7.2
23029,2013,14636,13281,1355,9.3
23031,2013,111315,104279,7036,6.3
24001,2013,33625,30773,2852,8.5
24003,2013,296544,279676,16868,5.7
24005,2013,442221,411840,30381,6.9
24009,2013,47760,44935,2825,5.9
24011,2013,17683,16458,1225,6.9
24013,2013,93058,87954,5104,5.5
24015,2013,52246,48225,4021,7.7
24017,2013,80256,75074,5182,6.5
24019,2013,15956,14400,1556,9.8
24021,2013,128454,121083,7371,5.7
24023,2013,15748,14480,1268,8.1
24025,2013,135689,126865,8824,6.5
24027,2013,171321,163072,8249,4.8
24029,2013,10347,9605,742,7.2
24031,2013,543131,516271,26860,4.9
24033,2013,486017,452445,33572,6.9
24035,2013,26466,24922,1544,5.8
24037,2013,54261,51029,3232,6
24039,2013,9577,8554,1023,10.7
24041,2013,19162,17934,1228,6.4
24043,2013,77220,71574,5646,7.3
24045,2013,50137,45782,4355,8.7
24047,2013,25909,22654,3255,12.6
24510,2013,296567,267895,28672,9.7
25001,2013,108446,99328,9118,8.4
25003,2013,65682,60814,4868,7.4
25005,2013,286380,261441,24939,8.7
25007,2013,9405,8545,860,9.1
25009,2013,399300,371158,28142,7
25011,2013,39301,36878,2423,6.2
25013,2013,220161,201060,19101,8.7
25015,2013,85411,80233,5178,6.1
25017,2013,839633,793619,46014,5.5
25019,2013,6591,6110,481,7.3
25021,2013,362471,341398,21073,5.8
25023,2013,262690,244326,18364,7
25025,2013,406853,381630,25223,6.2
25027,2013,420508,390255,30253,7.2
26001,2013,3794,3288,506,13.3
26003,2013,3373,2978,395,11.7
26005,2013,57933,54066,3867,6.7
26007,2013,13367,12075,1292,9.7
26009,2013,9975,8835,1140,11.4
26011,2013,6485,5642,843,13
26013,2013,3540,3028,512,14.5
26015,2013,29242,27375,1867,6.4
26017,2013,53013,48386,4627,8.7
26019,2013,8592,7707,885,10.3
26021,2013,72420,66133,6287,8.7
26023,2013,19007,17404,1603,8.4
26025,2013,62761,57804,4957,7.9
26027,2013,23514,21583,1931,8.2
26029,2013,12991,11599,1392,10.7
26031,2013,10497,9286,1211,11.5
26033,2013,16987,15211,1776,10.5
26035,2013,11870,10479,1391,11.7
26037,2013,39008,36649,2359,6
26039,2013,5375,4760,615,11.4
26041,2013,17484,15690,1794,10.3
26043,2013,12611,11565,1046,8.3
26045,2013,55291,51602,3689,6.7
26047,2013,18113,15969,2144,11.8
26049,2013,183792,165917,17875,9.7
26051,2013,10011,8842,1169,11.7
26053,2013,6708,5981,727,10.8
26055,2013,47035,43446,3589,7.6
26057,2013,18419,16780,1639,8.9
26059,2013,20505,18680,1825,8.9
26061,2013,16824,15333,1491,8.9
26063,2013,16323,14958,1365,8.4
26065,2013,144121,133094,11027,7.7
26067,2013,28765,26474,2291,8
26069,2013,10188,9023,1165,11.4
26071,2013,5068,4553,515,10.2
26073,2013,34863,32344,2519,7.2
26075,2013,72095,66139,5956,8.3
26077,2013,124901,116335,8566,6.9
26079,2013,7557,6713,844,11.2
26081,2013,326607,306212,20395,6.2
26083,2013,986,852,134,13.6
26085,2013,3619,3139,480,13.3
26087,2013,40283,35679,4604,11.4
26089,2013,10259,9472,787,7.7
26091,2013,47581,43858,3723,7.8
26093,2013,94808,87770,7038,7.4
26095,2013,2397,2149,248,10.3
26097,2013,5238,4597,641,12.2
26099,2013,420290,380495,39795,9.5
26101,2013,10484,9371,1113,10.6
26103,2013,33926,31153,2773,8.2
26105,2013,14467,13139,1328,9.2
26107,2013,18704,16831,1873,10
26109,2013,11748,10834,914,7.8
26111,2013,40777,37630,3147,7.7
26113,2013,6937,6296,641,9.2
26115,2013,74365,68874,5491,7.4
26117,2013,27452,24819,2633,9.6
26119,2013,3198,2685,513,16
26121,2013,76165,68623,7542,9.9
26123,2013,22019,20067,1952,8.9
26125,2013,628635,579614,49021,7.8
26127,2013,12719,11145,1574,12.4
26129,2013,8599,7586,1013,11.8
26131,2013,2445,2107,338,13.8
26133,2013,10015,9017,998,10
26135,2013,2959,2498,461,15.6
26137,2013,11213,10045,1168,10.4
26139,2013,144633,135820,8813,6.1
26141,2013,5459,4656,803,14.7
26143,2013,8077,6957,1120,13.9
26145,2013,88844,80811,8033,9
26147,2013,74581,65988,8593,11.5
26149,2013,28150,25963,2187,7.8
26151,2013,19369,17336,2033,10.5
26153,2013,3558,3102,456,12.8
26155,2013,33046,29948,3098,9.4
26157,2013,25033,22398,2635,10.5
26159,2013,34980,31454,3526,10.1
26161,2013,183727,173018,10709,5.8
26163,2013,776560,687300,89260,11.5
26165,2013,14622,13000,1622,11.1
27001,2013,6802,6295,507,7.5
27003,2013,188370,178904,9466,5
27005,2013,17969,16985,984,5.5
27007,2013,23024,21588,1436,6.2
27009,2013,21437,20167,1270,5.9
27011,2013,2557,2419,138,5.4
27013,2013,38620,37017,1603,4.2
27015,2013,14524,13769,755,5.2
27017,2013,17509,16462,1047,6
27019,2013,53318,51020,2298,4.3
27021,2013,13991,12842,1149,8.2
27023,2013,6945,6588,357,5.1
27025,2013,28523,26932,1591,5.6
27027,2013,34830,33337,1493,4.3
27029,2013,4474,3998,476,10.6
27031,2013,3055,2878,177,5.8
27033,2013,5756,5422,334,5.8
27035,2013,31432,29255,2177,6.9
27037,2013,229724,219309,10415,4.5
27039,2013,11330,10794,536,4.7
27041,2013,19873,18991,882,4.4
27043,2013,7494,7090,404,5.4
27045,2013,11107,10549,558,5
27047,2013,16459,15640,819,5
27049,2013,26821,25565,1256,4.7
27051,2013,3282,3094,188,5.7
27053,2013,666831,636298,30533,4.6
27055,2013,10478,9953,525,5
27057,2013,9534,8846,688,7.2
27059,2013,20202,18989,1213,6
27061,2013,21916,20238,1678,7.7
27063,2013,6229,5971,258,4.1
27065,2013,8793,8077,716,8.1
27067,2013,23472,22357,1115,4.8
27069,2013,2419,2274,145,6
27071,2013,6725,6168,557,8.3
27073,2013,3667,3462,205,5.6
27075,2013,5775,5417,358,6.2
27077,2013,2374,2240,134,5.6
27079,2013,15497,14553,944,6.1
27081,2013,3311,3158,153,4.6
27083,2013,15280,14649,631,4.1
27085,2013,20019,18899,1120,5.6
27087,2013,2397,2259,138,5.8
27089,2013,5567,5142,425,7.6
27091,2013,10335,9791,544,5.3
27093,2013,12741,12036,705,5.5
27095,2013,12678,11727,951,7.5
27097,2013,17677,16486,1191,6.7
27099,2013,20474,19557,917,4.5
27101,2013,4837,4579,258,5.3
27103,2013,19715,18978,737,3.7
27105,2013,11061,10615,446,4
27107,2013,3312,3122,190,5.7
27109,2013,83374,80035,3339,4
27111,2013,30867,29246,1621,5.3
27113,2013,8656,8109,547,6.3
27115,2013,14831,13805,1026,6.9
27117,2013,4689,4473,216,4.6
27119,2013,17100,16180,920,5.4
27121,2013,5964,5710,254,4.3
27123,2013,275220,261715,13505,4.9
27125,2013,2255,2103,152,6.7
27127,2013,8051,7610,441,5.5
27129,2013,8238,7702,536,6.5
27131,2013,34992,33260,1732,4.9
27133,2013,5626,5446,180,3.2
27135,2013,8614,8235,379,4.4
27137,2013,102216,96029,6187,6.1
27139,2013,76971,73598,3373,4.4
27141,2013,48786,46184,2602,5.3
27143,2013,8320,7863,457,5.5
27145,2013,86690,82446,4244,4.9
27147,2013,21395,20419,976,4.6
27149,2013,5510,5303,207,3.8
27151,2013,4894,4609,285,5.8
27153,2013,12851,12166,685,5.3
27155,2013,1660,1576,84,5.1
27157,2013,11829,11284,545,4.6
27159,2013,6166,5735,431,7
27161,2013,9926,9380,546,5.5
27163,2013,134883,128912,5971,4.4
27165,2013,6179,5853,326,5.3
27167,2013,3625,3474,151,4.2
27169,2013,29580,28287,1293,4.4
27171,2013,70559,66999,3560,5
27173,2013,5541,5269,272,4.9
28001,2013,11835,10732,1103,9.3
28003,2013,15378,14183,1195,7.8
28005,2013,4549,4134,415,9.1
28007,2013,7251,6572,679,9.4
28009,2013,3136,2808,328,10.5
28011,2013,13795,12321,1474,10.7
28013,2013,6403,5865,538,8.4
28015,2013,3473,3106,367,10.6
28017,2013,7609,6797,812,10.7
28019,2013,3746,3427,319,8.5
28021,2013,3299,2739,560,17
28023,2013,6657,5993,664,10
28025,2013,8387,7094,1293,15.4
28027,2013,9813,8548,1265,12.9
28029,2013,11475,10269,1206,10.5
28031,2013,7955,7329,626,7.9
28033,2013,81100,76308,4792,5.9
28035,2013,33102,30310,2792,8.4
28037,2013,2953,2681,272,9.2
28039,2013,8564,7757,807,9.4
28041,2013,4435,3984,451,10.2
28043,2013,9334,8510,824,8.8
28045,2013,18932,17446,1486,7.8
28047,2013,86617,80121,6496,7.5
28049,2013,110759,101375,9384,8.5
28051,2013,6301,5247,1054,16.7
28053,2013,3053,2529,524,17.2
28055,2013,446,355,91,20.4
28057,2013,10027,9223,804,8
28059,2013,60944,55537,5407,8.9
28061,2013,6514,5867,647,9.9
28063,2013,2480,2003,477,19.2
28065,2013,4218,3686,532,12.6
28067,2013,27346,25417,1929,7.1
28069,2013,3956,3447,509,12.9
28071,2013,23038,21391,1647,7.1
28073,2013,27531,25904,1627,5.9
28075,2013,34590,31701,2889,8.4
28077,2013,4717,4281,436,9.2
28079,2013,8108,7415,693,8.5
28081,2013,39557,36395,3162,8
28083,2013,10738,9207,1531,14.3
28085,2013,13920,12848,1072,7.7
28087,2013,26976,24470,2506,9.3
28089,2013,49764,46853,2911,5.8
28091,2013,9936,9000,936,9.4
28093,2013,14805,13303,1502,10.1
28095,2013,15505,13681,1824,11.8
28097,2013,4375,3881,494,11.3
28099,2013,10958,10105,853,7.8
28101,2013,8981,8311,670,7.5
28103,2013,4087,3540,547,13.4
28105,2013,22213,20446,1767,8
28107,2013,13674,12047,1627,11.9
28109,2013,22827,21135,1692,7.4
28111,2013,4249,3807,442,10.4
28113,2013,14642,13206,1436,9.8
28115,2013,13672,12659,1013,7.4
28117,2013,10947,10023,924,8.4
28119,2013,2858,2434,424,14.8
28121,2013,71226,67505,3721,5.2
28123,2013,12742,11900,842,6.6
28125,2013,1844,1604,240,13
28127,2013,10948,10137,811,7.4
28129,2013,6839,6380,459,6.7
28131,2013,6461,5846,615,9.5
28133,2013,8994,7744,1250,13.9
28135,2013,5809,5163,646,11.1
28137,2013,11969,10902,1067,8.9
28139,2013,8735,7879,856,9.8
28141,2013,7695,6985,710,9.2
28143,2013,4791,4196,595,12.4
28145,2013,13076,12149,927,7.1
28147,2013,5295,4730,565,10.7
28149,2013,21636,19688,1948,9
28151,2013,19117,16343,2774,14.5
28153,2013,7893,7049,844,10.7
28155,2013,4070,3682,388,9.5
28157,2013,2983,2613,370,12.4
28159,2013,7388,6575,813,11
28161,2013,5024,4523,501,10
28163,2013,9442,8404,1038,11
29001,2013,10778,10038,740,6.9
29003,2013,9896,9366,530,5.4
29005,2013,2880,2712,168,5.8
29007,2013,11236,10525,711,6.3
29009,2013,14905,13888,1017,6.8
29011,2013,5490,5096,394,7.2
29013,2013,8001,7390,611,7.6
29015,2013,7256,6640,616,8.5
29017,2013,5753,5345,408,7.1
29019,2013,97547,93154,4393,4.5
29021,2013,46590,43698,2892,6.2
29023,2013,18709,17237,1472,7.9
29025,2013,4348,4057,291,6.7
29027,2013,21630,20329,1301,6
29029,2013,18806,17070,1736,9.2
29031,2013,40913,38559,2354,5.8
29033,2013,4678,4336,342,7.3
29035,2013,2548,2304,244,9.6
29037,2013,52287,48993,3294,6.3
29039,2013,5879,5465,414,7
29041,2013,3740,3506,234,6.3
29043,2013,41036,38796,2240,5.5
29045,2013,3361,3094,267,7.9
29047,2013,126817,119105,7712,6.1
29049,2013,10753,10041,712,6.6
29051,2013,39752,37668,2084,5.2
29053,2013,7692,7158,534,6.9
29055,2013,10900,9968,932,8.6
29057,2013,3450,3215,235,6.8
29059,2013,6960,6359,601,8.6
29061,2013,4074,3820,254,6.2
29063,2013,5041,4738,303,6
29065,2013,6255,5783,472,7.5
29067,2013,5072,4596,476,9.4
29069,2013,13008,11718,1290,9.9
29071,2013,51642,47925,3717,7.2
29073,2013,7541,7064,477,6.3
29075,2013,3598,3409,189,5.3
29077,2013,144536,136572,7964,5.5
29079,2013,4922,4634,288,5.9
29081,2013,3966,3676,290,7.3
29083,2013,9867,9162,705,7.1
29085,2013,3689,3322,367,9.9
29087,2013,2742,2595,147,5.4
29089,2013,4927,4609,318,6.5
29091,2013,16415,15131,1284,7.8
29093,2013,3932,3514,418,10.6
29095,2013,353084,326123,26961,7.6
29097,2013,57982,54596,3386,5.8
29099,2013,114854,107043,7811,6.8
29101,2013,22943,21282,1661,7.2
29103,2013,1984,1875,109,5.5
29105,2013,15595,14099,1496,9.6
29107,2013,16918,15831,1087,6.4
29109,2013,17426,16276,1150,6.6
29111,2013,5081,4799,282,5.6
29113,2013,26314,24321,1993,7.6
29115,2013,5317,4849,468,8.8
29117,2013,7269,6859,410,5.6
29119,2013,9980,9338,642,6.4
29121,2013,7426,6941,485,6.5
29123,2013,5564,5139,425,7.6
29125,2013,4179,3903,276,6.6
29127,2013,14636,13756,880,6
29129,2013,1810,1711,99,5.5
29131,2013,11497,10492,1005,8.7
29133,2013,6303,5811,492,7.8
29135,2013,7318,6853,465,6.4
29137,2013,4111,3810,301,7.3
29139,2013,5720,5308,412,7.2
29141,2013,7850,7108,742,9.5
29143,2013,8286,7638,648,7.8
29145,2013,28942,27198,1744,6
29147,2013,11357,10614,743,6.5
29149,2013,4137,3808,329,8
29151,2013,7207,6848,359,5
29153,2013,3677,3297,380,10.3
29155,2013,7102,6368,734,10.3
29157,2013,10138,9587,551,5.4
29159,2013,20082,18763,1319,6.6
29161,2013,19353,17995,1358,7
29163,2013,8097,7570,527,6.5
29165,2013,52743,49755,2988,5.7
29167,2013,13918,12927,991,7.1
29169,2013,15626,14387,1239,7.9
29171,2013,2450,2305,145,5.9
29173,2013,5605,5280,325,5.8
29175,2013,10533,9672,861,8.2
29177,2013,11131,10271,860,7.7
29179,2013,2522,2284,238,9.4
29181,2013,5554,5040,514,9.3
29183,2013,207053,196045,11008,5.3
29185,2013,3918,3614,304,7.8
29186,2013,9020,8370,650,7.2
29187,2013,26293,24046,2247,8.5
29189,2013,524367,491621,32746,6.2
29195,2013,11092,10428,664,6
29197,2013,1902,1753,149,7.8
29199,2013,2375,2248,127,5.3
29201,2013,19825,18412,1413,7.1
29203,2013,3368,3047,321,9.5
29205,2013,3062,2891,171,5.6
29207,2013,13229,12060,1169,8.8
29209,2013,13598,12169,1429,10.5
29211,2013,2716,2540,176,6.5
29213,2013,25840,23086,2754,10.7
29215,2013,9707,8912,795,8.2
29217,2013,9780,9202,578,5.9
29219,2013,16865,15713,1152,6.8
29221,2013,10473,9454,1019,9.7
29223,2013,5639,5174,465,8.2
29225,2013,15913,14839,1074,6.7
29227,2013,1319,1265,54,4.1
29229,2013,7599,6962,637,8.4
29510,2013,159822,146476,13346,8.4
30001,2013,4840,4612,228,4.7
30003,2013,5701,4900,801,14.1
30005,2013,2471,2319,152,6.2
30007,2013,2508,2348,160,6.4
30009,2013,5395,5154,241,4.5
30011,2013,672,651,21,3.1
30013,2013,38386,36422,1964,5.1
30015,2013,2586,2491,95,3.7
30017,2013,6632,6409,223,3.4
30019,2013,932,902,30,3.2
30021,2013,4807,4655,152,3.2
30023,2013,5209,4952,257,4.9
30025,2013,2038,1998,40,2
30027,2013,5870,5582,288,4.9
30029,2013,43843,40469,3374,7.7
30031,2013,54783,52526,2257,4.1
30033,2013,761,737,24,3.2
30035,2013,6341,5701,640,10.1
30037,2013,397,377,20,5
30039,2013,1501,1387,114,7.6
30041,2013,7938,7416,522,6.6
30043,2013,5608,5333,275,4.9
30045,2013,978,930,48,4.9
30047,2013,12370,11565,805,6.5
30049,2013,35064,33537,1527,4.4
30051,2013,991,957,34,3.4
30053,2013,8122,7068,1054,13
30055,2013,1095,1069,26,2.4
30057,2013,4161,3932,229,5.5
30059,2013,931,882,49,5.3
30061,2013,1781,1595,186,10.4
30063,2013,59395,56311,3084,5.2
30065,2013,2376,2256,120,5.1
30067,2013,8011,7502,509,6.4
30069,2013,294,280,14,4.8
30071,2013,2057,1936,121,5.9
30073,2013,2901,2758,143,4.9
30075,2013,1124,1087,37,3.3
30077,2013,2946,2782,164,5.6
30079,2013,521,497,24,4.6
30081,2013,18747,17484,1263,6.7
30083,2013,7070,6885,185,2.6
30085,2013,4921,4650,271,5.5
30087,2013,4200,3931,269,6.4
30089,2013,4739,4243,496,10.5
30091,2013,2172,2111,61,2.8
30093,2013,17176,16237,939,5.5
30095,2013,5064,4860,204,4
30097,2013,1769,1703,66,3.7
30099,2013,2953,2826,127,4.3
30101,2013,2387,2295,92,3.9
30103,2013,355,339,16,4.5
30105,2013,4244,4083,161,3.8
30107,2013,824,773,51,6.2
30109,2013,558,539,19,3.4
30111,2013,79268,75831,3437,4.3
31001,2013,16963,16346,617,3.6
31003,2013,3619,3503,116,3.2
31005,2013,221,204,17,7.7
31007,2013,437,417,20,4.6
31009,2013,272,258,14,5.1
31011,2013,3060,2960,100,3.3
31013,2013,5988,5757,231,3.9
31015,2013,1130,1090,40,3.5
31017,2013,1437,1381,56,3.9
31019,2013,27441,26553,888,3.2
31021,2013,3658,3492,166,4.5
31023,2013,4791,4629,162,3.4
31025,2013,13321,12743,578,4.3
31027,2013,4733,4593,140,3
31029,2013,2406,2349,57,2.4
31031,2013,3490,3394,96,2.8
31033,2013,5819,5655,164,2.8
31035,2013,3503,3383,120,3.4
31037,2013,5626,5428,198,3.5
31039,2013,4961,4811,150,3
31041,2013,6162,5991,171,2.8
31043,2013,11215,10688,527,4.7
31045,2013,5429,5234,195,3.6
31047,2013,13275,12769,506,3.8
31049,2013,1134,1096,38,3.4
31051,2013,3123,3006,117,3.7
31053,2013,19259,18449,810,4.2
31055,2013,286568,274688,11880,4.1
31057,2013,1304,1268,36,2.8
31059,2013,3306,3207,99,3
31061,2013,1600,1544,56,3.5
31063,2013,1598,1544,54,3.4
31065,2013,2732,2636,96,3.5
31067,2013,11128,10617,511,4.6
31069,2013,1237,1202,35,2.8
31071,2013,1231,1193,38,3.1
31073,2013,1166,1126,40,3.4
31075,2013,420,406,14,3.3
31077,2013,1302,1256,46,3.5
31079,2013,32586,31376,1210,3.7
31081,2013,4853,4698,155,3.2
31083,2013,1863,1805,58,3.1
31085,2013,648,626,22,3.4
31087,2013,1363,1308,55,4
31089,2013,6014,5825,189,3.1
31091,2013,436,415,21,4.8
31093,2013,3425,3299,126,3.7
31095,2013,4346,4185,161,3.7
31097,2013,2186,2091,95,4.3
31099,2013,3905,3795,110,2.8
31101,2013,4713,4543,170,3.6
31103,2013,611,591,20,3.3
31105,2013,2199,2126,73,3.3
31107,2013,4808,4638,170,3.5
31109,2013,168939,163096,5843,3.5
31111,2013,19247,18518,729,3.8
31113,2013,503,487,16,3.2
31115,2013,378,361,17,4.5
31117,2013,372,358,14,3.8
31119,2013,19357,18681,676,3.5
31121,2013,4210,4054,156,3.7
31123,2013,2756,2667,89,3.2
31125,2013,2079,2012,67,3.2
31127,2013,3824,3633,191,5
31129,2013,2458,2379,79,3.2
31131,2013,8438,8078,360,4.3
31133,2013,1685,1632,53,3.1
31135,2013,1823,1776,47,2.6
31137,2013,5093,4942,151,3
31139,2013,4223,4082,141,3.3
31141,2013,17752,17136,616,3.5
31143,2013,3001,2899,102,3.4
31145,2013,6439,6249,190,3
31147,2013,4365,4170,195,4.5
31149,2013,887,859,28,3.2
31151,2013,7400,7085,315,4.3
31153,2013,89279,86071,3208,3.6
31155,2013,11178,10727,451,4
31157,2013,19161,18356,805,4.2
31159,2013,9023,8690,333,3.7
31161,2013,2801,2710,91,3.2
31163,2013,1740,1682,58,3.3
31165,2013,806,779,27,3.3
31167,2013,3693,3570,123,3.3
31169,2013,3058,2973,85,2.8
31171,2013,455,437,18,4
31173,2013,3105,2867,238,7.7
31175,2013,2143,2072,71,3.3
31177,2013,11140,10731,409,3.7
31179,2013,5689,5509,180,3.2
31181,2013,1748,1680,68,3.9
31183,2013,525,508,17,3.2
31185,2013,7507,7237,270,3.6
32001,2013,11223,10187,1036,9.2
32003,2013,1004304,906943,97361,9.7
32005,2013,22757,20550,2207,9.7
32007,2013,28863,27076,1787,6.2
32009,2013,543,517,26,4.8
32011,2013,1094,1027,67,6.1
32013,2013,9360,8778,582,6.2
32015,2013,3551,3293,258,7.3
32017,2013,2046,1852,194,9.5
32019,2013,22801,19944,2857,12.5
32021,2013,1817,1586,231,12.7
32023,2013,16527,14537,1990,12
32027,2013,2685,2450,235,8.8
32029,2013,1894,1674,220,11.6
32031,2013,221367,200386,20981,9.5
32033,2013,4942,4583,359,7.3
32510,2013,25386,22741,2645,10.4
33001,2013,31992,30389,1603,5
33003,2013,24429,23228,1201,4.9
33005,2013,41945,39958,1987,4.7
33007,2013,15929,14960,969,6.1
33009,2013,48366,46322,2044,4.2
33011,2013,227769,215532,12237,5.4
33013,2013,80880,77141,3739,4.6
33015,2013,175733,166177,9556,5.4
33017,2013,70150,66728,3422,4.9
33019,2013,24092,23100,992,4.1
34001,2013,137707,121628,16079,11.7
34003,2013,481398,449009,32389,6.7
34005,2013,232955,215038,17917,7.7
34007,2013,258070,233809,24261,9.4
34009,2013,49389,42349,7040,14.3
34011,2013,69744,61557,8187,11.7
34013,2013,379967,343127,36840,9.7
34015,2013,150305,136764,13541,9
34017,2013,359472,331172,28300,7.9
34019,2013,66590,62694,3896,5.9
34021,2013,193914,179786,14128,7.3
34023,2013,432083,399517,32566,7.5
34025,2013,328758,304017,24741,7.5
34027,2013,265032,248681,16351,6.2
34029,2013,266927,242170,24757,9.3
34031,2013,250983,225959,25024,10
34033,2013,31832,28513,3319,10.4
34035,2013,174719,163627,11092,6.3
34037,2013,79412,73105,6307,7.9
34039,2013,281378,257806,23572,8.4
34041,2013,57922,53498,4424,7.6
35001,2013,319638,298965,20673,6.5
35003,2013,1240,1130,110,8.9
35005,2013,26633,24960,1673,6.3
35006,2013,9105,8330,775,8.5
35007,2013,6173,5735,438,7.1
35009,2013,21427,20330,1097,5.1
35011,2013,809,772,37,4.6
35013,2013,93721,86715,7006,7.5
35015,2013,27668,26399,1269,4.6
35017,2013,12842,11973,869,6.8
35019,2013,1632,1490,142,8.7
35021,2013,284,269,15,5.3
35023,2013,2174,2010,164,7.5
35025,2013,29310,27998,1312,4.5
35027,2013,8804,8237,567,6.4
35028,2013,8621,8257,364,4.2
35029,2013,11300,9151,2149,19
35031,2013,24305,21847,2458,10.1
35033,2013,2254,1991,263,11.7
35035,2013,25244,23635,1609,6.4
35037,2013,3305,3065,240,7.3
35039,2013,16644,15053,1591,9.6
35041,2013,8342,7877,465,5.6
35043,2013,60574,56064,4510,7.4
35045,2013,54546,50846,3700,6.8
35047,2013,11093,10166,927,8.4
35049,2013,73219,69131,4088,5.6
35051,2013,3989,3600,389,9.8
35053,2013,6612,6124,488,7.4
35055,2013,15047,13493,1554,10.3
35057,2013,5597,5025,572,10.2
35059,2013,1865,1779,86,4.6
35061,2013,29884,27388,2496,8.4
36001,2013,160805,151059,9746,6.1
36003,2013,23799,22014,1785,7.5
36005,2013,603461,532428,71033,11.8
36007,2013,91934,84779,7155,7.8
36009,2013,38100,34851,3249,8.5
36011,2013,38854,35989,2865,7.4
36013,2013,60218,55387,4831,8
36015,2013,39609,36479,3130,7.9
36017,2013,24097,22335,1762,7.3
36019,2013,37176,34085,3091,8.3
36021,2013,31847,29936,1911,6
36023,2013,24308,22426,1882,7.7
36025,2013,21050,19394,1656,7.9
36027,2013,145589,135882,9707,6.7
36029,2013,460260,426138,34122,7.4
36031,2013,18113,16615,1498,8.3
36033,2013,21544,19640,1904,8.8
36035,2013,24736,22393,2343,9.5
36037,2013,30534,28447,2087,6.8
36039,2013,21353,19483,1870,8.8
36041,2013,2430,2198,232,9.5
36043,2013,30004,27656,2348,7.8
36045,2013,48330,43868,4462,9.2
36047,2013,1212011,1098648,113363,9.4
36049,2013,12245,11087,1158,9.5
36051,2013,31880,29640,2240,7
36053,2013,34421,31803,2618,7.6
36055,2013,374652,348519,26133,7
36057,2013,23179,21049,2130,9.2
36059,2013,697079,655888,41191,5.9
36061,2013,904861,836910,67951,7.5
36063,2013,105051,96158,8893,8.5
36065,2013,107247,99277,7970,7.4
36067,2013,231715,215866,15849,6.8
36069,2013,55910,52396,3514,6.3
36071,2013,178952,166724,12228,6.8
36073,2013,18710,17009,1701,9.1
36075,2013,57217,51569,5648,9.9
36077,2013,31133,29012,2121,6.8
36079,2013,51371,48251,3120,6.1
36081,2013,1143134,1054708,88426,7.7
36083,2013,83498,77929,5569,6.7
36085,2013,221068,201233,19835,9
36087,2013,150777,141334,9443,6.3
36089,2013,48498,44069,4429,9.1
36091,2013,118109,111244,6865,5.8
36093,2013,78057,72831,5226,6.7
36095,2013,15298,14057,1241,8.1
36097,2013,8880,8099,781,8.8
36099,2013,15922,14817,1105,6.9
36101,2013,45687,41830,3857,8.4
36103,2013,781627,730042,51585,6.6
36105,2013,34588,31778,2810,8.1
36107,2013,24972,23194,1778,7.1
36109,2013,55924,53012,2912,5.2
36111,2013,90350,83899,6451,7.1
36113,2013,33147,30437,2710,8.2
36115,2013,29415,27222,2193,7.5
36117,2013,45964,42482,3482,7.6
36119,2013,477670,447795,29875,6.3
36121,2013,18818,17327,1491,7.9
36123,2013,11977,11158,819,6.8
37001,2013,77241,71636,5605,7.3
37003,2013,17479,16120,1359,7.8
37005,2013,4418,4030,388,8.8
37007,2013,10919,9886,1033,9.5
37009,2013,12855,11676,1179,9.2
37011,2013,7684,7000,684,8.9
37013,2013,20457,18514,1943,9.5
37015,2013,8460,7608,852,10.1
37017,2013,14348,12692,1656,11.5
37019,2013,47687,43022,4665,9.8
37021,2013,127657,120025,7632,6
37023,2013,40101,36781,3320,8.3
37025,2013,92218,85209,7009,7.6
37027,2013,36369,32887,3482,9.6
37029,2013,4522,4200,322,7.1
37031,2013,31178,28746,2432,7.8
37033,2013,9858,8971,887,9
37035,2013,76000,69551,6449,8.5
37037,2013,31556,29575,1981,6.3
37039,2013,11264,10226,1038,9.2
37041,2013,5721,5158,563,9.8
37043,2013,4054,3699,355,8.8
37045,2013,46531,42113,4418,9.5
37047,2013,24084,21604,2480,10.3
37049,2013,41467,37866,3601,8.7
37051,2013,130858,118196,12662,9.7
37053,2013,12601,11611,990,7.9
37055,2013,20509,18245,2264,11
37057,2013,79304,72799,6505,8.2
37059,2013,19961,18464,1497,7.5
37061,2013,26448,24336,2112,8
37063,2013,150359,140933,9426,6.3
37065,2013,23959,20849,3110,13
37067,2013,177448,164068,13380,7.5
37069,2013,28238,25905,2333,8.3
37071,2013,100807,91777,9030,9
37073,2013,5255,4889,366,7
37075,2013,3516,2980,536,15.2
37077,2013,28335,26396,1939,6.8
37079,2013,9411,8669,742,7.9
37081,2013,255228,234235,20993,8.2
37083,2013,21762,19195,2567,11.8
37085,2013,49676,45085,4591,9.2
37087,2013,27582,25428,2154,7.8
37089,2013,49054,46007,3047,6.2
37091,2013,9503,8610,893,9.4
37093,2013,19761,17808,1953,9.9
37095,2013,2161,1911,250,11.6
37097,2013,79420,72776,6644,8.4
37099,2013,18421,16804,1617,8.8
37101,2013,84436,78453,5983,7.1
37103,2013,4539,4157,382,8.4
37105,2013,26079,23433,2646,10.1
37107,2013,28502,26023,2479,8.7
37109,2013,39874,36584,3290,8.3
37111,2013,20426,18593,1833,9
37113,2013,15200,13812,1388,9.1
37115,2013,9486,8710,776,8.2
37117,2013,10106,9049,1057,10.5
37119,2013,537143,496753,40390,7.5
37121,2013,6668,5935,733,11
37123,2013,11679,10711,968,8.3
37125,2013,37899,34956,2943,7.8
37127,2013,45333,40644,4689,10.3
37129,2013,109520,101245,8275,7.6
37131,2013,8159,7344,815,10
37133,2013,64041,59535,4506,7
37135,2013,72648,68785,3863,5.3
37137,2013,5330,4883,447,8.4
37139,2013,17676,15973,1703,9.6
37141,2013,25025,22765,2260,9
37143,2013,5223,4722,501,9.6
37145,2013,18290,16445,1845,10.1
37147,2013,87887,80794,7093,8.1
37149,2013,8666,8091,575,6.6
37151,2013,67952,62081,5871,8.6
37153,2013,17436,15386,2050,11.8
37155,2013,52119,45939,6180,11.9
37157,2013,42156,38076,4080,9.7
37159,2013,62823,56994,5829,9.3
37161,2013,25935,23039,2896,11.2
37163,2013,29661,27265,2396,8.1
37165,2013,12250,10404,1846,15.1
37167,2013,28855,26498,2357,8.2
37169,2013,22180,20437,1743,7.9
37171,2013,33280,30507,2773,8.3
37173,2013,6598,5782,816,12.4
37175,2013,13397,12405,992,7.4
37177,2013,1562,1360,202,12.9
37179,2013,105688,98763,6925,6.6
37181,2013,18128,16045,2083,11.5
37183,2013,511268,480573,30695,6
37185,2013,7301,6501,800,11
37187,2013,5300,4640,660,12.5
37189,2013,26955,25233,1722,6.4
37191,2013,54777,50520,4257,7.8
37193,2013,29954,27278,2676,8.9
37195,2013,38146,33663,4483,11.8
37197,2013,17877,16497,1380,7.7
37199,2013,7807,7064,743,9.5
38001,2013,1111,1083,28,2.5
38003,2013,5713,5530,183,3.2
38005,2013,2549,2355,194,7.6
38007,2013,475,461,14,2.9
38009,2013,3260,3134,126,3.9
38011,2013,1999,1959,40,2
38013,2013,1388,1358,30,2.2
38015,2013,47344,46166,1178,2.5
38017,2013,91442,88921,2521,2.8
38019,2013,2077,2008,69,3.3
38021,2013,2661,2599,62,2.3
38023,2013,1774,1749,25,1.4
38025,2013,4107,4049,58,1.4
38027,2013,1271,1195,76,6
38029,2013,1591,1506,85,5.3
38031,2013,1634,1578,56,3.4
38033,2013,973,951,22,2.3
38035,2013,37216,36083,1133,3
38037,2013,1275,1238,37,2.9
38039,2013,1202,1174,28,2.3
38041,2013,1479,1440,39,2.6
38043,2013,1256,1197,59,4.7
38045,2013,2238,2187,51,2.3
38047,2013,918,890,28,3.1
38049,2013,3292,3155,137,4.2
38051,2013,1251,1213,38,3
38053,2013,7561,7448,113,1.5
38055,2013,4825,4622,203,4.2
38057,2013,4170,3978,192,4.6
38059,2013,15781,15258,523,3.3
38061,2013,8007,7884,123,1.5
38063,2013,1555,1488,67,4.3
38065,2013,891,837,54,6.1
38067,2013,3627,3407,220,6.1
38069,2013,1830,1753,77,4.2
38071,2013,5753,5536,217,3.8
38073,2013,2768,2688,80,2.9
38075,2013,1403,1369,34,2.4
38077,2013,8580,8291,289,3.4
38079,2013,4896,4291,605,12.4
38081,2013,2140,2086,54,2.5
38083,2013,718,689,29,4
38085,2013,1315,1254,61,4.6
38087,2013,523,512,11,2.1
38089,2013,19479,19149,330,1.7
38091,2013,1042,1017,25,2.4
38093,2013,10503,10174,329,3.1
38095,2013,1215,1168,47,3.9
38097,2013,4502,4372,130,2.9
38099,2013,5627,5348,279,5
38101,2013,34493,33558,935,2.7
38103,2013,2215,2119,96,4.3
38105,2013,29283,28922,361,1.2
39001,2013,10693,9333,1360,12.7
39003,2013,49469,45593,3876,7.8
39005,2013,25526,23459,2067,8.1
39007,2013,46023,41653,4370,9.5
39009,2013,27507,25027,2480,9
39011,2013,23963,22547,1416,5.9
39013,2013,31961,29328,2633,8.2
39015,2013,20086,18043,2043,10.2
39017,2013,186298,172339,13959,7.5
39019,2013,13701,12618,1083,7.9
39021,2013,20016,18632,1384,6.9
39023,2013,65934,60980,4954,7.5
39025,2013,102499,94956,7543,7.4
39027,2013,17092,15306,1786,10.4
39029,2013,50566,46402,4164,8.2
39031,2013,16354,14756,1598,9.8
39033,2013,19717,17910,1807,9.2
39035,2013,621938,578643,43295,7
39037,2013,26400,24550,1850,7
39039,2013,18938,17518,1420,7.5
39041,2013,98089,92856,5233,5.3
39043,2013,38552,35423,3129,8.1
39045,2013,74047,69122,4925,6.7
39047,2013,14379,13276,1103,7.7
39049,2013,638834,597678,41156,6.4
39051,2013,22451,20669,1782,7.9
39053,2013,12514,11301,1213,9.7
39055,2013,49259,46455,2804,5.7
39057,2013,79411,73867,5544,7
39059,2013,18546,16937,1609,8.7
39061,2013,402433,373075,29358,7.3
39063,2013,40198,37697,2501,6.2
39065,2013,14935,13783,1152,7.7
39067,2013,7290,6712,578,7.9
39069,2013,14026,12787,1239,8.8
39071,2013,17509,15674,1835,10.5
39073,2013,13199,12129,1070,8.1
39075,2013,20046,19000,1046,5.2
39077,2013,28662,25729,2933,10.2
39079,2013,13604,12173,1431,10.5
39081,2013,30601,27268,3333,10.9
39083,2013,30388,28293,2095,6.9
39085,2013,125690,117860,7830,6.2
39087,2013,26127,23831,2296,8.8
39089,2013,86490,80506,5984,6.9
39091,2013,23045,21468,1577,6.8
39093,2013,151036,139963,11073,7.3
39095,2013,210736,192447,18289,8.7
39097,2013,20234,18968,1266,6.3
39099,2013,109548,100196,9352,8.5
39101,2013,28132,25909,2223,7.9
39103,2013,95022,89543,5479,5.8
39105,2013,9414,8297,1117,11.9
39107,2013,22395,21248,1147,5.1
39109,2013,51861,48121,3740,7.2
39111,2013,6483,5835,648,10
39113,2013,251314,230464,20850,8.3
39115,2013,6692,6017,675,10.1
39117,2013,16896,15539,1357,8
39119,2013,39959,36308,3651,9.1
39121,2013,5289,4779,510,9.6
39123,2013,21969,19837,2132,9.7
39125,2013,9021,8332,689,7.6
39127,2013,16068,14527,1541,9.6
39129,2013,25657,23782,1875,7.3
39131,2013,10768,9451,1317,12.2
39133,2013,87710,80952,6758,7.7
39135,2013,21306,19699,1607,7.5
39137,2013,18816,17684,1132,6
39139,2013,54943,50214,4729,8.6
39141,2013,33507,30593,2914,8.7
39143,2013,31562,29173,2389,7.6
39145,2013,30349,26730,3619,11.9
39147,2013,27411,25285,2126,7.8
39149,2013,23761,22169,1592,6.7
39151,2013,189051,174746,14305,7.6
39153,2013,271165,250484,20681,7.6
39155,2013,94552,85711,8841,9.4
39157,2013,45049,41768,3281,7.3
39159,2013,26626,25075,1551,5.8
39161,2013,14212,13223,989,7
39163,2013,5578,4983,595,10.7
39165,2013,109855,102770,7085,6.4
39167,2013,28367,25927,2440,8.6
39169,2013,59320,55625,3695,6.2
39171,2013,18654,17264,1390,7.5
39173,2013,69091,64239,4852,7
39175,2013,12358,11576,782,6.3
40001,2013,8268,7458,810,9.8
40003,2013,2935,2839,96,3.3
40005,2013,4913,4575,338,6.9
40007,2013,3026,2924,102,3.4
40009,2013,12591,12178,413,3.3
40011,2013,4319,4146,173,4
40013,2013,17738,16771,967,5.5
40015,2013,11382,10668,714,6.3
40017,2013,64764,62100,2664,4.1
40019,2013,22035,20864,1171,5.3
40021,2013,18732,17429,1303,7
40023,2013,5976,5468,508,8.5
40025,2013,1233,1193,40,3.2
40027,2013,137044,131186,5858,4.3
40029,2013,2253,2082,171,7.6
40031,2013,50119,47228,2891,5.8
40033,2013,2862,2701,161,5.6
40035,2013,6245,5840,405,6.5
40037,2013,31249,29367,1882,6
40039,2013,16021,15431,590,3.7
40041,2013,16990,15817,1173,6.9
40043,2013,2595,2505,90,3.5
40045,2013,2333,2260,73,3.1
40047,2013,29436,28225,1211,4.1
40049,2013,12456,11835,621,5
40051,2013,25532,24317,1215,4.8
40053,2013,2661,2572,89,3.3
40055,2013,1998,1891,107,5.4
40057,2013,1348,1290,58,4.3
40059,2013,1919,1855,64,3.3
40061,2013,4475,4064,411,9.2
40063,2013,5739,5280,459,8
40065,2013,10828,10246,582,5.4
40067,2013,2582,2446,136,5.3
40069,2013,3587,3295,292,8.1
40071,2013,19986,18607,1379,6.9
40073,2013,7786,7517,269,3.5
40075,2013,4150,3947,203,4.9
40077,2013,4145,3777,368,8.9
40079,2013,19765,18009,1756,8.9
40081,2013,15467,14672,795,5.1
40083,2013,20749,19807,942,4.5
40085,2013,5251,5022,229,4.4
40087,2013,17828,17050,778,4.4
40089,2013,14336,12992,1344,9.4
40091,2013,7397,6670,727,9.8
40093,2013,4130,3991,139,3.4
40095,2013,6956,6555,401,5.8
40097,2013,18855,17764,1091,5.8
40099,2013,6474,6149,325,5
40101,2013,29712,27790,1922,6.5
40103,2013,5474,5232,242,4.4
40105,2013,4820,4494,326,6.8
40107,2013,4423,4110,313,7.1
40109,2013,368547,350727,17820,4.8
40111,2013,16247,15017,1230,7.6
40113,2013,21114,19885,1229,5.8
40115,2013,14143,13005,1138,8
40117,2013,7389,6942,447,6
40119,2013,37539,35878,1661,4.4
40121,2013,17988,16675,1313,7.3
40123,2013,17768,16797,971,5.5
40125,2013,32121,30370,1751,5.5
40127,2013,4709,4291,418,8.9
40129,2013,1878,1818,60,3.2
40131,2013,43827,41595,2232,5.1
40133,2013,9739,8943,796,8.2
40135,2013,16866,15454,1412,8.4
40137,2013,20607,19493,1114,5.4
40139,2013,9289,8882,407,4.4
40141,2013,3369,3187,182,5.4
40143,2013,311042,295184,15858,5.1
40145,2013,35929,34108,1821,5.1
40147,2013,24628,23441,1187,4.8
40149,2013,5576,5342,234,4.2
40151,2013,5141,4974,167,3.2
40153,2013,10735,10355,380,3.5
41001,2013,6798,6142,656,9.6
41003,2013,43861,41356,2505,5.7
41005,2013,196842,182940,13902,7.1
41007,2013,17859,16470,1389,7.8
41009,2013,22297,20150,2147,9.6
41011,2013,26336,23640,2696,10.2
41013,2013,8908,7830,1078,12.1
41015,2013,8639,7722,917,10.6
41017,2013,78225,70780,7445,9.5
41019,2013,44120,39463,4657,10.6
41021,2013,849,768,81,9.5
41023,2013,3188,2794,394,12.4
41025,2013,3323,2939,384,11.6
41027,2013,13728,12859,869,6.3
41029,2013,95941,86594,9347,9.7
41031,2013,9215,8253,962,10.4
41033,2013,32200,28636,3564,11.1
41035,2013,28848,25741,3107,10.8
41037,2013,3467,3073,394,11.4
41039,2013,167538,154123,13415,8
41041,2013,20605,18792,1813,8.8
41043,2013,53526,48355,5171,9.7
41045,2013,12329,11284,1045,8.5
41047,2013,147319,134308,13011,8.8
41049,2013,5530,5105,425,7.7
41051,2013,411694,383774,27920,6.8
41053,2013,34690,31889,2801,8.1
41055,2013,864,784,80,9.3
41057,2013,10924,10010,914,8.4
41059,2013,35210,32108,3102,8.8
41061,2013,11733,10744,989,8.4
41063,2013,3222,2863,359,11.1
41065,2013,13690,12655,1035,7.6
41067,2013,287115,269048,18067,6.3
41069,2013,731,685,46,6.3
41071,2013,49342,45625,3717,7.5
42001,2013,55379,52136,3243,5.9
42003,2013,651471,608849,42622,6.5
42005,2013,33614,31036,2578,7.7
42007,2013,86547,80293,6254,7.2
42009,2013,24716,22646,2070,8.4
42011,2013,211349,196277,15072,7.1
42013,2013,61530,57240,4290,7
42015,2013,31862,29539,2323,7.3
42017,2013,337193,314955,22238,6.6
42019,2013,97878,91854,6024,6.2
42021,2013,64646,59007,5639,8.7
42023,2013,2355,2127,228,9.7
42025,2013,32223,29221,3002,9.3
42027,2013,78023,73913,4110,5.3
42029,2013,273553,259105,14448,5.3
42031,2013,18681,17167,1514,8.1
42033,2013,37794,34384,3410,9
42035,2013,19289,17545,1744,9
42037,2013,35338,32621,2717,7.7
42039,2013,41793,38773,3020,7.2
42041,2013,125785,118599,7186,5.7
42043,2013,140474,130893,9581,6.8
42045,2013,290497,270012,20485,7.1
42047,2013,16466,15342,1124,6.8
42049,2013,136005,125900,10105,7.4
42051,2013,59733,53988,5745,9.6
42053,2013,1975,1779,196,9.9
42055,2013,76621,71560,5061,6.6
42057,2013,7407,6723,684,9.2
42059,2013,18767,17413,1354,7.2
42061,2013,20339,18341,1998,9.8
42063,2013,44099,40688,3411,7.7
42065,2013,21100,19366,1734,8.2
42067,2013,12032,11175,857,7.1
42069,2013,107648,98713,8935,8.3
42071,2013,270478,254195,16283,6
42073,2013,43048,39810,3238,7.5
42075,2013,70741,66344,4397,6.2
42077,2013,183266,168918,14348,7.8
42079,2013,160771,145695,15076,9.4
42081,2013,61872,57031,4841,7.8
42083,2013,19696,18087,1609,8.2
42085,2013,53738,49855,3883,7.2
42087,2013,21390,19644,1746,8.2
42089,2013,81573,73940,7633,9.4
42091,2013,435631,410096,25535,5.9
42093,2013,9465,8947,518,5.5
42095,2013,155747,144230,11517,7.4
42097,2013,44732,40820,3912,8.7
42099,2013,24261,22674,1587,6.5
42101,2013,698341,626447,71894,10.3
42103,2013,25830,23335,2495,9.7
42105,2013,7750,7029,721,9.3
42107,2013,70247,63787,6460,9.2
42109,2013,19745,18389,1356,6.9
42111,2013,35811,32504,3307,9.2
42113,2013,3058,2805,253,8.3
42115,2013,22343,20750,1593,7.1
42117,2013,21269,19446,1823,8.6
42119,2013,19150,17936,1214,6.3
42121,2013,25271,23308,1963,7.8
42123,2013,20427,19126,1301,6.4
42125,2013,107010,99585,7425,6.9
42127,2013,22714,20928,1786,7.9
42129,2013,186380,173353,13027,7
42131,2013,14327,13092,1235,8.6
42133,2013,232152,216526,15626,6.7
44001,2013,26266,24188,2078,7.9
44003,2013,91867,83834,8033,8.7
44005,2013,44336,40570,3766,8.5
44007,2013,324619,292958,31661,9.8
44009,2013,69840,63821,6019,8.6
45001,2013,10543,9540,1003,9.5
45003,2013,72660,67173,5487,7.6
45005,2013,3092,2658,434,14
45007,2013,85793,79702,6091,7.1
45009,2013,5580,4827,753,13.5
45011,2013,8716,7660,1056,12.1
45013,2013,67239,62946,4293,6.4
45015,2013,88891,82678,6213,7
45017,2013,6930,6266,664,9.6
45019,2013,187570,176533,11037,5.9
45021,2013,23727,21241,2486,10.5
45023,2013,13675,12005,1670,12.2
45025,2013,20991,19066,1925,9.2
45027,2013,12981,11643,1338,10.3
45029,2013,16338,14716,1622,9.9
45031,2013,30085,27276,2809,9.3
45033,2013,12757,11248,1509,11.8
45035,2013,68615,64078,4537,6.6
45037,2013,10518,9671,847,8.1
45039,2013,10096,9011,1085,10.7
45041,2013,64910,59546,5364,8.3
45043,2013,24370,21897,2473,10.1
45045,2013,230748,216668,14080,6.1
45047,2013,31544,28826,2718,8.6
45049,2013,8346,7571,775,9.3
45051,2013,132824,121377,11447,8.6
45053,2013,11177,10405,772,6.9
45055,2013,27933,25752,2181,7.8
45057,2013,34303,31119,3184,9.3
45059,2013,29889,27330,2559,8.6
45061,2013,6562,5838,724,11
45063,2013,137482,129529,7953,5.8
45065,2013,3505,3161,344,9.8
45067,2013,13048,11342,1706,13.1
45069,2013,10509,9061,1448,13.8
45071,2013,17934,16632,1302,7.3
45073,2013,33189,30647,2542,7.7
45075,2013,38527,33764,4763,12.4
45077,2013,54650,50614,4036,7.4
45079,2013,190577,177504,13073,6.9
45081,2013,8569,7976,593,6.9
45083,2013,135553,125081,10472,7.7
45085,2013,44194,40331,3863,8.7
45087,2013,11730,10406,1324,11.3
45089,2013,12675,11090,1585,12.5
45091,2013,119431,110241,9190,7.7
46003,2013,1640,1596,44,2.7
46005,2013,9447,9110,337,3.6
46007,2013,1132,1060,72,6.4
46009,2013,2994,2897,97,3.2
46011,2013,17711,17107,604,3.4
46013,2013,20885,20206,679,3.3
46015,2013,2596,2507,89,3.4
46017,2013,737,672,65,8.8
46019,2013,5023,4828,195,3.9
46021,2013,840,810,30,3.6
46023,2013,3983,3810,173,4.3
46025,2013,1972,1895,77,3.9
46027,2013,7062,6802,260,3.7
46029,2013,15402,14851,551,3.6
46031,2013,1504,1400,104,6.9
46033,2013,4012,3808,204,5.1
46035,2013,11196,10847,349,3.1
46037,2013,2912,2759,153,5.3
46039,2013,2374,2241,133,5.6
46041,2013,2413,2039,374,15.5
46043,2013,1699,1645,54,3.2
46045,2013,2276,2212,64,2.8
46047,2013,3029,2877,152,5
46049,2013,1158,1120,38,3.3
46051,2013,4630,4436,194,4.2
46053,2013,2093,2011,82,3.9
46055,2013,1077,1046,31,2.9
46057,2013,3106,2999,107,3.4
46059,2013,1821,1771,50,2.7
46061,2013,1799,1724,75,4.2
46063,2013,771,749,22,2.9
46065,2013,9871,9584,287,2.9
46067,2013,3654,3535,119,3.3
46069,2013,716,692,24,3.4
46071,2013,1307,1226,81,6.2
46073,2013,1192,1155,37,3.1
46075,2013,618,596,22,3.6
46077,2013,2873,2780,93,3.2
46079,2013,6293,6050,243,3.9
46081,2013,12643,12144,499,3.9
46083,2013,28507,27734,773,2.7
46085,2013,1854,1765,89,4.8
46087,2013,3162,3060,102,3.2
46089,2013,1131,1088,43,3.8
46091,2013,2535,2423,112,4.4
46093,2013,13518,13004,514,3.8
46095,2013,831,768,63,7.6
46097,2013,1231,1186,45,3.7
46099,2013,102441,99051,3390,3.3
46101,2013,3986,3803,183,4.6
46102,2013,3664,3168,496,13.5
46103,2013,53179,51108,2071,3.9
46105,2013,1531,1474,57,3.7
46107,2013,1199,1153,46,3.8
46109,2013,4823,4572,251,5.2
46111,2013,1288,1249,39,3
46115,2013,3327,3208,119,3.6
46117,2013,1851,1800,51,2.8
46119,2013,880,854,26,3
46121,2013,3175,2864,311,9.8
46123,2013,3087,2980,107,3.5
46125,2013,4707,4564,143,3
46127,2013,7860,7533,327,4.2
46129,2013,2350,2222,128,5.4
46135,2013,11480,11096,384,3.3
46137,2013,1028,964,64,6.2
47001,2013,33670,31001,2669,7.9
47003,2013,20010,18167,1843,9.2
47005,2013,6881,6207,674,9.8
47007,2013,4336,3882,454,10.5
47009,2013,59248,55124,4124,7
47011,2013,49460,45942,3518,7.1
47013,2013,15240,13551,1689,11.1
47015,2013,5901,5435,466,7.9
47017,2013,13104,11547,1557,11.9
47019,2013,24769,22488,2281,9.2
47021,2013,19932,18615,1317,6.6
47023,2013,8264,7592,672,8.1
47025,2013,13005,11608,1397,10.7
47027,2013,3095,2762,333,10.8
47029,2013,14976,13342,1634,10.9
47031,2013,24434,22525,1909,7.8
47033,2013,7009,6369,640,9.1
47035,2013,23433,21253,2180,9.3
47037,2013,354139,333157,20982,5.9
47039,2013,5083,4542,541,10.6
47041,2013,7703,6923,780,10.1
47043,2013,23788,21958,1830,7.7
47045,2013,17060,15277,1783,10.5
47047,2013,18128,16562,1566,8.6
47049,2013,7410,6686,724,9.8
47051,2013,19598,18177,1421,7.3
47053,2013,22064,19629,2435,11
47055,2013,14056,12906,1150,8.2
47057,2013,9409,8468,941,10
47059,2013,30354,27422,2932,9.7
47061,2013,5319,4783,536,10.1
47063,2013,26957,24498,2459,9.1
47065,2013,168353,156177,12176,7.2
47067,2013,2146,1892,254,11.8
47069,2013,9780,8692,1088,11.1
47071,2013,10975,9839,1136,10.4
47073,2013,24671,22501,2170,8.8
47075,2013,8098,7142,956,11.8
47077,2013,12664,11334,1330,10.5
47079,2013,14296,12942,1354,9.5
47081,2013,10482,9613,869,8.3
47083,2013,3363,2995,368,10.9
47085,2013,8644,7882,762,8.8
47087,2013,4570,4098,472,10.3
47089,2013,23296,21183,2113,9.1
47091,2013,7329,6668,661,9
47093,2013,227126,212736,14390,6.3
47095,2013,2179,1959,220,10.1
47097,2013,10224,9028,1196,11.7
47099,2013,18101,16314,1787,9.9
47101,2013,4990,4460,530,10.6
47103,2013,15549,14577,972,6.3
47105,2013,22077,20358,1719,7.8
47107,2013,22842,20775,2067,9
47109,2013,9327,8233,1094,11.7
47111,2013,10056,9232,824,8.2
47113,2013,47496,43660,3836,8.1
47115,2013,11995,10900,1095,9.1
47117,2013,14317,13148,1169,8.2
47119,2013,40771,37872,2899,7.1
47121,2013,5030,4514,516,10.3
47123,2013,19236,17351,1885,9.8
47125,2013,77325,71473,5852,7.6
47127,2013,3323,3123,200,6
47129,2013,8051,7229,822,10.2
47131,2013,13660,12072,1588,11.6
47133,2013,9492,8636,856,9
47135,2013,3114,2821,293,9.4
47137,2013,2318,2097,221,9.5
47139,2013,7531,6837,694,9.2
47141,2013,32459,29859,2600,8
47143,2013,13350,11922,1428,10.7
47145,2013,23176,21080,2096,9
47147,2013,33566,31296,2270,6.8
47149,2013,146980,137817,9163,6.2
47151,2013,8582,7338,1244,14.5
47153,2013,5908,5399,509,8.6
47155,2013,48968,44826,4142,8.5
47157,2013,438627,399995,38632,8.8
47159,2013,8513,7848,665,7.8
47161,2013,5339,4754,585,11
47163,2013,71515,66077,5438,7.6
47165,2013,85370,80082,5288,6.2
47167,2013,27946,25294,2652,9.5
47169,2013,3649,3339,310,8.5
47171,2013,7406,6625,781,10.5
47173,2013,7413,6698,715,9.6
47175,2013,2192,1939,253,11.5
47177,2013,17518,16022,1496,8.5
47179,2013,58779,54532,4247,7.2
47181,2013,6531,5899,632,9.7
47183,2013,16516,14800,1716,10.4
47185,2013,11865,10740,1125,9.5
47187,2013,101172,95951,5221,5.2
47189,2013,61464,57587,3877,6.3
48001,2013,22042,20763,1279,5.8
48003,2013,9173,8823,350,3.8
48005,2013,37966,35509,2457,6.5
48007,2013,10069,9408,661,6.6
48009,2013,4231,4010,221,5.2
48011,2013,1006,966,40,4
48013,2013,20247,18985,1262,6.2
48015,2013,14136,13307,829,5.9
48017,2013,3048,2830,218,7.2
48019,2013,9071,8525,546,6
48021,2013,35910,33700,2210,6.2
48023,2013,1673,1584,89,5.3
48025,2013,11321,10577,744,6.6
48027,2013,135335,125981,9354,6.9
48029,2013,854655,804941,49714,5.8
48031,2013,5540,5280,260,4.7
48033,2013,417,400,17,4.1
48035,2013,8081,7558,523,6.5
48037,2013,40557,37466,3091,7.6
48039,2013,164345,154302,10043,6.1
48041,2013,102810,97768,5042,4.9
48043,2013,4155,3924,231,5.6
48045,2013,628,593,35,5.6
48047,2013,2764,2516,248,9
48049,2013,15936,14906,1030,6.5
48051,2013,7697,7222,475,6.2
48053,2013,20802,19663,1139,5.5
48055,2013,17125,16001,1124,6.6
48057,2013,10844,10172,672,6.2
48059,2013,5917,5578,339,5.7
48061,2013,167093,150439,16654,10
48063,2013,5516,5111,405,7.3
48065,2013,3178,3037,141,4.4
48067,2013,12596,11437,1159,9.2
48069,2013,3785,3607,178,4.7
48071,2013,17485,16202,1283,7.3
48073,2013,21534,20041,1493,6.9
48075,2013,2936,2811,125,4.3
48077,2013,5141,4857,284,5.5
48079,2013,1403,1310,93,6.6
48081,2013,1459,1385,74,5.1
48083,2013,3158,2920,238,7.5
48085,2013,457847,432552,25295,5.5
48087,2013,1217,1155,62,5.1
48089,2013,10102,9520,582,5.8
48091,2013,57924,54472,3452,6
48093,2013,5654,5323,331,5.9
48095,2013,1455,1397,58,4
48097,2013,20486,19463,1023,5
48099,2013,25222,23411,1811,7.2
48101,2013,624,582,42,6.7
48103,2013,2087,1994,93,4.5
48105,2013,1883,1787,96,5.1
48107,2013,2767,2603,164,5.9
48109,2013,1019,968,51,5
48111,2013,3898,3762,136,3.5
48113,2013,1234933,1153569,81364,6.6
48115,2013,5001,4681,320,6.4
48117,2013,9157,8749,408,4.5
48119,2013,2636,2469,167,6.3
48121,2013,400381,378959,21422,5.4
48123,2013,9704,9245,459,4.7
48125,2013,770,699,71,9.2
48127,2013,6783,6443,340,5
48129,2013,1988,1887,101,5.1
48131,2013,5542,5188,354,6.4
48133,2013,8530,8014,516,6
48135,2013,78750,75338,3412,4.3
48137,2013,904,851,53,5.9
48139,2013,77676,72879,4797,6.2
48141,2013,347223,319781,27442,7.9
48143,2013,19851,18780,1071,5.4
48145,2013,6779,6299,480,7.1
48147,2013,15283,14217,1066,7
48149,2013,12661,12098,563,4.4
48151,2013,1886,1784,102,5.4
48153,2013,3123,2847,276,8.8
48155,2013,578,548,30,5.2
48157,2013,333271,314975,18296,5.5
48159,2013,4690,4384,306,6.5
48161,2013,7859,7317,542,6.9
48163,2013,9288,8854,434,4.7
48165,2013,8916,8544,372,4.2
48167,2013,155754,145043,10711,6.9
48169,2013,2238,2137,101,4.5
48171,2013,12426,11879,547,4.4
48173,2013,744,717,27,3.6
48175,2013,3538,3354,184,5.2
48177,2013,9517,9030,487,5.1
48179,2013,9786,9282,504,5.2
48181,2013,60525,56735,3790,6.3
48183,2013,61556,57894,3662,5.9
48185,2013,11818,11110,708,6
48187,2013,70098,66253,3845,5.5
48189,2013,14811,12843,1968,13.3
48191,2013,1290,1199,91,7.1
48193,2013,3622,3406,216,6
48195,2013,3129,3027,102,3.3
48197,2013,1699,1600,99,5.8
48199,2013,25303,23267,2036,8
48201,2013,2199353,2066248,133105,6.1
48203,2013,32322,30108,2214,6.8
48205,2013,2932,2840,92,3.1
48207,2013,2712,2578,134,4.9
48209,2013,89904,85104,4800,5.3
48211,2013,2476,2401,75,3
48213,2013,34562,32104,2458,7.1
48215,2013,331246,296978,34268,10.3
48217,2013,15972,14946,1026,6.4
48219,2013,11924,11325,599,5
48221,2013,24016,22561,1455,6.1
48223,2013,17273,16278,995,5.8
48225,2013,9852,9238,614,6.2
48227,2013,13572,12840,732,5.4
48229,2013,1294,1204,90,7
48231,2013,38180,35340,2840,7.4
48233,2013,9776,9172,604,6.2
48235,2013,851,815,36,4.2
48237,2013,4008,3795,213,5.3
48239,2013,7442,7070,372,5
48241,2013,14521,13002,1519,10.5
48243,2013,1162,1114,48,4.1
48245,2013,111265,99171,12094,10.9
48247,2013,2326,2161,165,7.1
48249,2013,20143,18909,1234,6.1
48251,2013,73689,69180,4509,6.1
48253,2013,5849,5456,393,6.7
48255,2013,5624,5323,301,5.4
48257,2013,52451,49120,3331,6.4
48259,2013,18245,17320,925,5.1
48261,2013,297,285,12,4
48263,2013,532,511,21,3.9
48265,2013,21483,20299,1184,5.5
48267,2013,2162,2057,105,4.9
48269,2013,239,228,11,4.6
48271,2013,1218,1102,116,9.5
48273,2013,15445,14445,1000,6.5
48275,2013,1753,1659,94,5.4
48277,2013,22306,20497,1809,8.1
48279,2013,6148,5727,421,6.8
48281,2013,9130,8477,653,7.2
48283,2013,4177,4020,157,3.8
48285,2013,9230,8797,433,4.7
48287,2013,9140,8673,467,5.1
48289,2013,6965,6484,481,6.9
48291,2013,31027,28265,2762,8.9
48293,2013,9484,8845,639,6.7
48295,2013,1721,1653,68,4
48297,2013,6032,5769,263,4.4
48299,2013,8109,7588,521,6.4
48301,2013,75,71,4,5.3
48303,2013,147449,140162,7287,4.9
48305,2013,2859,2708,151,5.3
48307,2013,4272,4047,225,5.3
48309,2013,112195,105259,6936,6.2
48311,2013,882,859,23,2.6
48313,2013,4820,4508,312,6.5
48315,2013,4541,4175,366,8.1
48317,2013,2551,2443,108,4.2
48319,2013,1959,1852,107,5.5
48321,2013,16851,15215,1636,9.7
48323,2013,23667,20712,2955,12.5
48325,2013,20326,19091,1235,6.1
48327,2013,920,866,54,5.9
48329,2013,86065,82915,3150,3.7
48331,2013,10128,9334,794,7.8
48333,2013,2071,1962,109,5.3
48335,2013,2878,2719,159,5.5
48337,2013,10367,9857,510,4.9
48339,2013,246342,233018,13324,5.4
48341,2013,11440,10953,487,4.3
48343,2013,5841,5281,560,9.6
48345,2013,502,472,30,6
48347,2013,29229,27325,1904,6.5
48349,2013,23391,21863,1528,6.5
48351,2013,5606,5003,603,10.8
48353,2013,6968,6571,397,5.7
48355,2013,168310,158015,10295,6.1
48357,2013,5430,5226,204,3.8
48359,2013,961,918,43,4.5
48361,2013,37976,34026,3950,10.4
48363,2013,13386,12510,876,6.5
48365,2013,12748,11960,788,6.2
48367,2013,58687,55438,3249,5.5
48369,2013,5068,4872,196,3.9
48371,2013,6705,6343,362,5.4
48373,2013,17371,16030,1341,7.7
48375,2013,57539,54644,2895,5
48377,2013,3757,3274,483,12.9
48379,2013,5339,5011,328,6.1
48381,2013,68531,65580,2951,4.3
48383,2013,1959,1881,78,4
48385,2013,1063,978,85,8
48387,2013,5142,4625,517,10.1
48389,2013,5631,5306,325,5.8
48391,2013,3563,3371,192,5.4
48393,2013,451,431,20,4.4
48395,2013,7289,6778,511,7
48397,2013,42276,39844,2432,5.8
48399,2013,4979,4717,262,5.3
48401,2013,24311,22801,1510,6.2
48403,2013,3561,3101,460,12.9
48405,2013,2936,2595,341,11.6
48407,2013,11454,10588,866,7.6
48409,2013,30665,28462,2203,7.2
48411,2013,2273,2143,130,5.7
48413,2013,1803,1739,64,3.5
48415,2013,8566,8210,356,4.2
48417,2013,2298,2222,76,3.3
48419,2013,11631,10768,863,7.4
48421,2013,1480,1420,60,4.1
48423,2013,101647,94998,6649,6.5
48425,2013,4147,3897,250,6
48427,2013,26344,22402,3942,15
48429,2013,4207,3990,217,5.2
48431,2013,752,723,29,3.9
48433,2013,707,674,33,4.7
48435,2013,2065,1971,94,4.6
48437,2013,2964,2714,250,8.4
48439,2013,981537,922170,59367,6
48441,2013,64664,61254,3410,5.3
48443,2013,525,499,26,5
48445,2013,5533,5205,328,5.9
48447,2013,796,756,40,5
48449,2013,13079,12107,972,7.4
48451,2013,54242,51444,2798,5.2
48453,2013,629919,598189,31730,5
48455,2013,5569,5153,416,7.5
48457,2013,7602,6822,780,10.3
48459,2013,18538,17353,1185,6.4
48461,2013,1710,1640,70,4.1
48463,2013,11949,11114,835,7
48465,2013,19633,18180,1453,7.4
48467,2013,23851,22295,1556,6.5
48469,2013,45837,43393,2444,5.3
48471,2013,23123,21594,1529,6.6
48473,2013,20839,19492,1347,6.5
48475,2013,5520,5261,259,4.7
48477,2013,15728,14867,861,5.5
48479,2013,110366,103601,6765,6.1
48481,2013,21509,20226,1283,6
48483,2013,3137,3002,135,4.3
48485,2013,57339,53984,3355,5.9
48487,2013,5779,5445,334,5.8
48489,2013,7436,6263,1173,15.8
48491,2013,246626,233607,13019,5.3
48493,2013,22213,21045,1168,5.3
48495,2013,3322,3147,175,5.3
48497,2013,28410,26707,1703,6
48499,2013,16725,15507,1218,7.3
48501,2013,4214,4051,163,3.9
48503,2013,8574,8132,442,5.2
48505,2013,7064,6624,440,6.2
48507,2013,4011,3430,581,14.5
49001,2013,3021,2880,141,4.7
49003,2013,23161,22064,1097,4.7
49005,2013,57784,55494,2290,4
49007,2013,8948,8383,565,6.3
49009,2013,429,408,21,4.9
49011,2013,152577,146091,6486,4.3
49013,2013,9299,8899,400,4.3
49015,2013,4713,4426,287,6.1
49017,2013,2781,2525,256,9.2
49019,2013,5455,5033,422,7.7
49021,2013,19376,18301,1075,5.5
49023,2013,4697,4460,237,5
49025,2013,3474,3288,186,5.4
49027,2013,5902,5660,242,4.1
49029,2013,4505,4323,182,4
49031,2013,484,447,37,7.6
49033,2013,984,939,45,4.6
49035,2013,569638,544635,25003,4.4
49037,2013,5676,5224,452,8
49039,2013,11058,10436,622,5.6
49041,2013,9265,8762,503,5.4
49043,2013,22039,21124,915,4.2
49045,2013,28488,26941,1547,5.4
49047,2013,15671,14989,682,4.4
49049,2013,248743,238194,10549,4.2
49051,2013,12196,11627,569,4.7
49053,2013,59344,56072,3272,5.5
49055,2013,1378,1228,150,10.9
49057,2013,114544,108338,6206,5.4
50001,2013,20786,19928,858,4.1
50003,2013,19275,18271,1004,5.2
50005,2013,15757,14921,836,5.3
50007,2013,95084,91824,3260,3.4
50009,2013,2841,2649,192,6.8
50011,2013,27490,26340,1150,4.2
50013,2013,4054,3872,182,4.5
50015,2013,13883,13094,789,5.7
50017,2013,16176,15512,664,4.1
50019,2013,13824,12881,943,6.8
50021,2013,32280,30562,1718,5.3
50023,2013,34583,33092,1491,4.3
50025,2013,24092,22966,1126,4.7
50027,2013,30322,29054,1268,4.2
51001,2013,16230,15058,1172,7.2
51003,2013,52528,49982,2546,4.8
51005,2013,7516,7020,496,6.6
51007,2013,6172,5806,366,5.9
51009,2013,15798,14830,968,6.1
51011,2013,7158,6696,462,6.5
51013,2013,145047,140035,5012,3.5
51015,2013,36891,34964,1927,5.2
51017,2013,2577,2441,136,5.3
51019,2013,38232,36052,2180,5.7
51021,2013,2877,2682,195,6.8
51023,2013,17629,16703,926,5.3
51025,2013,6659,6035,624,9.4
51027,2013,8169,7269,900,11
51029,2013,6408,5900,508,7.9
51031,2013,26938,25332,1606,6
51033,2013,14580,13550,1030,7.1
51035,2013,13264,12164,1100,8.3
51036,2013,3789,3532,257,6.8
51037,2013,5314,4900,414,7.8
51041,2013,174669,164793,9876,5.7
51043,2013,7623,7261,362,4.7
51045,2013,2456,2283,173,7
51047,2013,23378,22123,1255,5.4
51049,2013,4508,4208,300,6.7
51051,2013,5347,4750,597,11.2
51053,2013,13541,12544,997,7.4
51057,2013,5685,5307,378,6.6
51059,2013,624266,596686,27580,4.4
51061,2013,35911,34139,1772,4.9
51063,2013,8387,7933,454,5.4
51065,2013,13031,12409,622,4.8
51067,2013,27210,25604,1606,5.9
51069,2013,44138,41800,2338,5.3
51071,2013,8217,7643,574,7
51073,2013,19318,18312,1006,5.2
51075,2013,10371,9837,534,5.1
51077,2013,7011,6334,677,9.7
51079,2013,9685,9218,467,4.8
51081,2013,4355,4018,337,7.7
51083,2013,15859,14409,1450,9.1
51085,2013,55404,52602,2802,5.1
51087,2013,174077,164368,9709,5.6
51089,2013,23405,21274,2131,9.1
51091,2013,1419,1358,61,4.3
51093,2013,18857,17773,1084,5.7
51095,2013,33696,31896,1800,5.3
51097,2013,3638,3416,222,6.1
51099,2013,11975,11281,694,5.8
51101,2013,8699,8208,491,5.6
51103,2013,5401,4995,406,7.5
51105,2013,9305,8488,817,8.8
51107,2013,191048,182680,8368,4.4
51109,2013,18051,17027,1024,5.7
51111,2013,5326,4950,376,7.1
51113,2013,7224,6902,322,4.5
51115,2013,4163,3952,211,5.1
51117,2013,12780,11588,1192,9.3
51119,2013,5113,4830,283,5.5
51121,2013,49663,46856,2807,5.7
51125,2013,7358,6952,406,5.5
51127,2013,10783,10239,544,5
51131,2013,6035,5485,550,9.1
51133,2013,5690,5269,421,7.4
51135,2013,7072,6645,427,6
51137,2013,16114,15161,953,5.9
51139,2013,11944,10841,1103,9.2
51141,2013,7802,7154,648,8.3
51143,2013,30444,28299,2145,7
51145,2013,13561,12871,690,5.1
51147,2013,9990,9151,839,8.4
51149,2013,14741,13709,1032,7
51153,2013,231105,219058,12047,5.2
51155,2013,16858,15578,1280,7.6
51157,2013,3916,3715,201,5.1
51159,2013,3939,3695,244,6.2
51161,2013,49826,47327,2499,5
51163,2013,10416,9811,605,5.8
51165,2013,40622,38560,2062,5.1
51167,2013,11603,10619,984,8.5
51169,2013,10003,9305,698,7
51171,2013,20940,19764,1176,5.6
51173,2013,13405,12189,1216,9.1
51175,2013,9241,8724,517,5.6
51177,2013,64155,60426,3729,5.8
51179,2013,66087,62345,3742,5.7
51181,2013,3633,3368,265,7.3
51183,2013,4185,3797,388,9.3
51185,2013,17673,16146,1527,8.6
51187,2013,20087,18854,1233,6.1
51191,2013,27839,26066,1773,6.4
51193,2013,9100,8475,625,6.9
51195,2013,15100,13538,1562,10.3
51197,2013,14001,12909,1092,7.8
51199,2013,31835,30123,1712,5.4
51510,2013,93676,89882,3794,4.1
51520,2013,7823,7277,546,7
51530,2013,3313,3088,225,6.8
51540,2013,23398,22302,1096,4.7
51550,2013,116337,109455,6882,5.9
51570,2013,8661,8098,563,6.5
51580,2013,2561,2346,215,8.4
51590,2013,19805,17864,1941,9.8
51595,2013,2382,2148,234,9.8
51600,2013,13109,12563,546,4.2
51610,2013,7840,7534,306,3.9
51620,2013,3694,3351,343,9.3
51630,2013,13762,12872,890,6.5
51640,2013,3019,2759,260,8.6
51650,2013,65846,60905,4941,7.5
51660,2013,24034,22408,1626,6.8
51670,2013,9657,8714,943,9.8
51678,2013,2252,2060,192,8.5
51680,2013,35746,33209,2537,7.1
51683,2013,22238,21039,1199,5.4
51685,2013,8804,8356,448,5.1
51690,2013,5700,5059,641,11.2
51700,2013,90473,84337,6136,6.8
51710,2013,112762,104905,7857,7
51720,2013,1871,1715,156,8.3
51730,2013,13777,12169,1608,11.7
51735,2013,6346,6031,315,5
51740,2013,45482,41776,3706,8.1
51750,2013,8338,7709,629,7.5
51760,2013,110462,102949,7513,6.8
51770,2013,49779,46460,3319,6.7
51775,2013,13049,12289,760,5.8
51790,2013,11954,11259,695,5.8
51800,2013,41983,39325,2658,6.3
51810,2013,231008,218514,12494,5.4
51820,2013,10028,9420,608,6.1
51830,2013,6877,6349,528,7.7
51840,2013,14359,13524,835,5.8
53001,2013,8376,7674,702,8.4
53003,2013,9793,9144,649,6.6
53005,2013,90301,82246,8055,8.9
53007,2013,40399,37461,2938,7.3
53009,2013,27336,24710,2626,9.6
53011,2013,208351,190701,17650,8.5
53013,2013,1768,1626,142,8
53015,2013,43324,39074,4250,9.8
53017,2013,18914,17348,1566,8.3
53019,2013,2485,2150,335,13.5
53021,2013,38399,34773,3626,9.4
53023,2013,986,913,73,7.4
53025,2013,44014,40206,3808,8.7
53027,2013,28125,24791,3334,11.9
53029,2013,31776,29413,2363,7.4
53031,2013,11424,10351,1073,9.4
53033,2013,1137369,1079695,57674,5.1
53035,2013,113691,105488,8203,7.2
53037,2013,20207,18636,1571,7.8
53039,2013,9722,8805,917,9.4
53041,2013,31352,28046,3306,10.5
53043,2013,5090,4742,348,6.8
53045,2013,23363,21030,2333,10
53047,2013,21002,19197,1805,8.6
53049,2013,7996,7096,900,11.3
53051,2013,4682,4125,557,11.9
53053,2013,384278,352223,32055,8.3
53055,2013,7788,7323,465,6
53057,2013,56754,51876,4878,8.6
53059,2013,4998,4501,497,9.9
53061,2013,388729,366189,22540,5.8
53063,2013,227420,208842,18578,8.2
53065,2013,17734,15819,1915,10.8
53067,2013,122799,113494,9305,7.6
53069,2013,1294,1139,155,12
53071,2013,28421,26403,2018,7.1
53073,2013,102157,94564,7593,7.4
53075,2013,22211,20876,1335,6
53077,2013,119049,107154,11895,10
54001,2013,6708,6230,478,7.1
54003,2013,52548,49590,2958,5.6
54005,2013,8653,7826,827,9.6
54007,2013,5331,4783,548,10.3
54009,2013,10372,9572,800,7.7
54011,2013,42399,39956,2443,5.8
54013,2013,2880,2588,292,10.1
54015,2013,3481,3063,418,12
54017,2013,3517,3329,188,5.3
54019,2013,16983,15521,1462,8.6
54021,2013,2751,2568,183,6.7
54023,2013,5995,5505,490,8.2
54025,2013,15465,14314,1151,7.4
54027,2013,9572,8901,671,7
54029,2013,13397,12309,1088,8.1
54031,2013,5452,4935,517,9.5
54033,2013,31778,30013,1765,5.6
54035,2013,12024,11197,827,6.9
54037,2013,27404,26092,1312,4.8
54039,2013,89397,84118,5279,5.9
54041,2013,7359,6887,472,6.4
54043,2013,7548,6823,725,9.6
54045,2013,12378,11163,1215,9.8
54047,2013,6192,5406,786,12.7
54049,2013,26745,25157,1588,5.9
54051,2013,14300,13257,1043,7.3
54053,2013,10566,9575,991,9.4
54055,2013,23129,21359,1770,7.7
54057,2013,11895,10963,932,7.8
54059,2013,8480,7533,947,11.2
54061,2013,50023,47763,2260,4.5
54063,2013,5677,5320,357,6.3
54065,2013,7439,6978,461,6.2
54067,2013,10373,9379,994,9.6
54069,2013,21330,20120,1210,5.7
54071,2013,3579,3384,195,5.4
54073,2013,2893,2682,211,7.3
54075,2013,3595,3287,308,8.6
54077,2013,14631,13675,956,6.5
54079,2013,25958,24485,1473,5.7
54081,2013,31791,29478,2313,7.3
54083,2013,11921,11061,860,7.2
54085,2013,4555,4276,279,6.1
54087,2013,5358,4803,555,10.4
54089,2013,4550,4203,347,7.6
54091,2013,7758,7320,438,5.6
54093,2013,3272,3049,223,6.8
54095,2013,3632,3315,317,8.7
54097,2013,9610,8927,683,7.1
54099,2013,16041,14931,1110,6.9
54101,2013,3515,3153,362,10.3
54103,2013,7282,6620,662,9.1
54105,2013,2318,2083,235,10.1
54107,2013,38447,36064,2383,6.2
54109,2013,8288,7522,766,9.2
55001,2013,8728,7779,949,10.9
55003,2013,8163,7416,747,9.2
55005,2013,23646,21873,1773,7.5
55007,2013,7760,6907,853,11
55009,2013,138058,129508,8550,6.2
55011,2013,6552,6122,430,6.6
55013,2013,7488,6852,636,8.5
55015,2013,27183,25753,1430,5.3
55017,2013,32980,30757,2223,6.7
55019,2013,17131,15922,1209,7.1
55021,2013,31235,29194,2041,6.5
55023,2013,8124,7459,665,8.2
55025,2013,301176,287079,14097,4.7
55027,2013,47380,44129,3251,6.9
55029,2013,15743,14189,1554,9.9
55031,2013,23575,22013,1562,6.6
55033,2013,23547,22050,1497,6.4
55035,2013,57925,54651,3274,5.7
55037,2013,2196,2014,182,8.3
55039,2013,57075,53566,3509,6.1
55041,2013,4081,3634,447,11
55043,2013,27655,26025,1630,5.9
55045,2013,20863,19671,1192,5.7
55047,2013,10208,9398,810,7.9
55049,2013,13546,12669,877,6.5
55051,2013,2728,2436,292,10.7
55053,2013,10149,9433,716,7.1
55055,2013,45916,43039,2877,6.3
55057,2013,13481,12386,1095,8.1
55059,2013,87142,80488,6654,7.6
55061,2013,10937,10239,698,6.4
55063,2013,66774,63237,3537,5.3
55065,2013,9349,8845,504,5.4
55067,2013,9815,8923,892,9.1
55069,2013,15183,13918,1265,8.3
55071,2013,42699,39551,3148,7.4
55073,2013,72133,67297,4836,6.7
55075,2013,21452,19753,1699,7.9
55077,2013,7511,6877,634,8.4
55078,2013,1573,1324,249,15.8
55079,2013,479051,438834,40217,8.4
55081,2013,22765,21198,1567,6.9
55083,2013,20459,18881,1578,7.7
55085,2013,18597,17003,1594,8.6
55087,2013,100500,94371,6129,6.1
55089,2013,47534,45045,2489,5.2
55091,2013,4031,3803,228,5.7
55093,2013,23999,22735,1264,5.3
55095,2013,24312,22581,1731,7.1
55097,2013,38957,36265,2692,6.9
55099,2013,6856,6384,472,6.9
55101,2013,99747,91446,8301,8.3
55103,2013,9350,8782,568,6.1
55105,2013,82182,75846,6336,7.7
55107,2013,6736,6161,575,8.5
55109,2013,47819,45248,2571,5.4
55111,2013,35391,33178,2213,6.3
55113,2013,8191,7295,896,10.9
55115,2013,21470,19868,1602,7.5
55117,2013,60767,57070,3697,6.1
55119,2013,10992,10286,706,6.4
55121,2013,16417,15500,917,5.6
55123,2013,15137,14234,903,6
55125,2013,10182,9151,1031,10.1
55127,2013,56803,52916,3887,6.8
55129,2013,7999,7405,594,7.4
55131,2013,75272,70971,4301,5.7
55133,2013,219053,206988,12065,5.5
55135,2013,27361,25360,2001,7.3
55137,2013,11830,10816,1014,8.6
55139,2013,91680,85827,5853,6.4
55141,2013,39012,36176,2836,7.3
56001,2013,20692,19916,776,3.8
56003,2013,5583,5293,290,5.2
56005,2013,25698,24607,1091,4.2
56007,2013,8378,8016,362,4.3
56009,2013,8108,7811,297,3.7
56011,2013,3691,3527,164,4.4
56013,2013,21046,19848,1198,5.7
56015,2013,7333,7025,308,4.2
56017,2013,2557,2436,121,4.7
56019,2013,4478,4251,227,5.1
56021,2013,48587,46258,2329,4.8
56023,2013,8165,7697,468,5.7
56025,2013,43105,41150,1955,4.5
56027,2013,1381,1332,49,3.5
56029,2013,15864,15056,808,5.1
56031,2013,4804,4593,211,4.4
56033,2013,15792,14923,869,5.5
56035,2013,5081,4842,239,4.7
56037,2013,23883,22838,1045,4.4
56039,2013,14107,13318,789,5.6
56041,2013,9960,9435,525,5.3
56043,2013,4362,4146,216,5
56045,2013,3956,3814,142,3.6
72001,2013,4814,3702,1112,23.1
72003,2013,12355,10071,2284,18.5
72005,2013,15382,12693,2689,17.5
72007,2013,7117,5921,1196,16.8
72009,2013,7012,5816,1196,17.1
72011,2013,9259,7554,1705,18.4
72013,2013,25281,21338,3943,15.6
72015,2013,5661,4227,1434,25.3
72017,2013,6321,4964,1357,21.5
72019,2013,7725,6527,1198,15.5
72021,2013,69653,62613,7040,10.1
72023,2013,14878,11878,3000,20.2
72025,2013,50558,44534,6024,11.9
72027,2013,9990,8486,1504,15.1
72029,2013,16427,14276,2151,13.1
72031,2013,64572,58444,6128,9.5
72033,2013,8470,7366,1104,13
72035,2013,16912,14616,2296,13.6
72037,2013,4195,3437,758,18.1
72039,2013,4465,3317,1148,25.7
72041,2013,16280,14210,2070,12.7
72043,2013,11414,9106,2308,20.2
72045,2013,5492,4395,1097,20
72047,2013,9748,8285,1463,15
72049,2013,850,793,57,6.7
72051,2013,12844,11707,1137,8.9
72053,2013,12255,10154,2101,17.1
72054,2013,3696,2924,772,20.9
72055,2013,4776,3503,1273,26.7
72057,2013,12982,10159,2823,21.7
72059,2013,5696,4443,1253,22
72061,2013,37826,35532,2294,6.1
72063,2013,17235,15394,1841,10.7
72065,2013,13423,11264,2159,16.1
72067,2013,5859,4863,996,17
72069,2013,18539,15140,3399,18.3
72071,2013,12116,10012,2104,17.4
72073,2013,4374,3574,800,18.3
72075,2013,16078,13566,2512,15.6
72077,2013,12703,10729,1974,15.5
72079,2013,6224,4520,1704,27.4
72081,2013,8092,6088,2004,24.8
72083,2013,3106,2357,749,24.1
72085,2013,11794,9724,2070,17.6
72087,2013,9120,7979,1141,12.5
72089,2013,6796,5513,1283,18.9
72091,2013,12064,10407,1657,13.7
72093,2013,2129,1679,450,21.1
72095,2013,3221,2524,697,21.6
72097,2013,25197,20390,4807,19.1
72099,2013,11132,8933,2199,19.8
72101,2013,8706,7030,1676,19.3
72103,2013,8518,7126,1392,16.3
72105,2013,7670,6403,1267,16.5
72107,2013,5542,4506,1036,18.7
72109,2013,5139,3886,1253,24.4
72111,2013,6682,5309,1373,20.5
72113,2013,50837,42728,8109,16
72115,2013,6366,5160,1206,18.9
72117,2013,4767,3791,976,20.5
72119,2013,17586,15509,2077,11.8
72121,2013,6712,5287,1425,21.2
72123,2013,8610,6374,2236,26
72125,2013,10853,8689,2164,19.9
72127,2013,139982,128736,11246,8
72129,2013,12656,10558,2098,16.6
72131,2013,11363,8654,2709,23.8
72133,2013,10008,8118,1890,18.9
72135,2013,26290,23838,2452,9.3
72137,2013,31209,27921,3288,10.5
72139,2013,27826,25725,2101,7.6
72141,2013,7324,5885,1439,19.6
72143,2013,10188,8751,1437,14.1
72145,2013,14601,12198,2403,16.5
72147,2013,3080,2589,491,15.9
72149,2013,8184,6416,1768,21.6
72151,2013,10169,7742,2427,23.9
72153,2013,11350,8959,2391,21.1
01001,2014,25592,24097,1495,5.8
01003,2014,86384,81083,5301,6.1
01005,2014,8845,7913,932,10.5
01007,2014,8559,7942,617,7.2
01009,2014,24527,23023,1504,6.1
01011,2014,4732,4314,418,8.8
01013,2014,9270,8477,793,8.6
01015,2014,47237,43467,3770,8
01017,2014,15302,14276,1026,6.7
01019,2014,11386,10725,661,5.8
01021,2014,19096,17899,1197,6.3
01023,2014,4494,4089,405,9
01025,2014,8155,7162,993,12.2
01027,2014,5511,5117,394,7.1
01029,2014,5853,5467,386,6.6
01031,2014,20228,18884,1344,6.6
01033,2014,24027,22034,1993,8.3
01035,2014,4716,4229,487,10.3
01037,2014,4467,4074,393,8.8
01039,2014,15911,14674,1237,7.8
01041,2014,6298,5862,436,6.9
01043,2014,35919,33738,2181,6.1
01045,2014,20316,18878,1438,7.1
01047,2014,16003,14204,1799,11.2
01049,2014,28943,26954,1989,6.9
01051,2014,36543,34455,2088,5.7
01053,2014,14365,13215,1150,8
01055,2014,43719,40639,3080,7
01057,2014,6349,5851,498,7.8
01059,2014,13714,12653,1061,7.7
01061,2014,10793,10071,722,6.7
01063,2014,2985,2613,372,12.5
01065,2014,6032,5436,596,9.9
01067,2014,6775,6267,508,7.5
01069,2014,45142,42080,3062,6.8
01071,2014,23446,21743,1703,7.3
01073,2014,312131,292505,19626,6.3
01075,2014,5625,5232,393,7
01077,2014,43474,40346,3128,7.2
01079,2014,14021,12868,1153,8.2
01081,2014,71346,67358,3988,5.6
01083,2014,39576,37162,2414,6.1
01085,2014,3872,3376,496,12.8
01087,2014,8237,7486,751,9.1
01089,2014,170070,159573,10497,6.2
01091,2014,7623,7015,608,8
01093,2014,12288,11317,971,7.9
01095,2014,39903,37239,2664,6.7
01097,2014,185318,170959,14359,7.7
01099,2014,7615,6773,842,11.1
01101,2014,105004,97799,7205,6.9
01103,2014,56034,52336,3698,6.6
01105,2014,3489,3066,423,12.1
01107,2014,7760,7124,636,8.2
01109,2014,14948,13846,1102,7.4
01111,2014,9274,8650,624,6.7
01113,2014,24767,23147,1620,6.5
01115,2014,38507,36288,2219,5.8
01117,2014,107208,102400,4808,4.5
01119,2014,5373,4917,456,8.5
01121,2014,35386,32639,2747,7.8
01123,2014,18416,17034,1382,7.5
01125,2014,97049,91323,5726,5.9
01127,2014,25752,23714,2038,7.9
01129,2014,6654,6015,639,9.6
01131,2014,2864,2379,485,16.9
01133,2014,9630,8802,828,8.6
02013,2014,2225,2125,100,4.5
02016,2014,4475,4260,215,4.8
02020,2014,158075,149849,8226,5.2
02050,2014,7305,6131,1174,16.1
02060,2014,497,457,40,8
02068,2014,1072,961,111,10.4
02070,2014,2119,1906,213,10.1
02090,2014,46792,44092,2700,5.8
02100,2014,1113,994,119,10.7
02105,2014,1140,967,173,15.2
02110,2014,17460,16578,882,5.1
02122,2014,27954,25759,2195,7.9
02130,2014,7107,6548,559,7.9
02150,2014,6581,6208,373,5.7
02158,2014,2828,2155,673,23.8
02164,2014,644,539,105,16.3
02170,2014,44887,41270,3617,8.1
02180,2014,4124,3617,507,12.3
02185,2014,4350,4091,259,6
02188,2014,3006,2494,512,17
02195,2014,1583,1433,150,9.5
02198,2014,2836,2457,379,13.4
02220,2014,4682,4443,239,5.1
02230,2014,805,709,96,11.9
02240,2014,2921,2535,386,13.2
02261,2014,4884,4413,471,9.6
02275,2014,1061,972,89,8.4
02282,2014,273,246,27,9.9
02290,2014,2585,2095,490,19
04001,2014,21213,17890,3323,15.7
04003,2014,50969,46682,4287,8.4
04005,2014,72238,67117,5121,7.1
04007,2014,21413,19635,1778,8.3
04009,2014,14442,13369,1073,7.4
04011,2014,4720,4414,306,6.5
04012,2014,7954,7351,603,7.6
04013,2014,1961997,1848119,113878,5.8
04015,2014,78362,71531,6831,8.7
04017,2014,41688,37075,4613,11.1
04019,2014,463126,435183,27943,6
04021,2014,153748,142996,10752,7
04023,2014,20297,17674,2623,12.9
04025,2014,94311,88321,5990,6.4
04027,2014,93407,72025,21382,22.9
05001,2014,9465,8957,508,5.4
05003,2014,8475,7691,784,9.3
05005,2014,15985,14918,1067,6.7
05007,2014,115416,110110,5306,4.6
05009,2014,15663,14726,937,6
05011,2014,4154,3806,348,8.4
05013,2014,2367,2211,156,6.6
05015,2014,12543,11894,649,5.2
05017,2014,3851,3448,403,10.5
05019,2014,9517,8858,659,6.9
05021,2014,6413,5912,501,7.8
05023,2014,9746,8940,806,8.3
05025,2014,3455,3220,235,6.8
05027,2014,9539,8857,682,7.1
05029,2014,8596,7982,614,7.1
05031,2014,49474,46787,2687,5.4
05033,2014,26799,25198,1601,6
05035,2014,21431,19852,1579,7.4
05037,2014,8098,7584,514,6.3
05039,2014,2878,2610,268,9.3
05041,2014,5551,5104,447,8.1
05043,2014,7984,7312,672,8.4
05045,2014,59036,55766,3270,5.5
05047,2014,7288,6875,413,5.7
05049,2014,4801,4524,277,5.8
05051,2014,40337,37787,2550,6.3
05053,2014,8221,7773,448,5.4
05055,2014,19626,18386,1240,6.3
05057,2014,9926,9334,592,6
05059,2014,13977,13170,807,5.8
05061,2014,6195,5836,359,5.8
05063,2014,15481,14278,1203,7.8
05065,2014,4916,4547,369,7.5
05067,2014,6191,5621,570,9.2
05069,2014,29502,26927,2575,8.7
05071,2014,10296,9623,673,6.5
05073,2014,2661,2454,207,7.8
05075,2014,7084,6572,512,7.2
05077,2014,3251,3006,245,7.5
05079,2014,4214,3916,298,7.1
05081,2014,5544,5181,363,6.5
05083,2014,9079,8537,542,6
05085,2014,32741,31075,1666,5.1
05087,2014,6967,6631,336,4.8
05089,2014,6535,6125,410,6.3
05091,2014,19371,18246,1125,5.8
05093,2014,19074,17319,1755,9.2
05095,2014,3093,2885,208,6.7
05097,2014,3349,3082,267,8
05099,2014,3683,3460,223,6.1
05101,2014,3362,3167,195,5.8
05103,2014,9954,9160,794,8
05105,2014,4230,3904,326,7.7
05107,2014,7228,6535,693,9.6
05109,2014,4206,3898,308,7.3
05111,2014,10103,9404,699,6.9
05113,2014,8455,7927,528,6.2
05115,2014,29613,27762,1851,6.3
05117,2014,3813,3593,220,5.8
05119,2014,184541,174392,10149,5.5
05121,2014,6550,6033,517,7.9
05123,2014,8978,8198,780,8.7
05125,2014,54605,51970,2635,4.8
05127,2014,4542,4314,228,5
05129,2014,2994,2804,190,6.3
05131,2014,57179,53937,3242,5.7
05133,2014,5792,5388,404,7
05135,2014,5968,5464,504,8.4
05137,2014,4701,4343,358,7.6
05139,2014,16579,15354,1225,7.4
05141,2014,6454,5933,521,8.1
05143,2014,110153,105350,4803,4.4
05145,2014,34471,32051,2420,7
05147,2014,3166,2926,240,7.6
05149,2014,9035,8527,508,5.6
06001,2014,808094,761108,46986,5.8
06003,2014,510,468,42,8.2
06005,2014,14348,13157,1191,8.3
06007,2014,101244,92493,8751,8.6
06009,2014,20243,18625,1618,8
06011,2014,11085,9159,1926,17.4
06013,2014,539630,506344,33286,6.2
06015,2014,9932,8932,1000,10.1
06017,2014,87908,81778,6130,7
06019,2014,438262,387533,50729,11.6
06021,2014,12803,11439,1364,10.7
06023,2014,62360,58211,4149,6.7
06025,2014,78264,59459,18805,24
06027,2014,9212,8584,628,6.8
06029,2014,392530,351686,40844,10.4
06031,2014,57441,50599,6842,11.9
06033,2014,29283,26665,2618,8.9
06035,2014,10817,9833,984,9.1
06037,2014,4992593,4580294,412299,8.3
06039,2014,61807,54885,6922,11.2
06041,2014,138798,132877,5921,4.3
06043,2014,8091,7381,710,8.8
06045,2014,40384,37559,2825,7
06047,2014,114317,99655,14662,12.8
06049,2014,3366,3021,345,10.2
06051,2014,8241,7660,581,7.1
06053,2014,217706,198037,19669,9
06055,2014,73419,69255,4164,5.7
06057,2014,47849,44716,3133,6.5
06059,2014,1568990,1482935,86055,5.5
06061,2014,175478,164489,10989,6.3
06063,2014,8099,7165,934,11.5
06065,2014,1011115,928255,82860,8.2
06067,2014,679083,629508,49575,7.3
06069,2014,29172,26452,2720,9.3
06071,2014,905417,832966,72451,8
06073,2014,1540711,1441734,98977,6.4
06075,2014,528606,505504,23102,4.4
06077,2014,312045,279182,32863,10.5
06079,2014,140238,132419,7819,5.6
06081,2014,426911,408922,17989,4.2
06083,2014,217803,204497,13306,6.1
06085,2014,989909,938914,50995,5.2
06087,2014,142308,129860,12448,8.7
06089,2014,74869,67672,7197,9.6
06091,2014,1412,1270,142,10.1
06093,2014,18004,16009,1995,11.1
06095,2014,202785,187536,15249,7.5
06097,2014,256135,241776,14359,5.6
06099,2014,240588,213722,26866,11.2
06101,2014,44288,38691,5597,12.6
06103,2014,25084,22673,2411,9.6
06105,2014,5170,4682,488,9.4
06107,2014,198164,172149,26015,13.1
06109,2014,21576,19710,1866,8.6
06111,2014,430087,401521,28566,6.6
06113,2014,102234,94543,7691,7.5
06115,2014,27896,24771,3125,11.2
08001,2014,245118,231093,14025,5.7
08003,2014,7515,6974,541,7.2
08005,2014,331367,315109,16258,4.9
08007,2014,5727,5384,343,6
08009,2014,1926,1873,53,2.8
08011,2014,1652,1565,87,5.3
08013,2014,176233,169031,7202,4.1
08014,2014,34187,32743,1444,4.2
08015,2014,8387,8021,366,4.4
08017,2014,972,944,28,2.9
08019,2014,5519,5263,256,4.6
08021,2014,3610,3329,281,7.8
08023,2014,1610,1464,146,9.1
08025,2014,1315,1238,77,5.9
08027,2014,1979,1888,91,4.6
08029,2014,13601,12644,957,7
08031,2014,368895,351178,17717,4.8
08033,2014,1329,1277,52,3.9
08035,2014,169258,162473,6785,4
08037,2014,32403,31051,1352,4.2
08039,2014,12963,12410,553,4.3
08041,2014,306746,288358,18388,6
08043,2014,14535,13342,1193,8.2
08045,2014,31180,29540,1640,5.3
08047,2014,3451,3300,151,4.4
08049,2014,8933,8574,359,4
08051,2014,9677,9286,391,4
08053,2014,434,418,16,3.7
08055,2014,2412,2171,241,10
08057,2014,835,805,30,3.6
08059,2014,307711,293718,13993,4.5
08061,2014,752,727,25,3.3
08063,2014,4313,4182,131,3
08065,2014,4507,4298,209,4.6
08067,2014,29925,28665,1260,4.2
08069,2014,177138,169598,7540,4.3
08071,2014,6427,5943,484,7.5
08073,2014,2135,2048,87,4.1
08075,2014,10999,10582,417,3.8
08077,2014,73237,68674,4563,6.2
08079,2014,424,403,21,5
08081,2014,7309,6888,421,5.8
08083,2014,12660,11889,771,6.1
08085,2014,19274,17967,1307,6.8
08087,2014,14811,14131,680,4.6
08089,2014,7971,7363,608,7.6
08091,2014,2134,2011,123,5.8
08093,2014,9358,8928,430,4.6
08095,2014,2253,2179,74,3.3
08097,2014,11028,10491,537,4.9
08099,2014,5729,5460,269,4.7
08101,2014,72326,67044,5282,7.3
08103,2014,2941,2766,175,6
08105,2014,4821,4378,443,9.2
08107,2014,14388,13789,599,4.2
08109,2014,3005,2743,262,8.7
08111,2014,475,450,25,5.3
08113,2014,4923,4689,234,4.8
08115,2014,1086,1036,50,4.6
08117,2014,20084,19408,676,3.4
08119,2014,11585,10907,678,5.9
08121,2014,2647,2563,84,3.2
08123,2014,145429,138946,6483,4.5
08125,2014,4959,4795,164,3.3
09001,2014,476177,446751,29426,6.2
09003,2014,473952,441939,32013,6.8
09005,2014,105593,99240,6353,6
09007,2014,92185,86916,5269,5.7
09009,2014,455190,422217,32973,7.2
09011,2014,136710,127418,9292,6.8
09013,2014,84813,79881,4932,5.8
09015,2014,62811,58202,4609,7.3
10001,2014,75025,70212,4813,6.4
10003,2014,282578,266987,15591,5.5
10005,2014,94584,89126,5458,5.8
11001,2014,379123,349686,29437,7.8
12001,2014,129427,122675,6752,5.2
12003,2014,11197,10480,717,6.4
12005,2014,87477,81927,5550,6.3
12007,2014,10742,10136,606,5.6
12009,2014,257669,239673,17996,7
12011,2014,986355,927797,58558,5.9
12013,2014,4941,4598,343,6.9
12015,2014,66825,62231,4594,6.9
12017,2014,48185,44063,4122,8.6
12019,2014,97719,92097,5622,5.8
12021,2014,159908,150359,9549,6
12023,2014,28333,26450,1883,6.6
12027,2014,13158,12216,942,7.2
12029,2014,5550,5139,411,7.4
12031,2014,459550,428626,30924,6.7
12033,2014,139177,130243,8934,6.4
12035,2014,43180,40007,3173,7.3
12037,2014,4940,4662,278,5.6
12039,2014,18794,17246,1548,8.2
12041,2014,6550,6109,441,6.7
12043,2014,4916,4538,378,7.7
12045,2014,6118,5746,372,6.1
12047,2014,4601,4251,350,7.6
12049,2014,10334,9540,794,7.7
12051,2014,15814,14020,1794,11.3
12053,2014,66194,60933,5261,7.9
12055,2014,35810,32789,3021,8.4
12057,2014,682187,642710,39477,5.8
12059,2014,6856,6377,479,7
12061,2014,61696,56819,4877,7.9
12063,2014,17468,16297,1171,6.7
12065,2014,5492,5129,363,6.6
12067,2014,3351,3179,172,5.1
12069,2014,138216,129372,8844,6.4
12071,2014,310076,291349,18727,6
12073,2014,149736,141427,8309,5.5
12075,2014,16283,15167,1116,6.9
12077,2014,2749,2566,183,6.7
12079,2014,7730,7179,551,7.1
12081,2014,160396,151207,9189,5.7
12083,2014,131483,121884,9599,7.3
12085,2014,68622,64457,4165,6.1
12086,2014,1313992,1225796,88196,6.7
12087,2014,45000,43146,1854,4.1
12089,2014,36234,34074,2160,6
12091,2014,91984,87244,4740,5.2
12093,2014,17658,16358,1300,7.4
12095,2014,675922,636407,39515,5.8
12097,2014,152534,142258,10276,6.7
12099,2014,684170,644026,40144,5.9
12101,2014,212826,198617,14209,6.7
12103,2014,471251,444032,27219,5.8
12105,2014,278220,258191,20029,7.2
12107,2014,27921,25481,2440,8.7
12109,2014,110553,105354,5199,4.7
12111,2014,130418,119962,10456,8
12113,2014,73052,69054,3998,5.5
12115,2014,174763,164541,10222,5.8
12117,2014,235834,222355,13479,5.7
12119,2014,28243,25884,2359,8.4
12121,2014,17955,16823,1132,6.3
12123,2014,9354,8711,643,6.9
12125,2014,4730,4447,283,6
12127,2014,237578,221355,16223,6.8
12129,2014,14295,13554,741,5.2
12131,2014,27324,25876,1448,5.3
12133,2014,9684,9032,652,6.7
13001,2014,8639,7879,760,8.8
13003,2014,3605,3333,272,7.5
13005,2014,4833,4498,335,6.9
13007,2014,1112,1012,100,9
13009,2014,18420,16821,1599,8.7
13011,2014,8126,7589,537,6.6
13013,2014,35082,32888,2194,6.3
13015,2014,46476,43155,3321,7.1
13017,2014,5579,5024,555,9.9
13019,2014,7214,6600,614,8.5
13021,2014,68808,63311,5497,8
13023,2014,4617,4100,517,11.2
13025,2014,6867,6235,632,9.2
13027,2014,6612,6136,476,7.2
13029,2014,15498,14501,997,6.4
13031,2014,34436,31923,2513,7.3
13033,2014,9142,8229,913,10
13035,2014,9996,9250,746,7.5
13037,2014,2134,1986,148,6.9
13039,2014,21894,20455,1439,6.6
13043,2014,5059,4711,348,6.9
13045,2014,51802,47579,4223,8.2
13047,2014,30947,29054,1893,6.1
13049,2014,4791,4439,352,7.3
13051,2014,131333,121772,9561,7.3
13053,2014,2222,2007,215,9.7
13055,2014,10485,9690,795,7.6
13057,2014,117663,111239,6424,5.5
13059,2014,56056,52183,3873,6.9
13061,2014,912,809,103,11.3
13063,2014,124310,112797,11513,9.3
13065,2014,2818,2583,235,8.3
13067,2014,392311,369170,23141,5.9
13069,2014,17583,16159,1424,8.1
13071,2014,20022,18410,1612,8.1
13073,2014,66237,62407,3830,5.8
13075,2014,7374,6778,596,8.1
13077,2014,66310,62246,4064,6.1
13079,2014,5596,5179,417,7.5
13081,2014,9426,8596,830,8.8
13083,2014,7863,7369,494,6.3
13085,2014,10765,10113,652,6.1
13087,2014,11341,10421,920,8.1
13089,2014,367659,341149,26510,7.2
13091,2014,7409,6689,720,9.7
13093,2014,4622,4180,442,9.6
13095,2014,38534,34993,3541,9.2
13097,2014,67469,62499,4970,7.4
13099,2014,4331,3944,387,8.9
13101,2014,1778,1674,104,5.8
13103,2014,26187,24567,1620,6.2
13105,2014,8042,7352,690,8.6
13107,2014,8557,7666,891,10.4
13109,2014,4722,4419,303,6.4
13111,2014,9826,9083,743,7.6
13113,2014,53595,50344,3251,6.1
13115,2014,43150,39753,3397,7.9
13117,2014,100080,94849,5231,5.2
13119,2014,9221,8476,745,8.1
13121,2014,507906,472230,35676,7
13123,2014,11927,11065,862,7.2
13125,2014,1262,1161,101,8
13127,2014,36971,34227,2744,7.4
13129,2014,25995,24110,1885,7.3
13131,2014,10422,9661,761,7.3
13133,2014,6406,5883,523,8.2
13135,2014,443051,416344,26707,6
13137,2014,18913,17603,1310,6.9
13139,2014,89803,84535,5268,5.9
13141,2014,2514,2221,293,11.7
13143,2014,11838,10903,935,7.9
13145,2014,15679,14746,933,6
13147,2014,10353,9580,773,7.5
13149,2014,4953,4562,391,7.9
13151,2014,103221,95766,7455,7.2
13153,2014,65734,61280,4454,6.8
13155,2014,3132,2836,296,9.5
13157,2014,29726,27994,1732,5.8
13159,2014,6333,5914,419,6.6
13161,2014,6377,5858,519,8.1
13163,2014,6631,5888,743,11.2
13165,2014,3251,2928,323,9.9
13167,2014,3924,3588,336,8.6
13169,2014,13651,12793,858,6.3
13171,2014,7764,7026,738,9.5
13173,2014,3781,3477,304,8
13175,2014,18972,17230,1742,9.2
13177,2014,14100,13225,875,6.2
13179,2014,25555,23612,1943,7.6
13181,2014,3327,3051,276,8.3
13183,2014,6680,6187,493,7.4
13185,2014,50392,46747,3645,7.2
13187,2014,15212,14248,964,6.3
13189,2014,8772,7900,872,9.9
13191,2014,5849,5391,458,7.8
13193,2014,4724,4170,554,11.7
13195,2014,12668,11825,843,6.7
13197,2014,3447,3183,264,7.7
13199,2014,8718,7871,847,9.7
13201,2014,2666,2498,168,6.3
13205,2014,8738,8055,683,7.8
13207,2014,12693,11846,847,6.7
13209,2014,3846,3451,395,10.3
13211,2014,8336,7790,546,6.5
13213,2014,15820,14346,1474,9.3
13215,2014,80580,73822,6758,8.4
13217,2014,47794,43893,3901,8.2
13219,2014,17209,16341,868,5
13221,2014,6640,6202,438,6.6
13223,2014,74612,70045,4567,6.1
13225,2014,11451,10370,1081,9.4
13227,2014,13782,12868,914,6.6
13229,2014,8064,7464,600,7.4
13231,2014,8168,7598,570,7
13233,2014,18287,16867,1420,7.8
13235,2014,4050,3735,315,7.8
13237,2014,8065,7339,726,9
13239,2014,888,814,74,8.3
13241,2014,6530,5998,532,8.1
13243,2014,2711,2449,262,9.7
13245,2014,84390,77083,7307,8.7
13247,2014,41908,38630,3278,7.8
13249,2014,2168,2004,164,7.6
13251,2014,5346,4813,533,10
13253,2014,3111,2818,293,9.4
13255,2014,27191,24631,2560,9.4
13257,2014,11177,10325,852,7.6
13259,2014,2181,2019,162,7.4
13261,2014,13395,12130,1265,9.4
13263,2014,2797,2578,219,7.8
13265,2014,591,527,64,10.8
13267,2014,9493,8836,657,6.9
13269,2014,2838,2549,289,10.2
13271,2014,5233,4724,509,9.7
13273,2014,3608,3320,288,8
13275,2014,17095,15606,1489,8.7
13277,2014,18197,16876,1321,7.3
13279,2014,12199,11000,1199,9.8
13281,2014,4126,3748,378,9.2
13283,2014,2786,2492,294,10.6
13285,2014,35993,33362,2631,7.3
13287,2014,3248,2991,257,7.9
13289,2014,2987,2656,331,11.1
13291,2014,9487,8865,622,6.6
13293,2014,11271,10272,999,8.9
13295,2014,29312,27207,2105,7.2
13297,2014,41291,38642,2649,6.4
13299,2014,14713,13555,1158,7.9
13301,2014,2706,2445,261,9.6
13303,2014,7530,6923,607,8.1
13305,2014,11797,10768,1029,8.7
13307,2014,1013,925,88,8.7
13309,2014,1861,1632,229,12.3
13311,2014,13792,12939,853,6.2
13313,2014,44594,41112,3482,7.8
13315,2014,2832,2574,258,9.1
13317,2014,3724,3379,345,9.3
13319,2014,3705,3385,320,8.6
13321,2014,8915,8216,699,7.8
15001,2014,87549,82712,4837,5.5
15003,2014,460906,442173,18733,4.1
15007,2014,34728,33050,1678,4.8
15009,2014,82282,78560,3722,4.5
16001,2014,211675,202897,8778,4.1
16003,2014,1676,1509,167,10
16005,2014,41517,39634,1883,4.5
16007,2014,2859,2731,128,4.5
16009,2014,3966,3646,320,8.1
16011,2014,22056,21064,992,4.5
16013,2014,11457,10947,510,4.5
16015,2014,2919,2729,190,6.5
16017,2014,18225,16926,1299,7.1
16019,2014,49585,47518,2067,4.2
16021,2014,4908,4613,295,6
16023,2014,1301,1232,69,5.3
16025,2014,631,597,34,5.4
16027,2014,89013,83748,5265,5.9
16029,2014,3851,3689,162,4.2
16031,2014,11236,10760,476,4.2
16033,2014,443,422,21,4.7
16035,2014,3130,2840,290,9.3
16037,2014,2136,1990,146,6.8
16039,2014,11005,10431,574,5.2
16041,2014,6403,6188,215,3.4
16043,2014,6975,6693,282,4
16045,2014,7511,7069,442,5.9
16047,2014,7984,7666,318,4
16049,2014,6486,6000,486,7.5
16051,2014,12248,11757,491,4
16053,2014,11172,10730,442,4
16055,2014,70471,66396,4075,5.8
16057,2014,19291,18513,778,4
16059,2014,3360,3098,262,7.8
16061,2014,1594,1522,72,4.5
16063,2014,2603,2454,149,5.7
16065,2014,19017,18410,607,3.2
16067,2014,10405,9931,474,4.6
16069,2014,20340,19518,822,4
16071,2014,2115,2035,80,3.8
16073,2014,5018,4835,183,3.6
16075,2014,10955,10338,617,5.6
16077,2014,3976,3783,193,4.9
16079,2014,5203,4686,517,9.9
16081,2014,5620,5395,225,4
16083,2014,38509,36870,1639,4.3
16085,2014,4558,4214,344,7.5
16087,2014,4582,4278,304,6.6
17001,2014,32648,30917,1731,5.3
17003,2014,2557,2285,272,10.6
17005,2014,7895,7381,514,6.5
17007,2014,26332,24290,2042,7.8
17009,2014,2736,2622,114,4.2
17011,2014,17479,16210,1269,7.3
17013,2014,2367,2173,194,8.2
17015,2014,7851,7352,499,6.4
17017,2014,6435,5994,441,6.9
17019,2014,103437,97267,6170,6
17021,2014,15794,14602,1192,7.5
17023,2014,7967,7402,565,7.1
17025,2014,6441,5930,511,7.9
17027,2014,19962,18886,1076,5.4
17029,2014,24287,22654,1633,6.7
17031,2014,2656503,2457046,199457,7.5
17033,2014,9747,9120,627,6.4
17035,2014,5862,5519,343,5.9
17037,2014,54957,51382,3575,6.5
17039,2014,7937,7415,522,6.6
17041,2014,9865,9289,576,5.8
17043,2014,510472,481099,29373,5.8
17045,2014,9136,8485,651,7.1
17047,2014,2851,2661,190,6.7
17049,2014,18369,17377,992,5.4
17051,2014,9756,9020,736,7.5
17053,2014,6454,6065,389,6
17055,2014,16643,15114,1529,9.2
17057,2014,15756,14413,1343,8.5
17059,2014,2464,2290,174,7.1
17061,2014,6179,5764,415,6.7
17063,2014,25614,23370,2244,8.8
17065,2014,4334,4078,256,5.9
17067,2014,8885,8314,571,6.4
17069,2014,1639,1497,142,8.7
17071,2014,3740,3504,236,6.3
17073,2014,25335,23663,1672,6.6
17075,2014,14981,14029,952,6.4
17077,2014,28476,26661,1815,6.4
17079,2014,4647,4351,296,6.4
17081,2014,17621,16312,1309,7.4
17083,2014,11080,10291,789,7.1
17085,2014,11566,10859,707,6.1
17087,2014,4161,3767,394,9.5
17089,2014,265033,246916,18117,6.8
17091,2014,55450,51042,4408,7.9
17093,2014,65238,61029,4209,6.5
17095,2014,23593,21969,1624,6.9
17097,2014,365552,342156,23396,6.4
17099,2014,57219,52588,4631,8.1
17101,2014,6348,5858,490,7.7
17103,2014,18148,17020,1128,6.2
17105,2014,17475,16364,1111,6.4
17107,2014,13029,12201,828,6.4
17109,2014,14297,13327,970,6.8
17111,2014,165878,154972,10906,6.6
17113,2014,90812,85872,4940,5.4
17115,2014,50807,46494,4313,8.5
17117,2014,23135,21419,1716,7.4
17119,2014,132302,123052,9250,7
17121,2014,18048,16682,1366,7.6
17123,2014,5759,5356,403,7
17125,2014,6638,6071,567,8.5
17127,2014,6320,5819,501,7.9
17129,2014,6751,6373,378,5.6
17131,2014,8315,7737,578,7
17133,2014,17884,16930,954,5.3
17135,2014,12140,11086,1054,8.7
17137,2014,17220,16201,1019,5.9
17139,2014,7048,6668,380,5.4
17141,2014,25937,24031,1906,7.3
17143,2014,91580,84588,6992,7.6
17145,2014,8885,8138,747,8.4
17147,2014,8326,7857,469,5.6
17149,2014,7751,7309,442,5.7
17151,2014,1796,1648,148,8.2
17153,2014,2138,1917,221,10.3
17155,2014,3034,2803,231,7.6
17157,2014,14165,13234,931,6.6
17159,2014,7233,6771,462,6.4
17161,2014,72888,67783,5105,7
17163,2014,126446,116595,9851,7.8
17165,2014,10769,9892,877,8.1
17167,2014,104420,98301,6119,5.9
17169,2014,3458,3226,232,6.7
17171,2014,2560,2385,175,6.8
17173,2014,10150,9467,683,6.7
17175,2014,2804,2594,210,7.5
17177,2014,22244,20619,1625,7.3
17179,2014,67808,63274,4534,6.7
17181,2014,7296,6657,639,8.8
17183,2014,35544,32549,2995,8.4
17185,2014,5567,5237,330,5.9
17187,2014,8737,8231,506,5.8
17189,2014,9025,8599,426,4.7
17191,2014,7674,7169,505,6.6
17193,2014,7074,6662,412,5.8
17195,2014,28586,26619,1967,6.9
17197,2014,357122,329887,27235,7.6
17199,2014,31399,29175,2224,7.1
17201,2014,142097,130399,11698,8.2
17203,2014,19699,18616,1083,5.5
18001,2014,16404,15652,752,4.6
18003,2014,175535,165486,10049,5.7
18005,2014,42575,40710,1865,4.4
18007,2014,4470,4228,242,5.4
18009,2014,5260,4871,389,7.4
18011,2014,32164,30752,1412,4.4
18013,2014,7352,6913,439,6
18015,2014,9874,9358,516,5.2
18017,2014,17719,16699,1020,5.8
18019,2014,57571,54462,3109,5.4
18021,2014,12427,11588,839,6.8
18023,2014,16644,15790,854,5.1
18025,2014,4890,4515,375,7.7
18027,2014,15165,14487,678,4.5
18029,2014,25097,23447,1650,6.6
18031,2014,14171,13475,696,4.9
18033,2014,21242,20136,1106,5.2
18035,2014,53552,49800,3752,7
18037,2014,22024,21128,896,4.1
18039,2014,102088,96907,5181,5.1
18041,2014,9082,8374,708,7.8
18043,2014,39047,37062,1985,5.1
18045,2014,8192,7620,572,7
18047,2014,10874,10165,709,6.5
18049,2014,9784,9171,613,6.3
18051,2014,18417,17591,826,4.5
18053,2014,32631,30394,2237,6.9
18055,2014,13843,12743,1100,7.9
18057,2014,160990,154444,6546,4.1
18059,2014,36584,34690,1894,5.2
18061,2014,19028,17963,1065,5.6
18063,2014,80630,76922,3708,4.6
18065,2014,21448,19987,1461,6.8
18067,2014,36906,34592,2314,6.3
18069,2014,18538,17463,1075,5.8
18071,2014,21304,20240,1064,5
18073,2014,16129,15053,1076,6.7
18075,2014,10093,9508,585,5.8
18077,2014,15050,14137,913,6.1
18079,2014,13079,12204,875,6.7
18081,2014,75464,71709,3755,5
18083,2014,18828,17845,983,5.2
18085,2014,40291,38322,1969,4.9
18087,2014,18208,17395,813,4.5
18089,2014,230412,212215,18197,7.9
18091,2014,48844,45113,3731,7.6
18093,2014,20366,18721,1645,8.1
18095,2014,57898,53769,4129,7.1
18097,2014,467172,436719,30453,6.5
18099,2014,23705,22406,1299,5.5
18101,2014,4952,4687,265,5.4
18103,2014,15660,14625,1035,6.6
18105,2014,67449,63588,3861,5.7
18107,2014,18680,17670,1010,5.4
18109,2014,34969,32937,2032,5.8
18111,2014,6942,6458,484,7
18113,2014,23118,21917,1201,5.2
18115,2014,3216,2994,222,6.9
18117,2014,8534,7874,660,7.7
18119,2014,9475,8708,767,8.1
18121,2014,6944,6460,484,7
18123,2014,9170,8634,536,5.8
18125,2014,6341,6020,321,5.1
18127,2014,83972,78766,5206,6.2
18129,2014,13146,12517,629,4.8
18131,2014,6190,5856,334,5.4
18133,2014,16258,15179,1079,6.6
18135,2014,12475,11671,804,6.4
18137,2014,13629,12730,899,6.6
18139,2014,8525,8045,480,5.6
18141,2014,128665,120243,8422,6.5
18143,2014,10181,9489,692,6.8
18145,2014,22420,21145,1275,5.7
18147,2014,10740,10188,552,5.1
18149,2014,10225,9484,741,7.2
18151,2014,19794,18838,956,4.8
18153,2014,8643,8025,618,7.2
18155,2014,4800,4517,283,5.9
18157,2014,91254,86665,4589,5
18159,2014,8159,7736,423,5.2
18161,2014,3541,3342,199,5.6
18163,2014,92028,87063,4965,5.4
18165,2014,7221,6601,620,8.6
18167,2014,49449,45685,3764,7.6
18169,2014,15461,14600,861,5.6
18171,2014,4093,3844,249,6.1
18173,2014,31166,29635,1531,4.9
18175,2014,13310,12424,886,6.7
18177,2014,30897,28885,2012,6.5
18179,2014,13749,13089,660,4.8
18181,2014,13444,12762,682,5.1
18183,2014,16831,15962,869,5.2
19001,2014,4159,3992,167,4
19003,2014,2215,2141,74,3.3
19005,2014,7716,7282,434,5.6
19007,2014,6160,5809,351,5.7
19009,2014,3264,3124,140,4.3
19011,2014,13885,13246,639,4.6
19013,2014,72272,68735,3537,4.9
19015,2014,15217,14701,516,3.4
19017,2014,14199,13680,519,3.7
19019,2014,11484,10951,533,4.6
19021,2014,11499,11045,454,3.9
19023,2014,8393,8039,354,4.2
19025,2014,4427,4214,213,4.8
19027,2014,11244,10890,354,3.1
19029,2014,7395,7076,319,4.3
19031,2014,10942,10521,421,3.8
19033,2014,23270,22192,1078,4.6
19035,2014,6641,6304,337,5.1
19037,2014,6489,6182,307,4.7
19039,2014,4685,4476,209,4.5
19041,2014,8957,8584,373,4.2
19043,2014,10205,9698,507,5
19045,2014,24821,23521,1300,5.2
19047,2014,8746,8391,355,4.1
19049,2014,42783,41381,1402,3.3
19051,2014,4116,3906,210,5.1
19053,2014,4447,4279,168,3.8
19055,2014,10543,10146,397,3.8
19057,2014,20873,19829,1044,5
19059,2014,9727,9273,454,4.7
19061,2014,55658,53366,2292,4.1
19063,2014,5743,5517,226,3.9
19065,2014,10810,10270,540,5
19067,2014,8422,8043,379,4.5
19069,2014,5986,5750,236,3.9
19071,2014,4176,4015,161,3.9
19073,2014,5282,5070,212,4
19075,2014,6735,6455,280,4.2
19077,2014,5621,5375,246,4.4
19079,2014,7109,6788,321,4.5
19081,2014,6308,6100,208,3.3
19083,2014,8723,8347,376,4.3
19085,2014,7550,7248,302,4
19087,2014,9560,9141,419,4.4
19089,2014,5325,5110,215,4
19091,2014,5269,5070,199,3.8
19093,2014,3896,3757,139,3.6
19095,2014,10223,9797,426,4.2
19097,2014,11037,10480,557,5
19099,2014,19360,18506,854,4.4
19101,2014,9094,8699,395,4.3
19103,2014,84169,81583,2586,3.1
19105,2014,10812,10281,531,4.9
19107,2014,5526,5282,244,4.4
19109,2014,8677,8399,278,3.2
19111,2014,17762,16719,1043,5.9
19113,2014,121203,115899,5304,4.4
19115,2014,5944,5677,267,4.5
19117,2014,4318,4150,168,3.9
19119,2014,7027,6849,178,2.5
19121,2014,8245,7872,373,4.5
19123,2014,11879,11359,520,4.4
19125,2014,17466,16802,664,3.8
19127,2014,19868,18799,1069,5.4
19129,2014,7410,7087,323,4.4
19131,2014,5470,5276,194,3.5
19133,2014,4764,4527,237,5
19135,2014,4081,3876,205,5
19137,2014,5170,4958,212,4.1
19139,2014,22154,21152,1002,4.5
19141,2014,8250,7982,268,3.2
19143,2014,3465,3350,115,3.3
19145,2014,6608,6316,292,4.4
19147,2014,4861,4686,175,3.6
19149,2014,14689,14187,502,3.4
19151,2014,4335,4184,151,3.5
19153,2014,256079,245281,10798,4.2
19155,2014,49272,47164,2108,4.3
19157,2014,10422,9980,442,4.2
19159,2014,2535,2437,98,3.9
19161,2014,5566,5348,218,3.9
19163,2014,88960,84355,4605,5.2
19165,2014,7065,6844,221,3.1
19167,2014,20167,19576,591,2.9
19169,2014,56722,55089,1633,2.9
19171,2014,9254,8767,487,5.3
19173,2014,3248,3129,119,3.7
19175,2014,6827,6506,321,4.7
19177,2014,3921,3744,177,4.5
19179,2014,18170,17176,994,5.5
19181,2014,26815,25756,1059,3.9
19183,2014,12344,11901,443,3.6
19185,2014,2877,2733,144,5
19187,2014,19859,18901,958,4.8
19189,2014,5234,5014,220,4.2
19191,2014,12080,11568,512,4.2
19193,2014,56047,53597,2450,4.4
19195,2014,4211,4021,190,4.5
19197,2014,6962,6678,284,4.1
20001,2014,6808,6462,346,5.1
20003,2014,4188,3972,216,5.2
20005,2014,7634,7138,496,6.5
20007,2014,2716,2633,83,3.1
20009,2014,15460,14910,550,3.6
20011,2014,7096,6722,374,5.3
20013,2014,5408,5187,221,4.1
20015,2014,31954,30396,1558,4.9
20017,2014,1234,1183,51,4.1
20019,2014,1578,1492,86,5.4
20021,2014,10351,9830,521,5
20023,2014,1314,1273,41,3.1
20025,2014,1144,1114,30,2.6
20027,2014,4170,3986,184,4.4
20029,2014,4390,4205,185,4.2
20031,2014,4895,4616,279,5.7
20033,2014,979,949,30,3.1
20035,2014,17265,16465,800,4.6
20037,2014,19137,18113,1024,5.4
20039,2014,1353,1306,47,3.5
20041,2014,9723,9230,493,5.1
20043,2014,4296,4102,194,4.5
20045,2014,64653,62013,2640,4.1
20047,2014,1605,1552,53,3.3
20049,2014,1308,1241,67,5.1
20051,2014,17910,17417,493,2.8
20053,2014,3446,3344,102,3
20055,2014,20202,19509,693,3.4
20057,2014,18179,17488,691,3.8
20059,2014,14053,13335,718,5.1
20061,2014,12335,11434,901,7.3
20063,2014,1483,1444,39,2.6
20065,2014,1313,1270,43,3.3
20067,2014,3937,3803,134,3.4
20069,2014,3495,3401,94,2.7
20071,2014,897,878,19,2.1
20073,2014,3328,3178,150,4.5
20075,2014,1662,1624,38,2.3
20077,2014,2981,2870,111,3.7
20079,2014,17114,16386,728,4.3
20081,2014,2356,2295,61,2.6
20083,2014,1034,999,35,3.4
20085,2014,7388,7083,305,4.1
20087,2014,10217,9724,493,4.8
20089,2014,1380,1326,54,3.9
20091,2014,320844,308722,12122,3.8
20093,2014,2117,2052,65,3.1
20095,2014,3604,3460,144,4
20097,2014,1350,1306,44,3.3
20099,2014,10775,10147,628,5.8
20101,2014,864,836,28,3.2
20103,2014,35001,33255,1746,5
20105,2014,1772,1699,73,4.1
20107,2014,4320,3998,322,7.5
20109,2014,1734,1695,39,2.2
20111,2014,16517,15671,846,5.1
20113,2014,16828,16282,546,3.2
20115,2014,6141,5891,250,4.1
20117,2014,5877,5687,190,3.2
20119,2014,2380,2317,63,2.6
20121,2014,16858,16062,796,4.7
20123,2014,3835,3710,125,3.3
20125,2014,17339,16343,996,5.7
20127,2014,3097,2960,137,4.4
20129,2014,1489,1430,59,4
20131,2014,5848,5681,167,2.9
20133,2014,6394,5912,482,7.5
20135,2014,1613,1569,44,2.7
20137,2014,3039,2967,72,2.4
20139,2014,8140,7697,443,5.4
20141,2014,2058,1981,77,3.7
20143,2014,3241,3108,133,4.1
20145,2014,3390,3262,128,3.8
20147,2014,2908,2806,102,3.5
20149,2014,12031,11562,469,3.9
20151,2014,5501,5322,179,3.3
20153,2014,1516,1479,37,2.4
20155,2014,31192,29818,1374,4.4
20157,2014,2568,2490,78,3
20159,2014,5448,5256,192,3.5
20161,2014,36581,35230,1351,3.7
20163,2014,2850,2747,103,3.6
20165,2014,1808,1744,64,3.5
20167,2014,3837,3702,135,3.5
20169,2014,30690,29396,1294,4.2
20171,2014,2852,2774,78,2.7
20173,2014,247015,233744,13271,5.4
20175,2014,11156,10766,390,3.5
20177,2014,91878,87492,4386,4.8
20179,2014,1458,1420,38,2.6
20181,2014,3091,2992,99,3.2
20183,2014,2117,2051,66,3.1
20185,2014,2164,2082,82,3.8
20187,2014,1026,992,34,3.3
20189,2014,3365,3264,101,3
20191,2014,11068,10540,528,4.8
20193,2014,4380,4253,127,2.9
20195,2014,1489,1443,46,3.1
20197,2014,3760,3605,155,4.1
20199,2014,876,853,23,2.6
20201,2014,3105,3005,100,3.2
20203,2014,1235,1200,35,2.8
20205,2014,4170,3882,288,6.9
20207,2014,1628,1542,86,5.3
20209,2014,75571,70393,5178,6.9
21001,2014,7225,6600,625,8.7
21003,2014,8669,8157,512,5.9
21005,2014,11430,10835,595,5.2
21007,2014,3676,3382,294,8
21009,2014,18723,17547,1176,6.3
21011,2014,4722,4302,420,8.9
21013,2014,9312,8372,940,10.1
21015,2014,65263,61886,3377,5.2
21017,2014,9649,9106,543,5.6
21019,2014,19080,17641,1439,7.5
21021,2014,12291,11442,849,6.9
21023,2014,3800,3500,300,7.9
21025,2014,4180,3703,477,11.4
21027,2014,8086,7503,583,7.2
21029,2014,39222,36948,2274,5.8
21031,2014,5191,4802,389,7.5
21033,2014,5452,5097,355,6.5
21035,2014,18717,17638,1079,5.8
21037,2014,47891,45410,2481,5.2
21039,2014,2383,2240,143,6
21041,2014,4870,4523,347,7.1
21043,2014,10486,9360,1126,10.7
21045,2014,6621,6170,451,6.8
21047,2014,25430,23496,1934,7.6
21049,2014,16981,15942,1039,6.1
21051,2014,5556,4934,622,11.2
21053,2014,4005,3644,361,9
21055,2014,3873,3633,240,6.2
21057,2014,2951,2727,224,7.6
21059,2014,45947,43342,2605,5.7
21061,2014,4782,4383,399,8.3
21063,2014,2154,1910,244,11.3
21065,2014,5408,5001,407,7.5
21067,2014,167042,159045,7997,4.8
21069,2014,6371,5879,492,7.7
21071,2014,12405,11131,1274,10.3
21073,2014,24366,23076,1290,5.3
21075,2014,2228,2043,185,8.3
21077,2014,3863,3593,270,7
21079,2014,7592,7096,496,6.5
21081,2014,11207,10473,734,6.5
21083,2014,15867,14680,1187,7.5
21085,2014,10866,9954,912,8.4
21087,2014,5083,4751,332,6.5
21089,2014,14295,13075,1220,8.5
21091,2014,3982,3742,240,6
21093,2014,46624,43727,2897,6.2
21095,2014,8402,7230,1172,13.9
21097,2014,8426,7921,505,6
21099,2014,7821,7326,495,6.3
21101,2014,21654,20338,1316,6.1
21103,2014,7643,7203,440,5.8
21105,2014,2129,1997,132,6.2
21107,2014,20419,19105,1314,6.4
21109,2014,4584,4058,526,11.5
21111,2014,377526,354769,22757,6
21113,2014,24917,23610,1307,5.2
21115,2014,8055,7312,743,9.2
21117,2014,83150,78539,4611,5.5
21119,2014,5136,4565,571,11.1
21121,2014,10122,9116,1006,9.9
21123,2014,5767,5387,380,6.6
21125,2014,24135,22294,1841,7.6
21127,2014,5277,4771,506,9.6
21129,2014,2314,2089,225,9.7
21131,2014,3176,2768,408,12.8
21133,2014,7248,6353,895,12.3
21135,2014,5173,4674,499,9.6
21137,2014,9331,8507,824,8.8
21139,2014,3761,3452,309,8.2
21141,2014,11925,11250,675,5.7
21143,2014,2982,2774,208,7
21145,2014,29490,27423,2067,7
21147,2014,5047,4514,533,10.6
21149,2014,4317,4042,275,6.4
21151,2014,45320,42866,2454,5.4
21153,2014,3726,3205,521,14
21155,2014,9194,8607,587,6.4
21157,2014,14964,13956,1008,6.7
21159,2014,3437,3124,313,9.1
21161,2014,7745,7132,613,7.9
21163,2014,12125,11269,856,7.1
21165,2014,2358,2126,232,9.8
21167,2014,9902,9290,612,6.2
21169,2014,4133,3881,252,6.1
21171,2014,4603,4348,255,5.5
21173,2014,11759,10881,878,7.5
21175,2014,4796,4345,451,9.4
21177,2014,12367,11425,942,7.6
21179,2014,21310,20008,1302,6.1
21181,2014,3452,3185,267,7.7
21183,2014,9523,8791,732,7.7
21185,2014,30277,28841,1436,4.7
21187,2014,5526,5249,277,5
21189,2014,1179,1056,123,10.4
21191,2014,6763,6312,451,6.7
21193,2014,9540,8556,984,10.3
21195,2014,22002,19689,2313,10.5
21197,2014,4972,4551,421,8.5
21199,2014,26287,24356,1931,7.3
21201,2014,809,746,63,7.8
21203,2014,6889,6368,521,7.6
21205,2014,10557,9821,736,7
21207,2014,6586,5911,675,10.2
21209,2014,26495,25202,1293,4.9
21211,2014,22505,21391,1114,5
21213,2014,8492,7991,501,5.9
21215,2014,9159,8676,483,5.3
21217,2014,11281,10409,872,7.7
21219,2014,5462,5166,296,5.4
21221,2014,5718,5314,404,7.1
21223,2014,3877,3595,282,7.3
21225,2014,6760,6326,434,6.4
21227,2014,59387,56085,3302,5.6
21229,2014,6125,5793,332,5.4
21231,2014,7259,6556,703,9.7
21233,2014,6291,5948,343,5.5
21235,2014,13408,12237,1171,8.7
21237,2014,2056,1824,232,11.3
21239,2014,14242,13606,636,4.5
22001,2014,26660,25126,1534,5.8
22003,2014,8901,8261,640,7.2
22005,2014,59691,56508,3183,5.3
22007,2014,10064,9289,775,7.7
22009,2014,16135,14970,1165,7.2
22011,2014,14801,13797,1004,6.8
22013,2014,5932,5462,470,7.9
22015,2014,58164,54829,3335,5.7
22017,2014,111121,102857,8264,7.4
22019,2014,94560,88975,5585,5.9
22021,2014,4077,3762,315,7.7
22023,2014,3443,3273,170,4.9
22025,2014,3844,3534,310,8.1
22027,2014,6359,5887,472,7.4
22029,2014,7755,7087,668,8.6
22031,2014,11127,10223,904,8.1
22033,2014,232110,218765,13345,5.7
22035,2014,2221,1896,325,14.6
22037,2014,8191,7663,528,6.4
22039,2014,13137,12249,888,6.8
22041,2014,7599,6882,717,9.4
22043,2014,8412,7813,599,7.1
22045,2014,32577,30517,2060,6.3
22047,2014,14373,13248,1125,7.8
22049,2014,7241,6816,425,5.9
22051,2014,218144,205071,13073,6
22053,2014,13574,12777,797,5.9
22055,2014,122466,116444,6022,4.9
22057,2014,48496,46170,2326,4.8
22059,2014,6630,6284,346,5.2
22061,2014,20682,19123,1559,7.5
22063,2014,66592,62932,3660,5.5
22065,2014,3924,3490,434,11.1
22067,2014,11167,9912,1255,11.2
22069,2014,16902,15589,1313,7.8
22071,2014,179100,166682,12418,6.9
22073,2014,72003,66977,5026,7
22075,2014,10240,9657,583,5.7
22077,2014,10107,9396,711,7
22079,2014,58049,54173,3876,6.7
22081,2014,3992,3704,288,7.2
22083,2014,8723,7964,759,8.7
22085,2014,9213,8610,603,6.5
22087,2014,19230,17897,1333,6.9
22089,2014,25492,23940,1552,6.1
22091,2014,4536,4081,455,10
22093,2014,9772,8931,841,8.6
22095,2014,20388,18759,1629,8
22097,2014,34204,31591,2613,7.6
22099,2014,24678,23260,1418,5.7
22101,2014,25338,23748,1590,6.3
22103,2014,115007,108503,6504,5.7
22105,2014,53770,49673,4097,7.6
22107,2014,1784,1617,167,9.4
22109,2014,54687,52036,2651,4.8
22111,2014,9375,8671,704,7.5
22113,2014,26530,25049,1481,5.6
22115,2014,17437,15949,1488,8.5
22117,2014,16966,15633,1333,7.9
22119,2014,15682,14314,1368,8.7
22121,2014,12886,12137,749,5.8
22123,2014,4244,3691,553,13
22125,2014,5361,5056,305,5.7
22127,2014,5420,5011,409,7.5
23001,2014,55903,52872,3031,5.4
23003,2014,32947,30446,2501,7.6
23005,2014,159182,152163,7019,4.4
23007,2014,14938,13966,972,6.5
23009,2014,29772,27760,2012,6.8
23011,2014,63304,59907,3397,5.4
23013,2014,20643,19584,1059,5.1
23015,2014,17201,16188,1013,5.9
23017,2014,27349,25435,1914,7
23019,2014,78958,74152,4806,6.1
23021,2014,7697,7138,559,7.3
23023,2014,19029,18168,861,4.5
23025,2014,24315,22415,1900,7.8
23027,2014,20834,19579,1255,6
23029,2014,14381,13211,1170,8.1
23031,2014,109863,104207,5656,5.1
24001,2014,33237,30717,2520,7.6
24003,2014,297176,282147,15029,5.1
24005,2014,441060,414224,26836,6.1
24009,2014,47177,44669,2508,5.3
24011,2014,17396,16308,1088,6.3
24013,2014,92495,88055,4440,4.8
24015,2014,52391,48941,3450,6.6
24017,2014,80072,75479,4593,5.7
24019,2014,15771,14449,1322,8.4
24021,2014,127923,121463,6460,5
24023,2014,15526,14419,1107,7.1
24025,2014,135128,127461,7667,5.7
24027,2014,173235,165752,7483,4.3
24029,2014,10338,9674,664,6.4
24031,2014,543806,519929,23877,4.4
24033,2014,485869,456453,29416,6.1
24035,2014,26344,25003,1341,5.1
24037,2014,54022,51124,2898,5.4
24039,2014,9270,8395,875,9.4
24041,2014,19106,18063,1043,5.5
24043,2014,76322,71392,4930,6.5
24045,2014,50031,46162,3869,7.7
24047,2014,25646,22689,2957,11.5
24510,2014,293710,268596,25114,8.6
25001,2014,112047,104026,8021,7.2
25003,2014,65736,61427,4309,6.6
25005,2014,288796,267557,21239,7.4
25007,2014,9475,8724,751,7.9
25009,2014,405075,380815,24260,6
25011,2014,39513,37418,2095,5.3
25013,2014,222233,205366,16867,7.6
25015,2014,87024,82441,4583,5.3
25017,2014,855080,815154,39926,4.7
25019,2014,6964,6532,432,6.2
25021,2014,367315,348954,18361,5
25023,2014,266941,250880,16061,6
25025,2014,415478,393538,21940,5.3
25027,2014,426643,400605,26038,6.1
26001,2014,3827,3420,407,10.6
26003,2014,3317,2971,346,10.4
26005,2014,59723,56480,3243,5.4
26007,2014,13539,12454,1085,8
26009,2014,10066,9108,958,9.5
26011,2014,6395,5686,709,11.1
26013,2014,3464,3074,390,11.3
26015,2014,29947,28323,1624,5.4
26017,2014,53115,49280,3835,7.2
26019,2014,8724,7968,756,8.7
26021,2014,73384,68411,4973,6.8
26023,2014,19284,17999,1285,6.7
26025,2014,64070,60003,4067,6.3
26027,2014,23830,22222,1608,6.7
26029,2014,13093,12025,1068,8.2
26031,2014,10672,9528,1144,10.7
26033,2014,16873,15269,1604,9.5
26035,2014,11917,10742,1175,9.9
26037,2014,39584,37585,1999,5.1
26039,2014,5337,4830,507,9.5
26041,2014,17439,15962,1477,8.5
26043,2014,12851,11974,877,6.8
26045,2014,55740,52542,3198,5.7
26047,2014,17937,16224,1713,9.6
26049,2014,183989,169477,14512,7.9
26051,2014,10036,9103,933,9.3
26053,2014,6695,6099,596,8.9
26055,2014,47932,45036,2896,6
26057,2014,18468,17163,1305,7.1
26059,2014,20499,19062,1437,7
26061,2014,16940,15639,1301,7.7
26063,2014,16541,15403,1138,6.9
26065,2014,145404,136389,9015,6.2
26067,2014,29239,27423,1816,6.2
26069,2014,10300,9296,1004,9.7
26071,2014,5203,4750,453,8.7
26073,2014,35482,33376,2106,5.9
26075,2014,73006,68136,4870,6.7
26077,2014,128073,120871,7202,5.6
26079,2014,7712,6984,728,9.4
26081,2014,336183,319531,16652,5
26083,2014,984,875,109,11.1
26085,2014,3617,3212,405,11.2
26087,2014,39947,36130,3817,9.6
26089,2014,10528,9825,703,6.7
26091,2014,47993,44908,3085,6.4
26093,2014,95604,89549,6055,6.3
26095,2014,2482,2271,211,8.5
26097,2014,5292,4700,592,11.2
26099,2014,421577,388338,33239,7.9
26101,2014,10357,9475,882,8.5
26103,2014,33789,31416,2373,7
26105,2014,14682,13575,1107,7.5
26107,2014,19178,17654,1524,7.9
26109,2014,11726,10918,808,6.9
26111,2014,41613,39074,2539,6.1
26113,2014,7062,6513,549,7.8
26115,2014,76049,71400,4649,6.1
26117,2014,27654,25557,2097,7.6
26119,2014,3156,2747,409,13
26121,2014,77193,71251,5942,7.7
26123,2014,22621,20991,1630,7.2
26125,2014,631312,590414,40898,6.5
26127,2014,12836,11546,1290,10
26129,2014,8595,7751,844,9.8
26131,2014,2381,2109,272,11.4
26133,2014,10213,9340,873,8.5
26135,2014,2978,2626,352,11.8
26137,2014,11208,10297,911,8.1
26139,2014,149245,142082,7163,4.8
26141,2014,5447,4750,697,12.8
26143,2014,7955,7042,913,11.5
26145,2014,89118,82447,6671,7.5
26147,2014,73821,66758,7063,9.6
26149,2014,28863,27182,1681,5.8
26151,2014,19634,17960,1674,8.5
26153,2014,3532,3144,388,11
26155,2014,33253,30744,2509,7.5
26157,2014,25134,22977,2157,8.6
26159,2014,35352,32503,2849,8.1
26161,2014,187194,178063,9131,4.9
26163,2014,769698,695664,74034,9.6
26165,2014,14690,13432,1258,8.6
27001,2014,6773,6320,453,6.7
27003,2014,189012,181179,7833,4.1
27005,2014,17973,17117,856,4.8
27007,2014,23308,22067,1241,5.3
27009,2014,21709,20612,1097,5.1
27011,2014,2593,2478,115,4.4
27013,2014,38535,37210,1325,3.4
27015,2014,14191,13543,648,4.6
27017,2014,17587,16665,922,5.2
27019,2014,54275,52309,1966,3.6
27021,2014,13987,12994,993,7.1
27023,2014,6897,6584,313,4.5
27025,2014,28580,27234,1346,4.7
27027,2014,35232,34032,1200,3.4
27029,2014,4545,4070,475,10.5
27031,2014,3056,2884,172,5.6
27033,2014,5580,5288,292,5.2
27035,2014,31470,29626,1844,5.9
27037,2014,231488,222750,8738,3.8
27039,2014,11250,10781,469,4.2
27041,2014,19873,19132,741,3.7
27043,2014,7374,6989,385,5.2
27045,2014,11025,10540,485,4.4
27047,2014,16245,15541,704,4.3
27049,2014,26726,25673,1053,3.9
27051,2014,3281,3118,163,5
27053,2014,672373,646952,25421,3.8
27055,2014,10356,9897,459,4.4
27057,2014,9436,8833,603,6.4
27059,2014,20236,19213,1023,5.1
27061,2014,21948,20500,1448,6.6
27063,2014,6301,6038,263,4.2
27065,2014,8850,8192,658,7.4
27067,2014,23673,22668,1005,4.2
27069,2014,2390,2273,117,4.9
27071,2014,6433,5889,544,8.5
27073,2014,3651,3477,174,4.8
27075,2014,5682,5421,261,4.6
27077,2014,2387,2273,114,4.8
27079,2014,15483,14648,835,5.4
27081,2014,3280,3138,142,4.3
27083,2014,15283,14731,552,3.6
27085,2014,19821,18906,915,4.6
27087,2014,2361,2228,133,5.6
27089,2014,5590,5212,378,6.8
27091,2014,10219,9738,481,4.7
27093,2014,12859,12267,592,4.6
27095,2014,12681,11830,851,6.7
27097,2014,17393,16306,1087,6.2
27099,2014,20278,19504,774,3.8
27101,2014,4858,4621,237,4.9
27103,2014,19769,19165,604,3.1
27105,2014,11232,10848,384,3.4
27107,2014,3315,3149,166,5
27109,2014,83045,80180,2865,3.4
27111,2014,30881,29478,1403,4.5
27113,2014,8844,8388,456,5.2
27115,2014,14604,13708,896,6.1
27117,2014,4781,4601,180,3.8
27119,2014,17086,16298,788,4.6
27121,2014,6223,5996,227,3.6
27123,2014,277353,266179,11174,4
27125,2014,2259,2128,131,5.8
27127,2014,8001,7648,353,4.4
27129,2014,8205,7753,452,5.5
27131,2014,35104,33660,1444,4.1
27133,2014,5672,5528,144,2.5
27135,2014,8812,8488,324,3.7
27137,2014,102275,97072,5203,5.1
27139,2014,78161,75345,2816,3.6
27141,2014,49201,46967,2234,4.5
27143,2014,8268,7886,382,4.6
27145,2014,87717,84136,3581,4.1
27147,2014,21301,20496,805,3.8
27149,2014,5569,5388,181,3.3
27151,2014,4868,4632,236,4.8
27153,2014,12817,12220,597,4.7
27155,2014,1712,1633,79,4.6
27157,2014,11726,11253,473,4
27159,2014,6142,5760,382,6.2
27161,2014,9670,9205,465,4.8
27163,2014,136043,131092,4951,3.6
27165,2014,6160,5857,303,4.9
27167,2014,3592,3470,122,3.4
27169,2014,29343,28249,1094,3.7
27171,2014,71187,68185,3002,4.2
27173,2014,5487,5260,227,4.1
28001,2014,11621,10656,965,8.3
28003,2014,15162,14158,1004,6.6
28005,2014,4456,4101,355,8
28007,2014,7057,6443,614,8.7
28009,2014,2984,2706,278,9.3
28011,2014,13333,12063,1270,9.5
28013,2014,6251,5786,465,7.4
28015,2014,3418,3095,323,9.4
28017,2014,7218,6520,698,9.7
28019,2014,3584,3293,291,8.1
28021,2014,3115,2661,454,14.6
28023,2014,6281,5717,564,9
28025,2014,7994,6937,1057,13.2
28027,2014,9573,8451,1122,11.7
28029,2014,11189,10199,990,8.8
28031,2014,7854,7337,517,6.6
28033,2014,81496,77157,4339,5.3
28035,2014,32345,29952,2393,7.4
28037,2014,2912,2669,243,8.3
28039,2014,8934,8200,734,8.2
28041,2014,4402,4012,390,8.9
28043,2014,9312,8644,668,7.2
28045,2014,18508,17175,1333,7.2
28047,2014,84931,79239,5692,6.7
28049,2014,108306,100481,7825,7.2
28051,2014,6149,5230,919,14.9
28053,2014,2566,2161,405,15.8
28055,2014,427,353,74,17.3
28057,2014,9916,9209,707,7.1
28059,2014,59196,54485,4711,8
28061,2014,6445,5898,547,8.5
28063,2014,2408,2022,386,16
28065,2014,4126,3705,421,10.2
28067,2014,26718,25073,1645,6.2
28069,2014,3757,3279,478,12.7
28071,2014,23320,21833,1487,6.4
28073,2014,27828,26408,1420,5.1
28075,2014,32630,30190,2440,7.5
28077,2014,4528,4154,374,8.3
28079,2014,7845,7289,556,7.1
28081,2014,38898,36110,2788,7.2
28083,2014,10572,9243,1329,12.6
28085,2014,13769,12862,907,6.6
28087,2014,25310,23110,2200,8.7
28089,2014,49859,47247,2612,5.2
28091,2014,9910,9099,811,8.2
28093,2014,14384,13140,1244,8.6
28095,2014,15487,13933,1554,10
28097,2014,4201,3815,386,9.2
28099,2014,10798,10069,729,6.8
28101,2014,8788,8204,584,6.6
28103,2014,4013,3513,500,12.5
28105,2014,22120,20537,1583,7.2
28107,2014,13437,12025,1412,10.5
28109,2014,22375,20881,1494,6.7
28111,2014,4215,3830,385,9.1
28113,2014,14568,13367,1201,8.2
28115,2014,13510,12595,915,6.8
28117,2014,10877,10065,812,7.5
28119,2014,2755,2396,359,13
28121,2014,71121,67833,3288,4.6
28123,2014,12694,11999,695,5.5
28125,2014,1773,1578,195,11
28127,2014,10781,10094,687,6.4
28129,2014,6738,6350,388,5.8
28131,2014,6342,5803,539,8.5
28133,2014,8674,7594,1080,12.5
28135,2014,5850,5310,540,9.2
28137,2014,11796,10799,997,8.5
28139,2014,8742,8019,723,8.3
28141,2014,7605,7021,584,7.7
28143,2014,4766,4207,559,11.7
28145,2014,12872,12084,788,6.1
28147,2014,5166,4679,487,9.4
28149,2014,20979,19382,1597,7.6
28151,2014,18392,16096,2296,12.5
28153,2014,7750,7066,684,8.8
28155,2014,3971,3632,339,8.5
28157,2014,2840,2516,324,11.4
28159,2014,7165,6453,712,9.9
28161,2014,4931,4478,453,9.2
28163,2014,9293,8372,921,9.9
29001,2014,10596,9912,684,6.5
29003,2014,9853,9345,508,5.2
29005,2014,2872,2717,155,5.4
29007,2014,11238,10609,629,5.6
29009,2014,14807,13898,909,6.1
29011,2014,5487,5142,345,6.3
29013,2014,8099,7526,573,7.1
29015,2014,7177,6619,558,7.8
29017,2014,5644,5262,382,6.8
29019,2014,97642,93570,4072,4.2
29021,2014,46268,43630,2638,5.7
29023,2014,19091,17746,1345,7
29025,2014,4334,4096,238,5.5
29027,2014,21789,20562,1227,5.6
29029,2014,18806,17274,1532,8.1
29031,2014,40671,38449,2222,5.5
29033,2014,4740,4401,339,7.2
29035,2014,2558,2329,229,9
29037,2014,52818,49794,3024,5.7
29039,2014,5862,5489,373,6.4
29041,2014,3851,3628,223,5.8
29043,2014,42202,40124,2078,4.9
29045,2014,3439,3200,239,6.9
29047,2014,129421,122399,7022,5.4
29049,2014,10687,10059,628,5.9
29051,2014,39658,37666,1992,5
29053,2014,7651,7194,457,6
29055,2014,10891,10019,872,8
29057,2014,3509,3298,211,6
29059,2014,6968,6437,531,7.6
29061,2014,4036,3801,235,5.8
29063,2014,4973,4703,270,5.4
29065,2014,6270,5846,424,6.8
29067,2014,5029,4644,385,7.7
29069,2014,13140,11948,1192,9.1
29071,2014,52096,48725,3371,6.5
29073,2014,7619,7216,403,5.3
29075,2014,3636,3430,206,5.7
29077,2014,147361,140197,7164,4.9
29079,2014,4901,4642,259,5.3
29081,2014,3982,3721,261,6.6
29083,2014,10123,9465,658,6.5
29085,2014,3697,3388,309,8.4
29087,2014,2697,2565,132,4.9
29089,2014,4989,4720,269,5.4
29091,2014,16281,15118,1163,7.1
29093,2014,3926,3538,388,9.9
29095,2014,357424,332011,25413,7.1
29097,2014,57747,54690,3057,5.3
29099,2014,116368,109123,7245,6.2
29101,2014,22810,21340,1470,6.4
29103,2014,1971,1880,91,4.6
29105,2014,15906,14619,1287,8.1
29107,2014,16963,15952,1011,6
29109,2014,17479,16449,1030,5.9
29111,2014,5159,4890,269,5.2
29113,2014,26578,24850,1728,6.5
29115,2014,5223,4797,426,8.2
29117,2014,7309,6941,368,5
29119,2014,10292,9695,597,5.8
29121,2014,7450,6992,458,6.1
29123,2014,5503,5122,381,6.9
29125,2014,3973,3726,247,6.2
29127,2014,14632,13822,810,5.5
29129,2014,1870,1775,95,5.1
29131,2014,11646,10747,899,7.7
29133,2014,6267,5811,456,7.3
29135,2014,7384,6942,442,6
29137,2014,4186,3918,268,6.4
29139,2014,5687,5351,336,5.9
29141,2014,7967,7276,691,8.7
29143,2014,8465,7837,628,7.4
29145,2014,28439,26903,1536,5.4
29147,2014,11103,10345,758,6.8
29149,2014,4145,3834,311,7.5
29151,2014,7227,6890,337,4.7
29153,2014,3666,3337,329,9
29155,2014,7100,6439,661,9.3
29157,2014,10282,9723,559,5.4
29159,2014,20660,19393,1267,6.1
29161,2014,19441,18183,1258,6.5
29163,2014,8149,7685,464,5.7
29165,2014,53995,51234,2761,5.1
29167,2014,14115,13218,897,6.4
29169,2014,15225,14120,1105,7.3
29171,2014,2492,2366,126,5.1
29173,2014,5641,5343,298,5.3
29175,2014,10569,9823,746,7.1
29177,2014,11136,10377,759,6.8
29179,2014,2693,2468,225,8.4
29181,2014,5568,5111,457,8.2
29183,2014,212198,201966,10232,4.8
29185,2014,3989,3683,306,7.7
29186,2014,9079,8477,602,6.6
29187,2014,26319,24310,2009,7.6
29189,2014,529310,498504,30806,5.8
29195,2014,11245,10613,632,5.6
29197,2014,1890,1750,140,7.4
29199,2014,2393,2278,115,4.8
29201,2014,19874,18567,1307,6.6
29203,2014,3427,3105,322,9.4
29205,2014,3059,2875,184,6
29207,2014,13153,12126,1027,7.8
29209,2014,13318,12029,1289,9.7
29211,2014,2741,2560,181,6.6
29213,2014,25745,23227,2518,9.8
29215,2014,9437,8691,746,7.9
29217,2014,9836,9282,554,5.6
29219,2014,17114,16061,1053,6.2
29221,2014,10469,9572,897,8.6
29223,2014,5654,5234,420,7.4
29225,2014,16304,15318,986,6
29227,2014,1295,1242,53,4.1
29229,2014,7644,7087,557,7.3
29510,2014,160134,148002,12132,7.6
30001,2014,4865,4685,180,3.7
30003,2014,5592,5032,560,10
30005,2014,2432,2291,141,5.8
30007,2014,2500,2366,134,5.4
30009,2014,5386,5176,210,3.9
30011,2014,686,664,22,3.2
30013,2014,38271,36623,1648,4.3
30015,2014,2590,2506,84,3.2
30017,2014,6588,6376,212,3.2
30019,2014,951,922,29,3
30021,2014,4862,4734,128,2.6
30023,2014,5236,5008,228,4.4
30025,2014,2072,2032,40,1.9
30027,2014,5741,5494,247,4.3
30029,2014,43747,40921,2826,6.5
30031,2014,56846,54862,1984,3.5
30033,2014,747,727,20,2.7
30035,2014,5953,5325,628,10.5
30037,2014,392,374,18,4.6
30039,2014,1526,1422,104,6.8
30041,2014,7828,7375,453,5.8
30043,2014,5628,5369,259,4.6
30045,2014,966,925,41,4.2
30047,2014,12480,11787,693,5.6
30049,2014,35194,33885,1309,3.7
30051,2014,972,942,30,3.1
30053,2014,7917,7030,887,11.2
30055,2014,1088,1063,25,2.3
30057,2014,4228,4033,195,4.6
30059,2014,907,868,39,4.3
30061,2014,1746,1587,159,9.1
30063,2014,59924,57262,2662,4.4
30065,2014,2361,2265,96,4.1
30067,2014,8063,7611,452,5.6
30069,2014,284,272,12,4.2
30071,2014,1992,1886,106,5.3
30073,2014,2841,2701,140,4.9
30075,2014,1075,1042,33,3.1
30077,2014,2935,2788,147,5
30079,2014,514,492,22,4.3
30081,2014,18779,17643,1136,6
30083,2014,7322,7147,175,2.4
30085,2014,4818,4569,249,5.2
30087,2014,4173,3937,236,5.7
30089,2014,4636,4204,432,9.3
30091,2014,2128,2072,56,2.6
30093,2014,17009,16170,839,4.9
30095,2014,4994,4807,187,3.7
30097,2014,1781,1718,63,3.5
30099,2014,2880,2772,108,3.8
30101,2014,2346,2275,71,3
30103,2014,346,332,14,4
30105,2014,4361,4229,132,3
30107,2014,782,743,39,5
30109,2014,550,534,16,2.9
30111,2014,79413,76460,2953,3.7
31001,2014,16697,16132,565,3.4
31003,2014,3586,3489,97,2.7
31005,2014,224,212,12,5.4
31007,2014,436,420,16,3.7
31009,2014,274,262,12,4.4
31011,2014,3020,2941,79,2.6
31013,2014,5736,5557,179,3.1
31015,2014,1098,1062,36,3.3
31017,2014,1418,1369,49,3.5
31019,2014,27445,26687,758,2.8
31021,2014,3578,3438,140,3.9
31023,2014,4821,4678,143,3
31025,2014,13220,12727,493,3.7
31027,2014,4661,4553,108,2.3
31029,2014,2344,2296,48,2
31031,2014,3410,3327,83,2.4
31033,2014,5740,5615,125,2.2
31035,2014,3457,3344,113,3.3
31037,2014,5614,5447,167,3
31039,2014,4943,4813,130,2.6
31041,2014,6126,5978,148,2.4
31043,2014,11034,10622,412,3.7
31045,2014,5278,5123,155,2.9
31047,2014,13316,12854,462,3.5
31049,2014,1090,1060,30,2.8
31051,2014,3053,2960,93,3
31053,2014,19196,18496,700,3.6
31055,2014,286124,275745,10379,3.6
31057,2014,1275,1246,29,2.3
31059,2014,3241,3163,78,2.4
31061,2014,1574,1524,50,3.2
31063,2014,1549,1506,43,2.8
31065,2014,2706,2628,78,2.9
31067,2014,11073,10615,458,4.1
31069,2014,1191,1157,34,2.9
31071,2014,1200,1169,31,2.6
31073,2014,1135,1101,34,3
31075,2014,428,418,10,2.3
31077,2014,1270,1229,41,3.2
31079,2014,32357,31093,1264,3.9
31081,2014,4757,4614,143,3
31083,2014,1799,1752,47,2.6
31085,2014,627,609,18,2.9
31087,2014,1339,1293,46,3.4
31089,2014,5914,5757,157,2.7
31091,2014,423,405,18,4.3
31093,2014,3362,3237,125,3.7
31095,2014,4293,4162,131,3.1
31097,2014,2166,2083,83,3.8
31099,2014,3843,3749,94,2.4
31101,2014,4659,4525,134,2.9
31103,2014,619,602,17,2.7
31105,2014,2224,2168,56,2.5
31107,2014,4726,4579,147,3.1
31109,2014,167759,162752,5007,3
31111,2014,18707,18099,608,3.3
31113,2014,494,479,15,3
31115,2014,381,366,15,3.9
31117,2014,438,428,10,2.3
31119,2014,19460,18886,574,2.9
31121,2014,4108,3953,155,3.8
31123,2014,2678,2597,81,3
31125,2014,2068,2012,56,2.7
31127,2014,3722,3578,144,3.9
31129,2014,2401,2333,68,2.8
31131,2014,8233,7928,305,3.7
31133,2014,1651,1605,46,2.8
31135,2014,1849,1810,39,2.1
31137,2014,5046,4915,131,2.6
31139,2014,4234,4112,122,2.9
31141,2014,17292,16776,516,3
31143,2014,2959,2864,95,3.2
31145,2014,6280,6118,162,2.6
31147,2014,4271,4115,156,3.7
31149,2014,882,859,23,2.6
31151,2014,7225,6976,249,3.4
31153,2014,89703,86921,2782,3.1
31155,2014,11004,10621,383,3.5
31157,2014,18729,18049,680,3.6
31159,2014,8834,8562,272,3.1
31161,2014,2777,2704,73,2.6
31163,2014,1725,1668,57,3.3
31165,2014,805,785,20,2.5
31167,2014,3571,3471,100,2.8
31169,2014,3028,2951,77,2.5
31171,2014,427,412,15,3.5
31173,2014,3017,2834,183,6.1
31175,2014,2115,2051,64,3
31177,2014,11029,10673,356,3.2
31179,2014,5560,5404,156,2.8
31181,2014,1726,1668,58,3.4
31183,2014,558,542,16,2.9
31185,2014,7386,7152,234,3.2
32001,2014,10838,10017,821,7.6
32003,2014,1015138,934013,81125,8
32005,2014,22293,20508,1785,8
32007,2014,28094,26532,1562,5.6
32009,2014,530,506,24,4.5
32011,2014,1031,970,61,5.9
32013,2014,8925,8371,554,6.2
32015,2014,3357,3136,221,6.6
32017,2014,1931,1787,144,7.5
32019,2014,22792,20469,2323,10.2
32021,2014,1653,1467,186,11.3
32023,2014,16247,14684,1563,9.6
32027,2014,2594,2407,187,7.2
32029,2014,1840,1673,167,9.1
32031,2014,221758,204965,16793,7.6
32033,2014,4869,4576,293,6
32510,2014,24881,22728,2153,8.7
33001,2014,31670,30351,1319,4.2
33003,2014,24216,23199,1017,4.2
33005,2014,42101,40402,1699,4
33007,2014,15179,14317,862,5.7
33009,2014,48557,46884,1673,3.4
33011,2014,229068,218783,10285,4.5
33013,2014,81047,77950,3097,3.8
33015,2014,176958,168803,8155,4.6
33017,2014,70746,67921,2825,4
33019,2014,23776,22939,837,3.5
34001,2014,131786,117879,13907,10.6
34003,2014,477459,451477,25982,5.4
34005,2014,228530,213837,14693,6.4
34007,2014,251710,232309,19401,7.7
34009,2014,48551,42607,5944,12.2
34011,2014,67609,60908,6701,9.9
34013,2014,373430,343438,29992,8
34015,2014,147452,136672,10780,7.3
34017,2014,357191,334435,22756,6.4
34019,2014,65322,62135,3187,4.9
34021,2014,193885,182465,11420,5.9
34023,2014,432008,405617,26391,6.1
34025,2014,325525,305755,19770,6.1
34027,2014,260268,247132,13136,5
34029,2014,264480,244949,19531,7.4
34031,2014,246941,226555,20386,8.3
34033,2014,31079,28435,2644,8.5
34035,2014,172461,163446,9015,5.2
34037,2014,76996,72043,4953,6.4
34039,2014,277500,258188,19312,7
34041,2014,56857,53260,3597,6.3
35001,2014,322039,302055,19984,6.2
35003,2014,1195,1095,100,8.4
35005,2014,27242,25575,1667,6.1
35006,2014,9118,8337,781,8.6
35007,2014,6183,5794,389,6.3
35009,2014,21805,20699,1106,5.1
35011,2014,845,805,40,4.7
35013,2014,94444,87556,6888,7.3
35015,2014,29198,27904,1294,4.4
35017,2014,12583,11752,831,6.6
35019,2014,1623,1498,125,7.7
35021,2014,320,304,16,5
35023,2014,2159,2005,154,7.1
35025,2014,30873,29516,1357,4.4
35027,2014,8851,8319,532,6
35028,2014,8504,8153,351,4.1
35029,2014,11429,9362,2067,18.1
35031,2014,24071,21632,2439,10.1
35033,2014,2277,2026,251,11
35035,2014,24876,23320,1556,6.3
35037,2014,3321,3103,218,6.6
35039,2014,16597,15141,1456,8.8
35041,2014,8167,7714,453,5.5
35043,2014,61522,57119,4403,7.2
35045,2014,55607,52058,3549,6.4
35047,2014,11058,10158,900,8.1
35049,2014,73022,69048,3974,5.4
35051,2014,3971,3606,365,9.2
35053,2014,6510,6031,479,7.4
35055,2014,15109,13612,1497,9.9
35057,2014,5603,5054,549,9.8
35059,2014,1913,1825,88,4.6
35061,2014,29723,27385,2338,7.9
36001,2014,157231,149537,7694,4.9
36003,2014,23317,21866,1451,6.2
36005,2014,603659,544535,59124,9.8
36007,2014,87974,82128,5846,6.6
36009,2014,36618,34052,2566,7
36011,2014,37606,35352,2254,6
36013,2014,57764,53827,3937,6.8
36015,2014,38162,35772,2390,6.3
36017,2014,23178,21737,1441,6.2
36019,2014,35975,33595,2380,6.6
36021,2014,31318,29840,1478,4.7
36023,2014,23656,22116,1540,6.5
36025,2014,20026,18710,1316,6.6
36027,2014,142208,134639,7569,5.3
36029,2014,448357,420978,27379,6.1
36031,2014,17545,16336,1209,6.9
36033,2014,20508,19019,1489,7.3
36035,2014,23430,21632,1798,7.7
36037,2014,30017,28353,1664,5.5
36039,2014,20711,19311,1400,6.8
36041,2014,2429,2248,181,7.5
36043,2014,28845,26887,1958,6.8
36045,2014,46594,43045,3549,7.6
36047,2014,1213629,1121072,92557,7.6
36049,2014,11864,10932,932,7.9
36051,2014,30942,29148,1794,5.8
36053,2014,33417,31271,2146,6.4
36055,2014,364428,343276,21152,5.8
36057,2014,22262,20597,1665,7.5
36059,2014,685576,652794,32782,4.8
36061,2014,904995,849573,55422,6.1
36063,2014,101512,94377,7135,7
36065,2014,103148,96844,6304,6.1
36067,2014,224609,212105,12504,5.6
36069,2014,54760,51895,2865,5.2
36071,2014,175397,165754,9643,5.5
36073,2014,18042,16659,1383,7.7
36075,2014,55045,50595,4450,8.1
36077,2014,29997,28284,1713,5.7
36079,2014,50255,47786,2469,4.9
36081,2014,1149016,1075856,73160,6.4
36083,2014,81138,76775,4363,5.4
36085,2014,219682,203323,16359,7.4
36087,2014,149322,141622,7700,5.2
36089,2014,47068,43413,3655,7.8
36091,2014,115624,110226,5398,4.7
36093,2014,76083,71998,4085,5.4
36095,2014,14737,13749,988,6.7
36097,2014,8603,7999,604,7
36099,2014,15513,14639,874,5.6
36101,2014,44082,41043,3039,6.9
36103,2014,765958,724675,41283,5.4
36105,2014,33269,31082,2187,6.6
36107,2014,23775,22323,1452,6.1
36109,2014,54746,52342,2404,4.4
36111,2014,87975,82958,5017,5.7
36113,2014,32293,30163,2130,6.6
36115,2014,28560,26820,1740,6.1
36117,2014,44400,41655,2745,6.2
36119,2014,470532,446378,24154,5.1
36121,2014,18350,17153,1197,6.5
36123,2014,11690,11028,662,5.7
37001,2014,76788,72425,4363,5.7
37003,2014,17462,16479,983,5.6
37005,2014,4390,4090,300,6.8
37007,2014,10916,10142,774,7.1
37009,2014,12411,11559,852,6.9
37011,2014,7649,7148,501,6.5
37013,2014,20086,18609,1477,7.4
37015,2014,8521,7847,674,7.9
37017,2014,14293,12951,1342,9.4
37019,2014,47692,43921,3771,7.9
37021,2014,127701,121692,6009,4.7
37023,2014,39356,36903,2453,6.2
37025,2014,94294,88799,5495,5.8
37027,2014,35485,32905,2580,7.3
37029,2014,4551,4273,278,6.1
37031,2014,31073,29138,1935,6.2
37033,2014,9652,8955,697,7.2
37035,2014,74635,69887,4748,6.4
37037,2014,32234,30657,1577,4.9
37039,2014,11102,10313,789,7.1
37041,2014,5678,5229,449,7.9
37043,2014,4102,3833,269,6.6
37045,2014,45968,42610,3358,7.3
37047,2014,23019,21056,1963,8.5
37049,2014,41085,38241,2844,6.9
37051,2014,127529,117233,10296,8.1
37053,2014,12710,11907,803,6.3
37055,2014,20109,18413,1696,8.4
37057,2014,78367,73417,4950,6.3
37059,2014,19674,18520,1154,5.9
37061,2014,26579,24879,1700,6.4
37063,2014,152918,145077,7841,5.1
37065,2014,23234,20836,2398,10.3
37067,2014,177241,166593,10648,6
37069,2014,28290,26445,1845,6.5
37071,2014,100790,93923,6867,6.8
37073,2014,5194,4886,308,5.9
37075,2014,3317,2874,443,13.4
37077,2014,28123,26596,1527,5.4
37079,2014,9411,8823,588,6.2
37081,2014,253255,236650,16605,6.6
37083,2014,21260,19200,2060,9.7
37085,2014,49364,45717,3647,7.4
37087,2014,27241,25653,1588,5.8
37089,2014,49410,46914,2496,5.1
37091,2014,9381,8686,695,7.4
37093,2014,19390,17769,1621,8.4
37095,2014,2199,1996,203,9.2
37097,2014,79927,74888,5039,6.3
37099,2014,18360,17132,1228,6.7
37101,2014,85844,80958,4886,5.7
37103,2014,4487,4189,298,6.6
37105,2014,25012,22966,2046,8.2
37107,2014,27845,25854,1991,7.2
37109,2014,39627,37184,2443,6.2
37111,2014,20795,19461,1334,6.4
37113,2014,15033,14038,995,6.6
37115,2014,9395,8808,587,6.2
37117,2014,9881,9108,773,7.8
37119,2014,547830,514977,32853,6
37121,2014,6534,6028,506,7.7
37123,2014,11468,10735,733,6.4
37125,2014,38167,35829,2338,6.1
37127,2014,44229,40700,3529,8
37129,2014,110518,103947,6571,5.9
37131,2014,7942,7302,640,8.1
37133,2014,64004,60102,3902,6.1
37135,2014,72655,69277,3378,4.6
37137,2014,5300,4948,352,6.6
37139,2014,17273,15879,1394,8.1
37141,2014,25303,23507,1796,7.1
37143,2014,5100,4702,398,7.8
37145,2014,17937,16544,1393,7.8
37147,2014,87449,81808,5641,6.5
37149,2014,8404,7953,451,5.4
37151,2014,66615,62250,4365,6.6
37153,2014,16931,15414,1517,9
37155,2014,51109,46270,4839,9.5
37157,2014,41107,38027,3080,7.5
37159,2014,62422,58012,4410,7.1
37161,2014,25447,23268,2179,8.6
37163,2014,29629,27710,1919,6.5
37165,2014,11991,10557,1434,12
37167,2014,28518,26792,1726,6.1
37169,2014,21777,20455,1322,6.1
37171,2014,32998,30962,2036,6.2
37173,2014,6487,5901,586,9
37175,2014,13339,12558,781,5.9
37177,2014,1554,1399,155,10
37179,2014,108767,103054,5713,5.3
37181,2014,18054,16367,1687,9.3
37183,2014,523322,497564,25758,4.9
37185,2014,7218,6576,642,8.9
37187,2014,5039,4553,486,9.6
37189,2014,27026,25624,1402,5.2
37191,2014,53843,50391,3452,6.4
37193,2014,29532,27578,1954,6.6
37195,2014,37615,34040,3575,9.5
37197,2014,17520,16525,995,5.7
37199,2014,7488,6981,507,6.8
38001,2014,1111,1081,30,2.7
38003,2014,5587,5415,172,3.1
38005,2014,2509,2347,162,6.5
38007,2014,490,476,14,2.9
38009,2014,3253,3142,111,3.4
38011,2014,1891,1857,34,1.8
38013,2014,1296,1263,33,2.5
38015,2014,47374,46219,1155,2.4
38017,2014,92639,90401,2238,2.4
38019,2014,2049,1990,59,2.9
38021,2014,2583,2531,52,2
38023,2014,1870,1842,28,1.5
38025,2014,4290,4236,54,1.3
38027,2014,1289,1218,71,5.5
38029,2014,1558,1471,87,5.6
38031,2014,1629,1580,49,3
38033,2014,974,954,20,2.1
38035,2014,36921,35899,1022,2.8
38037,2014,1295,1259,36,2.8
38039,2014,1183,1155,28,2.4
38041,2014,1536,1504,32,2.1
38043,2014,1278,1228,50,3.9
38045,2014,2255,2201,54,2.4
38047,2014,927,899,28,3
38049,2014,3298,3161,137,4.2
38051,2014,1244,1207,37,3
38053,2014,9177,9039,138,1.5
38055,2014,4880,4687,193,4
38057,2014,4142,3980,162,3.9
38059,2014,15932,15413,519,3.3
38061,2014,9044,8929,115,1.3
38063,2014,1530,1473,57,3.7
38065,2014,880,824,56,6.4
38067,2014,3596,3396,200,5.6
38069,2014,1802,1726,76,4.2
38071,2014,5664,5464,200,3.5
38073,2014,2727,2650,77,2.8
38075,2014,1404,1368,36,2.6
38077,2014,8503,8246,257,3
38079,2014,4782,4238,544,11.4
38081,2014,2162,2114,48,2.2
38083,2014,723,688,35,4.8
38085,2014,1298,1238,60,4.6
38087,2014,510,500,10,2
38089,2014,21294,20951,343,1.6
38091,2014,1027,1004,23,2.2
38093,2014,10420,10133,287,2.8
38095,2014,1233,1190,43,3.5
38097,2014,4451,4335,116,2.6
38099,2014,5565,5308,257,4.6
38101,2014,34480,33577,903,2.6
38103,2014,2189,2094,95,4.3
38105,2014,31802,31423,379,1.2
39001,2014,10511,9543,968,9.2
39003,2014,48333,45525,2808,5.8
39005,2014,25539,24013,1526,6
39007,2014,44917,41690,3227,7.2
39009,2014,27597,25699,1898,6.9
39011,2014,24129,23081,1048,4.3
39013,2014,31814,29671,2143,6.7
39015,2014,19679,18207,1472,7.5
39017,2014,186495,176122,10373,5.6
39019,2014,13567,12732,835,6.2
39021,2014,19924,18913,1011,5.1
39023,2014,64952,61183,3769,5.8
39025,2014,102547,96913,5634,5.5
39027,2014,16940,15633,1307,7.7
39029,2014,50085,46839,3246,6.5
39031,2014,15769,14576,1193,7.6
39033,2014,19577,18259,1318,6.7
39035,2014,618619,580181,38438,6.2
39037,2014,26129,24732,1397,5.3
39039,2014,18947,17903,1044,5.5
39041,2014,100360,96223,4137,4.1
39043,2014,37400,34992,2408,6.4
39045,2014,74634,70750,3884,5.2
39047,2014,14132,13282,850,6
39049,2014,647175,615598,31577,4.9
39051,2014,22357,21034,1323,5.9
39053,2014,12402,11444,958,7.7
39055,2014,49265,46802,2463,5
39057,2014,79695,75506,4189,5.3
39059,2014,19085,17797,1288,6.7
39061,2014,401330,379328,22002,5.5
39063,2014,40428,38623,1805,4.5
39065,2014,15103,14237,866,5.7
39067,2014,7351,6905,446,6.1
39069,2014,13744,12853,891,6.5
39071,2014,17319,15972,1347,7.8
39073,2014,13174,12320,854,6.5
39075,2014,19891,19089,802,4
39077,2014,27875,25640,2235,8
39079,2014,13219,12052,1167,8.8
39081,2014,29780,27351,2429,8.2
39083,2014,31112,29459,1653,5.3
39085,2014,125007,118136,6871,5.5
39087,2014,25834,24105,1729,6.7
39089,2014,86613,82052,4561,5.3
39091,2014,23075,21913,1162,5
39093,2014,150956,141295,9661,6.4
39095,2014,208806,195371,13435,6.4
39097,2014,20450,19477,973,4.8
39099,2014,107937,100671,7266,6.7
39101,2014,27856,26179,1677,6
39103,2014,95319,90543,4776,5
39105,2014,9183,8353,830,9
39107,2014,22648,21782,866,3.8
39109,2014,52044,49228,2816,5.4
39111,2014,5874,5225,649,11
39113,2014,248980,233644,15336,6.2
39115,2014,6664,6143,521,7.8
39117,2014,16794,15791,1003,6
39119,2014,39331,36526,2805,7.1
39121,2014,5080,4692,388,7.6
39123,2014,21485,19838,1647,7.7
39125,2014,9009,8512,497,5.5
39127,2014,15809,14640,1169,7.4
39129,2014,25790,24328,1462,5.7
39131,2014,10499,9544,955,9.1
39133,2014,86796,81694,5102,5.9
39135,2014,21126,19917,1209,5.7
39137,2014,18639,17790,849,4.6
39139,2014,54494,50923,3571,6.6
39141,2014,33651,31491,2160,6.4
39143,2014,31280,29482,1798,5.7
39145,2014,29871,27248,2623,8.8
39147,2014,27153,25589,1564,5.8
39149,2014,23641,22431,1210,5.1
39151,2014,188190,177238,10952,5.8
39153,2014,272138,256027,16111,5.9
39155,2014,92565,85834,6731,7.3
39157,2014,45297,42780,2517,5.6
39159,2014,26793,25595,1198,4.5
39161,2014,14399,13694,705,4.9
39163,2014,5512,5069,443,8
39165,2014,110916,105384,5532,5
39167,2014,28218,26408,1810,6.4
39169,2014,59502,56731,2771,4.7
39171,2014,18775,17749,1026,5.5
39173,2014,69133,65521,3612,5.2
39175,2014,12349,11804,545,4.4
40001,2014,8095,7447,648,8
40003,2014,3090,3014,76,2.5
40005,2014,4799,4504,295,6.1
40007,2014,3097,3011,86,2.8
40009,2014,12752,12393,359,2.8
40011,2014,4483,4328,155,3.5
40013,2014,17849,16986,863,4.8
40015,2014,11141,10538,603,5.4
40017,2014,65881,63544,2337,3.5
40019,2014,22017,21040,977,4.4
40021,2014,18520,17404,1116,6
40023,2014,5813,5332,481,8.3
40025,2014,1274,1238,36,2.8
40027,2014,135716,130731,4985,3.7
40029,2014,2298,2144,154,6.7
40031,2014,49297,46997,2300,4.7
40033,2014,2849,2718,131,4.6
40035,2014,6052,5718,334,5.5
40037,2014,30961,29420,1541,5
40039,2014,15898,15405,493,3.1
40041,2014,17100,16107,993,5.8
40043,2014,2402,2327,75,3.1
40045,2014,2337,2267,70,3
40047,2014,29645,28589,1056,3.6
40049,2014,12625,12112,513,4.1
40051,2014,25397,24380,1017,4
40053,2014,2808,2734,74,2.6
40055,2014,2032,1938,94,4.6
40057,2014,1278,1226,52,4.1
40059,2014,1970,1916,54,2.7
40061,2014,4341,4018,323,7.4
40063,2014,5642,5247,395,7
40065,2014,10657,10199,458,4.3
40067,2014,2583,2463,120,4.6
40069,2014,3631,3377,254,7
40071,2014,19276,18178,1098,5.7
40073,2014,7959,7714,245,3.1
40075,2014,4055,3890,165,4.1
40077,2014,3959,3666,293,7.4
40079,2014,19364,18032,1332,6.9
40081,2014,15487,14787,700,4.5
40083,2014,20983,20143,840,4
40085,2014,5432,5237,195,3.6
40087,2014,18112,17445,667,3.7
40089,2014,14151,13009,1142,8.1
40091,2014,7038,6390,648,9.2
40093,2014,4356,4244,112,2.6
40095,2014,6932,6599,333,4.8
40097,2014,18771,17857,914,4.9
40099,2014,6548,6273,275,4.2
40101,2014,29290,27615,1675,5.7
40103,2014,5538,5335,203,3.7
40105,2014,4753,4463,290,6.1
40107,2014,4452,4184,268,6
40109,2014,369494,354038,15456,4.2
40111,2014,15989,14904,1085,6.8
40113,2014,20964,19890,1074,5.1
40115,2014,13802,12870,932,6.8
40117,2014,7304,6917,387,5.3
40119,2014,38372,36937,1435,3.7
40121,2014,17156,16103,1053,6.1
40123,2014,17758,16990,768,4.3
40125,2014,32112,30594,1518,4.7
40127,2014,4695,4345,350,7.5
40129,2014,1794,1744,50,2.8
40131,2014,43698,41863,1835,4.2
40133,2014,9564,8910,654,6.8
40135,2014,16678,15538,1140,6.8
40137,2014,20291,19386,905,4.5
40139,2014,9342,8998,344,3.7
40141,2014,3294,3141,153,4.6
40143,2014,311497,298129,13368,4.3
40145,2014,35574,34064,1510,4.2
40147,2014,24453,23416,1037,4.2
40149,2014,5601,5409,192,3.4
40151,2014,5287,5144,143,2.7
40153,2014,10761,10428,333,3.1
41001,2014,6709,6149,560,8.3
41003,2014,44306,42067,2239,5.1
41005,2014,200674,188359,12315,6.1
41007,2014,18007,16820,1187,6.6
41009,2014,22361,20482,1879,8.4
41011,2014,26037,23705,2332,9
41013,2014,9007,8124,883,9.8
41015,2014,8618,7746,872,10.1
41017,2014,80974,74716,6258,7.7
41019,2014,44014,39987,4027,9.1
41021,2014,824,758,66,8
41023,2014,3134,2805,329,10.5
41025,2014,3278,2963,315,9.6
41027,2014,13719,12972,747,5.4
41029,2014,96590,88481,8109,8.4
41031,2014,9380,8546,834,8.9
41033,2014,32744,29678,3066,9.4
41035,2014,28574,25906,2668,9.3
41037,2014,3491,3156,335,9.6
41039,2014,169150,157488,11662,6.9
41041,2014,20532,18928,1604,7.8
41043,2014,54049,49668,4381,8.1
41045,2014,12026,11074,952,7.9
41047,2014,149146,138180,10966,7.4
41049,2014,5473,5096,377,6.9
41051,2014,419257,394554,24703,5.9
41053,2014,35485,33067,2418,6.8
41055,2014,881,815,66,7.5
41057,2014,11158,10386,772,6.9
41059,2014,35255,32524,2731,7.7
41061,2014,11581,10742,839,7.2
41063,2014,3206,2886,320,10
41065,2014,13563,12673,890,6.6
41067,2014,292947,276570,16377,5.6
41069,2014,729,684,45,6.2
41071,2014,49992,46773,3219,6.4
42001,2014,55103,52576,2527,4.6
42003,2014,646276,611659,34617,5.4
42005,2014,33133,30999,2134,6.4
42007,2014,85879,80318,5561,6.5
42009,2014,24249,22648,1601,6.6
42011,2014,210887,199318,11569,5.5
42013,2014,60914,57424,3490,5.7
42015,2014,31609,29893,1716,5.4
42017,2014,335113,317554,17559,5.2
42019,2014,97387,92467,4920,5.1
42021,2014,62972,58579,4393,7
42023,2014,2298,2136,162,7
42025,2014,31568,29330,2238,7.1
42027,2014,77594,74263,3331,4.3
42029,2014,273734,262363,11371,4.2
42031,2014,18428,17274,1154,6.3
42033,2014,36679,34036,2643,7.2
42035,2014,18956,17576,1380,7.3
42037,2014,34213,32089,2124,6.2
42039,2014,41232,38844,2388,5.8
42041,2014,126046,120397,5649,4.5
42043,2014,139261,131829,7432,5.3
42045,2014,290038,274034,16004,5.5
42047,2014,16349,15510,839,5.1
42049,2014,134566,126246,8320,6.2
42051,2014,58440,53844,4596,7.9
42053,2014,1929,1774,155,8
42055,2014,76476,72318,4158,5.4
42057,2014,7298,6782,516,7.1
42059,2014,18507,17477,1030,5.6
42061,2014,19850,18284,1566,7.9
42063,2014,43182,40565,2617,6.1
42065,2014,20844,19510,1334,6.4
42067,2014,11849,11181,668,5.6
42069,2014,106658,99644,7014,6.6
42071,2014,272451,259896,12555,4.6
42073,2014,42587,39942,2645,6.2
42075,2014,70094,66624,3470,5
42077,2014,182924,171834,11090,6.1
42079,2014,158948,147310,11638,7.3
42081,2014,61499,57723,3776,6.1
42083,2014,19306,18071,1235,6.4
42085,2014,53041,49934,3107,5.9
42087,2014,21084,19734,1350,6.4
42089,2014,79785,73770,6015,7.5
42091,2014,436360,416063,20297,4.7
42093,2014,9235,8805,430,4.7
42095,2014,155242,146019,9223,5.9
42097,2014,43906,40959,2947,6.7
42099,2014,24000,22762,1238,5.2
42101,2014,690640,634680,55960,8.1
42103,2014,25070,23168,1902,7.6
42105,2014,7565,7007,558,7.4
42107,2014,68945,64064,4881,7.1
42109,2014,19849,18826,1023,5.2
42111,2014,34988,32432,2556,7.3
42113,2014,3058,2871,187,6.1
42115,2014,21434,20163,1271,5.9
42117,2014,20445,19029,1416,6.9
42119,2014,19118,18167,951,5
42121,2014,24677,23220,1457,5.9
42123,2014,20163,19101,1062,5.3
42125,2014,106119,100012,6107,5.8
42127,2014,22330,20900,1430,6.4
42129,2014,183129,172616,10513,5.7
42131,2014,14266,13317,949,6.7
42133,2014,230583,218166,12417,5.4
44001,2014,26195,24436,1759,6.7
44003,2014,91583,85019,6564,7.2
44005,2014,44139,41102,3037,6.9
44007,2014,325001,298540,26461,8.1
44009,2014,69661,64657,5004,7.2
45001,2014,10573,9756,817,7.7
45003,2014,72952,68195,4757,6.5
45005,2014,2868,2518,350,12.2
45007,2014,86661,81481,5180,6
45009,2014,5563,4918,645,11.6
45011,2014,8645,7806,839,9.7
45013,2014,69412,65463,3949,5.7
45015,2014,90849,85382,5467,6
45017,2014,6883,6330,553,8
45019,2014,192269,182328,9941,5.2
45021,2014,23658,21689,1969,8.3
45023,2014,13431,12129,1302,9.7
45025,2014,21215,19756,1459,6.9
45027,2014,12985,11895,1090,8.4
45029,2014,16641,15368,1273,7.6
45031,2014,29743,27364,2379,8
45033,2014,12598,11382,1216,9.7
45035,2014,70255,66147,4108,5.8
45037,2014,10552,9841,711,6.7
45039,2014,10029,9156,873,8.7
45041,2014,64845,60153,4692,7.2
45043,2014,24832,22701,2131,8.6
45045,2014,235485,222899,12586,5.3
45047,2014,31663,29474,2189,6.9
45049,2014,8312,7669,643,7.7
45051,2014,134177,124239,9938,7.4
45053,2014,11427,10775,652,5.7
45055,2014,28425,26588,1837,6.5
45057,2014,35267,32717,2550,7.2
45059,2014,29883,27760,2123,7.1
45061,2014,6450,5864,586,9.1
45063,2014,141474,134295,7179,5.1
45065,2014,3487,3212,275,7.9
45067,2014,12858,11499,1359,10.6
45069,2014,9970,8911,1059,10.6
45071,2014,18553,17488,1065,5.7
45073,2014,34176,32012,2164,6.3
45075,2014,37849,33546,4303,11.4
45077,2014,54844,51374,3470,6.3
45079,2014,193911,182298,11613,6
45081,2014,8655,8161,494,5.7
45083,2014,136862,128147,8715,6.4
45085,2014,44398,41142,3256,7.3
45087,2014,11502,10509,993,8.6
45089,2014,12647,11381,1266,10
45091,2014,122614,114878,7736,6.3
46003,2014,1604,1562,42,2.6
46005,2014,9398,9106,292,3.1
46007,2014,1132,1070,62,5.5
46009,2014,2996,2912,84,2.8
46011,2014,18143,17570,573,3.2
46013,2014,20966,20353,613,2.9
46015,2014,2560,2476,84,3.3
46017,2014,732,675,57,7.8
46019,2014,5077,4905,172,3.4
46021,2014,849,821,28,3.3
46023,2014,4008,3855,153,3.8
46025,2014,1984,1907,77,3.9
46027,2014,7074,6829,245,3.5
46029,2014,15329,14820,509,3.3
46031,2014,1488,1401,87,5.8
46033,2014,3964,3783,181,4.6
46035,2014,11264,10945,319,2.8
46037,2014,2871,2718,153,5.3
46039,2014,2329,2203,126,5.4
46041,2014,2366,2022,344,14.5
46043,2014,1721,1671,50,2.9
46045,2014,2228,2171,57,2.6
46047,2014,3002,2861,141,4.7
46049,2014,1140,1104,36,3.2
46051,2014,4684,4516,168,3.6
46053,2014,2070,1999,71,3.4
46055,2014,1087,1057,30,2.8
46057,2014,3122,3014,108,3.5
46059,2014,1824,1777,47,2.6
46061,2014,1805,1742,63,3.5
46063,2014,773,755,18,2.3
46065,2014,9945,9686,259,2.6
46067,2014,3650,3545,105,2.9
46069,2014,710,690,20,2.8
46071,2014,1333,1261,72,5.4
46073,2014,1197,1167,30,2.5
46075,2014,606,584,22,3.6
46077,2014,2879,2793,86,3
46079,2014,6314,6085,229,3.6
46081,2014,12619,12178,441,3.5
46083,2014,29504,28787,717,2.4
46085,2014,1800,1724,76,4.2
46087,2014,3151,3067,84,2.7
46089,2014,1126,1082,44,3.9
46091,2014,2521,2417,104,4.1
46093,2014,13268,12822,446,3.4
46095,2014,825,775,50,6.1
46097,2014,1238,1198,40,3.2
46099,2014,104391,101243,3148,3
46101,2014,3964,3801,163,4.1
46102,2014,3614,3133,481,13.3
46103,2014,53922,52076,1846,3.4
46105,2014,1548,1496,52,3.4
46107,2014,1198,1158,40,3.3
46109,2014,4849,4615,234,4.8
46111,2014,1241,1210,31,2.5
46115,2014,3384,3264,120,3.5
46117,2014,1855,1807,48,2.6
46119,2014,883,858,25,2.8
46121,2014,3104,2834,270,8.7
46123,2014,3122,3022,100,3.2
46125,2014,4660,4524,136,2.9
46127,2014,7998,7701,297,3.7
46129,2014,2360,2233,127,5.4
46135,2014,11352,11009,343,3
46137,2014,1002,943,59,5.9
47001,2014,32942,30699,2243,6.8
47003,2014,19400,17946,1454,7.5
47005,2014,6693,6106,587,8.8
47007,2014,4270,3886,384,9
47009,2014,58620,55103,3517,6
47011,2014,48981,46011,2970,6.1
47013,2014,14677,13305,1372,9.3
47015,2014,5767,5401,366,6.3
47017,2014,12454,11202,1252,10.1
47019,2014,23726,21901,1825,7.7
47021,2014,19735,18650,1085,5.5
47023,2014,8113,7562,551,6.8
47025,2014,12627,11535,1092,8.6
47027,2014,2985,2713,272,9.1
47029,2014,14475,13167,1308,9
47031,2014,24345,22791,1554,6.4
47033,2014,6854,6331,523,7.6
47035,2014,22993,21165,1828,8
47037,2014,354746,336922,17824,5
47039,2014,4775,4320,455,9.5
47041,2014,7421,6814,607,8.2
47043,2014,23478,22006,1472,6.3
47045,2014,16523,15162,1361,8.2
47047,2014,17746,16466,1280,7.2
47049,2014,7010,6415,595,8.5
47051,2014,19560,18361,1199,6.1
47053,2014,21134,19248,1886,8.9
47055,2014,14170,13304,866,6.1
47057,2014,9179,8428,751,8.2
47059,2014,30045,27619,2426,8.1
47061,2014,5079,4603,476,9.4
47063,2014,26232,24295,1937,7.4
47065,2014,164006,153840,10166,6.2
47067,2014,2060,1858,202,9.8
47069,2014,9535,8649,886,9.3
47071,2014,10425,9489,936,9
47073,2014,23764,22022,1742,7.3
47075,2014,7726,6966,760,9.8
47077,2014,12158,11108,1050,8.6
47079,2014,13862,12746,1116,8.1
47081,2014,10284,9607,677,6.6
47083,2014,3283,2959,324,9.9
47085,2014,8349,7697,652,7.8
47087,2014,4452,4061,391,8.8
47089,2014,22944,21243,1701,7.4
47091,2014,7107,6619,488,6.9
47093,2014,224838,212595,12243,5.4
47095,2014,2093,1900,193,9.2
47097,2014,9782,8823,959,9.8
47099,2014,17565,16136,1429,8.1
47101,2014,4835,4401,434,9
47103,2014,15274,14456,818,5.4
47105,2014,21702,20253,1449,6.7
47107,2014,22291,20612,1679,7.5
47109,2014,8909,7964,945,10.6
47111,2014,9920,9271,649,6.5
47113,2014,46304,43164,3140,6.8
47115,2014,11586,10671,915,7.9
47117,2014,14391,13489,902,6.3
47119,2014,40944,38510,2434,5.9
47121,2014,4852,4430,422,8.7
47123,2014,18951,17508,1443,7.6
47125,2014,76880,71762,5118,6.7
47127,2014,3275,3108,167,5.1
47129,2014,7752,7069,683,8.8
47131,2014,12775,11554,1221,9.6
47133,2014,9083,8366,717,7.9
47135,2014,3033,2788,245,8.1
47137,2014,2270,2068,202,8.9
47139,2014,7365,6784,581,7.9
47141,2014,31916,29720,2196,6.9
47143,2014,13215,12102,1113,8.4
47145,2014,22469,20751,1718,7.6
47147,2014,33348,31453,1895,5.7
47149,2014,149027,141220,7807,5.2
47151,2014,8217,7258,959,11.7
47153,2014,5708,5283,425,7.4
47155,2014,48690,45216,3474,7.1
47157,2014,427775,395254,32521,7.6
47159,2014,8310,7779,531,6.4
47161,2014,5205,4724,481,9.2
47163,2014,69569,64942,4627,6.7
47165,2014,86108,81574,4534,5.3
47167,2014,27258,25004,2254,8.3
47169,2014,3655,3397,258,7.1
47171,2014,7094,6446,648,9.1
47173,2014,7196,6628,568,7.9
47175,2014,2100,1898,202,9.6
47177,2014,17344,16168,1176,6.8
47179,2014,57467,53844,3623,6.3
47181,2014,6428,5868,560,8.7
47183,2014,15813,14458,1355,8.6
47185,2014,11388,10544,844,7.4
47187,2014,103259,98575,4684,4.5
47189,2014,62259,58970,3289,5.3
48001,2014,21817,20801,1016,4.7
48003,2014,9539,9254,285,3
48005,2014,37784,35807,1977,5.2
48007,2014,10213,9648,565,5.5
48009,2014,4247,4056,191,4.5
48011,2014,1005,973,32,3.2
48013,2014,20396,19387,1009,4.9
48015,2014,14153,13478,675,4.8
48017,2014,2961,2812,149,5
48019,2014,9136,8701,435,4.8
48021,2014,36755,34968,1787,4.9
48023,2014,1654,1584,70,4.2
48025,2014,10747,10123,624,5.8
48027,2014,135048,127186,7862,5.8
48029,2014,867427,826882,40545,4.7
48031,2014,5686,5478,208,3.7
48033,2014,424,411,13,3.1
48035,2014,8149,7729,420,5.2
48037,2014,39706,37211,2495,6.3
48039,2014,166915,158427,8488,5.1
48041,2014,104465,100306,4159,4
48043,2014,4073,3884,189,4.6
48045,2014,638,611,27,4.2
48047,2014,2710,2501,209,7.7
48049,2014,15869,15048,821,5.2
48051,2014,7601,7240,361,4.7
48053,2014,21525,20599,926,4.3
48055,2014,17261,16363,898,5.2
48057,2014,11102,10573,529,4.8
48059,2014,5838,5579,259,4.4
48061,2014,166548,152683,13865,8.3
48063,2014,5225,4906,319,6.1
48065,2014,3155,3049,106,3.4
48067,2014,12298,11359,939,7.6
48069,2014,3802,3650,152,4
48071,2014,17863,16834,1029,5.8
48073,2014,21206,19977,1229,5.8
48075,2014,2866,2762,104,3.6
48077,2014,5025,4796,229,4.6
48079,2014,1399,1328,71,5.1
48081,2014,1440,1378,62,4.3
48083,2014,3124,2934,190,6.1
48085,2014,474652,453073,21579,4.5
48087,2014,1261,1210,51,4
48089,2014,10288,9831,457,4.4
48091,2014,59918,57202,2716,4.5
48093,2014,5543,5276,267,4.8
48095,2014,1415,1373,42,3
48097,2014,20569,19777,792,3.9
48099,2014,24749,23276,1473,6
48101,2014,605,568,37,6.1
48103,2014,2010,1929,81,4
48105,2014,1935,1862,73,3.8
48107,2014,2701,2575,126,4.7
48109,2014,1014,972,42,4.1
48111,2014,3907,3793,114,2.9
48113,2014,1252417,1184567,67850,5.4
48115,2014,4904,4666,238,4.9
48117,2014,9119,8789,330,3.6
48119,2014,2655,2495,160,6
48121,2014,414627,396241,18386,4.4
48123,2014,10026,9643,383,3.8
48125,2014,746,699,47,6.3
48127,2014,7668,7379,289,3.8
48129,2014,1621,1543,78,4.8
48131,2014,5536,5228,308,5.6
48133,2014,8373,7968,405,4.8
48135,2014,82479,79641,2838,3.4
48137,2014,868,831,37,4.3
48139,2014,79176,75284,3892,4.9
48141,2014,344937,322806,22131,6.4
48143,2014,20123,19269,854,4.2
48145,2014,6555,6196,359,5.5
48147,2014,15296,14483,813,5.3
48149,2014,13089,12641,448,3.4
48151,2014,1865,1782,83,4.5
48153,2014,2967,2756,211,7.1
48155,2014,580,555,25,4.3
48157,2014,347457,331776,15681,4.5
48159,2014,4664,4424,240,5.1
48161,2014,7853,7412,441,5.6
48163,2014,10355,9985,370,3.6
48165,2014,9377,9072,305,3.3
48167,2014,157806,148959,8847,5.6
48169,2014,2247,2165,82,3.6
48171,2014,12535,12094,441,3.5
48173,2014,831,809,22,2.6
48175,2014,3575,3429,146,4.1
48177,2014,9949,9566,383,3.8
48179,2014,9799,9405,394,4
48181,2014,60426,57494,2932,4.9
48183,2014,61224,58249,2975,4.9
48185,2014,11838,11274,564,4.8
48187,2014,71661,68564,3097,4.3
48189,2014,13540,12269,1271,9.4
48191,2014,1265,1186,79,6.2
48193,2014,3572,3407,165,4.6
48195,2014,3246,3164,82,2.5
48197,2014,1650,1569,81,4.9
48199,2014,25424,23830,1594,6.3
48201,2014,2232655,2121528,111127,5
48203,2014,32231,30459,1772,5.5
48205,2014,2904,2831,73,2.5
48207,2014,2697,2591,106,3.9
48209,2014,94149,90132,4017,4.3
48211,2014,2548,2487,61,2.4
48213,2014,34779,32838,1941,5.6
48215,2014,332401,303296,29105,8.8
48217,2014,15901,15063,838,5.3
48219,2014,12103,11637,466,3.9
48221,2014,24286,23091,1195,4.9
48223,2014,17511,16691,820,4.7
48225,2014,9814,9328,486,5
48227,2014,13608,13013,595,4.4
48229,2014,1253,1174,79,6.3
48231,2014,38616,36334,2282,5.9
48233,2014,10530,10071,459,4.4
48235,2014,834,803,31,3.7
48237,2014,4312,4151,161,3.7
48239,2014,7640,7341,299,3.9
48241,2014,14462,13284,1178,8.1
48243,2014,1149,1108,41,3.6
48245,2014,110263,101135,9128,8.3
48247,2014,2201,2068,133,6
48249,2014,20128,19078,1050,5.2
48251,2014,74454,70704,3750,5
48253,2014,5812,5492,320,5.5
48255,2014,6283,6053,230,3.7
48257,2014,53669,50909,2760,5.1
48259,2014,18702,17946,756,4
48261,2014,339,329,10,2.9
48263,2014,514,496,18,3.5
48265,2014,21456,20516,940,4.4
48267,2014,2116,2034,82,3.9
48269,2014,225,216,9,4
48271,2014,1230,1141,89,7.2
48273,2014,15278,14446,832,5.4
48275,2014,1741,1666,75,4.3
48277,2014,22169,20818,1351,6.1
48279,2014,6036,5685,351,5.8
48281,2014,8977,8474,503,5.6
48283,2014,4582,4441,141,3.1
48285,2014,8985,8633,352,3.9
48287,2014,9351,8979,372,4
48289,2014,7229,6845,384,5.3
48291,2014,31019,28796,2223,7.2
48293,2014,9212,8675,537,5.8
48295,2014,1751,1692,59,3.4
48297,2014,6122,5904,218,3.6
48299,2014,8098,7680,418,5.2
48301,2014,79,75,4,5.1
48303,2014,147972,142148,5824,3.9
48305,2014,2865,2740,125,4.4
48307,2014,4117,3944,173,4.2
48309,2014,113042,107330,5712,5.1
48311,2014,1061,1040,21,2
48313,2014,5032,4786,246,4.9
48315,2014,4486,4196,290,6.5
48317,2014,2690,2599,91,3.4
48319,2014,1899,1812,87,4.6
48321,2014,16699,15389,1310,7.8
48323,2014,23423,20859,2564,10.9
48325,2014,20426,19424,1002,4.9
48327,2014,887,845,42,4.7
48329,2014,91048,88435,2613,2.9
48331,2014,10240,9605,635,6.2
48333,2014,2051,1962,89,4.3
48335,2014,2908,2784,124,4.3
48337,2014,10149,9746,403,4
48339,2014,254119,242904,11215,4.4
48341,2014,11311,10918,393,3.5
48343,2014,5631,5191,440,7.8
48345,2014,497,476,21,4.2
48347,2014,28660,27131,1529,5.3
48349,2014,23166,21961,1205,5.2
48351,2014,5566,5105,461,8.3
48353,2014,7056,6753,303,4.3
48355,2014,168445,159829,8616,5.1
48357,2014,5579,5413,166,3
48359,2014,942,908,34,3.6
48361,2014,37935,34911,3024,8
48363,2014,13391,12702,689,5.1
48365,2014,12574,11953,621,4.9
48367,2014,59174,56475,2699,4.6
48369,2014,5134,4977,157,3.1
48371,2014,6872,6587,285,4.1
48373,2014,17247,16138,1109,6.4
48375,2014,56909,54658,2251,4
48377,2014,3417,3019,398,11.6
48379,2014,5412,5146,266,4.9
48381,2014,68923,66547,2376,3.4
48383,2014,2080,2014,66,3.2
48385,2014,1060,994,66,6.2
48387,2014,4942,4559,383,7.7
48389,2014,5766,5534,232,4
48391,2014,3605,3451,154,4.3
48393,2014,451,435,16,3.5
48395,2014,7156,6772,384,5.4
48397,2014,43464,41504,1960,4.5
48399,2014,4978,4767,211,4.2
48401,2014,24235,23042,1193,4.9
48403,2014,3546,3172,374,10.5
48405,2014,2829,2559,270,9.5
48407,2014,11426,10768,658,5.8
48409,2014,30720,28804,1916,6.2
48411,2014,2234,2141,93,4.2
48413,2014,1782,1728,54,3
48415,2014,8621,8335,286,3.3
48417,2014,2377,2311,66,2.8
48419,2014,11626,10947,679,5.8
48421,2014,1507,1460,47,3.1
48423,2014,102372,97045,5327,5.2
48425,2014,4141,3929,212,5.1
48427,2014,26023,22476,3547,13.6
48429,2014,4297,4109,188,4.4
48431,2014,813,789,24,3
48433,2014,698,671,27,3.9
48435,2014,2024,1952,72,3.6
48437,2014,2885,2708,177,6.1
48439,2014,992127,942237,49890,5
48441,2014,64490,61775,2715,4.2
48443,2014,481,459,22,4.6
48445,2014,5618,5377,241,4.3
48447,2014,834,801,33,4
48449,2014,12925,12111,814,6.3
48451,2014,54729,52523,2206,4
48453,2014,645151,618834,26317,4.1
48455,2014,5529,5197,332,6
48457,2014,7585,6980,605,8
48459,2014,18599,17644,955,5.1
48461,2014,1877,1817,60,3.2
48463,2014,11699,11034,665,5.7
48465,2014,19404,18291,1113,5.7
48467,2014,23929,22664,1265,5.3
48469,2014,46314,44388,1926,4.2
48471,2014,23183,21924,1259,5.4
48473,2014,21343,20253,1090,5.1
48475,2014,5928,5716,212,3.6
48477,2014,15718,14996,722,4.6
48479,2014,111319,105664,5655,5.1
48481,2014,21599,20592,1007,4.7
48483,2014,3085,2975,110,3.6
48485,2014,56575,53820,2755,4.9
48487,2014,5301,5041,260,4.9
48489,2014,7179,6290,889,12.4
48491,2014,255648,244510,11138,4.4
48493,2014,22574,21637,937,4.2
48495,2014,3290,3145,145,4.4
48497,2014,28524,27135,1389,4.9
48499,2014,16787,15787,1000,6
48501,2014,4299,4169,130,3
48503,2014,8681,8327,354,4.1
48505,2014,6946,6586,360,5.2
48507,2014,3902,3428,474,12.1
49001,2014,2965,2845,120,4
49003,2014,23416,22508,908,3.9
49005,2014,58854,56967,1887,3.2
49007,2014,8694,8248,446,5.1
49009,2014,430,412,18,4.2
49011,2014,155775,150192,5583,3.6
49013,2014,9574,9225,349,3.6
49015,2014,4613,4366,247,5.4
49017,2014,2716,2478,238,8.8
49019,2014,5521,5169,352,6.4
49021,2014,19911,19007,904,4.5
49023,2014,4795,4599,196,4.1
49025,2014,3562,3392,170,4.8
49027,2014,5961,5753,208,3.5
49029,2014,4687,4527,160,3.4
49031,2014,459,426,33,7.2
49033,2014,1005,966,39,3.9
49035,2014,575348,554142,21206,3.7
49037,2014,5605,5171,434,7.7
49039,2014,11061,10557,504,4.6
49041,2014,9263,8845,418,4.5
49043,2014,22524,21751,773,3.4
49045,2014,28889,27501,1388,4.8
49047,2014,15986,15414,572,3.6
49049,2014,255066,246156,8910,3.5
49051,2014,12710,12229,481,3.8
49053,2014,61472,58769,2703,4.4
49055,2014,1384,1253,131,9.5
49057,2014,114819,109768,5051,4.4
50001,2014,20815,20045,770,3.7
50003,2014,18669,17815,854,4.6
50005,2014,15271,14537,734,4.8
50007,2014,95519,92639,2880,3
50009,2014,2769,2606,163,5.9
50011,2014,27466,26386,1080,3.9
50013,2014,4067,3886,181,4.5
50015,2014,13753,13049,704,5.1
50017,2014,15891,15285,606,3.8
50019,2014,13614,12770,844,6.2
50021,2014,31762,30269,1493,4.7
50023,2014,34253,32933,1320,3.9
50025,2014,23511,22555,956,4.1
50027,2014,29695,28606,1089,3.7
51001,2014,16051,14976,1075,6.7
51003,2014,53556,51144,2412,4.5
51005,2014,7191,6764,427,5.9
51007,2014,6204,5877,327,5.3
51009,2014,15618,14769,849,5.4
51011,2014,7111,6704,407,5.7
51013,2014,144432,139692,4740,3.3
51015,2014,36818,35087,1731,4.7
51017,2014,2590,2474,116,4.5
51019,2014,38414,36446,1968,5.1
51021,2014,2865,2692,173,6
51023,2014,17675,16811,864,4.9
51025,2014,6463,5940,523,8.1
51027,2014,7765,6951,814,10.5
51029,2014,6299,5869,430,6.8
51031,2014,26614,25182,1432,5.4
51033,2014,14761,13848,913,6.2
51035,2014,13179,12292,887,6.7
51036,2014,3715,3493,222,6
51037,2014,5296,4937,359,6.8
51041,2014,177299,168197,9102,5.1
51043,2014,7539,7208,331,4.4
51045,2014,2455,2300,155,6.3
51047,2014,23332,22162,1170,5
51049,2014,4534,4256,278,6.1
51051,2014,5193,4663,530,10.2
51053,2014,13453,12583,870,6.5
51057,2014,5677,5315,362,6.4
51059,2014,619387,593460,25927,4.2
51061,2014,35894,34244,1650,4.6
51063,2014,8296,7910,386,4.7
51065,2014,13158,12581,577,4.4
51067,2014,27143,25687,1456,5.4
51069,2014,44445,42352,2093,4.7
51071,2014,8060,7561,499,6.2
51073,2014,19421,18482,939,4.8
51075,2014,10532,10027,505,4.8
51077,2014,7066,6517,549,7.8
51079,2014,9844,9410,434,4.4
51081,2014,4241,3966,275,6.5
51083,2014,15541,14328,1213,7.8
51085,2014,55756,53209,2547,4.6
51087,2014,176112,167113,8999,5.1
51089,2014,22906,21144,1762,7.7
51091,2014,1419,1364,55,3.9
51093,2014,18959,17962,997,5.3
51095,2014,34588,32884,1704,4.9
51097,2014,3641,3431,210,5.8
51099,2014,12071,11420,651,5.4
51101,2014,8746,8294,452,5.2
51103,2014,5344,4934,410,7.7
51105,2014,8835,8110,725,8.2
51107,2014,195838,187500,8338,4.3
51109,2014,18435,17497,938,5.1
51111,2014,5337,5021,316,5.9
51113,2014,7240,6947,293,4
51115,2014,4121,3930,191,4.6
51117,2014,12619,11643,976,7.7
51119,2014,5024,4770,254,5.1
51121,2014,49740,47197,2543,5.1
51125,2014,7386,7022,364,4.9
51127,2014,11069,10567,502,4.5
51131,2014,6079,5618,461,7.6
51133,2014,5636,5237,399,7.1
51135,2014,7074,6695,379,5.4
51137,2014,16170,15311,859,5.3
51139,2014,11822,10867,955,8.1
51141,2014,7719,7201,518,6.7
51143,2014,30235,28310,1925,6.4
51145,2014,13652,13031,621,4.5
51147,2014,10019,9251,768,7.7
51149,2014,14755,13820,935,6.3
51153,2014,231653,220293,11360,4.9
51155,2014,16445,15440,1005,6.1
51157,2014,3794,3612,182,4.8
51159,2014,3970,3753,217,5.5
51161,2014,49945,47657,2288,4.6
51163,2014,10292,9742,550,5.3
51165,2014,40350,38457,1893,4.7
51167,2014,11269,10379,890,7.9
51169,2014,9777,9205,572,5.9
51171,2014,21207,20145,1062,5
51173,2014,13439,12373,1066,7.9
51175,2014,9117,8670,447,4.9
51177,2014,64072,60599,3473,5.4
51179,2014,66634,63079,3555,5.3
51181,2014,3661,3433,228,6.2
51183,2014,4105,3784,321,7.8
51185,2014,17212,15810,1402,8.1
51187,2014,19902,18778,1124,5.6
51191,2014,27600,26007,1593,5.8
51193,2014,9006,8423,583,6.5
51195,2014,14425,13054,1371,9.5
51197,2014,13780,12891,889,6.5
51199,2014,31810,30215,1595,5
51510,2014,93474,89876,3598,3.8
51520,2014,7716,7222,494,6.4
51530,2014,3304,3112,192,5.8
51540,2014,24203,23154,1049,4.3
51550,2014,117186,110994,6192,5.3
51570,2014,8698,8193,505,5.8
51580,2014,2486,2287,199,8
51590,2014,19585,17881,1704,8.7
51595,2014,2312,2122,190,8.2
51600,2014,13233,12687,546,4.1
51610,2014,7783,7502,281,3.6
51620,2014,3612,3328,284,7.9
51630,2014,13661,12825,836,6.1
51640,2014,2991,2771,220,7.4
51650,2014,65542,61105,4437,6.8
51660,2014,24200,22722,1478,6.1
51670,2014,9651,8782,869,9
51678,2014,2272,2095,177,7.8
51680,2014,35976,33674,2302,6.4
51683,2014,22099,20990,1109,5
51685,2014,8156,7765,391,4.8
51690,2014,5542,4991,551,9.9
51700,2014,90644,84950,5694,6.3
51710,2014,111971,104820,7151,6.4
51720,2014,1806,1666,140,7.8
51730,2014,13786,12306,1480,10.7
51735,2014,6293,6007,286,4.5
51740,2014,45063,41773,3290,7.3
51750,2014,8463,7891,572,6.8
51760,2014,112298,105385,6913,6.2
51770,2014,50057,47113,2944,5.9
51775,2014,13110,12432,678,5.2
51790,2014,12032,11410,622,5.2
51800,2014,42336,39892,2444,5.8
51810,2014,231599,220150,11449,4.9
51820,2014,10062,9523,539,5.4
51830,2014,6633,6145,488,7.4
51840,2014,14421,13680,741,5.1
53001,2014,8540,7929,611,7.2
53003,2014,9692,9171,521,5.4
53005,2014,89780,83055,6725,7.5
53007,2014,41114,38582,2532,6.2
53009,2014,26698,24455,2243,8.4
53011,2014,209005,194319,14686,7
53013,2014,1738,1614,124,7.1
53015,2014,43554,40040,3514,8.1
53017,2014,19300,17927,1373,7.1
53019,2014,2449,2170,279,11.4
53021,2014,38004,34834,3170,8.3
53023,2014,958,895,63,6.6
53025,2014,44784,41452,3332,7.4
53027,2014,27163,24413,2750,10.1
53029,2014,31677,29583,2094,6.6
53031,2014,11180,10283,897,8
53033,2014,1161650,1107340,54310,4.7
53035,2014,113411,106467,6944,6.1
53037,2014,20171,18773,1398,6.9
53039,2014,9572,8830,742,7.8
53041,2014,30501,27737,2764,9.1
53043,2014,5029,4739,290,5.8
53045,2014,23101,21170,1931,8.4
53047,2014,21284,19767,1517,7.1
53049,2014,7846,7070,776,9.9
53051,2014,4575,4117,458,10
53053,2014,384924,357930,26994,7
53055,2014,7681,7297,384,5
53057,2014,56387,52318,4069,7.2
53059,2014,4939,4533,406,8.2
53061,2014,396742,376058,20684,5.2
53063,2014,225148,209448,15700,7
53065,2014,17376,15756,1620,9.3
53067,2014,123211,115212,7999,6.5
53069,2014,1274,1151,123,9.7
53071,2014,28418,26669,1749,6.2
53073,2014,101168,94523,6645,6.6
53075,2014,22120,20965,1155,5.2
53077,2014,119327,108951,10376,8.7
54001,2014,6828,6367,461,6.8
54003,2014,52577,49693,2884,5.5
54005,2014,8429,7647,782,9.3
54007,2014,5230,4735,495,9.5
54009,2014,10113,9378,735,7.3
54011,2014,42160,39841,2319,5.5
54013,2014,2906,2623,283,9.7
54015,2014,3321,2959,362,10.9
54017,2014,3636,3454,182,5
54019,2014,16617,15226,1391,8.4
54021,2014,2744,2565,179,6.5
54023,2014,5814,5366,448,7.7
54025,2014,15148,14098,1050,6.9
54027,2014,9417,8820,597,6.3
54029,2014,13143,12087,1056,8
54031,2014,5355,4902,453,8.5
54033,2014,31820,30107,1713,5.4
54035,2014,11842,11051,791,6.7
54037,2014,26915,25659,1256,4.7
54039,2014,88729,83502,5227,5.9
54041,2014,7182,6726,456,6.3
54043,2014,7528,6805,723,9.6
54045,2014,11904,10649,1255,10.5
54047,2014,5777,5020,757,13.1
54049,2014,26450,24865,1585,6
54051,2014,14259,13167,1092,7.7
54053,2014,10139,9181,958,9.4
54055,2014,22241,20540,1701,7.6
54057,2014,11796,10859,937,7.9
54059,2014,7719,6792,927,12
54061,2014,50335,48105,2230,4.4
54063,2014,5567,5240,327,5.9
54065,2014,7406,6965,441,6
54067,2014,10065,9146,919,9.1
54069,2014,20996,19825,1171,5.6
54071,2014,3483,3312,171,4.9
54073,2014,2977,2765,212,7.1
54075,2014,3540,3233,307,8.7
54077,2014,14479,13607,872,6
54079,2014,25917,24476,1441,5.6
54081,2014,31237,28991,2246,7.2
54083,2014,11815,10959,856,7.2
54085,2014,4597,4311,286,6.2
54087,2014,5289,4758,531,10
54089,2014,4485,4164,321,7.2
54091,2014,7747,7334,413,5.3
54093,2014,3362,3148,214,6.4
54095,2014,3607,3278,329,9.1
54097,2014,9551,8906,645,6.8
54099,2014,15867,14777,1090,6.9
54101,2014,3442,3146,296,8.6
54103,2014,7267,6520,747,10.3
54105,2014,2266,2047,219,9.7
54107,2014,37832,35578,2254,6
54109,2014,7957,7199,758,9.5
55001,2014,8397,7655,742,8.8
55003,2014,8053,7450,603,7.5
55005,2014,24073,22684,1389,5.8
55007,2014,7543,6820,723,9.6
55009,2014,138429,131737,6692,4.8
55011,2014,6461,6098,363,5.6
55013,2014,7369,6777,592,8
55015,2014,27141,26006,1135,4.2
55017,2014,33060,31280,1780,5.4
55019,2014,16967,16041,926,5.5
55021,2014,31191,29548,1643,5.3
55023,2014,7986,7422,564,7.1
55025,2014,305699,294406,11293,3.7
55027,2014,47524,44974,2550,5.4
55029,2014,15374,14116,1258,8.2
55031,2014,23540,22204,1336,5.7
55033,2014,23637,22405,1232,5.2
55035,2014,57985,55385,2600,4.5
55037,2014,2205,2041,164,7.4
55039,2014,57108,54304,2804,4.9
55041,2014,4023,3674,349,8.7
55043,2014,27739,26404,1335,4.8
55045,2014,20836,19897,939,4.5
55047,2014,10045,9399,646,6.4
55049,2014,13552,12858,694,5.1
55051,2014,2680,2426,254,9.5
55053,2014,10205,9607,598,5.9
55055,2014,45809,43527,2282,5
55057,2014,13382,12519,863,6.4
55059,2014,86956,81700,5256,6
55061,2014,10840,10293,547,5
55063,2014,66688,63784,2904,4.4
55065,2014,9400,9003,397,4.2
55067,2014,9567,8846,721,7.5
55069,2014,15376,14420,956,6.2
55071,2014,42556,39987,2569,6
55073,2014,73153,69471,3682,5
55075,2014,21094,19671,1423,6.7
55077,2014,7326,6801,525,7.2
55078,2014,1600,1402,198,12.4
55079,2014,478590,445743,32847,6.9
55081,2014,22545,21329,1216,5.4
55083,2014,20346,19086,1260,6.2
55085,2014,18768,17503,1265,6.7
55087,2014,101278,96459,4819,4.8
55089,2014,47938,45912,2026,4.2
55091,2014,4031,3839,192,4.8
55093,2014,24016,22954,1062,4.4
55095,2014,24436,23038,1398,5.7
55097,2014,39291,37105,2186,5.6
55099,2014,6777,6412,365,5.4
55101,2014,99836,93259,6577,6.6
55103,2014,9308,8838,470,5
55105,2014,82279,77242,5037,6.1
55107,2014,6994,6536,458,6.5
55109,2014,48304,46146,2158,4.5
55111,2014,34985,33240,1745,5
55113,2014,7957,7246,711,8.9
55115,2014,21295,20033,1262,5.9
55117,2014,61210,58430,2780,4.5
55119,2014,10637,10070,567,5.3
55121,2014,16526,15773,753,4.6
55123,2014,15042,14315,727,4.8
55125,2014,10082,9231,851,8.4
55127,2014,56997,53844,3153,5.5
55129,2014,7931,7437,494,6.2
55131,2014,75760,72324,3436,4.5
55133,2014,220550,210796,9754,4.4
55135,2014,27318,25774,1544,5.7
55137,2014,11616,10786,830,7.1
55139,2014,91578,86811,4767,5.2
55141,2014,34762,32443,2319,6.7
56001,2014,20462,19757,705,3.4
56003,2014,5572,5322,250,4.5
56005,2014,26223,25345,878,3.3
56007,2014,8429,8093,336,4
56009,2014,8329,8079,250,3
56011,2014,3707,3563,144,3.9
56013,2014,20533,19513,1020,5
56015,2014,7131,6875,256,3.6
56017,2014,2483,2381,102,4.1
56019,2014,4474,4273,201,4.5
56021,2014,48704,46599,2105,4.3
56023,2014,8226,7803,423,5.1
56025,2014,43303,41561,1742,4
56027,2014,1349,1304,45,3.3
56029,2014,15729,15028,701,4.5
56031,2014,4774,4591,183,3.8
56033,2014,15885,15150,735,4.6
56035,2014,4867,4659,208,4.3
56037,2014,23262,22335,927,4
56039,2014,14419,13751,668,4.6
56041,2014,9870,9396,474,4.8
56043,2014,4271,4086,185,4.3
56045,2014,3966,3836,130,3.3
72001,2014,4491,3505,986,22
72003,2014,11990,9927,2063,17.2
72005,2014,14933,12472,2461,16.5
72007,2014,6921,5778,1143,16.5
72009,2014,6839,5641,1198,17.5
72011,2014,8959,7489,1470,16.4
72013,2014,24353,20564,3789,15.6
72015,2014,5305,4074,1231,23.2
72017,2014,6148,4926,1222,19.9
72019,2014,7540,6357,1183,15.7
72021,2014,67762,60786,6976,10.3
72023,2014,14391,11927,2464,17.1
72025,2014,48642,42911,5731,11.8
72027,2014,9628,8196,1432,14.9
72029,2014,16179,14067,2112,13.1
72031,2014,63037,56843,6194,9.8
72033,2014,8159,7153,1006,12.3
72035,2014,16375,14300,2075,12.7
72037,2014,4010,3327,683,17
72039,2014,4189,3225,964,23
72041,2014,15764,13876,1888,12
72043,2014,11022,8702,2320,21
72045,2014,5312,4315,997,18.8
72047,2014,9535,8093,1442,15.1
72049,2014,786,737,49,6.2
72051,2014,12666,11559,1107,8.7
72053,2014,11911,9816,2095,17.6
72054,2014,3526,2861,665,18.9
72055,2014,4483,3364,1119,25
72057,2014,12315,9799,2516,20.4
72059,2014,5499,4301,1198,21.8
72061,2014,36950,34644,2306,6.2
72063,2014,17085,15283,1802,10.5
72065,2014,13093,10962,2131,16.3
72067,2014,5662,4836,826,14.6
72069,2014,17974,14868,3106,17.3
72071,2014,12423,10543,1880,15.1
72073,2014,4202,3467,735,17.5
72075,2014,15739,13175,2564,16.3
72077,2014,12462,10543,1919,15.4
72079,2014,5891,4484,1407,23.9
72081,2014,7587,5819,1768,23.3
72083,2014,2901,2167,734,25.3
72085,2014,11421,9580,1841,16.1
72087,2014,8944,7761,1183,13.2
72089,2014,6658,5377,1281,19.2
72091,2014,11792,10169,1623,13.8
72093,2014,1959,1549,410,20.9
72095,2014,3119,2452,667,21.4
72097,2014,24223,20082,4141,17.1
72099,2014,10762,8778,1984,18.4
72101,2014,8422,6867,1555,18.5
72103,2014,8288,7026,1262,15.2
72105,2014,7478,6233,1245,16.6
72107,2014,5389,4365,1024,19
72109,2014,4915,3747,1168,23.8
72111,2014,6496,5126,1370,21.1
72113,2014,48964,41435,7529,15.4
72115,2014,6126,4996,1130,18.4
72117,2014,4706,3768,938,19.9
72119,2014,17162,15120,2042,11.9
72121,2014,6508,5288,1220,18.7
72123,2014,8312,6121,2191,26.4
72125,2014,10549,8649,1900,18
72127,2014,135903,124920,10983,8.1
72129,2014,12230,10320,1910,15.6
72131,2014,11018,8461,2557,23.2
72133,2014,9874,7920,1954,19.8
72135,2014,25939,23561,2378,9.2
72137,2014,30263,27171,3092,10.2
72139,2014,27129,25028,2101,7.7
72141,2014,7047,5740,1307,18.5
72143,2014,9965,8591,1374,13.8
72145,2014,14157,11869,2288,16.2
72147,2014,3152,2710,442,14
72149,2014,7920,6196,1724,21.8
72151,2014,9642,7546,2096,21.7
72153,2014,11031,8665,2366,21.4
01001,2015,25613,24283,1330,5.2
01003,2015,87741,82882,4859,5.5
01005,2015,8613,7848,765,8.9
01007,2015,8576,8009,567,6.6
01009,2015,24485,23163,1322,5.4
01011,2015,4779,4400,379,7.9
01013,2015,9138,8444,694,7.6
01015,2015,45928,42699,3229,7
01017,2015,14980,14076,904,6
01019,2015,11162,10554,608,5.4
01021,2015,19143,18063,1080,5.6
01023,2015,4380,3982,398,9.1
01025,2015,7994,7057,937,11.7
01027,2015,5551,5211,340,6.1
01029,2015,5680,5338,342,6
01031,2015,20279,19071,1208,6
01033,2015,23613,21743,1870,7.9
01035,2015,4683,4251,432,9.2
01037,2015,4428,4132,296,6.7
01039,2015,15464,14360,1104,7.1
01041,2015,6358,5977,381,6
01043,2015,36403,34489,1914,5.3
01045,2015,19846,18584,1262,6.4
01047,2015,15596,14101,1495,9.6
01049,2015,28780,27035,1745,6.1
01051,2015,36760,34914,1846,5
01053,2015,14604,13578,1026,7
01055,2015,42703,40064,2639,6.2
01057,2015,6425,5974,451,7
01059,2015,13667,12788,879,6.4
01061,2015,10791,10152,639,5.9
01063,2015,2879,2560,319,11.1
01065,2015,6050,5580,470,7.8
01067,2015,6718,6262,456,6.8
01069,2015,44562,41786,2776,6.2
01071,2015,23472,21911,1561,6.7
01073,2015,311020,293095,17925,5.8
01075,2015,5618,5263,355,6.3
01077,2015,42662,39705,2957,6.9
01079,2015,13679,12622,1057,7.7
01081,2015,70891,67171,3720,5.2
01083,2015,39962,37775,2187,5.5
01085,2015,3828,3387,441,11.5
01087,2015,7972,7330,642,8.1
01089,2015,170963,161591,9372,5.5
01091,2015,7407,6842,565,7.6
01093,2015,12488,11621,867,6.9
01095,2015,40405,38067,2338,5.8
01097,2015,186989,174138,12851,6.9
01099,2015,7342,6604,738,10.1
01101,2015,105091,98690,6401,6.1
01103,2015,54935,51702,3233,5.9
01105,2015,3486,3138,348,10
01107,2015,8011,7469,542,6.8
01109,2015,14945,13963,982,6.6
01111,2015,9437,8880,557,5.9
01113,2015,24116,22685,1431,5.9
01115,2015,38582,36569,2013,5.2
01117,2015,108246,103691,4555,4.2
01119,2015,5110,4702,408,8
01121,2015,35147,32839,2308,6.6
01123,2015,18748,17606,1142,6.1
01125,2015,98905,93526,5379,5.4
01127,2015,25572,23726,1846,7.2
01129,2015,6702,6105,597,8.9
01131,2015,2825,2411,414,14.7
01133,2015,9379,8673,706,7.5
02013,2015,2477,2397,80,3.2
02016,2015,4066,3909,157,3.9
02020,2015,156808,148903,7905,5
02050,2015,7366,6306,1060,14.4
02060,2015,382,346,36,9.4
02068,2015,1071,977,94,8.8
02070,2015,2042,1844,198,9.7
02090,2015,46412,43877,2535,5.5
02100,2015,1087,980,107,9.8
02105,2015,1134,962,172,15.2
02110,2015,17095,16289,806,4.7
02122,2015,27646,25480,2166,7.8
02130,2015,6965,6485,480,6.9
02150,2015,6622,6303,319,4.8
02158,2015,2811,2161,650,23.1
02164,2015,646,565,81,12.5
02170,2015,46199,42647,3552,7.7
02180,2015,4084,3597,487,11.9
02185,2015,4306,4060,246,5.7
02188,2015,2911,2445,466,16
02195,2015,1494,1361,133,8.9
02198,2015,2764,2416,348,12.6
02220,2015,4602,4390,212,4.6
02230,2015,813,719,94,11.6
02240,2015,3010,2689,321,10.7
02261,2015,4882,4459,423,8.7
02275,2015,1031,950,81,7.9
02282,2015,259,237,22,8.5
02290,2015,2412,1969,443,18.4
04001,2015,20607,17869,2738,13.3
04003,2015,50302,46640,3662,7.3
04005,2015,73254,68492,4762,6.5
04007,2015,21199,19528,1671,7.9
04009,2015,14508,13443,1065,7.3
04011,2015,4045,3725,320,7.9
04012,2015,8169,7561,608,7.4
04013,2015,2022190,1918529,103661,5.1
04015,2015,79550,73238,6312,7.9
04017,2015,40696,36765,3931,9.7
04019,2015,465210,439734,25476,5.5
04021,2015,157161,147286,9875,6.3
04023,2015,19869,17592,2277,11.5
04025,2015,96196,90798,5398,5.6
04027,2015,93659,73341,20318,21.7
05001,2015,9483,9087,396,4.2
05003,2015,8142,7511,631,7.7
05005,2015,16211,15322,889,5.5
05007,2015,121772,117188,4584,3.8
05009,2015,15834,15064,770,4.9
05011,2015,4381,4115,266,6.1
05013,2015,2406,2276,130,5.4
05015,2015,12652,12074,578,4.6
05017,2015,3724,3386,338,9.1
05019,2015,9448,8924,524,5.5
05021,2015,6294,5879,415,6.6
05023,2015,9606,8940,666,6.9
05025,2015,3356,3167,189,5.6
05027,2015,9533,8910,623,6.5
05029,2015,8635,8109,526,6.1
05031,2015,50977,48721,2256,4.4
05033,2015,26840,25448,1392,5.2
05035,2015,21410,20092,1318,6.2
05037,2015,8097,7659,438,5.4
05039,2015,2871,2664,207,7.2
05041,2015,5543,5139,404,7.3
05043,2015,7924,7371,553,7
05045,2015,59881,57095,2786,4.7
05047,2015,7409,7043,366,4.9
05049,2015,4756,4509,247,5.2
05051,2015,39930,37750,2180,5.5
05053,2015,8255,7880,375,4.5
05055,2015,19941,18908,1033,5.2
05057,2015,9851,9364,487,4.9
05059,2015,14152,13438,714,5
05061,2015,6055,5799,256,4.2
05063,2015,15660,14649,1011,6.5
05065,2015,4976,4648,328,6.6
05067,2015,6185,5720,465,7.5
05069,2015,28758,26731,2027,7
05071,2015,10393,9796,597,5.7
05073,2015,2616,2417,199,7.6
05075,2015,7043,6620,423,6
05077,2015,3179,2967,212,6.7
05079,2015,4124,3871,253,6.1
05081,2015,5592,5287,305,5.5
05083,2015,9157,8631,526,5.7
05085,2015,32983,31602,1381,4.2
05087,2015,7080,6807,273,3.9
05089,2015,6522,6184,338,5.2
05091,2015,19902,18907,995,5
05093,2015,18364,16712,1652,9
05095,2015,2972,2792,180,6.1
05097,2015,3225,3006,219,6.8
05099,2015,3631,3450,181,5
05101,2015,3392,3228,164,4.8
05103,2015,9877,9251,626,6.3
05105,2015,4199,3942,257,6.1
05107,2015,6992,6462,530,7.6
05109,2015,4166,3920,246,5.9
05111,2015,10059,9497,562,5.6
05113,2015,8291,7811,480,5.8
05115,2015,29663,28096,1567,5.3
05117,2015,3726,3551,175,4.7
05119,2015,185974,177479,8495,4.6
05121,2015,6181,5739,442,7.2
05123,2015,8944,8298,646,7.2
05125,2015,55967,53688,2279,4.1
05127,2015,4484,4269,215,4.8
05129,2015,3026,2855,171,5.7
05131,2015,57705,54934,2771,4.8
05133,2015,5600,5258,342,6.1
05135,2015,6002,5588,414,6.9
05137,2015,4703,4409,294,6.3
05139,2015,16863,15829,1034,6.1
05141,2015,6424,5993,431,6.7
05143,2015,115183,111119,4064,3.5
05145,2015,34519,32375,2144,6.2
05147,2015,3030,2836,194,6.4
05149,2015,8936,8482,454,5.1
06001,2015,819713,780846,38867,4.7
06003,2015,549,509,40,7.3
06005,2015,14328,13382,946,6.6
06007,2015,101133,93880,7253,7.2
06009,2015,20565,19254,1311,6.4
06011,2015,11052,9353,1699,15.4
06013,2015,545081,517678,27403,5
06015,2015,9862,9020,842,8.5
06017,2015,87962,82941,5021,5.7
06019,2015,440530,395656,44874,10.2
06021,2015,12971,11841,1130,8.7
06023,2015,62338,58854,3484,5.6
06025,2015,76722,57934,18788,24.5
06027,2015,9089,8563,526,5.8
06029,2015,390337,350477,39860,10.2
06031,2015,57756,51691,6065,10.5
06033,2015,29027,26823,2204,7.6
06035,2015,10768,9990,778,7.2
06037,2015,4989791,4659651,330140,6.6
06039,2015,59836,53546,6290,10.5
06041,2015,138814,133882,4932,3.6
06043,2015,8017,7445,572,7.1
06045,2015,39863,37546,2317,5.8
06047,2015,114106,101153,12953,11.4
06049,2015,3306,3023,283,8.6
06051,2015,8246,7741,505,6.1
06053,2015,218367,200694,17673,8.1
06055,2015,73784,70376,3408,4.6
06057,2015,48047,45443,2604,5.4
06059,2015,1585762,1514904,70858,4.5
06061,2015,176495,167571,8924,5.1
06063,2015,7895,7085,810,10.3
06065,2015,1034249,964997,69252,6.7
06067,2015,685132,644079,41053,6
06069,2015,29779,27529,2250,7.6
06071,2015,919978,860777,59201,6.4
06073,2015,1550059,1469475,80584,5.2
06075,2015,541937,522202,19735,3.6
06077,2015,314590,286629,27961,8.9
06079,2015,139039,132465,6574,4.7
06081,2015,434661,419819,14842,3.4
06083,2015,217344,205843,11501,5.3
06085,2015,1013160,971131,42029,4.1
06087,2015,143323,132596,10727,7.5
06089,2015,74172,68408,5764,7.8
06091,2015,1362,1243,119,8.7
06093,2015,17894,16219,1675,9.4
06095,2015,205023,192470,12553,6.1
06097,2015,257893,246328,11565,4.5
06099,2015,241118,218236,22882,9.5
06101,2015,44754,39973,4781,10.7
06103,2015,25036,23057,1979,7.9
06105,2015,5144,4745,399,7.8
06107,2015,202210,178710,23500,11.6
06109,2015,21547,20029,1518,7
06111,2015,427597,403472,24125,5.6
06113,2015,104234,97502,6732,6.5
06115,2015,27741,25165,2576,9.3
08001,2015,248066,237328,10738,4.3
08003,2015,7659,7266,393,5.1
08005,2015,334731,322320,12411,3.7
08007,2015,6018,5776,242,4
08009,2015,1972,1932,40,2
08011,2015,1734,1666,68,3.9
08013,2015,176969,171382,5587,3.2
08014,2015,35579,34409,1170,3.3
08015,2015,8503,8214,289,3.4
08017,2015,1011,984,27,2.7
08019,2015,5551,5348,203,3.7
08021,2015,3602,3398,204,5.7
08023,2015,1624,1520,104,6.4
08025,2015,1355,1295,60,4.4
08027,2015,1991,1921,70,3.5
08029,2015,13456,12691,765,5.7
08031,2015,376007,362183,13824,3.7
08033,2015,1325,1284,41,3.1
08035,2015,172348,167035,5313,3.1
08037,2015,32784,31760,1024,3.1
08039,2015,13276,12860,416,3.1
08041,2015,308006,293933,14073,4.6
08043,2015,14515,13624,891,6.1
08045,2015,30501,29242,1259,4.1
08047,2015,3401,3296,105,3.1
08049,2015,9065,8774,291,3.2
08051,2015,9802,9514,288,2.9
08053,2015,441,427,14,3.2
08055,2015,2372,2190,182,7.7
08057,2015,835,804,31,3.7
08059,2015,309200,298346,10854,3.5
08061,2015,792,771,21,2.7
08063,2015,4325,4222,103,2.4
08065,2015,4572,4396,176,3.8
08067,2015,29891,28866,1025,3.4
08069,2015,180786,174834,5952,3.3
08071,2015,6135,5792,343,5.6
08073,2015,2171,2098,73,3.4
08075,2015,10944,10612,332,3
08077,2015,71875,67916,3959,5.5
08079,2015,445,429,16,3.6
08081,2015,7114,6792,322,4.5
08083,2015,12352,11653,699,5.7
08085,2015,19348,18376,972,5
08087,2015,14685,14130,555,3.8
08089,2015,7891,7435,456,5.8
08091,2015,2157,2064,93,4.3
08093,2015,9379,9058,321,3.4
08095,2015,2360,2304,56,2.4
08097,2015,10749,10336,413,3.8
08099,2015,5819,5585,234,4
08101,2015,71778,67743,4035,5.6
08103,2015,2809,2662,147,5.2
08105,2015,4871,4565,306,6.3
08107,2015,14295,13833,462,3.2
08109,2015,3082,2893,189,6.1
08111,2015,471,451,20,4.2
08113,2015,5078,4887,191,3.8
08115,2015,1148,1109,39,3.4
08117,2015,20583,20066,517,2.5
08119,2015,11416,10910,506,4.4
08121,2015,2787,2716,71,2.5
08123,2015,147936,142272,5664,3.8
08125,2015,5137,5003,134,2.6
09001,2015,478906,453260,25646,5.4
09003,2015,474485,446684,27801,5.9
09005,2015,105249,99809,5440,5.2
09007,2015,92085,87537,4548,4.9
09009,2015,454262,425936,28326,6.2
09011,2015,136118,128031,8087,5.9
09013,2015,85144,80924,4220,5
09015,2015,62630,58661,3969,6.3
10001,2015,76292,72184,4108,5.4
10003,2015,291341,277640,13701,4.7
10005,2015,98099,93276,4823,4.9
11001,2015,389218,362420,26798,6.9
12001,2015,129313,123330,5983,4.6
12003,2015,11156,10532,624,5.6
12005,2015,87413,82618,4795,5.5
12007,2015,10730,10210,520,4.8
12009,2015,256081,240693,15388,6
12011,2015,986758,936033,50725,5.1
12013,2015,4935,4632,303,6.1
12015,2015,67565,63496,4069,6
12017,2015,47745,44146,3599,7.5
12019,2015,98313,93342,4971,5.1
12021,2015,163458,154844,8614,5.3
12023,2015,28936,27338,1598,5.5
12027,2015,13359,12581,778,5.8
12029,2015,5578,5230,348,6.2
12031,2015,459914,433142,26772,5.8
12033,2015,137919,130199,7720,5.6
12035,2015,43612,40862,2750,6.3
12037,2015,4766,4541,225,4.7
12039,2015,18185,16873,1312,7.2
12041,2015,6490,6121,369,5.7
12043,2015,4704,4367,337,7.2
12045,2015,5987,5671,316,5.3
12047,2015,4516,4222,294,6.5
12049,2015,10077,9371,706,7
12051,2015,15077,13469,1608,10.7
12053,2015,66008,61402,4606,7
12055,2015,35291,32638,2653,7.5
12057,2015,688343,653455,34888,5.1
12059,2015,6682,6270,412,6.2
12061,2015,61131,56931,4200,6.9
12063,2015,17287,16265,1022,5.9
12065,2015,5367,5046,321,6
12067,2015,3201,3053,148,4.6
12069,2015,140587,132816,7771,5.5
12071,2015,318898,302395,16503,5.2
12073,2015,147346,139916,7430,5
12075,2015,16423,15471,952,5.8
12077,2015,2635,2479,156,5.9
12079,2015,7465,7005,460,6.2
12081,2015,164648,156279,8369,5.1
12083,2015,129990,121531,8459,6.5
12085,2015,69398,65662,3736,5.4
12086,2015,1308410,1232427,75983,5.8
12087,2015,45712,44115,1597,3.5
12089,2015,36507,34626,1881,5.2
12091,2015,91599,87437,4162,4.5
12093,2015,17224,16136,1088,6.3
12095,2015,685068,650561,34507,5
12097,2015,157052,147955,9097,5.8
12099,2015,689849,654533,35316,5.1
12101,2015,215067,202400,12667,5.9
12103,2015,469965,446630,23335,5
12105,2015,279553,261825,17728,6.3
12107,2015,27226,25142,2084,7.7
12109,2015,113209,108733,4476,4
12111,2015,131118,122739,8379,6.4
12113,2015,73856,70274,3582,4.8
12115,2015,177559,168530,9029,5.1
12117,2015,236290,224626,11664,4.9
12119,2015,28592,26387,2205,7.7
12121,2015,17910,16930,980,5.5
12123,2015,8967,8363,604,6.7
12125,2015,4729,4498,231,4.9
12127,2015,238316,224339,13977,5.9
12129,2015,13939,13287,652,4.7
12131,2015,27801,26491,1310,4.7
12133,2015,9595,9023,572,6
13001,2015,8650,8018,632,7.3
13003,2015,3854,3633,221,5.7
13005,2015,4882,4602,280,5.7
13007,2015,1120,1039,81,7.2
13009,2015,17701,16345,1356,7.7
13011,2015,8199,7742,457,5.6
13013,2015,36021,34127,1894,5.3
13015,2015,46726,43978,2748,5.9
13017,2015,5462,4970,492,9
13019,2015,7027,6522,505,7.2
13021,2015,67741,63234,4507,6.7
13023,2015,4360,3988,372,8.5
13025,2015,6886,6373,513,7.4
13027,2015,6867,6449,418,6.1
13029,2015,16103,15257,846,5.3
13031,2015,34644,32544,2100,6.1
13033,2015,9106,8367,739,8.1
13035,2015,10098,9427,671,6.6
13037,2015,2123,1991,132,6.2
13039,2015,22241,21008,1233,5.5
13043,2015,4954,4672,282,5.7
13045,2015,51647,48177,3470,6.7
13047,2015,31288,29654,1634,5.2
13049,2015,4754,4450,304,6.4
13051,2015,132895,125127,7768,5.8
13053,2015,2104,1920,184,8.7
13055,2015,10523,9874,649,6.2
13057,2015,120022,114411,5611,4.7
13059,2015,56979,53512,3467,6.1
13061,2015,857,756,101,11.8
13063,2015,126041,116435,9606,7.6
13065,2015,2765,2571,194,7
13067,2015,397186,377070,20116,5.1
13069,2015,17243,16084,1159,6.7
13071,2015,19996,18719,1277,6.4
13073,2015,68455,65025,3430,5
13075,2015,7267,6782,485,6.7
13077,2015,67667,64075,3592,5.3
13079,2015,5560,5210,350,6.3
13081,2015,9400,8757,643,6.8
13083,2015,7831,7402,429,5.5
13085,2015,10915,10358,557,5.1
13087,2015,11362,10590,772,6.8
13089,2015,372077,349629,22448,6
13091,2015,6937,6356,581,8.4
13093,2015,4746,4388,358,7.5
13095,2015,37774,34859,2915,7.7
13097,2015,68150,63833,4317,6.3
13099,2015,4347,4045,302,6.9
13101,2015,1861,1774,87,4.7
13103,2015,27094,25710,1384,5.1
13105,2015,7593,7029,564,7.4
13107,2015,8295,7569,726,8.8
13109,2015,4651,4391,260,5.6
13111,2015,10085,9461,624,6.2
13113,2015,54014,51213,2801,5.2
13115,2015,42863,40002,2861,6.7
13117,2015,104129,99407,4722,4.5
13119,2015,9260,8679,581,6.3
13121,2015,513270,482603,30667,6
13123,2015,11691,10985,706,6
13125,2015,1230,1148,82,6.7
13127,2015,37590,35308,2282,6.1
13129,2015,26081,24541,1540,5.9
13131,2015,10394,9769,625,6
13133,2015,6809,6358,451,6.6
13135,2015,451210,427813,23397,5.2
13137,2015,18765,17692,1073,5.7
13139,2015,92527,88034,4493,4.9
13141,2015,2481,2238,243,9.8
13143,2015,11837,11063,774,6.5
13145,2015,15656,14836,820,5.2
13147,2015,10373,9730,643,6.2
13149,2015,4898,4584,314,6.4
13151,2015,104748,98295,6453,6.2
13153,2015,65505,61689,3816,5.8
13155,2015,3126,2864,262,8.4
13157,2015,30660,29177,1483,4.8
13159,2015,6423,6069,354,5.5
13161,2015,6326,5905,421,6.7
13163,2015,6348,5775,573,9
13165,2015,3096,2838,258,8.3
13167,2015,3861,3591,270,7
13169,2015,13440,12698,742,5.5
13171,2015,7661,7072,589,7.7
13173,2015,3771,3520,251,6.7
13175,2015,18590,17186,1404,7.6
13177,2015,14091,13342,749,5.3
13179,2015,24903,23330,1573,6.3
13181,2015,3355,3129,226,6.7
13183,2015,7066,6651,415,5.9
13185,2015,50225,47258,2967,5.9
13187,2015,15279,14453,826,5.4
13189,2015,8761,8032,729,8.3
13191,2015,5804,5427,377,6.5
13193,2015,4604,4181,423,9.2
13195,2015,12592,11893,699,5.6
13197,2015,3436,3146,290,8.4
13199,2015,8647,7954,693,8
13201,2015,2664,2519,145,5.4
13205,2015,8693,8108,585,6.7
13207,2015,12636,11901,735,5.8
13209,2015,3701,3380,321,8.7
13211,2015,8400,7938,462,5.5
13213,2015,16025,14845,1180,7.4
13215,2015,78679,72808,5871,7.5
13217,2015,48301,45037,3264,6.8
13219,2015,17543,16766,777,4.4
13221,2015,6709,6337,372,5.5
13223,2015,76124,72166,3958,5.2
13225,2015,11257,10364,893,7.9
13227,2015,13835,13100,735,5.3
13229,2015,8023,7523,500,6.2
13231,2015,8206,7736,470,5.7
13233,2015,18100,16901,1199,6.6
13235,2015,4002,3739,263,6.6
13237,2015,7780,7152,628,8.1
13239,2015,815,759,56,6.9
13241,2015,6486,6051,435,6.7
13243,2015,2419,2199,220,9.1
13245,2015,84057,77831,6226,7.4
13247,2015,42154,39404,2750,6.5
13249,2015,2104,1964,140,6.7
13251,2015,5027,4609,418,8.3
13253,2015,3081,2832,249,8.1
13255,2015,27038,24863,2175,8
13257,2015,10832,10124,708,6.5
13259,2015,2109,1963,146,6.9
13261,2015,12796,11732,1064,8.3
13263,2015,2689,2481,208,7.7
13265,2015,591,545,46,7.8
13267,2015,9251,8680,571,6.2
13269,2015,2766,2512,254,9.2
13271,2015,4811,4392,419,8.7
13273,2015,3621,3351,270,7.5
13275,2015,16768,15556,1212,7.2
13277,2015,18296,17178,1118,6.1
13279,2015,11832,10799,1033,8.7
13281,2015,3905,3597,308,7.9
13283,2015,2693,2464,229,8.5
13285,2015,35499,33342,2157,6.1
13287,2015,3184,2968,216,6.8
13289,2015,2957,2687,270,9.1
13291,2015,9805,9281,524,5.3
13293,2015,11099,10295,804,7.2
13295,2015,29318,27567,1751,6
13297,2015,41560,39313,2247,5.4
13299,2015,14448,13508,940,6.5
13301,2015,2632,2427,205,7.8
13303,2015,7178,6676,502,7
13305,2015,11536,10701,835,7.2
13307,2015,966,875,91,9.4
13309,2015,1690,1506,184,10.9
13311,2015,13746,13034,712,5.2
13313,2015,45473,42569,2904,6.4
13315,2015,2736,2521,215,7.9
13317,2015,3880,3599,281,7.2
13319,2015,3594,3331,263,7.3
13321,2015,8820,8249,571,6.5
15001,2015,88517,84615,3902,4.4
15003,2015,466639,451044,15595,3.3
15007,2015,35074,33660,1414,4
15009,2015,83739,80632,3107,3.7
16001,2015,217606,209616,7990,3.7
16003,2015,1719,1587,132,7.7
16005,2015,41969,40274,1695,4
16007,2015,2836,2707,129,4.5
16009,2015,4046,3777,269,6.6
16011,2015,22096,21183,913,4.1
16013,2015,11847,11421,426,3.6
16015,2015,3059,2863,196,6.4
16017,2015,18573,17451,1122,6
16019,2015,51094,49295,1799,3.5
16021,2015,5103,4818,285,5.6
16023,2015,1280,1221,59,4.6
16025,2015,650,627,23,3.5
16027,2015,91171,86572,4599,5
16029,2015,3772,3615,157,4.2
16031,2015,11482,11094,388,3.4
16033,2015,396,381,15,3.8
16035,2015,3094,2842,252,8.1
16037,2015,2135,1991,144,6.7
16039,2015,10761,10249,512,4.8
16041,2015,6464,6259,205,3.2
16043,2015,7191,6926,265,3.7
16045,2015,7548,7146,402,5.3
16047,2015,7993,7712,281,3.5
16049,2015,6412,6008,404,6.3
16051,2015,12491,12060,431,3.5
16053,2015,11351,10972,379,3.3
16055,2015,71744,68061,3683,5.1
16057,2015,19510,18829,681,3.5
16059,2015,3386,3146,240,7.1
16061,2015,1594,1502,92,5.8
16063,2015,2645,2524,121,4.6
16065,2015,19805,19268,537,2.7
16067,2015,10706,10308,398,3.7
16069,2015,20658,19884,774,3.7
16071,2015,2130,2054,76,3.6
16073,2015,5225,4972,253,4.8
16075,2015,11120,10563,557,5
16077,2015,3885,3701,184,4.7
16079,2015,5139,4734,405,7.9
16081,2015,5834,5631,203,3.5
16083,2015,39090,37628,1462,3.7
16085,2015,4804,4504,300,6.2
16087,2015,4575,4306,269,5.9
17001,2015,32540,30929,1611,5
17003,2015,2293,2084,209,9.1
17005,2015,7785,7374,411,5.3
17007,2015,26353,24644,1709,6.5
17009,2015,2779,2681,98,3.5
17011,2015,17118,16023,1095,6.4
17013,2015,2342,2185,157,6.7
17015,2015,7940,7509,431,5.4
17017,2015,6452,6089,363,5.6
17019,2015,104707,99308,5399,5.2
17021,2015,15471,14457,1014,6.6
17023,2015,8084,7584,500,6.2
17025,2015,6620,6154,466,7
17027,2015,20090,19189,901,4.5
17029,2015,24100,22647,1453,6
17031,2015,2649660,2484669,164991,6.2
17033,2015,9637,9069,568,5.9
17035,2015,5910,5600,310,5.2
17037,2015,54656,51617,3039,5.6
17039,2015,7938,7498,440,5.5
17041,2015,10090,9596,494,4.9
17043,2015,512246,487824,24422,4.8
17045,2015,9435,8848,587,6.2
17047,2015,2946,2771,175,5.9
17049,2015,18425,17546,879,4.8
17051,2015,9705,9070,635,6.5
17053,2015,6514,6163,351,5.4
17055,2015,16494,15167,1327,8
17057,2015,15796,14598,1198,7.6
17059,2015,2467,2303,164,6.6
17061,2015,6049,5680,369,6.1
17063,2015,25495,23723,1772,7
17065,2015,4378,4139,239,5.5
17067,2015,8917,8369,548,6.1
17069,2015,1528,1399,129,8.4
17071,2015,3751,3527,224,6
17073,2015,25188,23653,1535,6.1
17075,2015,14806,13971,835,5.6
17077,2015,28644,27059,1585,5.5
17079,2015,4642,4354,288,6.2
17081,2015,17180,16026,1154,6.7
17083,2015,11082,10383,699,6.3
17085,2015,11456,10832,624,5.4
17087,2015,4135,3784,351,8.5
17089,2015,267740,252380,15360,5.7
17091,2015,54856,51152,3704,6.8
17093,2015,66299,62851,3448,5.2
17095,2015,23218,21811,1407,6.1
17097,2015,367581,347895,19686,5.4
17099,2015,57425,53442,3983,6.9
17101,2015,6146,5712,434,7.1
17103,2015,17855,16906,949,5.3
17105,2015,17258,16333,925,5.4
17107,2015,13019,12318,701,5.4
17109,2015,14077,13224,853,6.1
17111,2015,165991,156983,9008,5.4
17113,2015,90917,86577,4340,4.8
17115,2015,50566,47041,3525,7
17117,2015,23062,21610,1452,6.3
17119,2015,133072,125119,7953,6
17121,2015,18100,16883,1217,6.7
17123,2015,5713,5336,377,6.6
17125,2015,6612,6143,469,7.1
17127,2015,6082,5640,442,7.3
17129,2015,6743,6428,315,4.7
17131,2015,8228,7717,511,6.2
17133,2015,18106,17317,789,4.4
17135,2015,12045,11138,907,7.5
17137,2015,16992,16146,846,5
17139,2015,7369,7049,320,4.3
17141,2015,25928,24338,1590,6.1
17143,2015,90043,83897,6146,6.8
17145,2015,8861,8232,629,7.1
17147,2015,8352,7934,418,5
17149,2015,7618,7226,392,5.1
17151,2015,1766,1643,123,7
17153,2015,2090,1906,184,8.8
17155,2015,3042,2855,187,6.1
17157,2015,14311,13538,773,5.4
17159,2015,7468,7032,436,5.8
17161,2015,72570,67964,4606,6.3
17163,2015,126230,117960,8270,6.6
17165,2015,10352,9554,798,7.7
17167,2015,105473,100026,5447,5.2
17169,2015,3483,3281,202,5.8
17171,2015,2559,2409,150,5.9
17173,2015,10235,9635,600,5.9
17175,2015,2764,2581,183,6.6
17177,2015,21553,20137,1416,6.6
17179,2015,66888,62716,4172,6.2
17181,2015,7357,6794,563,7.7
17183,2015,35468,32970,2498,7
17185,2015,5625,5309,316,5.6
17187,2015,8570,8125,445,5.2
17189,2015,9360,9008,352,3.8
17191,2015,7504,6989,515,6.9
17193,2015,6932,6536,396,5.7
17195,2015,28529,26772,1757,6.2
17197,2015,357201,335106,22095,6.2
17199,2015,31940,29975,1965,6.2
17201,2015,142251,132333,9918,7
17203,2015,19587,18599,988,5
18001,2015,16897,16252,645,3.8
18003,2015,178002,169803,8199,4.6
18005,2015,43575,41999,1576,3.6
18007,2015,4577,4372,205,4.5
18009,2015,5242,4926,316,6
18011,2015,33489,32253,1236,3.7
18013,2015,7442,7086,356,4.8
18015,2015,10021,9586,435,4.3
18017,2015,17757,16941,816,4.6
18019,2015,58777,56127,2650,4.5
18021,2015,12366,11711,655,5.3
18023,2015,16917,16236,681,4
18025,2015,4914,4617,297,6
18027,2015,15693,15099,594,3.8
18029,2015,25211,23917,1294,5.1
18031,2015,14291,13709,582,4.1
18033,2015,21782,20885,897,4.1
18035,2015,54435,51332,3103,5.7
18037,2015,22672,21903,769,3.4
18039,2015,104701,100631,4070,3.9
18041,2015,8989,8398,591,6.6
18043,2015,39856,38143,1713,4.3
18045,2015,8048,7571,477,5.9
18047,2015,11386,10808,578,5.1
18049,2015,9860,9388,472,4.8
18051,2015,18858,18141,717,3.8
18053,2015,32520,30756,1764,5.4
18055,2015,13753,12807,946,6.9
18057,2015,167214,161556,5658,3.4
18059,2015,37366,35788,1578,4.2
18061,2015,19380,18490,890,4.6
18063,2015,82850,79677,3173,3.8
18065,2015,21662,20509,1153,5.3
18067,2015,36982,35136,1846,5
18069,2015,18638,17822,816,4.4
18071,2015,21783,20915,868,4
18073,2015,16358,15405,953,5.8
18075,2015,9945,9448,497,5
18077,2015,15324,14581,743,4.8
18079,2015,13166,12490,676,5.1
18081,2015,77578,74412,3166,4.1
18083,2015,19025,18152,873,4.6
18085,2015,40658,39003,1655,4.1
18087,2015,18899,18207,692,3.7
18089,2015,229684,214008,15676,6.8
18091,2015,48516,45471,3045,6.3
18093,2015,20275,18946,1329,6.6
18095,2015,58216,54909,3307,5.7
18097,2015,472300,448310,23990,5.1
18099,2015,24006,23003,1003,4.2
18101,2015,5047,4834,213,4.2
18103,2015,15749,14929,820,5.2
18105,2015,67364,64049,3315,4.9
18107,2015,19264,18494,770,4
18109,2015,35364,33698,1666,4.7
18111,2015,6960,6555,405,5.8
18113,2015,23648,22639,1009,4.3
18115,2015,3178,3002,176,5.5
18117,2015,8726,8204,522,6
18119,2015,9285,8699,586,6.3
18121,2015,7052,6653,399,5.7
18123,2015,9230,8795,435,4.7
18125,2015,6188,5918,270,4.4
18127,2015,84690,80141,4549,5.4
18129,2015,13298,12770,528,4
18131,2015,6273,5989,284,4.5
18133,2015,16399,15560,839,5.1
18135,2015,12685,12055,630,5
18137,2015,13632,12901,731,5.4
18139,2015,8839,8455,384,4.3
18141,2015,130390,123827,6563,5
18143,2015,10265,9705,560,5.5
18145,2015,22623,21616,1007,4.5
18147,2015,10974,10519,455,4.1
18149,2015,10546,9919,627,5.9
18151,2015,19978,19196,782,3.9
18153,2015,8657,8117,540,6.2
18155,2015,4853,4612,241,5
18157,2015,93106,89153,3953,4.2
18159,2015,8380,8045,335,4
18161,2015,3561,3401,160,4.5
18163,2015,92227,88290,3937,4.3
18165,2015,7226,6711,515,7.1
18167,2015,48985,45975,3010,6.1
18169,2015,15385,14648,737,4.8
18171,2015,4097,3894,203,5
18173,2015,31749,30458,1291,4.1
18175,2015,13502,12800,702,5.2
18177,2015,30643,29012,1631,5.3
18179,2015,14036,13485,551,3.9
18181,2015,13608,13055,553,4.1
18183,2015,17016,16316,700,4.1
19001,2015,4225,4088,137,3.2
19003,2015,2291,2226,65,2.8
19005,2015,7703,7324,379,4.9
19007,2015,6226,5919,307,4.9
19009,2015,3239,3110,129,4
19011,2015,13778,13238,540,3.9
19013,2015,70538,67285,3253,4.6
19015,2015,15320,14854,466,3
19017,2015,13977,13482,495,3.5
19019,2015,11321,10835,486,4.3
19021,2015,11589,11162,427,3.7
19023,2015,8284,7919,365,4.4
19025,2015,4458,4264,194,4.4
19027,2015,11309,11011,298,2.6
19029,2015,7461,7188,273,3.7
19031,2015,10991,10611,380,3.5
19033,2015,23021,22105,916,4
19035,2015,6346,6015,331,5.2
19037,2015,6459,6166,293,4.5
19039,2015,4771,4574,197,4.1
19041,2015,8856,8532,324,3.7
19043,2015,10297,9867,430,4.2
19045,2015,24446,23214,1232,5
19047,2015,8754,8385,369,4.2
19049,2015,43702,42439,1263,2.9
19051,2015,4178,3991,187,4.5
19053,2015,4432,4285,147,3.3
19055,2015,10691,10327,364,3.4
19057,2015,20531,19554,977,4.8
19059,2015,10216,9816,400,3.9
19061,2015,55752,53694,2058,3.7
19063,2015,5666,5454,212,3.7
19065,2015,10820,10326,494,4.6
19067,2015,8706,8374,332,3.8
19069,2015,5962,5760,202,3.4
19071,2015,4152,4013,139,3.3
19073,2015,5572,5375,197,3.5
19075,2015,6736,6478,258,3.8
19077,2015,5625,5411,214,3.8
19079,2015,7233,6923,310,4.3
19081,2015,6370,6196,174,2.7
19083,2015,8821,8469,352,4
19085,2015,7543,7285,258,3.4
19087,2015,9604,9225,379,3.9
19089,2015,5380,5185,195,3.6
19091,2015,5345,5166,179,3.3
19093,2015,3962,3838,124,3.1
19095,2015,10389,10021,368,3.5
19097,2015,11173,10699,474,4.2
19099,2015,19117,18369,748,3.9
19101,2015,9157,8802,355,3.9
19103,2015,83930,81675,2255,2.7
19105,2015,10788,10334,454,4.2
19107,2015,5427,5194,233,4.3
19109,2015,8838,8584,254,2.9
19111,2015,18281,17291,990,5.4
19113,2015,120268,115675,4593,3.8
19115,2015,6029,5799,230,3.8
19117,2015,4404,4247,157,3.6
19119,2015,7067,6924,143,2
19121,2015,8240,7915,325,3.9
19123,2015,11843,11370,473,4
19125,2015,17444,16869,575,3.3
19127,2015,19451,18457,994,5.1
19129,2015,7430,7124,306,4.1
19131,2015,5598,5439,159,2.8
19133,2015,4765,4554,211,4.4
19135,2015,4040,3860,180,4.5
19137,2015,5173,4988,185,3.6
19139,2015,22228,21362,866,3.9
19141,2015,8436,8195,241,2.9
19143,2015,3546,3444,102,2.9
19145,2015,6575,6301,274,4.2
19147,2015,4867,4716,151,3.1
19149,2015,14799,14379,420,2.8
19151,2015,4312,4180,132,3.1
19153,2015,255818,246329,9489,3.7
19155,2015,49029,47222,1807,3.7
19157,2015,10516,10133,383,3.6
19159,2015,2569,2482,87,3.4
19161,2015,5646,5456,190,3.4
19163,2015,87924,83783,4141,4.7
19165,2015,7023,6820,203,2.9
19167,2015,20770,20256,514,2.5
19169,2015,57461,56013,1448,2.5
19171,2015,9674,9250,424,4.4
19173,2015,3241,3138,103,3.2
19175,2015,6580,6303,277,4.2
19177,2015,3844,3687,157,4.1
19179,2015,18024,17089,935,5.2
19181,2015,26725,25802,923,3.5
19183,2015,12398,12008,390,3.1
19185,2015,2852,2739,113,4
19187,2015,20368,19482,886,4.3
19189,2015,5173,4966,207,4
19191,2015,12236,11784,452,3.7
19193,2015,56233,54094,2139,3.8
19195,2015,4230,4060,170,4
19197,2015,6912,6640,272,3.9
20001,2015,6609,6271,338,5.1
20003,2015,4136,3937,199,4.8
20005,2015,7475,7016,459,6.1
20007,2015,2664,2551,113,4.2
20009,2015,14599,13984,615,4.2
20011,2015,7122,6782,340,4.8
20013,2015,5358,5145,213,4
20015,2015,32054,30689,1365,4.3
20017,2015,1253,1208,45,3.6
20019,2015,1552,1464,88,5.7
20021,2015,10419,9957,462,4.4
20023,2015,1359,1322,37,2.7
20025,2015,1160,1132,28,2.4
20027,2015,4120,3943,177,4.3
20029,2015,4315,4151,164,3.8
20031,2015,4743,4472,271,5.7
20033,2015,992,959,33,3.3
20035,2015,17052,16273,779,4.6
20037,2015,18938,17974,964,5.1
20039,2015,1351,1302,49,3.6
20041,2015,9525,9033,492,5.2
20043,2015,4322,4135,187,4.3
20045,2015,64800,62411,2389,3.7
20047,2015,1750,1697,53,3
20049,2015,1280,1219,61,4.8
20051,2015,17533,17009,524,3
20053,2015,2940,2832,108,3.7
20055,2015,20142,19432,710,3.5
20057,2015,18073,17459,614,3.4
20059,2015,14110,13465,645,4.6
20061,2015,12116,11367,749,6.2
20063,2015,1487,1450,37,2.5
20065,2015,1273,1223,50,3.9
20067,2015,3905,3765,140,3.6
20069,2015,3603,3520,83,2.3
20071,2015,935,915,20,2.1
20073,2015,3291,3141,150,4.6
20075,2015,1653,1621,32,1.9
20077,2015,2857,2746,111,3.9
20079,2015,17219,16548,671,3.9
20081,2015,2360,2301,59,2.5
20083,2015,1028,996,32,3.1
20085,2015,7244,6976,268,3.7
20087,2015,10193,9767,426,4.2
20089,2015,1375,1315,60,4.4
20091,2015,324891,313905,10986,3.4
20093,2015,2149,2082,67,3.1
20095,2015,3651,3493,158,4.3
20097,2015,1449,1406,43,3
20099,2015,10760,10143,617,5.7
20101,2015,879,850,29,3.3
20103,2015,35293,33706,1587,4.5
20105,2015,1799,1737,62,3.4
20107,2015,4331,4054,277,6.4
20109,2015,1757,1714,43,2.4
20111,2015,16646,15933,713,4.3
20113,2015,17192,16679,513,3
20115,2015,6166,5933,233,3.8
20117,2015,5738,5571,167,2.9
20119,2015,2419,2348,71,2.9
20121,2015,16767,16041,726,4.3
20123,2015,3777,3652,125,3.3
20125,2015,16586,15516,1070,6.5
20127,2015,3106,2973,133,4.3
20129,2015,1437,1377,60,4.2
20131,2015,5943,5791,152,2.6
20133,2015,6272,5806,466,7.4
20135,2015,1538,1487,51,3.3
20137,2015,2951,2878,73,2.5
20139,2015,8062,7661,401,5
20141,2015,2092,2019,73,3.5
20143,2015,3232,3110,122,3.8
20145,2015,3309,3186,123,3.7
20147,2015,2956,2861,95,3.2
20149,2015,11962,11526,436,3.6
20151,2015,5294,5080,214,4
20153,2015,1537,1501,36,2.3
20155,2015,30859,29532,1327,4.3
20157,2015,2592,2521,71,2.7
20159,2015,5481,5274,207,3.8
20161,2015,35653,34436,1217,3.4
20163,2015,2811,2682,129,4.6
20165,2015,1796,1733,63,3.5
20167,2015,3735,3596,139,3.7
20169,2015,30891,29730,1161,3.8
20171,2015,2886,2807,79,2.7
20173,2015,246927,235164,11763,4.8
20175,2015,10629,10171,458,4.3
20177,2015,91287,87421,3866,4.2
20179,2015,1483,1450,33,2.2
20181,2015,3093,3003,90,2.9
20183,2015,2095,2014,81,3.9
20185,2015,2184,2097,87,4
20187,2015,1062,1030,32,3
20189,2015,3180,3062,118,3.7
20191,2015,11085,10593,492,4.4
20193,2015,4417,4301,116,2.6
20195,2015,1510,1457,53,3.5
20197,2015,3735,3591,144,3.9
20199,2015,877,853,24,2.7
20201,2015,3130,3032,98,3.1
20203,2015,1256,1219,37,2.9
20205,2015,4010,3747,263,6.6
20207,2015,1612,1531,81,5
20209,2015,76199,71625,4574,6
21001,2015,7221,6703,518,7.2
21003,2015,8667,8245,422,4.9
21005,2015,11337,10870,467,4.1
21007,2015,3601,3353,248,6.9
21009,2015,18430,17476,954,5.2
21011,2015,4686,4325,361,7.7
21013,2015,8722,7974,748,8.6
21015,2015,65612,62944,2668,4.1
21017,2015,9742,9282,460,4.7
21019,2015,18304,17048,1256,6.9
21021,2015,12018,11352,666,5.5
21023,2015,3724,3490,234,6.3
21025,2015,3816,3441,375,9.8
21027,2015,7654,7181,473,6.2
21029,2015,39417,37629,1788,4.5
21031,2015,5092,4792,300,5.9
21033,2015,5298,5003,295,5.6
21035,2015,18545,17683,862,4.6
21037,2015,47787,45812,1975,4.1
21039,2015,2226,2095,131,5.9
21041,2015,5007,4730,277,5.5
21043,2015,9936,8932,1004,10.1
21045,2015,6505,6129,376,5.8
21047,2015,24935,23354,1581,6.3
21049,2015,16869,15992,877,5.2
21051,2015,5285,4772,513,9.7
21053,2015,3792,3475,317,8.4
21055,2015,3717,3511,206,5.5
21057,2015,2868,2695,173,6
21059,2015,45596,43501,2095,4.6
21061,2015,4681,4352,329,7
21063,2015,2037,1827,210,10.3
21065,2015,5193,4871,322,6.2
21067,2015,167896,161462,6434,3.8
21069,2015,6073,5688,385,6.3
21071,2015,11557,10462,1095,9.5
21073,2015,24314,23280,1034,4.3
21075,2015,2063,1904,159,7.7
21077,2015,3842,3644,198,5.2
21079,2015,7491,7104,387,5.2
21081,2015,11085,10496,589,5.3
21083,2015,15116,14175,941,6.2
21085,2015,10504,9798,706,6.7
21087,2015,4964,4699,265,5.3
21089,2015,13742,12696,1046,7.6
21091,2015,3887,3694,193,5
21093,2015,46591,44283,2308,5
21095,2015,6990,6103,887,12.7
21097,2015,8321,7934,387,4.7
21099,2015,7665,7271,394,5.1
21101,2015,21415,20382,1033,4.8
21103,2015,7660,7304,356,4.6
21105,2015,1926,1809,117,6.1
21107,2015,19115,18017,1098,5.7
21109,2015,4191,3816,375,8.9
21111,2015,377447,359404,18043,4.8
21113,2015,25261,24203,1058,4.2
21115,2015,7161,6527,634,8.9
21117,2015,83251,79580,3671,4.4
21119,2015,4711,4229,482,10.2
21121,2015,9732,8934,798,8.2
21123,2015,5859,5560,299,5.1
21125,2015,23383,21920,1463,6.3
21127,2015,4971,4496,475,9.6
21129,2015,1975,1803,172,8.7
21131,2015,2870,2549,321,11.2
21133,2015,6608,5840,768,11.6
21135,2015,4791,4365,426,8.9
21137,2015,9033,8423,610,6.8
21139,2015,3679,3414,265,7.2
21141,2015,11447,10896,551,4.8
21143,2015,2865,2700,165,5.8
21145,2015,28735,27086,1649,5.7
21147,2015,4634,4240,394,8.5
21149,2015,4255,4047,208,4.9
21151,2015,45187,43241,1946,4.3
21153,2015,3326,2801,525,15.8
21155,2015,9118,8669,449,4.9
21157,2015,14808,13977,831,5.6
21159,2015,3088,2778,310,10
21161,2015,7288,6838,450,6.2
21163,2015,11786,11130,656,5.6
21165,2015,2354,2151,203,8.6
21167,2015,9674,9186,488,5
21169,2015,4020,3811,209,5.2
21171,2015,4490,4292,198,4.4
21173,2015,11707,10937,770,6.6
21175,2015,4407,4039,368,8.4
21177,2015,11504,10670,834,7.2
21179,2015,21015,19951,1064,5.1
21181,2015,3175,2976,199,6.3
21183,2015,9309,8715,594,6.4
21185,2015,30933,29729,1204,3.9
21187,2015,5370,5147,223,4.2
21189,2015,1138,1022,116,10.2
21191,2015,6673,6317,356,5.3
21193,2015,8803,8002,801,9.1
21195,2015,20852,18913,1939,9.3
21197,2015,4859,4514,345,7.1
21199,2015,25445,23941,1504,5.9
21201,2015,781,730,51,6.5
21203,2015,6874,6434,440,6.4
21205,2015,10292,9680,612,5.9
21207,2015,6145,5422,723,11.8
21209,2015,26914,25852,1062,3.9
21211,2015,22894,21974,920,4
21213,2015,8323,7924,399,4.8
21215,2015,9257,8861,396,4.3
21217,2015,11775,11065,710,6
21219,2015,5230,4977,253,4.8
21221,2015,5725,5397,328,5.7
21223,2015,3841,3625,216,5.6
21225,2015,6127,5712,415,6.8
21227,2015,59459,56799,2660,4.5
21229,2015,5954,5688,266,4.5
21231,2015,7030,6457,573,8.2
21233,2015,5959,5647,312,5.2
21235,2015,13119,12227,892,6.8
21237,2015,1909,1715,194,10.2
21239,2015,14371,13867,504,3.5
22001,2015,25814,24047,1767,6.8
22003,2015,8823,8209,614,7
22005,2015,61641,58523,3118,5.1
22007,2015,9801,9029,772,7.9
22009,2015,15962,14762,1200,7.5
22011,2015,15192,14229,963,6.3
22013,2015,5802,5320,482,8.3
22015,2015,58174,54887,3287,5.7
22017,2015,110277,102400,7877,7.1
22019,2015,99199,93850,5349,5.4
22021,2015,4026,3692,334,8.3
22023,2015,3667,3496,171,4.7
22025,2015,3613,3266,347,9.6
22027,2015,6186,5733,453,7.3
22029,2015,7540,6887,653,8.7
22031,2015,11077,10193,884,8
22033,2015,235068,222312,12756,5.4
22035,2015,2217,1904,313,14.1
22037,2015,8211,7722,489,6
22039,2015,12988,12009,979,7.5
22041,2015,7520,6791,729,9.7
22043,2015,8473,7852,621,7.3
22045,2015,31824,29241,2583,8.1
22047,2015,14406,13352,1054,7.3
22049,2015,7254,6820,434,6
22051,2015,219440,206824,12616,5.7
22053,2015,13597,12754,843,6.2
22055,2015,120075,113260,6815,5.7
22057,2015,46629,44105,2524,5.4
22059,2015,6605,6149,456,6.9
22061,2015,21059,19587,1472,7
22063,2015,68282,64782,3500,5.1
22065,2015,3903,3540,363,9.3
22067,2015,10820,9630,1190,11
22069,2015,16568,15309,1259,7.6
22071,2015,182014,170157,11857,6.5
22073,2015,72271,67465,4806,6.6
22075,2015,10326,9748,578,5.6
22077,2015,10125,9456,669,6.6
22079,2015,58190,54430,3760,6.5
22081,2015,3916,3645,271,6.9
22083,2015,8664,7907,757,8.7
22085,2015,9477,8800,677,7.1
22087,2015,19721,18419,1302,6.6
22089,2015,25612,24146,1466,5.7
22091,2015,4531,4119,412,9.1
22093,2015,9805,8973,832,8.5
22095,2015,20378,18852,1526,7.5
22097,2015,33781,31067,2714,8
22099,2015,24078,22421,1657,6.9
22101,2015,24264,22416,1848,7.6
22103,2015,117457,111128,6329,5.4
22105,2015,54218,50300,3918,7.2
22107,2015,1718,1550,168,9.8
22109,2015,53010,49842,3168,6
22111,2015,9355,8685,670,7.2
22113,2015,25839,24044,1795,6.9
22115,2015,17431,16075,1356,7.8
22117,2015,17043,15742,1301,7.6
22119,2015,15581,14206,1375,8.8
22121,2015,13258,12515,743,5.6
22123,2015,4122,3568,554,13.4
22125,2015,5405,5120,285,5.3
22127,2015,5339,4887,452,8.5
23001,2015,54794,52511,2283,4.2
23003,2015,31699,29826,1873,5.9
23005,2015,157886,152476,5410,3.4
23007,2015,14532,13841,691,4.8
23009,2015,29054,27438,1616,5.6
23011,2015,61613,59006,2607,4.2
23013,2015,20470,19632,838,4.1
23015,2015,16723,15981,742,4.4
23017,2015,26525,25084,1441,5.4
23019,2015,76846,73216,3630,4.7
23021,2015,7451,7040,411,5.5
23023,2015,18929,18265,664,3.5
23025,2015,23628,22083,1545,6.5
23027,2015,20612,19541,1071,5.2
23029,2015,13988,13097,891,6.4
23031,2015,108457,104205,4252,3.9
24001,2015,32268,30019,2249,7
24003,2015,300734,287527,13207,4.4
24005,2015,444695,421196,23499,5.3
24009,2015,46983,44828,2155,4.6
24011,2015,17459,16508,951,5.4
24013,2015,92993,89073,3920,4.2
24015,2015,52551,49406,3145,6
24017,2015,80462,76461,4001,5
24019,2015,15795,14665,1130,7.2
24021,2015,128447,122710,5737,4.5
24023,2015,15630,14645,985,6.3
24025,2015,135790,129121,6669,4.9
24027,2015,176626,169904,6722,3.8
24029,2015,10568,10005,563,5.3
24031,2015,547058,525766,21292,3.9
24033,2015,486296,460826,25470,5.2
24035,2015,26606,25407,1199,4.5
24037,2015,54555,51911,2644,4.8
24039,2015,9220,8462,758,8.2
24041,2015,19256,18312,944,4.9
24043,2015,76636,72341,4295,5.6
24045,2015,50195,46792,3403,6.8
24047,2015,25449,22761,2688,10.6
24510,2015,293482,271363,22119,7.5
25001,2015,111629,104814,6815,6.1
25003,2015,65305,61781,3524,5.4
25005,2015,289123,271367,17756,6.1
25007,2015,9460,8842,618,6.5
25009,2015,407973,387578,20395,5
25011,2015,39456,37723,1733,4.4
25013,2015,222766,208514,14252,6.4
25015,2015,87393,83453,3940,4.5
25017,2015,863794,829932,33862,3.9
25019,2015,6970,6595,375,5.4
25021,2015,369268,353870,15398,4.2
25023,2015,268348,254783,13565,5.1
25025,2015,421127,402568,18559,4.4
25027,2015,427736,405970,21766,5.1
26001,2015,3804,3498,306,8
26003,2015,3228,2952,276,8.6
26005,2015,60443,57933,2510,4.2
26007,2015,13611,12760,851,6.3
26009,2015,9985,9237,748,7.5
26011,2015,6225,5665,560,9
26013,2015,3296,2994,302,9.2
26015,2015,30205,28905,1300,4.3
26017,2015,52185,49165,3020,5.8
26019,2015,8672,8065,607,7
26021,2015,73366,69532,3834,5.2
26023,2015,19138,18157,981,5.1
26025,2015,64125,60849,3276,5.1
26027,2015,24008,22790,1218,5.1
26029,2015,13041,12252,789,6.1
26031,2015,10680,9703,977,9.1
26033,2015,16684,15382,1302,7.8
26035,2015,11776,10861,915,7.8
26037,2015,39725,38164,1561,3.9
26039,2015,5271,4857,414,7.9
26041,2015,17233,16059,1174,6.8
26043,2015,12599,11884,715,5.7
26045,2015,55833,53355,2478,4.4
26047,2015,17627,16352,1275,7.2
26049,2015,181656,170568,11088,6.1
26051,2015,9974,9246,728,7.3
26053,2015,6491,6015,476,7.3
26055,2015,48427,46161,2266,4.7
26057,2015,18283,17243,1040,5.7
26059,2015,21016,19910,1106,5.3
26061,2015,16559,15504,1055,6.4
26063,2015,16356,15472,884,5.4
26065,2015,145756,138930,6826,4.7
26067,2015,29343,27999,1344,4.6
26069,2015,10091,9328,763,7.6
26071,2015,5204,4836,368,7.1
26073,2015,35287,33588,1699,4.8
26075,2015,73003,69131,3872,5.3
26077,2015,129090,123458,5632,4.4
26079,2015,7623,7036,587,7.7
26081,2015,342320,329402,12918,3.8
26083,2015,939,852,87,9.3
26085,2015,3677,3361,316,8.6
26087,2015,39802,36938,2864,7.2
26089,2015,10579,10020,559,5.3
26091,2015,47451,45067,2384,5
26093,2015,96623,92159,4464,4.6
26095,2015,2458,2286,172,7
26097,2015,5120,4621,499,9.7
26099,2015,422297,397995,24302,5.8
26101,2015,10402,9708,694,6.7
26103,2015,33367,31359,2008,6
26105,2015,14407,13524,883,6.1
26107,2015,19132,17951,1181,6.2
26109,2015,11522,10899,623,5.4
26111,2015,41412,39388,2024,4.9
26113,2015,6985,6526,459,6.6
26115,2015,76188,72708,3480,4.6
26117,2015,27672,26082,1590,5.7
26119,2015,3064,2758,306,10
26121,2015,77270,72756,4514,5.8
26123,2015,23068,21803,1265,5.5
26125,2015,634053,604103,29950,4.7
26127,2015,12482,11481,1001,8
26129,2015,8403,7740,663,7.9
26131,2015,2293,2077,216,9.4
26133,2015,10156,9493,663,6.5
26135,2015,2909,2656,253,8.7
26137,2015,11401,10700,701,6.1
26139,2015,152334,146781,5553,3.6
26141,2015,5355,4808,547,10.2
26143,2015,7804,7097,707,9.1
26145,2015,88365,83314,5051,5.7
26147,2015,72961,67987,4974,6.8
26149,2015,29031,27717,1314,4.5
26151,2015,19496,18223,1273,6.5
26153,2015,3457,3081,376,10.9
26155,2015,33064,31189,1875,5.7
26157,2015,24514,22866,1648,6.7
26159,2015,35218,33001,2217,6.3
26161,2015,188340,181321,7019,3.7
26163,2015,760432,707828,52604,6.9
26165,2015,14569,13583,986,6.8
27001,2015,6871,6422,449,6.5
27003,2015,189817,182979,6838,3.6
27005,2015,18395,17593,802,4.4
27007,2015,23498,22349,1149,4.9
27009,2015,21584,20629,955,4.4
27011,2015,2682,2563,119,4.4
27013,2015,39374,38217,1157,2.9
27015,2015,14617,14021,596,4.1
27017,2015,17567,16706,861,4.9
27019,2015,55168,53426,1742,3.2
27021,2015,14026,13092,934,6.7
27023,2015,6943,6640,303,4.4
27025,2015,28728,27534,1194,4.2
27027,2015,35539,34440,1099,3.1
27029,2015,4626,4207,419,9.1
27031,2015,3153,3015,138,4.4
27033,2015,5786,5512,274,4.7
27035,2015,31490,29873,1617,5.1
27037,2015,232239,224602,7637,3.3
27039,2015,11451,11026,425,3.7
27041,2015,20134,19448,686,3.4
27043,2015,7501,7174,327,4.4
27045,2015,11403,10939,464,4.1
27047,2015,16341,15727,614,3.8
27049,2015,26874,25933,941,3.5
27051,2015,3346,3189,157,4.7
27053,2015,676722,654583,22139,3.3
27055,2015,10482,10084,398,3.8
27057,2015,9552,8969,583,6.1
27059,2015,20194,19328,866,4.3
27061,2015,22291,20852,1439,6.5
27063,2015,6287,6034,253,4
27065,2015,8833,8253,580,6.6
27067,2015,24058,23162,896,3.7
27069,2015,2472,2358,114,4.6
27071,2015,6252,5746,506,8.1
27073,2015,3763,3609,154,4.1
27075,2015,5609,5341,268,4.8
27077,2015,2421,2314,107,4.4
27079,2015,15533,14787,746,4.8
27081,2015,3391,3273,118,3.5
27083,2015,15283,14793,490,3.2
27085,2015,20200,19408,792,3.9
27087,2015,2405,2266,139,5.8
27089,2015,5742,5347,395,6.9
27091,2015,10444,10022,422,4
27093,2015,13338,12780,558,4.2
27095,2015,12610,11882,728,5.8
27097,2015,17793,16835,958,5.4
27099,2015,20358,19707,651,3.2
27101,2015,5062,4838,224,4.4
27103,2015,20303,19770,533,2.6
27105,2015,11524,11156,368,3.2
27107,2015,3441,3281,160,4.6
27109,2015,83886,81446,2440,2.9
27111,2015,31112,29809,1303,4.2
27113,2015,9076,8612,464,5.1
27115,2015,14781,13961,820,5.5
27117,2015,4976,4810,166,3.3
27119,2015,17162,16440,722,4.2
27121,2015,6388,6166,222,3.5
27123,2015,279536,269716,9820,3.5
27125,2015,2329,2192,137,5.9
27127,2015,8267,7945,322,3.9
27129,2015,8590,8179,411,4.8
27131,2015,35417,34168,1249,3.5
27133,2015,5908,5783,125,2.1
27135,2015,8600,8260,340,4
27137,2015,101908,96866,5042,4.9
27139,2015,79144,76678,2466,3.1
27141,2015,49462,47487,1975,4
27143,2015,8509,8157,352,4.1
27145,2015,88119,84946,3173,3.6
27147,2015,21199,20494,705,3.3
27149,2015,5709,5549,160,2.8
27151,2015,5170,4860,310,6
27153,2015,13006,12438,568,4.4
27155,2015,1835,1759,76,4.1
27157,2015,11991,11539,452,3.8
27159,2015,6327,5954,373,5.9
27161,2015,9750,9348,402,4.1
27163,2015,137133,132814,4319,3.1
27165,2015,6250,5959,291,4.7
27167,2015,3690,3568,122,3.3
27169,2015,29467,28494,973,3.3
27171,2015,71969,69334,2635,3.7
27173,2015,5575,5371,204,3.7
28001,2015,11423,10516,907,7.9
28003,2015,15739,14855,884,5.6
28005,2015,4519,4178,341,7.5
28007,2015,6991,6461,530,7.6
28009,2015,2988,2750,238,8
28011,2015,13402,12353,1049,7.8
28013,2015,6145,5767,378,6.2
28015,2015,3464,3181,283,8.2
28017,2015,7158,6610,548,7.7
28019,2015,3714,3483,231,6.2
28021,2015,3122,2731,391,12.5
28023,2015,6083,5607,476,7.8
28025,2015,8026,7260,766,9.5
28027,2015,9461,8511,950,10
28029,2015,11271,10460,811,7.2
28031,2015,7975,7510,465,5.8
28033,2015,84658,80609,4049,4.8
28035,2015,32878,30817,2061,6.3
28037,2015,2941,2716,225,7.7
28039,2015,8866,8203,663,7.5
28041,2015,4334,4009,325,7.5
28043,2015,9491,8928,563,5.9
28045,2015,18695,17488,1207,6.5
28047,2015,85745,80670,5075,5.9
28049,2015,109335,102770,6565,6
28051,2015,6122,5388,734,12
28053,2015,2469,2158,311,12.6
28055,2015,420,348,72,17.1
28057,2015,10221,9638,583,5.7
28059,2015,59038,54896,4142,7
28061,2015,6371,5874,497,7.8
28063,2015,2280,1941,339,14.9
28065,2015,4133,3774,359,8.7
28067,2015,26580,24992,1588,6
28069,2015,3580,3211,369,10.3
28071,2015,24472,23140,1332,5.4
28073,2015,28934,27546,1388,4.8
28075,2015,31693,29623,2070,6.5
28077,2015,4750,4409,341,7.2
28079,2015,7900,7415,485,6.1
28081,2015,39902,37695,2207,5.5
28083,2015,10500,9374,1126,10.7
28085,2015,14241,13380,861,6
28087,2015,25148,23388,1760,7
28089,2015,51703,49346,2357,4.6
28091,2015,10019,9290,729,7.3
28093,2015,14459,13420,1039,7.2
28095,2015,15500,14361,1139,7.3
28097,2015,4203,3879,324,7.7
28099,2015,10635,9985,650,6.1
28101,2015,8728,8195,533,6.1
28103,2015,3957,3571,386,9.8
28105,2015,22520,21146,1374,6.1
28107,2015,13453,12287,1166,8.7
28109,2015,22893,21487,1406,6.1
28111,2015,4320,3977,343,7.9
28113,2015,14711,13640,1071,7.3
28115,2015,13891,13119,772,5.6
28117,2015,11007,10342,665,6
28119,2015,2690,2401,289,10.7
28121,2015,73096,70072,3024,4.1
28123,2015,12998,12375,623,4.8
28125,2015,1729,1563,166,9.6
28127,2015,10909,10270,639,5.9
28129,2015,6761,6400,361,5.3
28131,2015,6416,5942,474,7.4
28133,2015,8482,7595,887,10.5
28135,2015,5816,5378,438,7.5
28137,2015,12008,11163,845,7
28139,2015,9449,8850,599,6.3
28141,2015,8020,7512,508,6.3
28143,2015,4660,4229,431,9.2
28145,2015,13227,12555,672,5.1
28147,2015,5154,4739,415,8.1
28149,2015,20905,19520,1385,6.6
28151,2015,18059,16210,1849,10.2
28153,2015,7628,7027,601,7.9
28155,2015,3944,3662,282,7.2
28157,2015,2885,2581,304,10.5
28159,2015,7091,6508,583,8.2
28161,2015,4933,4581,352,7.1
28163,2015,9216,8465,751,8.1
29001,2015,10439,9850,589,5.6
29003,2015,9918,9505,413,4.2
29005,2015,2830,2704,126,4.5
29007,2015,11307,10783,524,4.6
29009,2015,14907,14160,747,5
29011,2015,5325,5036,289,5.4
29013,2015,8148,7652,496,6.1
29015,2015,7189,6720,469,6.5
29017,2015,5552,5241,311,5.6
29019,2015,98825,95347,3478,3.5
29021,2015,46475,44338,2137,4.6
29023,2015,18969,17792,1177,6.2
29025,2015,4393,4193,200,4.6
29027,2015,21665,20643,1022,4.7
29029,2015,18744,17515,1229,6.6
29031,2015,40849,39086,1763,4.3
29033,2015,4815,4524,291,6
29035,2015,2508,2322,186,7.4
29037,2015,53863,51270,2593,4.8
29039,2015,5889,5578,311,5.3
29041,2015,3851,3670,181,4.7
29043,2015,43036,41215,1821,4.2
29045,2015,3432,3187,245,7.1
29047,2015,132142,126130,6012,4.5
29049,2015,10987,10453,534,4.9
29051,2015,39364,37788,1576,4
29053,2015,7610,7170,440,5.8
29055,2015,10904,10246,658,6
29057,2015,3568,3387,181,5.1
29059,2015,6976,6541,435,6.2
29061,2015,4085,3898,187,4.6
29063,2015,5047,4812,235,4.7
29065,2015,6297,5930,367,5.8
29067,2015,5037,4695,342,6.8
29069,2015,13118,12062,1056,8.1
29071,2015,52501,49839,2662,5.1
29073,2015,7679,7352,327,4.3
29075,2015,3613,3461,152,4.2
29077,2015,149237,143026,6211,4.2
29079,2015,4909,4706,203,4.1
29081,2015,3984,3782,202,5.1
29083,2015,10105,9555,550,5.4
29085,2015,3720,3473,247,6.6
29087,2015,2709,2611,98,3.6
29089,2015,5043,4796,247,4.9
29091,2015,16342,15290,1052,6.4
29093,2015,3850,3544,306,7.9
29095,2015,362890,341445,21445,5.9
29097,2015,58041,55552,2489,4.3
29099,2015,117612,111887,5725,4.9
29101,2015,23100,21856,1244,5.4
29103,2015,1963,1886,77,3.9
29105,2015,15928,14916,1012,6.4
29107,2015,17174,16340,834,4.9
29109,2015,17874,16997,877,4.9
29111,2015,5211,4954,257,4.9
29113,2015,26943,25551,1392,5.2
29115,2015,5240,4872,368,7
29117,2015,7301,6990,311,4.3
29119,2015,10407,9913,494,4.7
29121,2015,7468,7069,399,5.3
29123,2015,5517,5192,325,5.9
29125,2015,3935,3726,209,5.3
29127,2015,14744,14088,656,4.4
29129,2015,1886,1802,84,4.5
29131,2015,11647,10945,702,6
29133,2015,6280,5916,364,5.8
29135,2015,7396,7033,363,4.9
29137,2015,4209,3989,220,5.2
29139,2015,5705,5421,284,5
29141,2015,8072,7528,544,6.7
29143,2015,8577,8043,534,6.2
29145,2015,28428,27127,1301,4.6
29147,2015,11010,10468,542,4.9
29149,2015,4161,3897,264,6.3
29151,2015,7157,6888,269,3.8
29153,2015,3646,3355,291,8
29155,2015,7041,6403,638,9.1
29157,2015,10205,9775,430,4.2
29159,2015,20917,19815,1102,5.3
29161,2015,19559,18518,1041,5.3
29163,2015,8107,7735,372,4.6
29165,2015,55415,53084,2331,4.2
29167,2015,14253,13500,753,5.3
29169,2015,14883,14013,870,5.8
29171,2015,2499,2400,99,4
29173,2015,5668,5428,240,4.2
29175,2015,10500,9870,630,6
29177,2015,11159,10547,612,5.5
29179,2015,2712,2522,190,7
29181,2015,5323,4899,424,8
29183,2015,217500,209123,8377,3.9
29185,2015,3977,3700,277,7
29186,2015,9058,8573,485,5.4
29187,2015,26396,24788,1608,6.1
29189,2015,533436,508699,24737,4.6
29195,2015,11049,10515,534,4.8
29197,2015,1907,1796,111,5.8
29199,2015,2450,2339,111,4.5
29201,2015,20042,18992,1050,5.2
29203,2015,3337,3064,273,8.2
29205,2015,3076,2930,146,4.7
29207,2015,13229,12352,877,6.6
29209,2015,13365,12308,1057,7.9
29211,2015,2778,2612,166,6
29213,2015,26158,24043,2115,8.1
29215,2015,9402,8776,626,6.7
29217,2015,9816,9317,499,5.1
29219,2015,17336,16506,830,4.8
29221,2015,10519,9812,707,6.7
29223,2015,5715,5379,336,5.9
29225,2015,16646,15798,848,5.1
29227,2015,1218,1178,40,3.3
29229,2015,7640,7161,479,6.3
29510,2015,159666,149970,9696,6.1
30001,2015,4979,4808,171,3.4
30003,2015,5550,5178,372,6.7
30005,2015,2396,2276,120,5
30007,2015,2484,2358,126,5.1
30009,2015,5425,5225,200,3.7
30011,2015,685,663,22,3.2
30013,2015,38294,36747,1547,4
30015,2015,2524,2441,83,3.3
30017,2015,6388,6177,211,3.3
30019,2015,943,919,24,2.5
30021,2015,4820,4668,152,3.2
30023,2015,5235,5027,208,4
30025,2015,1970,1924,46,2.3
30027,2015,5701,5465,236,4.1
30029,2015,44813,42251,2562,5.7
30031,2015,59442,57655,1787,3
30033,2015,762,741,21,2.8
30035,2015,5852,5327,525,9
30037,2015,380,364,16,4.2
30039,2015,1559,1462,97,6.2
30041,2015,7794,7468,326,4.2
30043,2015,5582,5354,228,4.1
30045,2015,994,960,34,3.4
30047,2015,12694,12060,634,5
30049,2015,35001,33822,1179,3.4
30051,2015,985,959,26,2.6
30053,2015,7807,7019,788,10.1
30055,2015,1062,1039,23,2.2
30057,2015,4286,4131,155,3.6
30059,2015,936,902,34,3.6
30061,2015,1728,1583,145,8.4
30063,2015,60506,58130,2376,3.9
30065,2015,2408,2305,103,4.3
30067,2015,8298,7900,398,4.8
30069,2015,284,269,15,5.3
30071,2015,1977,1877,100,5.1
30073,2015,2865,2737,128,4.5
30075,2015,1056,1029,27,2.6
30077,2015,2960,2828,132,4.5
30079,2015,529,507,22,4.2
30081,2015,19216,18215,1001,5.2
30083,2015,6878,6656,222,3.2
30085,2015,4691,4445,246,5.2
30087,2015,4174,3951,223,5.3
30089,2015,4703,4312,391,8.3
30091,2015,2075,2023,52,2.5
30093,2015,17128,16393,735,4.3
30095,2015,4930,4745,185,3.8
30097,2015,1788,1738,50,2.8
30099,2015,2889,2778,111,3.8
30101,2015,2298,2220,78,3.4
30103,2015,358,340,18,5
30105,2015,4390,4252,138,3.1
30107,2015,788,745,43,5.5
30109,2015,546,528,18,3.3
30111,2015,80763,78086,2677,3.3
31001,2015,16605,16086,519,3.1
31003,2015,3594,3502,92,2.6
31005,2015,224,214,10,4.5
31007,2015,440,425,15,3.4
31009,2015,268,256,12,4.5
31011,2015,3011,2937,74,2.5
31013,2015,5659,5489,170,3
31015,2015,1088,1060,28,2.6
31017,2015,1394,1342,52,3.7
31019,2015,27126,26465,661,2.4
31021,2015,3608,3477,131,3.6
31023,2015,4736,4604,132,2.8
31025,2015,13066,12632,434,3.3
31027,2015,4640,4530,110,2.4
31029,2015,2338,2293,45,1.9
31031,2015,3448,3369,79,2.3
31033,2015,5745,5620,125,2.2
31035,2015,3373,3275,98,2.9
31037,2015,5548,5403,145,2.6
31039,2015,4837,4709,128,2.6
31041,2015,6282,6142,140,2.2
31043,2015,10990,10602,388,3.5
31045,2015,5248,5112,136,2.6
31047,2015,13057,12644,413,3.2
31049,2015,1074,1047,27,2.5
31051,2015,3081,2979,102,3.3
31053,2015,19087,18466,621,3.3
31055,2015,286637,277160,9477,3.3
31057,2015,1196,1171,25,2.1
31059,2015,3207,3112,95,3
31061,2015,1510,1474,36,2.4
31063,2015,1531,1494,37,2.4
31065,2015,2727,2655,72,2.6
31067,2015,11041,10642,399,3.6
31069,2015,1196,1167,29,2.4
31071,2015,1193,1164,29,2.4
31073,2015,1074,1048,26,2.4
31075,2015,435,425,10,2.3
31077,2015,1248,1209,39,3.1
31079,2015,31580,30337,1243,3.9
31081,2015,4670,4536,134,2.9
31083,2015,1785,1747,38,2.1
31085,2015,616,602,14,2.3
31087,2015,1321,1278,43,3.3
31089,2015,5865,5725,140,2.4
31091,2015,405,388,17,4.2
31093,2015,3308,3187,121,3.7
31095,2015,4272,4156,116,2.7
31097,2015,2123,2053,70,3.3
31099,2015,3790,3706,84,2.2
31101,2015,4682,4557,125,2.7
31103,2015,660,646,14,2.1
31105,2015,2051,1978,73,3.6
31107,2015,4716,4565,151,3.2
31109,2015,167438,163022,4416,2.6
31111,2015,18529,17993,536,2.9
31113,2015,492,478,14,2.8
31115,2015,378,364,14,3.7
31117,2015,460,451,9,2
31119,2015,19199,18674,525,2.7
31121,2015,4025,3875,150,3.7
31123,2015,2649,2573,76,2.9
31125,2015,2064,2013,51,2.5
31127,2015,3688,3553,135,3.7
31129,2015,2380,2319,61,2.6
31131,2015,8196,7926,270,3.3
31133,2015,1671,1628,43,2.6
31135,2015,1834,1800,34,1.9
31137,2015,4990,4871,119,2.4
31139,2015,4165,4059,106,2.5
31141,2015,17135,16625,510,3
31143,2015,2908,2834,74,2.5
31145,2015,6100,5939,161,2.6
31147,2015,4298,4160,138,3.2
31149,2015,858,835,23,2.7
31151,2015,7276,7063,213,2.9
31153,2015,90607,88063,2544,2.8
31155,2015,10922,10587,335,3.1
31157,2015,18652,18022,630,3.4
31159,2015,8693,8441,252,2.9
31161,2015,2729,2655,74,2.7
31163,2015,1708,1658,50,2.9
31165,2015,788,768,20,2.5
31167,2015,3503,3414,89,2.5
31169,2015,2966,2896,70,2.4
31171,2015,435,422,13,3
31173,2015,2968,2811,157,5.3
31175,2015,2062,2004,58,2.8
31177,2015,10932,10604,328,3
31179,2015,5537,5396,141,2.5
31181,2015,1724,1663,61,3.5
31183,2015,562,549,13,2.3
31185,2015,7336,7124,212,2.9
32001,2015,10567,9841,726,6.9
32003,2015,1033990,963285,70705,6.8
32005,2015,22393,20888,1505,6.7
32007,2015,26822,25450,1372,5.1
32009,2015,527,504,23,4.4
32011,2015,998,940,58,5.8
32013,2015,8427,7938,489,5.8
32015,2015,3266,3050,216,6.6
32017,2015,1962,1844,118,6
32019,2015,21793,19768,2025,9.3
32021,2015,1608,1444,164,10.2
32023,2015,16107,14711,1396,8.7
32027,2015,2500,2331,169,6.8
32029,2015,1865,1727,138,7.4
32031,2015,224888,210859,14029,6.2
32033,2015,4800,4546,254,5.3
32510,2015,24760,22976,1784,7.2
33001,2015,31611,30561,1050,3.3
33003,2015,23806,22982,824,3.5
33005,2015,41561,40250,1311,3.2
33007,2015,14823,14179,644,4.3
33009,2015,48672,47341,1331,2.7
33011,2015,229847,221670,8177,3.6
33013,2015,81340,78844,2496,3.1
33015,2015,178834,172432,6402,3.6
33017,2015,71277,69061,2216,3.1
33019,2015,23689,23041,648,2.7
34001,2015,126383,114274,12109,9.6
34003,2015,479276,456727,22549,4.7
34005,2015,230059,217756,12303,5.3
34007,2015,252576,236249,16327,6.5
34009,2015,48038,42694,5344,11.1
34011,2015,67457,61503,5954,8.8
34013,2015,371065,345364,25701,6.9
34015,2015,148271,139287,8984,6.1
34017,2015,358799,339480,19319,5.4
34019,2015,64834,62076,2758,4.3
34021,2015,196407,186569,9838,5
34023,2015,435612,413173,22439,5.2
34025,2015,326153,309267,16886,5.2
34027,2015,259239,247878,11361,4.4
34029,2015,265397,248986,16411,6.2
34031,2015,246433,228970,17463,7.1
34033,2015,30816,28552,2264,7.3
34035,2015,172453,164570,7883,4.6
34037,2015,75821,71679,4142,5.5
34039,2015,277226,260453,16773,6.1
34041,2015,56691,53654,3037,5.4
35001,2015,323066,304141,18925,5.9
35003,2015,1194,1095,99,8.3
35005,2015,27780,26038,1742,6.3
35006,2015,9291,8551,740,8
35007,2015,6052,5691,361,6
35009,2015,21953,20887,1066,4.9
35011,2015,854,810,44,5.2
35013,2015,94548,87667,6881,7.3
35015,2015,29887,28423,1464,4.9
35017,2015,12501,11695,806,6.4
35019,2015,1638,1523,115,7
35021,2015,286,262,24,8.4
35023,2015,2141,2009,132,6.2
35025,2015,29983,28134,1849,6.2
35027,2015,8713,8213,500,5.7
35028,2015,8525,8182,343,4
35029,2015,11062,9155,1907,17.2
35031,2015,24354,21985,2369,9.7
35033,2015,2274,2055,219,9.6
35035,2015,25062,23520,1542,6.2
35037,2015,3278,3046,232,7.1
35039,2015,16632,15304,1328,8
35041,2015,8062,7628,434,5.4
35043,2015,62221,58111,4110,6.6
35045,2015,55754,51932,3822,6.9
35047,2015,11114,10266,848,7.6
35049,2015,73358,69456,3902,5.3
35051,2015,4038,3673,365,9
35053,2015,6553,6061,492,7.5
35055,2015,14948,13586,1362,9.1
35057,2015,5478,4985,493,9
35059,2015,1898,1815,83,4.4
35061,2015,29727,27526,2201,7.4
36001,2015,158427,151543,6884,4.3
36003,2015,20335,19014,1321,6.5
36005,2015,605820,558695,47125,7.8
36007,2015,86750,81577,5173,6
36009,2015,35202,32989,2213,6.3
36011,2015,37056,35079,1977,5.3
36013,2015,57578,54110,3468,6
36015,2015,37455,35259,2196,5.9
36017,2015,23079,21820,1259,5.5
36019,2015,35909,33819,2090,5.8
36021,2015,31399,30149,1250,4
36023,2015,23264,21895,1369,5.9
36025,2015,19491,18323,1168,6
36027,2015,143199,136773,6426,4.5
36029,2015,448519,424619,23900,5.3
36031,2015,17305,16264,1041,6
36033,2015,19965,18666,1299,6.5
36035,2015,23440,21932,1508,6.4
36037,2015,30090,28601,1489,4.9
36039,2015,20714,19547,1167,5.6
36041,2015,2433,2269,164,6.7
36043,2015,28408,26638,1770,6.2
36045,2015,46507,43444,3063,6.6
36047,2015,1214639,1142945,71694,5.9
36049,2015,11763,10950,813,6.9
36051,2015,31238,29597,1641,5.3
36053,2015,32879,31013,1866,5.7
36055,2015,365330,346821,18509,5.1
36057,2015,22263,20803,1460,6.6
36059,2015,697396,667975,29421,4.2
36061,2015,909876,865574,44302,4.9
36063,2015,101100,94876,6224,6.2
36065,2015,102089,96645,5444,5.3
36067,2015,222409,211451,10958,4.9
36069,2015,55047,52450,2597,4.7
36071,2015,177909,169624,8285,4.7
36073,2015,17869,16733,1136,6.4
36075,2015,54006,50131,3875,7.2
36077,2015,28695,27149,1546,5.4
36079,2015,50597,48441,2156,4.3
36081,2015,1157052,1098924,58128,5
36083,2015,81555,77766,3789,4.6
36085,2015,219485,206664,12821,5.8
36087,2015,152134,145261,6873,4.5
36089,2015,43878,40675,3203,7.3
36091,2015,116843,111998,4845,4.1
36093,2015,75726,72158,3568,4.7
36095,2015,14669,13818,851,5.8
36097,2015,8350,7798,552,6.6
36099,2015,15719,14910,809,5.1
36101,2015,43695,40946,2749,6.3
36103,2015,775941,739430,36511,4.7
36105,2015,33701,31883,1818,5.4
36107,2015,23376,22082,1294,5.5
36109,2015,50410,48194,2216,4.4
36111,2015,88315,84074,4241,4.8
36113,2015,32247,30463,1784,5.5
36115,2015,28645,27208,1437,5
36117,2015,44275,41920,2355,5.3
36119,2015,478305,456605,21700,4.5
36121,2015,18372,17338,1034,5.6
36123,2015,11738,11154,584,5
37001,2015,77316,73182,4134,5.3
37003,2015,17546,16683,863,4.9
37005,2015,4468,4194,274,6.1
37007,2015,10833,10127,706,6.5
37009,2015,12316,11575,741,6
37011,2015,7534,7087,447,5.9
37013,2015,20124,18800,1324,6.6
37015,2015,8607,7985,622,7.2
37017,2015,14746,13573,1173,8
37019,2015,48557,45015,3542,7.3
37021,2015,130462,124771,5691,4.4
37023,2015,39342,37131,2211,5.6
37025,2015,97651,92596,5055,5.2
37027,2015,35476,33260,2216,6.2
37029,2015,4614,4350,264,5.7
37031,2015,31347,29493,1854,5.9
37033,2015,9628,9021,607,6.3
37035,2015,75183,71041,4142,5.5
37037,2015,33400,31814,1586,4.7
37039,2015,11124,10407,717,6.4
37041,2015,5643,5240,403,7.1
37043,2015,4045,3797,248,6.1
37045,2015,46106,43162,2944,6.4
37047,2015,22619,20917,1702,7.5
37049,2015,41359,38856,2503,6.1
37051,2015,126316,117091,9225,7.3
37053,2015,12854,12109,745,5.8
37055,2015,20308,18794,1514,7.5
37057,2015,78770,74390,4380,5.6
37059,2015,19856,18857,999,5
37061,2015,26499,24981,1518,5.7
37063,2015,156678,148827,7851,5
37065,2015,22829,20645,2184,9.6
37067,2015,179807,169910,9897,5.5
37069,2015,28727,27027,1700,5.9
37071,2015,102829,96650,6179,6
37073,2015,5146,4864,282,5.5
37075,2015,3188,2806,382,12
37077,2015,28544,27134,1410,4.9
37079,2015,9484,8959,525,5.5
37081,2015,256391,241343,15048,5.9
37083,2015,20781,18950,1831,8.8
37085,2015,50270,46900,3370,6.7
37087,2015,27663,26209,1454,5.3
37089,2015,50682,48275,2407,4.7
37091,2015,9225,8574,651,7.1
37093,2015,19838,18265,1573,7.9
37095,2015,2146,1950,196,9.1
37097,2015,82219,77703,4516,5.5
37099,2015,18472,17348,1124,6.1
37101,2015,88197,83588,4609,5.2
37103,2015,4550,4288,262,5.8
37105,2015,26101,24219,1882,7.2
37107,2015,27752,25992,1760,6.3
37109,2015,40631,38426,2205,5.4
37111,2015,21268,20100,1168,5.5
37113,2015,15127,14194,933,6.2
37115,2015,9473,8934,539,5.7
37117,2015,9721,8975,746,7.7
37119,2015,565536,535243,30293,5.4
37121,2015,6313,5881,432,6.8
37123,2015,11631,10969,662,5.7
37125,2015,38306,36086,2220,5.8
37127,2015,43883,40689,3194,7.3
37129,2015,113437,107365,6072,5.4
37131,2015,7869,7277,592,7.5
37133,2015,63780,60021,3759,5.9
37135,2015,73404,70008,3396,4.6
37137,2015,5338,5020,318,6
37139,2015,17458,16193,1265,7.2
37141,2015,26028,24442,1586,6.1
37143,2015,5158,4790,368,7.1
37145,2015,17891,16677,1214,6.8
37147,2015,87726,82415,5311,6.1
37149,2015,8665,8224,441,5.1
37151,2015,66670,62868,3802,5.7
37153,2015,16933,15594,1339,7.9
37155,2015,51068,46745,4323,8.5
37157,2015,41138,38418,2720,6.6
37159,2015,63119,59280,3839,6.1
37161,2015,25061,23115,1946,7.8
37163,2015,29556,27807,1749,5.9
37165,2015,11865,10608,1257,10.6
37167,2015,28809,27276,1533,5.3
37169,2015,21813,20630,1183,5.4
37171,2015,33342,31537,1805,5.4
37173,2015,6778,6258,520,7.7
37175,2015,13552,12815,737,5.4
37177,2015,1548,1401,147,9.5
37179,2015,112371,106930,5441,4.8
37181,2015,18054,16509,1545,8.6
37183,2015,539721,514309,25412,4.7
37185,2015,7215,6618,597,8.3
37187,2015,4969,4538,431,8.7
37189,2015,27403,26076,1327,4.8
37191,2015,53753,50496,3257,6.1
37193,2015,29639,27958,1681,5.7
37195,2015,36766,33276,3490,9.5
37197,2015,17498,16621,877,5
37199,2015,7418,6981,437,5.9
38001,2015,1106,1074,32,2.9
38003,2015,5631,5450,181,3.2
38005,2015,2474,2360,114,4.6
38007,2015,467,453,14,3
38009,2015,3234,3093,141,4.4
38011,2015,1857,1823,34,1.8
38013,2015,1179,1140,39,3.3
38015,2015,48846,47680,1166,2.4
38017,2015,95153,93015,2138,2.2
38019,2015,2056,1999,57,2.8
38021,2015,2546,2499,47,1.8
38023,2015,1811,1778,33,1.8
38025,2015,4009,3930,79,2
38027,2015,1268,1207,61,4.8
38029,2015,1548,1471,77,5
38031,2015,1626,1579,47,2.9
38033,2015,976,954,22,2.3
38035,2015,37423,36509,914,2.4
38037,2015,1317,1275,42,3.2
38039,2015,1152,1125,27,2.3
38041,2015,1551,1512,39,2.5
38043,2015,1340,1291,49,3.7
38045,2015,2265,2209,56,2.5
38047,2015,946,919,27,2.9
38049,2015,3272,3134,138,4.2
38051,2015,1241,1202,39,3.1
38053,2015,9183,8955,228,2.5
38055,2015,4912,4728,184,3.7
38057,2015,4298,4117,181,4.2
38059,2015,16228,15727,501,3.1
38061,2015,8125,7965,160,2
38063,2015,1514,1457,57,3.8
38065,2015,881,829,52,5.9
38067,2015,3601,3408,193,5.4
38069,2015,1834,1757,77,4.2
38071,2015,5675,5483,192,3.4
38073,2015,2769,2701,68,2.5
38075,2015,1335,1290,45,3.4
38077,2015,8579,8345,234,2.7
38079,2015,4877,4373,504,10.3
38081,2015,2251,2210,41,1.8
38083,2015,724,688,36,5
38085,2015,1291,1234,57,4.4
38087,2015,464,452,12,2.6
38089,2015,20241,19693,548,2.7
38091,2015,1060,1036,24,2.3
38093,2015,10683,10408,275,2.6
38095,2015,1239,1205,34,2.7
38097,2015,4440,4314,126,2.8
38099,2015,5565,5332,233,4.2
38101,2015,34204,33112,1092,3.2
38103,2015,2166,2080,86,4
38105,2015,28638,27957,681,2.4
39001,2015,10676,9836,840,7.9
39003,2015,47812,45491,2321,4.9
39005,2015,25962,24655,1307,5
39007,2015,44321,41673,2648,6
39009,2015,27894,26156,1738,6.2
39011,2015,24437,23538,899,3.7
39013,2015,31132,29155,1977,6.4
39015,2015,19474,18260,1214,6.2
39017,2015,187336,178730,8606,4.6
39019,2015,13340,12544,796,6
39021,2015,19861,18991,870,4.4
39023,2015,64039,60836,3203,5
39025,2015,102612,97978,4634,4.5
39027,2015,16676,15640,1036,6.2
39029,2015,49354,46456,2898,5.9
39031,2015,15842,14832,1010,6.4
39033,2015,19064,17956,1108,5.8
39035,2015,611662,579929,31733,5.2
39037,2015,26200,25082,1118,4.3
39039,2015,18662,17745,917,4.9
39041,2015,102281,98666,3615,3.5
39043,2015,37334,35265,2069,5.5
39045,2015,74835,71573,3262,4.4
39047,2015,14014,13321,693,4.9
39049,2015,655452,628603,26849,4.1
39051,2015,22422,21328,1094,4.9
39053,2015,12197,11405,792,6.5
39055,2015,48906,46859,2047,4.2
39057,2015,80332,76822,3510,4.4
39059,2015,19191,17999,1192,6.2
39061,2015,401210,383148,18062,4.5
39063,2015,40732,39239,1493,3.7
39065,2015,14487,13788,699,4.8
39067,2015,7179,6727,452,6.3
39069,2015,13539,12782,757,5.6
39071,2015,16925,15847,1078,6.4
39073,2015,13004,12277,727,5.6
39075,2015,20613,19907,706,3.4
39077,2015,27596,25780,1816,6.6
39079,2015,13040,12059,981,7.5
39081,2015,29369,27187,2182,7.4
39083,2015,31209,29760,1449,4.6
39085,2015,124070,118469,5601,4.5
39087,2015,24884,23423,1461,5.9
39089,2015,86882,83024,3858,4.4
39091,2015,23082,22110,972,4.2
39093,2015,150521,142125,8396,5.6
39095,2015,208620,197540,11080,5.3
39097,2015,20483,19657,826,4
39099,2015,106868,100353,6515,6.1
39101,2015,27756,26334,1422,5.1
39103,2015,94924,90993,3931,4.1
39105,2015,9089,8340,749,8.2
39107,2015,22989,22235,754,3.3
39109,2015,52363,50059,2304,4.4
39111,2015,5538,4987,551,9.9
39113,2015,248915,236441,12474,5
39115,2015,6700,6211,489,7.3
39117,2015,16675,15834,841,5
39119,2015,38781,36370,2411,6.2
39121,2015,4970,4608,362,7.3
39123,2015,21011,19622,1389,6.6
39125,2015,8899,8472,427,4.8
39127,2015,15815,14782,1033,6.5
39129,2015,25726,24501,1225,4.8
39131,2015,10467,9700,767,7.3
39133,2015,86767,82541,4226,4.9
39135,2015,20972,19960,1012,4.8
39137,2015,18652,17929,723,3.9
39139,2015,53529,50539,2990,5.6
39141,2015,33692,31886,1806,5.4
39143,2015,31336,29826,1510,4.8
39145,2015,29556,27292,2264,7.7
39147,2015,27127,25814,1313,4.8
39149,2015,24062,23027,1035,4.3
39151,2015,186425,176599,9826,5.3
39153,2015,271574,258047,13527,5
39155,2015,91345,85450,5895,6.5
39157,2015,45413,42971,2442,5.4
39159,2015,27007,25969,1038,3.8
39161,2015,14318,13722,596,4.2
39163,2015,5456,5098,358,6.6
39165,2015,112341,107670,4671,4.2
39167,2015,28040,26352,1688,6
39169,2015,59959,57596,2363,3.9
39171,2015,18999,18160,839,4.4
39173,2015,69541,66567,2974,4.3
39175,2015,12340,11888,452,3.7
40001,2015,8176,7679,497,6.1
40003,2015,3168,3074,94,3
40005,2015,4868,4551,317,6.5
40007,2015,3028,2945,83,2.7
40009,2015,12226,11602,624,5.1
40011,2015,4492,4319,173,3.9
40013,2015,18363,17524,839,4.6
40015,2015,11852,11240,612,5.2
40017,2015,68377,65906,2471,3.6
40019,2015,22585,21557,1028,4.6
40021,2015,19291,18293,998,5.2
40023,2015,5923,5468,455,7.7
40025,2015,1377,1346,31,2.3
40027,2015,138323,133430,4893,3.5
40029,2015,2322,2145,177,7.6
40031,2015,49705,47539,2166,4.4
40033,2015,2864,2745,119,4.2
40035,2015,6268,5965,303,4.8
40037,2015,31378,29819,1559,5
40039,2015,15676,15040,636,4.1
40041,2015,17497,16631,866,4.9
40043,2015,2499,2409,90,3.6
40045,2015,2394,2297,97,4.1
40047,2015,30120,28932,1188,3.9
40049,2015,12848,12243,605,4.7
40051,2015,26251,25071,1180,4.5
40053,2015,3293,3197,96,2.9
40055,2015,2172,2049,123,5.7
40057,2015,1304,1259,45,3.5
40059,2015,1990,1929,61,3.1
40061,2015,4485,4129,356,7.9
40063,2015,5741,5311,430,7.5
40065,2015,10887,10444,443,4.1
40067,2015,2683,2529,154,5.7
40069,2015,3975,3716,259,6.5
40071,2015,19220,18126,1094,5.7
40073,2015,8288,8027,261,3.1
40075,2015,4168,3974,194,4.7
40077,2015,3866,3552,314,8.1
40079,2015,19662,18299,1363,6.9
40081,2015,15898,15155,743,4.7
40083,2015,21500,20681,819,3.8
40085,2015,5985,5772,213,3.6
40087,2015,18779,18081,698,3.7
40089,2015,14757,13585,1172,7.9
40091,2015,7095,6481,614,8.7
40093,2015,4303,4162,141,3.3
40095,2015,6792,6420,372,5.5
40097,2015,19427,18586,841,4.3
40099,2015,6775,6488,287,4.2
40101,2015,29616,28092,1524,5.1
40103,2015,5647,5446,201,3.6
40105,2015,4804,4530,274,5.7
40107,2015,4548,4281,267,5.9
40109,2015,375304,360493,14811,3.9
40111,2015,16241,15155,1086,6.7
40113,2015,21249,20127,1122,5.3
40115,2015,14390,13651,739,5.1
40117,2015,7481,7044,437,5.8
40119,2015,38435,37078,1357,3.5
40121,2015,17456,16459,997,5.7
40123,2015,18267,17538,729,4
40125,2015,32779,31303,1476,4.5
40127,2015,4919,4536,383,7.8
40129,2015,1840,1762,78,4.2
40131,2015,44666,42705,1961,4.4
40133,2015,9617,8960,657,6.8
40135,2015,16798,15730,1068,6.4
40137,2015,20303,19085,1218,6
40139,2015,9704,9391,313,3.2
40141,2015,3362,3218,144,4.3
40143,2015,318248,305047,13201,4.1
40145,2015,36293,34764,1529,4.2
40147,2015,24484,23428,1056,4.3
40149,2015,5614,5301,313,5.6
40151,2015,5374,5225,149,2.8
40153,2015,10316,9782,534,5.2
41001,2015,6674,6223,451,6.8
41003,2015,45443,43527,1916,4.2
41005,2015,205211,194716,10495,5.1
41007,2015,18355,17354,1001,5.5
41009,2015,22685,21065,1620,7.1
41011,2015,25954,24027,1927,7.4
41013,2015,9025,8271,754,8.4
41015,2015,8714,7996,718,8.2
41017,2015,84779,79794,4985,5.9
41019,2015,44379,41054,3325,7.5
41021,2015,810,758,52,6.4
41023,2015,3092,2823,269,8.7
41025,2015,3305,3068,237,7.2
41027,2015,13529,12892,637,4.7
41029,2015,98061,91415,6646,6.8
41031,2015,9647,8941,706,7.3
41033,2015,33278,30710,2568,7.7
41035,2015,28670,26434,2236,7.8
41037,2015,3437,3174,263,7.7
41039,2015,172577,162549,10028,5.8
41041,2015,20527,19163,1364,6.6
41043,2015,55202,51496,3706,6.7
41045,2015,11959,11198,761,6.4
41047,2015,152666,143517,9149,6
41049,2015,5543,5226,317,5.7
41051,2015,429736,408702,21034,4.9
41053,2015,36592,34536,2056,5.6
41055,2015,888,834,54,6.1
41057,2015,11392,10752,640,5.6
41059,2015,35259,33016,2243,6.4
41061,2015,11705,10985,720,6.2
41063,2015,3244,2991,253,7.8
41065,2015,13027,12298,729,5.6
41067,2015,301704,287562,14142,4.7
41069,2015,692,656,36,5.2
41071,2015,50875,48189,2686,5.3
42001,2015,54948,52641,2307,4.2
42003,2015,647041,614989,32052,5
42005,2015,33001,30811,2190,6.6
42007,2015,85719,80539,5180,6
42009,2015,24107,22645,1462,6.1
42011,2015,212348,201877,10471,4.9
42013,2015,60945,57806,3139,5.2
42015,2015,31343,29489,1854,5.9
42017,2015,337323,321590,15733,4.7
42019,2015,98026,93403,4623,4.7
42021,2015,62286,58202,4084,6.6
42023,2015,2261,2100,161,7.1
42025,2015,31422,29520,1902,6.1
42027,2015,77749,74662,3087,4
42029,2015,276863,266326,10537,3.8
42031,2015,18256,17166,1090,6
42033,2015,36382,33967,2415,6.6
42035,2015,18748,17458,1290,6.9
42037,2015,33711,31806,1905,5.7
42039,2015,41013,38882,2131,5.2
42041,2015,128296,123183,5113,4
42043,2015,140885,134330,6555,4.7
42045,2015,291308,277063,14245,4.9
42047,2015,16318,15514,804,4.9
42049,2015,134648,127251,7397,5.5
42051,2015,58319,53948,4371,7.5
42053,2015,1897,1748,149,7.9
42055,2015,77794,73937,3857,5
42057,2015,7436,6973,463,6.2
42059,2015,18149,17061,1088,6
42061,2015,19653,18274,1379,7
42063,2015,41721,39090,2631,6.3
42065,2015,20955,19676,1279,6.1
42067,2015,11982,11389,593,4.9
42069,2015,106329,100137,6192,5.8
42071,2015,275782,264447,11335,4.1
42073,2015,42084,39427,2657,6.3
42075,2015,70011,66844,3167,4.5
42077,2015,185598,175701,9897,5.3
42079,2015,158643,148413,10230,6.4
42081,2015,60858,57177,3681,6
42083,2015,18964,17813,1151,6.1
42085,2015,52958,50073,2885,5.4
42087,2015,20898,19692,1206,5.8
42089,2015,80688,75482,5206,6.5
42091,2015,440556,422255,18301,4.2
42093,2015,9140,8746,394,4.3
42095,2015,156427,148200,8227,5.3
42097,2015,43400,40752,2648,6.1
42099,2015,24089,23014,1075,4.5
42101,2015,695006,645640,49366,7.1
42103,2015,24893,23261,1632,6.6
42105,2015,7369,6851,518,7
42107,2015,68137,63854,4283,6.3
42109,2015,20049,19109,940,4.7
42111,2015,34439,32088,2351,6.8
42113,2015,3032,2845,187,6.2
42115,2015,21384,20191,1193,5.6
42117,2015,20316,18993,1323,6.5
42119,2015,19294,18431,863,4.5
42121,2015,24442,22989,1453,5.9
42123,2015,19941,18947,994,5
42125,2015,106542,100609,5933,5.6
42127,2015,22249,20955,1294,5.8
42129,2015,182787,172925,9862,5.4
42131,2015,14105,13245,860,6.1
42133,2015,232560,221499,11061,4.8
44001,2015,26168,24785,1383,5.3
44003,2015,91038,86019,5019,5.5
44005,2015,44092,41708,2384,5.4
44007,2015,323956,303417,20539,6.3
44009,2015,69330,65445,3885,5.6
45001,2015,10341,9628,713,6.9
45003,2015,73869,69507,4362,5.9
45005,2015,2747,2436,311,11.3
45007,2015,88401,83616,4785,5.4
45009,2015,5457,4883,574,10.5
45011,2015,8371,7617,754,9
45013,2015,71601,67680,3921,5.5
45015,2015,93423,88270,5153,5.5
45017,2015,6887,6395,492,7.1
45019,2015,198029,188413,9616,4.9
45021,2015,23446,21772,1674,7.1
45023,2015,13445,12317,1128,8.4
45025,2015,21429,20126,1303,6.1
45027,2015,13057,12050,1007,7.7
45029,2015,16707,15540,1167,7
45031,2015,30043,27823,2220,7.4
45033,2015,12664,11571,1093,8.6
45035,2015,72649,68664,3985,5.5
45037,2015,10660,9981,679,6.4
45039,2015,10016,9207,809,8.1
45041,2015,65465,61176,4289,6.6
45043,2015,25216,23090,2126,8.4
45045,2015,242770,230754,12016,4.9
45047,2015,31239,29260,1979,6.3
45049,2015,8341,7640,701,8.4
45051,2015,137231,127443,9788,7.1
45053,2015,11811,11205,606,5.1
45055,2015,28922,27190,1732,6
45057,2015,36683,34369,2314,6.3
45059,2015,30264,28275,1989,6.6
45061,2015,6454,5909,545,8.4
45063,2015,145267,138225,7042,4.8
45065,2015,3437,3193,244,7.1
45067,2015,12853,11569,1284,10
45069,2015,9640,8669,971,10.1
45071,2015,18883,17879,1004,5.3
45073,2015,34462,32460,2002,5.8
45075,2015,36921,32898,4023,10.9
45077,2015,56023,52784,3239,5.8
45079,2015,198546,187288,11258,5.7
45081,2015,8823,8360,463,5.2
45083,2015,139770,131767,8003,5.7
45085,2015,44354,41315,3039,6.9
45087,2015,11547,10634,913,7.9
45089,2015,12810,11626,1184,9.2
45091,2015,126581,119628,6953,5.5
46003,2015,1570,1535,35,2.2
46005,2015,9461,9212,249,2.6
46007,2015,1130,1073,57,5
46009,2015,3007,2927,80,2.7
46011,2015,18549,18006,543,2.9
46013,2015,20973,20415,558,2.7
46015,2015,2534,2466,68,2.7
46017,2015,714,664,50,7
46019,2015,5088,4915,173,3.4
46021,2015,849,824,25,2.9
46023,2015,3980,3843,137,3.4
46025,2015,1963,1892,71,3.6
46027,2015,7005,6790,215,3.1
46029,2015,15308,14836,472,3.1
46031,2015,1489,1413,76,5.1
46033,2015,3960,3792,168,4.2
46035,2015,11317,11030,287,2.5
46037,2015,2858,2715,143,5
46039,2015,2307,2193,114,4.9
46041,2015,2291,2028,263,11.5
46043,2015,1672,1631,41,2.5
46045,2015,2218,2163,55,2.5
46047,2015,2971,2839,132,4.4
46049,2015,1118,1089,29,2.6
46051,2015,4701,4562,139,3
46053,2015,2055,1990,65,3.2
46055,2015,1096,1071,25,2.3
46057,2015,3130,3026,104,3.3
46059,2015,1872,1829,43,2.3
46061,2015,1797,1737,60,3.3
46063,2015,779,760,19,2.4
46065,2015,9887,9649,238,2.4
46067,2015,3670,3579,91,2.5
46069,2015,706,686,20,2.8
46071,2015,1325,1268,57,4.3
46073,2015,1124,1099,25,2.2
46075,2015,584,567,17,2.9
46077,2015,2751,2670,81,2.9
46079,2015,6504,6268,236,3.6
46081,2015,12725,12309,416,3.3
46083,2015,30428,29744,684,2.2
46085,2015,1792,1708,84,4.7
46087,2015,3129,3054,75,2.4
46089,2015,1112,1075,37,3.3
46091,2015,2501,2405,96,3.8
46093,2015,13325,12904,421,3.2
46095,2015,797,756,41,5.1
46097,2015,1211,1182,29,2.4
46099,2015,106217,103350,2867,2.7
46101,2015,3940,3806,134,3.4
46102,2015,3583,3172,411,11.5
46103,2015,54315,52603,1712,3.2
46105,2015,1574,1524,50,3.2
46107,2015,1181,1143,38,3.2
46109,2015,4861,4650,211,4.3
46111,2015,1225,1194,31,2.5
46115,2015,3314,3212,102,3.1
46117,2015,1833,1789,44,2.4
46119,2015,869,847,22,2.5
46121,2015,3047,2822,225,7.4
46123,2015,3078,2996,82,2.7
46125,2015,4632,4508,124,2.7
46127,2015,8023,7751,272,3.4
46129,2015,2265,2143,122,5.4
46135,2015,11588,11287,301,2.6
46137,2015,983,933,50,5.1
47001,2015,33213,31279,1934,5.8
47003,2015,19368,18120,1248,6.4
47005,2015,6751,6233,518,7.7
47007,2015,4242,3905,337,7.9
47009,2015,59406,56332,3074,5.2
47011,2015,49333,46756,2577,5.2
47013,2015,14598,13442,1156,7.9
47015,2015,5846,5507,339,5.8
47017,2015,12159,11152,1007,8.3
47019,2015,23480,21969,1511,6.4
47021,2015,19826,18866,960,4.8
47023,2015,8208,7727,481,5.9
47025,2015,12551,11643,908,7.2
47027,2015,2992,2727,265,8.9
47029,2015,14376,13261,1115,7.8
47031,2015,24240,22900,1340,5.5
47033,2015,6806,6369,437,6.4
47035,2015,22883,21265,1618,7.1
47037,2015,363402,347500,15902,4.4
47039,2015,4702,4332,370,7.9
47041,2015,7350,6846,504,6.9
47043,2015,24044,22737,1307,5.4
47045,2015,16629,15436,1193,7.2
47047,2015,17833,16731,1102,6.2
47049,2015,6987,6478,509,7.3
47051,2015,19553,18539,1014,5.2
47053,2015,20985,19439,1546,7.4
47055,2015,14522,13798,724,5
47057,2015,9125,8519,606,6.6
47059,2015,30547,28576,1971,6.5
47061,2015,4862,4484,378,7.8
47063,2015,26410,24772,1638,6.2
47065,2015,166982,158114,8868,5.3
47067,2015,2059,1860,199,9.7
47069,2015,9270,8574,696,7.5
47071,2015,10242,9506,736,7.2
47073,2015,23485,21985,1500,6.4
47075,2015,7614,6977,637,8.4
47077,2015,12249,11273,976,8
47079,2015,13847,12943,904,6.5
47081,2015,10296,9711,585,5.7
47083,2015,3191,2916,275,8.6
47085,2015,8450,7880,570,6.7
47087,2015,4455,4105,350,7.9
47089,2015,23247,21760,1487,6.4
47091,2015,7294,6883,411,5.6
47093,2015,227941,217295,10646,4.7
47095,2015,1967,1799,168,8.5
47097,2015,9577,8730,847,8.8
47099,2015,17685,16518,1167,6.6
47101,2015,4794,4444,350,7.3
47103,2015,15112,14385,727,4.8
47105,2015,21890,20665,1225,5.6
47107,2015,22601,21172,1429,6.3
47109,2015,8741,7999,742,8.5
47111,2015,9941,9414,527,5.3
47113,2015,46436,43704,2732,5.9
47115,2015,11690,10900,790,6.8
47117,2015,14735,13911,824,5.6
47119,2015,42270,40105,2165,5.1
47121,2015,4847,4477,370,7.6
47123,2015,19008,17814,1194,6.3
47125,2015,78431,73868,4563,5.8
47127,2015,3299,3150,149,4.5
47129,2015,7701,7126,575,7.5
47131,2015,12451,11378,1073,8.6
47133,2015,9072,8425,647,7.1
47135,2015,3113,2904,209,6.7
47137,2015,2395,2211,184,7.7
47139,2015,7312,6830,482,6.6
47141,2015,32380,30493,1887,5.8
47143,2015,13065,12100,965,7.4
47145,2015,22535,21080,1455,6.5
47147,2015,33749,32102,1647,4.9
47149,2015,155268,148313,6955,4.5
47151,2015,8064,7313,751,9.3
47153,2015,5781,5407,374,6.5
47155,2015,49752,46755,2997,6
47157,2015,429131,401599,27532,6.4
47159,2015,8469,7994,475,5.6
47161,2015,5129,4735,394,7.7
47163,2015,69013,65022,3991,5.8
47165,2015,88407,84335,4072,4.6
47167,2015,27434,25493,1941,7.1
47169,2015,3676,3459,217,5.9
47171,2015,7017,6458,559,8
47173,2015,7205,6715,490,6.8
47175,2015,2050,1886,164,8
47177,2015,17767,16768,999,5.6
47179,2015,57724,54517,3207,5.6
47181,2015,6173,5717,456,7.4
47183,2015,15562,14504,1058,6.8
47185,2015,11391,10701,690,6.1
47187,2015,107362,103061,4301,4
47189,2015,64490,61537,2953,4.6
48001,2015,22863,21966,897,3.9
48003,2015,9308,8985,323,3.5
48005,2015,37424,35335,2089,5.6
48007,2015,10067,9558,509,5.1
48009,2015,4126,3944,182,4.4
48011,2015,976,950,26,2.7
48013,2015,20553,19576,977,4.8
48015,2015,14052,13408,644,4.6
48017,2015,2802,2682,120,4.3
48019,2015,9185,8821,364,4
48021,2015,37569,36113,1456,3.9
48023,2015,1628,1571,57,3.5
48025,2015,10389,9748,641,6.2
48027,2015,136386,130045,6341,4.6
48029,2015,879545,846082,33463,3.8
48031,2015,5772,5592,180,3.1
48033,2015,413,401,12,2.9
48035,2015,8067,7705,362,4.5
48037,2015,39184,37305,1879,4.8
48039,2015,167189,159547,7642,4.6
48041,2015,108693,105097,3596,3.3
48043,2015,3913,3759,154,3.9
48045,2015,595,572,23,3.9
48047,2015,2604,2346,258,9.9
48049,2015,15906,15220,686,4.3
48051,2015,7764,7426,338,4.4
48053,2015,21193,20422,771,3.6
48055,2015,17438,16683,755,4.3
48057,2015,11338,10886,452,4
48059,2015,5736,5492,244,4.3
48061,2015,163203,151606,11597,7.1
48063,2015,5097,4785,312,6.1
48065,2015,3070,2972,98,3.2
48067,2015,12176,11351,825,6.8
48069,2015,3619,3497,122,3.4
48071,2015,17821,16872,949,5.3
48073,2015,20915,19836,1079,5.2
48075,2015,2871,2782,89,3.1
48077,2015,4916,4701,215,4.4
48079,2015,1318,1251,67,5.1
48081,2015,1400,1343,57,4.1
48083,2015,3052,2883,169,5.5
48085,2015,489029,471301,17728,3.6
48087,2015,1272,1225,47,3.7
48089,2015,9914,9524,390,3.9
48091,2015,61941,59671,2270,3.7
48093,2015,5363,5136,227,4.2
48095,2015,1375,1330,45,3.3
48097,2015,19784,19055,729,3.7
48099,2015,24524,23357,1167,4.8
48101,2015,546,507,39,7.1
48103,2015,1839,1733,106,5.8
48105,2015,1903,1788,115,6
48107,2015,2650,2535,115,4.3
48109,2015,1041,998,43,4.1
48111,2015,4010,3923,87,2.2
48113,2015,1263778,1209785,53993,4.3
48115,2015,4776,4560,216,4.5
48117,2015,8802,8525,277,3.1
48119,2015,2595,2478,117,4.5
48121,2015,428863,413638,15225,3.6
48123,2015,10061,9661,400,4
48125,2015,703,671,32,4.6
48127,2015,7167,6836,331,4.6
48129,2015,1594,1528,66,4.1
48131,2015,5242,4819,423,8.1
48133,2015,8046,7665,381,4.7
48135,2015,79838,76136,3702,4.6
48137,2015,866,826,40,4.6
48139,2015,81012,77828,3184,3.9
48141,2015,341868,324220,17648,5.2
48143,2015,20177,19387,790,3.9
48145,2015,6459,6186,273,4.2
48147,2015,15388,14758,630,4.1
48149,2015,12784,12361,423,3.3
48151,2015,1802,1733,69,3.8
48153,2015,2747,2595,152,5.5
48155,2015,551,529,22,4
48157,2015,356151,341000,15151,4.3
48159,2015,4560,4338,222,4.9
48161,2015,7416,7015,401,5.4
48163,2015,9810,9435,375,3.8
48165,2015,9412,9108,304,3.2
48167,2015,158064,150200,7864,5
48169,2015,2132,2054,78,3.7
48171,2015,12654,12290,364,2.9
48173,2015,822,799,23,2.8
48175,2015,3450,3297,153,4.4
48177,2015,9708,9352,356,3.7
48179,2015,9283,8762,521,5.6
48181,2015,60044,57627,2417,4
48183,2015,59330,56394,2936,4.9
48185,2015,11521,10909,612,5.3
48187,2015,73001,70428,2573,3.5
48189,2015,12896,12079,817,6.3
48191,2015,1204,1140,64,5.3
48193,2015,3486,3324,162,4.6
48195,2015,3114,3022,92,3
48197,2015,1622,1542,80,4.9
48199,2015,25010,23601,1409,5.6
48201,2015,2236170,2132542,103628,4.6
48203,2015,31227,29600,1627,5.2
48205,2015,3006,2942,64,2.1
48207,2015,2584,2494,90,3.5
48209,2015,98543,95171,3372,3.4
48211,2015,2303,2231,72,3.1
48213,2015,34395,32727,1668,4.8
48215,2015,331132,304946,26186,7.9
48217,2015,15628,14919,709,4.5
48219,2015,11728,11242,486,4.1
48221,2015,24555,23450,1105,4.5
48223,2015,17027,16312,715,4.2
48225,2015,9946,9503,443,4.5
48227,2015,13366,12752,614,4.6
48229,2015,1282,1210,72,5.6
48231,2015,38939,37101,1838,4.7
48233,2015,9805,9373,432,4.4
48235,2015,800,771,29,3.6
48237,2015,4082,3910,172,4.2
48239,2015,7374,7098,276,3.7
48241,2015,13888,12852,1036,7.5
48243,2015,1080,1045,35,3.2
48245,2015,108046,100531,7515,7
48247,2015,2029,1883,146,7.2
48249,2015,19234,17717,1517,7.9
48251,2015,74349,71090,3259,4.4
48253,2015,5674,5362,312,5.5
48255,2015,6432,6160,272,4.2
48257,2015,55106,52866,2240,4.1
48259,2015,19176,18548,628,3.3
48261,2015,283,274,9,3.2
48263,2015,498,485,13,2.6
48265,2015,21197,20419,778,3.7
48267,2015,2002,1929,73,3.6
48269,2015,200,193,7,3.5
48271,2015,1185,1110,75,6.3
48273,2015,14408,13559,849,5.9
48275,2015,1683,1620,63,3.7
48277,2015,22201,21142,1059,4.8
48279,2015,5512,5021,491,8.9
48281,2015,9062,8665,397,4.4
48283,2015,4272,4095,177,4.1
48285,2015,8812,8479,333,3.8
48287,2015,9309,8979,330,3.5
48289,2015,6938,6569,369,5.3
48291,2015,30972,28837,2135,6.9
48293,2015,8586,8156,430,5
48295,2015,1725,1658,67,3.9
48297,2015,5894,5658,236,4
48299,2015,8156,7810,346,4.2
48301,2015,77,73,4,5.2
48303,2015,149704,144618,5086,3.4
48305,2015,2765,2654,111,4
48307,2015,3926,3738,188,4.8
48309,2015,112660,108082,4578,4.1
48311,2015,970,950,20,2.1
48313,2015,5121,4901,220,4.3
48315,2015,4417,4131,286,6.5
48317,2015,2586,2495,91,3.5
48319,2015,1805,1736,69,3.8
48321,2015,17190,16033,1157,6.7
48323,2015,23659,21143,2516,10.6
48325,2015,20439,19547,892,4.4
48327,2015,858,813,45,5.2
48329,2015,88454,85397,3057,3.5
48331,2015,10128,9599,529,5.2
48333,2015,1992,1919,73,3.7
48335,2015,2746,2592,154,5.6
48337,2015,9711,9300,411,4.2
48339,2015,258423,247470,10953,4.2
48341,2015,11120,10774,346,3.1
48343,2015,5318,4851,467,8.8
48345,2015,492,475,17,3.5
48347,2015,28152,26833,1319,4.7
48349,2015,22906,21944,962,4.2
48351,2015,5371,4968,403,7.5
48353,2015,6918,6639,279,4
48355,2015,165947,157759,8188,4.9
48357,2015,5276,5052,224,4.2
48359,2015,915,888,27,3
48361,2015,37212,34784,2428,6.5
48363,2015,13177,12492,685,5.2
48365,2015,11579,10975,604,5.2
48367,2015,59614,57142,2472,4.1
48369,2015,4972,4855,117,2.4
48371,2015,6871,6517,354,5.2
48373,2015,17053,16022,1031,6
48375,2015,56299,54427,1872,3.3
48377,2015,3117,2786,331,10.6
48379,2015,5415,5169,246,4.5
48381,2015,69146,67147,1999,2.9
48383,2015,1931,1843,88,4.6
48385,2015,1064,1010,54,5.1
48387,2015,4913,4604,309,6.3
48389,2015,5683,5411,272,4.8
48391,2015,3309,3133,176,5.3
48393,2015,456,438,18,3.9
48395,2015,7253,6908,345,4.8
48397,2015,44934,43251,1683,3.7
48399,2015,4674,4501,173,3.7
48401,2015,22862,21776,1086,4.8
48403,2015,3505,3179,326,9.3
48405,2015,2800,2547,253,9
48407,2015,11299,10666,633,5.6
48409,2015,30255,28287,1968,6.5
48411,2015,2247,2165,82,3.6
48413,2015,1502,1423,79,5.3
48415,2015,8174,7836,338,4.1
48417,2015,2084,2025,59,2.8
48419,2015,11387,10789,598,5.3
48421,2015,1422,1383,39,2.7
48423,2015,103817,99181,4636,4.5
48425,2015,4113,3907,206,5
48427,2015,25897,22413,3484,13.5
48429,2015,4110,3938,172,4.2
48431,2015,747,722,25,3.3
48433,2015,663,634,29,4.4
48435,2015,1720,1616,104,6
48437,2015,2734,2604,130,4.8
48439,2015,992292,951071,41221,4.2
48441,2015,63404,61082,2322,3.7
48443,2015,435,414,21,4.8
48445,2015,5408,5155,253,4.7
48447,2015,781,756,25,3.2
48449,2015,12745,12012,733,5.8
48451,2015,54592,52356,2236,4.1
48453,2015,656233,634743,21490,3.3
48455,2015,5486,5163,323,5.9
48457,2015,7373,6857,516,7
48459,2015,17990,17047,943,5.2
48461,2015,1786,1716,70,3.9
48463,2015,11691,11102,589,5
48465,2015,19586,18413,1173,6
48467,2015,24230,23143,1087,4.5
48469,2015,45369,43473,1896,4.2
48471,2015,22995,21835,1160,5
48473,2015,21678,20639,1039,4.8
48475,2015,5917,5664,253,4.3
48477,2015,15372,14641,731,4.8
48479,2015,111872,106590,5282,4.7
48481,2015,21247,20311,936,4.4
48483,2015,2823,2714,109,3.9
48485,2015,55370,53001,2369,4.3
48487,2015,5114,4867,247,4.8
48489,2015,6751,5872,879,13
48491,2015,264219,255111,9108,3.4
48493,2015,22992,22121,871,3.8
48495,2015,3106,2929,177,5.7
48497,2015,28696,27368,1328,4.6
48499,2015,16774,15886,888,5.3
48501,2015,4049,3897,152,3.8
48503,2015,8476,8115,361,4.3
48505,2015,6196,5723,473,7.6
48507,2015,3809,3384,425,11.2
49001,2015,3116,2998,118,3.8
49003,2015,23973,23087,886,3.7
49005,2015,60031,58190,1841,3.1
49007,2015,8709,8213,496,5.7
49009,2015,467,445,22,4.7
49011,2015,159937,154526,5411,3.4
49013,2015,8807,8143,664,7.5
49015,2015,4402,4135,267,6.1
49017,2015,2755,2509,246,8.9
49019,2015,5609,5269,340,6.1
49021,2015,20328,19424,904,4.4
49023,2015,4937,4741,196,4
49025,2015,3624,3464,160,4.4
49027,2015,6124,5909,215,3.5
49029,2015,4927,4773,154,3.1
49031,2015,465,435,30,6.5
49033,2015,1045,1007,38,3.6
49035,2015,585345,565532,19813,3.4
49037,2015,5716,5265,451,7.9
49039,2015,11416,10944,472,4.1
49041,2015,9509,9085,424,4.5
49043,2015,23065,22302,763,3.3
49045,2015,29529,28306,1223,4.1
49047,2015,15303,14261,1042,6.8
49049,2015,266005,257332,8673,3.3
49051,2015,13256,12790,466,3.5
49053,2015,63647,61050,2597,4.1
49055,2015,1413,1285,128,9.1
49057,2015,117200,112397,4803,4.1
50001,2015,20688,19973,715,3.5
50003,2015,18570,17791,779,4.2
50005,2015,15077,14377,700,4.6
50007,2015,94840,92270,2570,2.7
50009,2015,2756,2597,159,5.8
50011,2015,27290,26320,970,3.6
50013,2015,3935,3778,157,4
50015,2015,13773,13136,637,4.6
50017,2015,15890,15346,544,3.4
50019,2015,13589,12834,755,5.6
50021,2015,31264,29939,1325,4.2
50023,2015,34050,32865,1185,3.5
50025,2015,23449,22615,834,3.6
50027,2015,29458,28514,944,3.2
51001,2015,15874,15009,865,5.4
51003,2015,53903,51800,2103,3.9
51005,2015,7046,6690,356,5.1
51007,2015,6188,5912,276,4.5
51009,2015,15276,14547,729,4.8
51011,2015,7037,6693,344,4.9
51013,2015,144256,140195,4061,2.8
51015,2015,36634,35133,1501,4.1
51017,2015,2536,2433,103,4.1
51019,2015,38220,36525,1695,4.4
51021,2015,2780,2622,158,5.7
51023,2015,17384,16656,728,4.2
51025,2015,6331,5900,431,6.8
51027,2015,7275,6486,789,10.8
51029,2015,6292,5919,373,5.9
51031,2015,26218,24978,1240,4.7
51033,2015,14729,13979,750,5.1
51035,2015,13046,12349,697,5.3
51036,2015,3716,3518,198,5.3
51037,2015,5248,4950,298,5.7
51041,2015,177917,170258,7659,4.3
51043,2015,7429,7133,296,4
51045,2015,2380,2249,131,5.5
51047,2015,23098,22094,1004,4.3
51049,2015,4554,4320,234,5.1
51051,2015,4911,4415,496,10.1
51053,2015,13308,12587,721,5.4
51057,2015,5510,5213,297,5.4
51059,2015,613502,591608,21894,3.6
51061,2015,35719,34310,1409,3.9
51063,2015,8291,7961,330,4
51065,2015,13157,12662,495,3.8
51067,2015,26439,25205,1234,4.7
51069,2015,44603,42834,1769,4
51071,2015,7941,7530,411,5.2
51073,2015,19086,18309,777,4.1
51075,2015,10614,10170,444,4.2
51077,2015,7043,6627,416,5.9
51079,2015,9845,9479,366,3.7
51081,2015,4170,3946,224,5.4
51083,2015,15196,14230,966,6.4
51085,2015,56222,54043,2179,3.9
51087,2015,176881,169285,7596,4.3
51089,2015,22348,20916,1432,6.4
51091,2015,1339,1292,47,3.5
51093,2015,18797,17938,859,4.6
51095,2015,34284,32800,1484,4.3
51097,2015,3630,3455,175,4.8
51099,2015,12051,11477,574,4.8
51101,2015,8702,8335,367,4.2
51103,2015,5128,4790,338,6.6
51105,2015,8570,7951,619,7.2
51107,2015,200016,192887,7129,3.6
51109,2015,18786,17990,796,4.2
51111,2015,5284,5014,270,5.1
51113,2015,7223,6977,246,3.4
51115,2015,4073,3901,172,4.2
51117,2015,12512,11746,766,6.1
51119,2015,4979,4768,211,4.2
51121,2015,49712,47565,2147,4.3
51125,2015,7265,6969,296,4.1
51127,2015,11211,10783,428,3.8
51131,2015,6097,5724,373,6.1
51133,2015,5463,5129,334,6.1
51135,2015,7128,6805,323,4.5
51137,2015,16050,15313,737,4.6
51139,2015,11639,10838,801,6.9
51141,2015,7637,7223,414,5.4
51143,2015,30063,28467,1596,5.3
51145,2015,13385,12852,533,4
51147,2015,10055,9426,629,6.3
51149,2015,14869,14065,804,5.4
51153,2015,231306,221747,9559,4.1
51155,2015,16306,15481,825,5.1
51157,2015,3733,3578,155,4.2
51159,2015,3899,3721,178,4.6
51161,2015,49061,47135,1926,3.9
51163,2015,10319,9834,485,4.7
51165,2015,40101,38451,1650,4.1
51167,2015,11420,10671,749,6.6
51169,2015,9498,9008,490,5.2
51171,2015,21030,20132,898,4.3
51173,2015,13457,12580,877,6.5
51175,2015,9195,8826,369,4
51177,2015,63787,60830,2957,4.6
51179,2015,66635,63664,2971,4.5
51181,2015,3715,3527,188,5.1
51183,2015,4072,3793,279,6.9
51185,2015,16608,15379,1229,7.4
51187,2015,19614,18681,933,4.8
51191,2015,26973,25679,1294,4.8
51193,2015,8918,8437,481,5.4
51195,2015,13780,12639,1141,8.3
51197,2015,13638,12898,740,5.4
51199,2015,31985,30613,1372,4.3
51510,2015,94136,91040,3096,3.3
51520,2015,7511,7109,402,5.4
51530,2015,3293,3126,167,5.1
51540,2015,24639,23730,909,3.7
51550,2015,116286,111008,5278,4.5
51570,2015,8664,8255,409,4.7
51580,2015,2418,2272,146,6
51590,2015,19111,17732,1379,7.2
51595,2015,2244,2088,156,7
51600,2015,12797,12349,448,3.5
51610,2015,7843,7604,239,3
51620,2015,3608,3366,242,6.7
51630,2015,13364,12650,714,5.3
51640,2015,2945,2784,161,5.5
51650,2015,64245,60387,3858,6
51660,2015,23877,22611,1266,5.3
51670,2015,9619,8890,729,7.6
51678,2015,2251,2098,153,6.8
51680,2015,35620,33627,1993,5.6
51683,2015,21589,20693,896,4.2
51685,2015,8332,7983,349,4.2
51690,2015,5355,4885,470,8.8
51700,2015,88789,83959,4830,5.4
51710,2015,110498,104330,6168,5.6
51720,2015,1732,1612,120,6.9
51730,2015,13498,12260,1238,9.2
51735,2015,6199,5959,240,3.9
51740,2015,44242,41486,2756,6.2
51750,2015,8290,7821,469,5.7
51760,2015,112678,106801,5877,5.2
51770,2015,48894,46501,2393,4.9
51775,2015,12762,12199,563,4.4
51790,2015,11807,11293,514,4.4
51800,2015,42280,40183,2097,5
51810,2015,228721,218915,9806,4.3
51820,2015,10008,9529,479,4.8
51830,2015,6656,6234,422,6.3
51840,2015,14196,13574,622,4.4
53001,2015,8609,8009,600,7
53003,2015,9666,9200,466,4.8
53005,2015,91650,85485,6165,6.7
53007,2015,42588,40198,2390,5.6
53009,2015,26774,24590,2184,8.2
53011,2015,214098,200230,13868,6.5
53013,2015,1692,1581,111,6.6
53015,2015,44070,40645,3425,7.8
53017,2015,19754,18480,1274,6.4
53019,2015,2473,2220,253,10.2
53021,2015,38937,35958,2979,7.7
53023,2015,929,871,58,6.2
53025,2015,44658,41381,3277,7.3
53027,2015,26896,24443,2453,9.1
53029,2015,31728,29776,1952,6.2
53031,2015,11187,10384,803,7.2
53033,2015,1183214,1132658,50556,4.3
53035,2015,115217,108775,6442,5.6
53037,2015,20822,19519,1303,6.3
53039,2015,9447,8764,683,7.2
53041,2015,31195,28552,2643,8.5
53043,2015,4871,4584,287,5.9
53045,2015,22993,21181,1812,7.9
53047,2015,21214,19732,1482,7
53049,2015,8091,7358,733,9.1
53051,2015,4597,4150,447,9.7
53053,2015,391872,366533,25339,6.5
53055,2015,7712,7337,375,4.9
53057,2015,56640,52777,3863,6.8
53059,2015,4943,4574,369,7.5
53061,2015,403394,384614,18780,4.7
53063,2015,227632,212682,14950,6.6
53065,2015,17431,15866,1565,9
53067,2015,125599,118055,7544,6
53069,2015,1292,1175,117,9.1
53071,2015,28019,26362,1657,5.9
53073,2015,104151,97912,6239,6
53075,2015,22725,21613,1112,4.9
53077,2015,121673,111772,9901,8.1
54001,2015,6896,6386,510,7.4
54003,2015,53893,51250,2643,4.9
54005,2015,8181,7386,795,9.7
54007,2015,5459,4972,487,8.9
54009,2015,10083,9344,739,7.3
54011,2015,41267,39023,2244,5.4
54013,2015,2760,2416,344,12.5
54015,2015,3270,2905,365,11.2
54017,2015,3641,3440,201,5.5
54019,2015,16270,14874,1396,8.6
54021,2015,2704,2493,211,7.8
54023,2015,5761,5325,436,7.6
54025,2015,15354,14347,1007,6.6
54027,2015,9621,9083,538,5.6
54029,2015,12990,11978,1012,7.8
54031,2015,5467,5058,409,7.5
54033,2015,31832,29825,2007,6.3
54035,2015,11905,11047,858,7.2
54037,2015,27741,26601,1140,4.1
54039,2015,86171,81006,5165,6
54041,2015,6973,6399,574,8.2
54043,2015,7352,6636,716,9.7
54045,2015,11491,10202,1289,11.2
54047,2015,5341,4660,681,12.8
54049,2015,26006,24224,1782,6.9
54051,2015,14044,12855,1189,8.5
54053,2015,9962,9113,849,8.5
54055,2015,21956,20363,1593,7.3
54057,2015,11616,10764,852,7.3
54059,2015,7225,6273,952,13.2
54061,2015,50436,48062,2374,4.7
54063,2015,5746,5426,320,5.6
54065,2015,7469,7059,410,5.5
54067,2015,9930,9031,899,9.1
54069,2015,20648,19490,1158,5.6
54071,2015,3572,3406,166,4.6
54073,2015,2983,2730,253,8.5
54075,2015,3590,3297,293,8.2
54077,2015,14629,13717,912,6.2
54079,2015,25519,24091,1428,5.6
54081,2015,30328,28089,2239,7.4
54083,2015,11892,11058,834,7
54085,2015,4492,4178,314,7
54087,2015,5220,4620,600,11.5
54089,2015,4518,4200,318,7
54091,2015,7735,7272,463,6
54093,2015,3421,3212,209,6.1
54095,2015,3654,3312,342,9.4
54097,2015,9656,8880,776,8
54099,2015,15561,14454,1107,7.1
54101,2015,3470,3208,262,7.6
54103,2015,7157,6441,716,10
54105,2015,2255,2022,233,10.3
54107,2015,37051,34718,2333,6.3
54109,2015,7742,6996,746,9.6
55001,2015,8330,7724,606,7.3
55003,2015,7925,7429,496,6.3
55005,2015,24463,23241,1222,5
55007,2015,7532,6904,628,8.3
55009,2015,139239,133568,5671,4.1
55011,2015,6536,6215,321,4.9
55013,2015,7274,6764,510,7
55015,2015,27461,26481,980,3.6
55017,2015,33152,31588,1564,4.7
55019,2015,17428,16665,763,4.4
55021,2015,31344,29973,1371,4.4
55023,2015,7905,7442,463,5.9
55025,2015,310760,300863,9897,3.2
55027,2015,47546,45449,2097,4.4
55029,2015,15488,14454,1034,6.7
55031,2015,23354,22197,1157,5
55033,2015,23775,22706,1069,4.5
55035,2015,58159,55944,2215,3.8
55037,2015,2213,2064,149,6.7
55039,2015,57033,54708,2325,4.1
55041,2015,3997,3698,299,7.5
55043,2015,28165,26930,1235,4.4
55045,2015,21092,20288,804,3.8
55047,2015,9995,9453,542,5.4
55049,2015,13694,13112,582,4.3
55051,2015,2622,2391,231,8.8
55053,2015,10348,9854,494,4.8
55055,2015,45653,43720,1933,4.2
55057,2015,13512,12817,695,5.1
55059,2015,87534,83081,4453,5.1
55061,2015,10894,10448,446,4.1
55063,2015,66619,64050,2569,3.9
55065,2015,9748,9390,358,3.7
55067,2015,9476,8899,577,6.1
55069,2015,15258,14496,762,5
55071,2015,41901,39798,2103,5
55073,2015,73458,70503,2955,4
55075,2015,20748,19543,1205,5.8
55077,2015,7499,7039,460,6.1
55078,2015,1604,1449,155,9.7
55079,2015,477049,449639,27410,5.7
55081,2015,22836,21819,1017,4.5
55083,2015,20344,19294,1050,5.2
55085,2015,18638,17561,1077,5.8
55087,2015,101956,97919,4037,4
55089,2015,48238,46460,1778,3.7
55091,2015,4108,3936,172,4.2
55093,2015,24134,23186,948,3.9
55095,2015,24609,23420,1189,4.8
55097,2015,39587,37769,1818,4.6
55099,2015,6852,6547,305,4.5
55101,2015,99357,93779,5578,5.6
55103,2015,9294,8904,390,4.2
55105,2015,83346,79023,4323,5.2
55107,2015,6997,6614,383,5.5
55109,2015,48811,46942,1869,3.8
55111,2015,35305,33855,1450,4.1
55113,2015,7817,7198,619,7.9
55115,2015,21287,20250,1037,4.9
55117,2015,61252,58942,2310,3.8
55119,2015,10700,10228,472,4.4
55121,2015,16616,15966,650,3.9
55123,2015,15494,14858,636,4.1
55125,2015,10002,9300,702,7
55127,2015,56987,54344,2643,4.6
55129,2015,7958,7530,428,5.4
55131,2015,76067,73215,2852,3.7
55133,2015,221401,212995,8406,3.8
55135,2015,27038,25784,1254,4.6
55137,2015,11490,10766,724,6.3
55139,2015,91455,87579,3876,4.2
55141,2015,34426,32528,1898,5.5
56001,2015,20655,20000,655,3.2
56003,2015,5563,5315,248,4.5
56005,2015,25834,24810,1024,4
56007,2015,8445,8129,316,3.7
56009,2015,8322,8015,307,3.7
56011,2015,3711,3581,130,3.5
56013,2015,20265,19134,1131,5.6
56015,2015,7086,6851,235,3.3
56017,2015,2402,2301,101,4.2
56019,2015,4206,3999,207,4.9
56021,2015,48668,46726,1942,4
56023,2015,8422,8022,400,4.7
56025,2015,42882,40766,2116,4.9
56027,2015,1329,1289,40,3
56029,2015,15782,15099,683,4.3
56031,2015,4916,4722,194,3.9
56033,2015,15945,15265,680,4.3
56035,2015,4574,4334,240,5.2
56037,2015,22766,21687,1079,4.7
56039,2015,14708,14134,574,3.9
56041,2015,9683,9195,488,5
56043,2015,4271,4091,180,4.2
56045,2015,3965,3829,136,3.4
72001,2015,4385,3608,777,17.7
72003,2015,11824,10171,1653,14
72005,2015,14766,12693,2073,14
72007,2015,6826,5829,997,14.6
72009,2015,6647,5678,969,14.6
72011,2015,8855,7701,1154,13
72013,2015,23921,20597,3324,13.9
72015,2015,5190,4213,977,18.8
72017,2015,5907,5009,898,15.2
72019,2015,7420,6438,982,13.2
72021,2015,67344,61086,6258,9.3
72023,2015,14130,12403,1727,12.2
72025,2015,48436,43420,5016,10.4
72027,2015,9428,8216,1212,12.9
72029,2015,16267,14356,1911,11.7
72031,2015,62759,57215,5544,8.8
72033,2015,8047,7206,841,10.5
72035,2015,16234,14491,1743,10.7
72037,2015,3866,3331,535,13.8
72039,2015,3914,3235,679,17.3
72041,2015,15544,14000,1544,9.9
72043,2015,11018,8938,2080,18.9
72045,2015,5153,4369,784,15.2
72047,2015,9417,8151,1266,13.4
72049,2015,844,813,31,3.7
72051,2015,12801,11800,1001,7.8
72053,2015,11550,9847,1703,14.7
72054,2015,3399,2891,508,14.9
72055,2015,4203,3379,824,19.6
72057,2015,12240,10122,2118,17.3
72059,2015,5317,4283,1034,19.4
72061,2015,37212,35047,2165,5.8
72063,2015,17288,15787,1501,8.7
72065,2015,13062,11023,2039,15.6
72067,2015,5582,4934,648,11.6
72069,2015,17642,15042,2600,14.7
72071,2015,12311,10759,1552,12.6
72073,2015,4157,3542,615,14.8
72075,2015,15754,13367,2387,15.2
72077,2015,12475,10741,1734,13.9
72079,2015,5608,4603,1005,17.9
72081,2015,7356,5859,1497,20.4
72083,2015,2886,2401,485,16.8
72085,2015,11348,9756,1592,14
72087,2015,8791,7759,1032,11.7
72089,2015,6453,5450,1003,15.5
72091,2015,11672,10290,1382,11.8
72093,2015,1855,1549,306,16.5
72095,2015,3036,2477,559,18.4
72097,2015,23407,20246,3161,13.5
72099,2015,10639,8980,1659,15.6
72101,2015,8135,6991,1144,14.1
72103,2015,8087,7023,1064,13.2
72105,2015,7305,6307,998,13.7
72107,2015,5252,4395,857,16.3
72109,2015,4846,3836,1010,20.8
72111,2015,6245,5154,1091,17.5
72113,2015,48398,41681,6717,13.9
72115,2015,6037,5025,1012,16.8
72117,2015,4638,3874,764,16.5
72119,2015,17057,15295,1762,10.3
72121,2015,6364,5424,940,14.8
72123,2015,7896,5992,1904,24.1
72125,2015,10328,8871,1457,14.1
72127,2015,135740,125426,10314,7.6
72129,2015,11977,10409,1568,13.1
72131,2015,10673,8553,2120,19.9
72133,2015,9531,7790,1741,18.3
72135,2015,26332,24137,2195,8.3
72137,2015,30026,27313,2713,9
72139,2015,27208,25305,1903,7
72141,2015,6923,5816,1107,16
72143,2015,9870,8718,1152,11.7
72145,2015,13818,11920,1898,13.7
72147,2015,3194,2832,362,11.3
72149,2015,7801,6262,1539,19.7
72151,2015,9196,7592,1604,17.4
72153,2015,10745,8716,2029,18.9
01001,2016,25966,24645,1321,5.1
01003,2016,90670,85839,4831,5.3
01005,2016,8417,7717,700,8.3
01007,2016,8623,8067,556,6.4
01009,2016,24623,23298,1325,5.4
01011,2016,4833,4503,330,6.8
01013,2016,9206,8571,635,6.9
01015,2016,45902,42906,2996,6.5
01017,2016,15006,14188,818,5.5
01019,2016,11353,10780,573,5
01021,2016,19219,18167,1052,5.5
01023,2016,4334,3966,368,8.5
01025,2016,7966,7102,864,10.8
01027,2016,5634,5300,334,5.9
01029,2016,5796,5450,346,6
01031,2016,20633,19424,1209,5.9
01033,2016,23491,21862,1629,6.9
01035,2016,4556,4173,383,8.4
01037,2016,4387,4126,261,5.9
01039,2016,15519,14472,1047,6.7
01041,2016,6463,6085,378,5.8
01043,2016,37971,36087,1884,5
01045,2016,19993,18839,1154,5.8
01047,2016,15443,14023,1420,9.2
01049,2016,29283,27511,1772,6.1
01051,2016,37292,35521,1771,4.7
01053,2016,14577,13611,966,6.6
01055,2016,43345,40787,2558,5.9
01057,2016,6607,6163,444,6.7
01059,2016,13889,13074,815,5.9
01061,2016,10825,10200,625,5.8
01063,2016,2876,2591,285,9.9
01065,2016,5991,5534,457,7.6
01067,2016,6733,6295,438,6.5
01069,2016,44624,42048,2576,5.8
01071,2016,23623,22136,1487,6.3
01073,2016,311710,293873,17837,5.7
01075,2016,5699,5379,320,5.6
01077,2016,42599,39895,2704,6.3
01079,2016,13742,12795,947,6.9
01081,2016,72474,68690,3784,5.2
01083,2016,40753,38621,2132,5.2
01085,2016,3806,3405,401,10.5
01087,2016,7881,7282,599,7.6
01089,2016,173846,164964,8882,5.1
01091,2016,7684,7136,548,7.1
01093,2016,12517,11690,827,6.6
01095,2016,41652,39434,2218,5.3
01097,2016,188082,175642,12440,6.6
01099,2016,7326,6664,662,9
01101,2016,105928,99944,5984,5.6
01103,2016,54957,51923,3034,5.5
01105,2016,3472,3115,357,10.3
01107,2016,7779,7246,533,6.9
01109,2016,14973,14002,971,6.5
01111,2016,9444,8918,526,5.6
01113,2016,23571,22264,1307,5.5
01115,2016,39145,37122,2023,5.2
01117,2016,109762,105053,4709,4.3
01119,2016,5119,4726,393,7.7
01121,2016,34872,32576,2296,6.6
01123,2016,18611,17575,1036,5.6
01125,2016,99416,93818,5598,5.6
01127,2016,25607,23706,1901,7.4
01129,2016,6752,6172,580,8.6
01131,2016,2822,2416,406,14.4
01133,2016,9548,8872,676,7.1
02013,2016,2587,2517,70,2.7
02016,2016,3978,3846,132,3.3
02020,2016,155461,146890,8571,5.5
02050,2016,7246,6214,1032,14.2
02060,2016,413,384,29,7
02068,2016,1094,995,99,9
02070,2016,2077,1877,200,9.6
02090,2016,46449,43717,2732,5.9
02100,2016,1074,964,110,10.2
02105,2016,1205,1062,143,11.9
02110,2016,17338,16559,779,4.5
02122,2016,27161,24847,2314,8.5
02130,2016,7026,6566,460,6.5
02150,2016,6416,6086,330,5.1
02158,2016,2725,2136,589,21.6
02164,2016,655,573,82,12.5
02170,2016,47408,43505,3903,8.2
02180,2016,4084,3565,519,12.7
02185,2016,3953,3685,268,6.8
02188,2016,2964,2490,474,16
02195,2016,1450,1319,131,9
02198,2016,2768,2431,337,12.2
02220,2016,4371,4169,202,4.6
02230,2016,805,715,90,11.2
02240,2016,2996,2674,322,10.7
02261,2016,4810,4396,414,8.6
02275,2016,1055,975,80,7.6
02282,2016,243,223,20,8.2
02290,2016,2423,1990,433,17.9
04001,2016,20320,17984,2336,11.5
04003,2016,49597,46498,3099,6.2
04005,2016,74181,69706,4475,6
04007,2016,20996,19474,1522,7.2
04009,2016,14373,13402,971,6.8
04011,2016,3900,3604,296,7.6
04012,2016,8470,7957,513,6.1
04013,2016,2080523,1985001,95522,4.6
04015,2016,80509,75168,5341,6.6
04017,2016,41330,37908,3422,8.3
04019,2016,469613,446263,23350,5
04021,2016,163946,154832,9114,5.6
04023,2016,19192,17261,1931,10.1
04025,2016,99526,94609,4917,4.9
04027,2016,94117,76345,17772,18.9
05001,2016,9267,8952,315,3.4
05003,2016,7735,7249,486,6.3
05005,2016,16098,15408,690,4.3
05007,2016,127925,124210,3715,2.9
05009,2016,15930,15346,584,3.7
05011,2016,4292,4067,225,5.2
05013,2016,2377,2268,109,4.6
05015,2016,12871,12414,457,3.6
05017,2016,3582,3347,235,6.6
05019,2016,9384,8970,414,4.4
05021,2016,6037,5697,340,5.6
05023,2016,9474,8912,562,5.9
05025,2016,3343,3193,150,4.5
05027,2016,9267,8738,529,5.7
05029,2016,8444,7962,482,5.7
05031,2016,52230,50539,1691,3.2
05033,2016,26949,25902,1047,3.9
05035,2016,21608,20634,974,4.5
05037,2016,7882,7534,348,4.4
05039,2016,2884,2739,145,5
05041,2016,5441,5145,296,5.4
05043,2016,7809,7357,452,5.8
05045,2016,60553,58259,2294,3.8
05047,2016,7362,7066,296,4
05049,2016,4666,4464,202,4.3
05051,2016,40084,38363,1721,4.3
05053,2016,8275,7977,298,3.6
05055,2016,19799,18953,846,4.3
05057,2016,9928,9554,374,3.8
05059,2016,14069,13516,553,3.9
05061,2016,5950,5755,195,3.3
05063,2016,16006,15215,791,4.9
05065,2016,4964,4686,278,5.6
05067,2016,6057,5680,377,6.2
05069,2016,28323,26739,1584,5.6
05071,2016,10526,10028,498,4.7
05073,2016,2547,2397,150,5.9
05075,2016,6917,6618,299,4.3
05077,2016,3091,2946,145,4.7
05079,2016,4095,3898,197,4.8
05081,2016,5592,5331,261,4.7
05083,2016,9121,8703,418,4.6
05085,2016,33387,32279,1108,3.3
05087,2016,7286,7053,233,3.2
05089,2016,6521,6261,260,4
05091,2016,19869,19038,831,4.2
05093,2016,18066,16844,1222,6.8
05095,2016,2879,2741,138,4.8
05097,2016,3100,2939,161,5.2
05099,2016,3616,3482,134,3.7
05101,2016,3411,3280,131,3.8
05103,2016,9816,9320,496,5.1
05105,2016,4167,3968,199,4.8
05107,2016,6657,6265,392,5.9
05109,2016,4170,3991,179,4.3
05111,2016,10091,9661,430,4.3
05113,2016,8150,7752,398,4.9
05115,2016,29216,27874,1342,4.6
05117,2016,3650,3511,139,3.8
05119,2016,187109,180487,6622,3.5
05121,2016,6521,6221,300,4.6
05123,2016,8829,8371,458,5.2
05125,2016,56860,55089,1771,3.1
05127,2016,4420,4256,164,3.7
05129,2016,2989,2853,136,4.6
05131,2016,57601,55461,2140,3.7
05133,2016,5627,5352,275,4.9
05135,2016,6050,5722,328,5.4
05137,2016,4740,4497,243,5.1
05139,2016,16312,15421,891,5.5
05141,2016,6101,5682,419,6.9
05143,2016,118386,115134,3252,2.7
05145,2016,34022,32258,1764,5.2
05147,2016,2968,2806,162,5.5
05149,2016,8668,8281,387,4.5
06001,2016,832455,796753,35702,4.3
06003,2016,555,519,36,6.5
06005,2016,14534,13670,864,5.9
06007,2016,101713,94995,6718,6.6
06009,2016,20812,19632,1180,5.7
06011,2016,10910,9214,1696,15.5
06013,2016,553635,528876,24759,4.5
06015,2016,9762,9028,734,7.5
06017,2016,88888,84324,4564,5.1
06019,2016,444982,402728,42254,9.5
06021,2016,12956,11878,1078,8.3
06023,2016,62468,59391,3077,4.9
06025,2016,75207,57049,18158,24.1
06027,2016,8865,8397,468,5.3
06029,2016,388311,348006,40305,10.4
06031,2016,57189,51492,5697,10
06033,2016,29086,27133,1953,6.7
06035,2016,10369,9650,719,6.9
06037,2016,5041430,4776678,264752,5.3
06039,2016,61085,55443,5642,9.2
06041,2016,139744,135162,4582,3.3
06043,2016,7573,7054,519,6.9
06045,2016,39644,37555,2089,5.3
06047,2016,114393,102304,12089,10.6
06049,2016,3294,3037,257,7.8
06051,2016,8372,7923,449,5.4
06053,2016,218899,202158,16741,7.6
06055,2016,72994,69862,3132,4.3
06057,2016,48182,45879,2303,4.8
06059,2016,1598784,1534101,64683,4
06061,2016,179769,171704,8065,4.5
06063,2016,7854,7091,763,9.7
06065,2016,1052365,988072,64293,6.1
06067,2016,694482,656950,37532,5.4
06069,2016,30453,28423,2030,6.7
06071,2016,930888,877173,53715,5.8
06073,2016,1564339,1490482,73857,4.7
06075,2016,555755,537455,18300,3.3
06077,2016,318508,292630,25878,8.1
06079,2016,139585,133558,6027,4.3
06081,2016,442147,428667,13480,3
06083,2016,215420,204513,10907,5.1
06085,2016,1028720,989938,38782,3.8
06087,2016,143850,133851,9999,7
06089,2016,74255,69082,5173,7
06091,2016,1334,1233,101,7.6
06093,2016,17906,16385,1521,8.5
06095,2016,207419,196011,11408,5.5
06097,2016,259412,249100,10312,4
06099,2016,242879,221970,20909,8.6
06101,2016,45006,40649,4357,9.7
06103,2016,25088,23302,1786,7.1
06105,2016,4996,4642,354,7.1
06107,2016,203393,180666,22727,11.2
06109,2016,21582,20240,1342,6.2
06111,2016,425658,403448,22210,5.2
06113,2016,106150,99902,6248,5.9
06115,2016,28170,25746,2424,8.6
08001,2016,253825,244897,8928,3.5
08003,2016,7974,7657,317,4
08005,2016,340924,330523,10401,3.1
08007,2016,6371,6165,206,3.2
08009,2016,2094,2059,35,1.7
08011,2016,1853,1797,56,3
08013,2016,181034,176281,4753,2.6
08014,2016,36815,35767,1048,2.8
08015,2016,8851,8620,231,2.6
08017,2016,1082,1058,24,2.2
08019,2016,5693,5513,180,3.2
08021,2016,3775,3594,181,4.8
08023,2016,1730,1648,82,4.7
08025,2016,1423,1374,49,3.4
08027,2016,2020,1958,62,3.1
08029,2016,13969,13293,676,4.8
08031,2016,385402,373636,11766,3.1
08033,2016,1072,1031,41,3.8
08035,2016,177701,173038,4663,2.6
08037,2016,33758,32846,912,2.7
08039,2016,13812,13459,353,2.6
08041,2016,314984,303345,11639,3.7
08043,2016,14717,13968,749,5.1
08045,2016,31024,29957,1067,3.4
08047,2016,3488,3406,82,2.4
08049,2016,9197,8954,243,2.6
08051,2016,10146,9917,229,2.3
08053,2016,448,437,11,2.5
08055,2016,2503,2347,156,6.2
08057,2016,892,869,23,2.6
08059,2016,315665,306485,9180,2.9
08061,2016,847,830,17,2
08063,2016,4543,4448,95,2.1
08065,2016,4622,4492,130,2.8
08067,2016,31017,30141,876,2.8
08069,2016,187550,182372,5178,2.8
08071,2016,6192,5884,308,5
08073,2016,2282,2224,58,2.5
08075,2016,11026,10707,319,2.9
08077,2016,72159,68373,3786,5.2
08079,2016,464,454,10,2.2
08081,2016,7189,6908,281,3.9
08083,2016,12735,12112,623,4.9
08085,2016,20086,19268,818,4.1
08087,2016,15054,14542,512,3.4
08089,2016,8121,7745,376,4.6
08091,2016,2168,2088,80,3.7
08093,2016,9844,9574,270,2.7
08095,2016,2474,2426,48,1.9
08097,2016,10747,10390,357,3.3
08099,2016,6010,5819,191,3.2
08101,2016,73155,69712,3443,4.7
08103,2016,2740,2603,137,5
08105,2016,5161,4909,252,4.9
08107,2016,14923,14538,385,2.6
08109,2016,3230,3075,155,4.8
08111,2016,480,463,17,3.5
08113,2016,5190,5024,166,3.2
08115,2016,1179,1152,27,2.3
08117,2016,21150,20719,431,2
08119,2016,11743,11315,428,3.6
08121,2016,2923,2861,62,2.1
08123,2016,150089,145044,5045,3.4
08125,2016,5444,5330,114,2.1
09001,2016,480522,457108,23414,4.9
09003,2016,474523,449088,25435,5.4
09005,2016,104779,99828,4951,4.7
09007,2016,92223,88120,4103,4.4
09009,2016,455053,429903,25150,5.5
09011,2016,136008,129023,6985,5.1
09013,2016,85364,81528,3836,4.5
09015,2016,62804,59308,3496,5.6
10001,2016,77259,73467,3792,4.9
10003,2016,293884,280885,12999,4.4
10005,2016,101100,96560,4540,4.5
11001,2016,395424,371295,24129,6.1
12001,2016,132521,126849,5672,4.3
12003,2016,11409,10853,556,4.9
12005,2016,87847,83662,4185,4.8
12007,2016,10852,10390,462,4.3
12009,2016,262336,248927,13409,5.1
12011,2016,1003202,958071,45131,4.5
12013,2016,4982,4696,286,5.7
12015,2016,69230,65546,3684,5.3
12017,2016,47800,44588,3212,6.7
12019,2016,100942,96402,4540,4.5
12021,2016,169065,161176,7889,4.7
12023,2016,29734,28286,1448,4.9
12027,2016,13459,12751,708,5.3
12029,2016,5646,5339,307,5.4
12031,2016,467244,444319,22925,4.9
12033,2016,140836,133868,6968,4.9
12035,2016,45303,42813,2490,5.5
12037,2016,4732,4527,205,4.3
12039,2016,18192,17053,1139,6.3
12041,2016,6671,6338,333,5
12043,2016,4714,4420,294,6.2
12045,2016,5961,5684,277,4.6
12047,2016,4653,4390,263,5.7
12049,2016,9247,8633,614,6.6
12051,2016,15391,14082,1309,8.5
12053,2016,67864,63763,4101,6
12055,2016,35694,33362,2332,6.5
12057,2016,706663,675394,31269,4.4
12059,2016,6706,6344,362,5.4
12061,2016,62131,58395,3736,6
12063,2016,17324,16421,903,5.2
12065,2016,5382,5099,283,5.3
12067,2016,2965,2836,129,4.4
12069,2016,145974,138893,7081,4.9
12071,2016,329055,313867,15188,4.6
12073,2016,150092,143297,6795,4.5
12075,2016,16633,15774,859,5.2
12077,2016,2635,2500,135,5.1
12079,2016,7319,6935,384,5.2
12081,2016,170456,162699,7757,4.6
12083,2016,131913,124245,7668,5.8
12085,2016,70833,67404,3429,4.8
12086,2016,1324474,1256325,68149,5.1
12087,2016,46410,44934,1476,3.2
12089,2016,37743,36047,1696,4.5
12091,2016,93159,89419,3740,4
12093,2016,18131,17201,930,5.1
12095,2016,705953,675257,30696,4.3
12097,2016,164117,155983,8134,5
12099,2016,708677,675422,33255,4.7
12101,2016,222330,210938,11392,5.1
12103,2016,477837,457088,20749,4.3
12105,2016,286641,270817,15824,5.5
12107,2016,26954,25241,1713,6.4
12109,2016,118494,114014,4480,3.8
12111,2016,135087,127280,7807,5.8
12113,2016,76061,72633,3428,4.5
12115,2016,180870,172654,8216,4.5
12117,2016,241834,231507,10327,4.3
12119,2016,29362,27261,2101,7.2
12121,2016,18169,17280,889,4.9
12123,2016,8829,8353,476,5.4
12125,2016,4792,4585,207,4.3
12127,2016,245272,232868,12404,5.1
12129,2016,14284,13694,590,4.1
12131,2016,28917,27676,1241,4.3
12133,2016,9692,9195,497,5.1
13001,2016,9189,8604,585,6.4
13003,2016,3976,3769,207,5.2
13005,2016,4982,4722,260,5.2
13007,2016,1181,1090,91,7.7
13009,2016,17633,16430,1203,6.8
13011,2016,8816,8389,427,4.8
13013,2016,37699,35927,1772,4.7
13015,2016,48191,45731,2460,5.1
13017,2016,5547,5093,454,8.2
13019,2016,7220,6779,441,6.1
13021,2016,68646,64580,4066,5.9
13023,2016,4502,4146,356,7.9
13025,2016,7095,6620,475,6.7
13027,2016,7011,6644,367,5.2
13029,2016,16929,16108,821,4.8
13031,2016,35964,33912,2052,5.7
13033,2016,9241,8531,710,7.7
13035,2016,10378,9795,583,5.6
13037,2016,2163,2041,122,5.6
13039,2016,20351,19183,1168,5.7
13043,2016,5072,4830,242,4.8
13045,2016,53541,50337,3204,6
13047,2016,32173,30624,1549,4.8
13049,2016,4740,4474,266,5.6
13051,2016,136081,128973,7108,5.2
13053,2016,2059,1889,170,8.3
13055,2016,10435,9779,656,6.3
13057,2016,125900,120561,5339,4.2
13059,2016,58761,55533,3228,5.5
13061,2016,883,792,91,10.3
13063,2016,130760,122159,8601,6.6
13065,2016,2769,2599,170,6.1
13067,2016,410112,391343,18769,4.6
13069,2016,18086,17038,1048,5.8
13071,2016,21099,19995,1104,5.2
13073,2016,71048,67761,3287,4.6
13075,2016,7523,7117,406,5.4
13077,2016,70400,66914,3486,5
13079,2016,5677,5344,333,5.9
13081,2016,9189,8637,552,6
13083,2016,8017,7614,403,5
13085,2016,11331,10803,528,4.7
13087,2016,11473,10713,760,6.6
13089,2016,382702,362151,20551,5.4
13091,2016,7015,6507,508,7.2
13093,2016,4950,4664,286,5.8
13095,2016,38158,35556,2602,6.8
13097,2016,70221,66334,3887,5.5
13099,2016,4400,4099,301,6.8
13101,2016,1883,1802,81,4.3
13103,2016,28415,27050,1365,4.8
13105,2016,7729,7230,499,6.5
13107,2016,8446,7795,651,7.7
13109,2016,4788,4554,234,4.9
13111,2016,10828,10251,577,5.3
13113,2016,55714,53099,2615,4.7
13115,2016,43497,40895,2602,6
13117,2016,111003,106392,4611,4.2
13119,2016,9787,9277,510,5.2
13121,2016,531088,502625,28463,5.4
13123,2016,11834,11165,669,5.7
13125,2016,1268,1192,76,6
13127,2016,39176,37105,2071,5.3
13129,2016,25299,23888,1411,5.6
13131,2016,10253,9698,555,5.4
13133,2016,6604,6206,398,6
13135,2016,467718,445552,22166,4.7
13137,2016,19302,18286,1016,5.3
13139,2016,96314,91998,4316,4.5
13141,2016,2530,2319,211,8.3
13143,2016,12157,11455,702,5.8
13145,2016,16068,15287,781,4.9
13147,2016,11012,10423,589,5.3
13149,2016,4996,4702,294,5.9
13151,2016,108905,102937,5968,5.5
13153,2016,67668,64064,3604,5.3
13155,2016,3218,2967,251,7.8
13157,2016,33289,31876,1413,4.2
13159,2016,6582,6268,314,4.8
13161,2016,6226,5832,394,6.3
13163,2016,6596,6111,485,7.4
13165,2016,3162,2924,238,7.5
13167,2016,3925,3687,238,6.1
13169,2016,13793,13133,660,4.8
13171,2016,7898,7382,516,6.5
13173,2016,3827,3607,220,5.7
13175,2016,19062,17799,1263,6.6
13177,2016,14557,13877,680,4.7
13179,2016,25043,23584,1459,5.8
13181,2016,3478,3274,204,5.9
13183,2016,7424,7025,399,5.4
13185,2016,51309,48613,2696,5.3
13187,2016,15971,15210,761,4.8
13189,2016,8800,8159,641,7.3
13191,2016,6003,5654,349,5.8
13193,2016,4679,4293,386,8.2
13195,2016,13083,12439,644,4.9
13197,2016,3380,3133,247,7.3
13199,2016,8757,8158,599,6.8
13201,2016,2753,2605,148,5.4
13205,2016,8569,8009,560,6.5
13207,2016,13018,12348,670,5.1
13209,2016,3724,3448,276,7.4
13211,2016,8698,8261,437,5
13213,2016,15641,14536,1105,7.1
13215,2016,78420,73115,5305,6.8
13217,2016,49997,47014,2983,6
13219,2016,18476,17722,754,4.1
13221,2016,6919,6584,335,4.8
13223,2016,79651,75983,3668,4.6
13225,2016,11438,10640,798,7
13227,2016,14402,13705,697,4.8
13229,2016,8555,8104,451,5.3
13231,2016,8403,7969,434,5.2
13233,2016,18070,16965,1105,6.1
13235,2016,4039,3803,236,5.8
13237,2016,7952,7394,558,7
13239,2016,815,756,59,7.2
13241,2016,6697,6303,394,5.9
13243,2016,2473,2265,208,8.4
13245,2016,84825,79116,5709,6.7
13247,2016,43247,40751,2496,5.8
13249,2016,2116,1983,133,6.3
13251,2016,5238,4845,393,7.5
13253,2016,3092,2850,242,7.8
13255,2016,27789,25887,1902,6.8
13257,2016,11033,10387,646,5.9
13259,2016,2137,2001,136,6.4
13261,2016,12843,11875,968,7.5
13263,2016,2745,2562,183,6.7
13265,2016,549,511,38,6.9
13267,2016,9332,8834,498,5.3
13269,2016,3323,3075,248,7.5
13271,2016,4812,4411,401,8.3
13273,2016,3656,3420,236,6.5
13275,2016,17531,16442,1089,6.2
13277,2016,18552,17558,994,5.4
13279,2016,11785,10868,917,7.8
13281,2016,4107,3829,278,6.8
13283,2016,2741,2531,210,7.7
13285,2016,36837,34968,1869,5.1
13287,2016,3236,3027,209,6.5
13289,2016,2949,2693,256,8.7
13291,2016,10449,9956,493,4.7
13293,2016,11141,10426,715,6.4
13295,2016,29936,28274,1662,5.6
13297,2016,43381,41259,2122,4.9
13299,2016,15482,14651,831,5.4
13301,2016,2699,2512,187,6.9
13303,2016,7183,6730,453,6.3
13305,2016,11294,10523,771,6.8
13307,2016,966,883,83,8.6
13309,2016,1733,1578,155,8.9
13311,2016,14482,13813,669,4.6
13313,2016,44740,42014,2726,6.1
13315,2016,2720,2525,195,7.2
13317,2016,3707,3462,245,6.6
13319,2016,3651,3420,231,6.3
13321,2016,9123,8593,530,5.8
15001,2016,91367,88009,3358,3.7
15003,2016,470086,457073,13013,2.8
15007,2016,35802,34648,1154,3.2
15009,2016,85706,83054,2652,3.1
16001,2016,225651,218199,7452,3.3
16003,2016,1749,1627,122,7
16005,2016,41168,39697,1471,3.6
16007,2016,2817,2688,129,4.6
16009,2016,4022,3782,240,6
16011,2016,22842,22035,807,3.5
16013,2016,11873,11497,376,3.2
16015,2016,3105,2939,166,5.3
16017,2016,18933,17902,1031,5.4
16019,2016,52500,50826,1674,3.2
16021,2016,5119,4848,271,5.3
16023,2016,1297,1243,54,4.2
16025,2016,659,635,24,3.6
16027,2016,93825,89735,4090,4.4
16029,2016,3803,3666,137,3.6
16031,2016,11615,11268,347,3
16033,2016,394,381,13,3.3
16035,2016,3058,2833,225,7.4
16037,2016,2147,2036,111,5.2
16039,2016,10980,10524,456,4.2
16041,2016,6655,6450,205,3.1
16043,2016,7385,7136,249,3.4
16045,2016,7747,7382,365,4.7
16047,2016,8016,7769,247,3.1
16049,2016,6357,5994,363,5.7
16051,2016,12853,12455,398,3.1
16053,2016,11371,11012,359,3.2
16055,2016,74006,70537,3469,4.7
16057,2016,19939,19305,634,3.2
16059,2016,3417,3206,211,6.2
16061,2016,1629,1526,103,6.3
16063,2016,2648,2529,119,4.5
16065,2016,20607,20108,499,2.4
16067,2016,10898,10549,349,3.2
16069,2016,20910,20223,687,3.3
16071,2016,2206,2126,80,3.6
16073,2016,5292,5049,243,4.6
16075,2016,11282,10756,526,4.7
16077,2016,3939,3777,162,4.1
16079,2016,5130,4763,367,7.2
16081,2016,5995,5801,194,3.2
16083,2016,39652,38298,1354,3.4
16085,2016,4980,4707,273,5.5
16087,2016,4610,4355,255,5.5
17001,2016,32482,30935,1547,4.8
17003,2016,2205,1999,206,9.3
17005,2016,7878,7474,404,5.1
17007,2016,26373,24696,1677,6.4
17009,2016,2855,2759,96,3.4
17011,2016,17373,16323,1050,6
17013,2016,2374,2227,147,6.2
17015,2016,7864,7420,444,5.6
17017,2016,6238,5892,346,5.5
17019,2016,105414,100035,5379,5.1
17021,2016,15369,14393,976,6.4
17023,2016,8162,7687,475,5.8
17025,2016,6705,6247,458,6.8
17027,2016,20450,19537,913,4.5
17029,2016,24522,23074,1448,5.9
17031,2016,2665321,2504624,160697,6
17033,2016,9026,8462,564,6.2
17035,2016,5981,5670,311,5.2
17037,2016,55086,52136,2950,5.4
17039,2016,7909,7457,452,5.7
17041,2016,10230,9745,485,4.7
17043,2016,517069,492745,24324,4.7
17045,2016,9704,9123,581,6
17047,2016,2972,2799,173,5.8
17049,2016,18686,17803,883,4.7
17051,2016,9754,9110,644,6.6
17053,2016,6545,6184,361,5.5
17055,2016,16691,15339,1352,8.1
17057,2016,15807,14639,1168,7.4
17059,2016,2535,2342,193,7.6
17061,2016,6068,5715,353,5.8
17063,2016,25768,24043,1725,6.7
17065,2016,4257,3990,267,6.3
17067,2016,8830,8253,577,6.5
17069,2016,1399,1263,136,9.7
17071,2016,3717,3490,227,6.1
17073,2016,25204,23681,1523,6
17075,2016,14842,14027,815,5.5
17077,2016,28680,27132,1548,5.4
17079,2016,4646,4354,292,6.3
17081,2016,17567,16441,1126,6.4
17083,2016,11056,10410,646,5.8
17085,2016,11375,10763,612,5.4
17087,2016,4209,3842,367,8.7
17089,2016,269704,254742,14962,5.5
17091,2016,55303,51760,3543,6.4
17093,2016,67998,64531,3467,5.1
17095,2016,22943,21530,1413,6.2
17097,2016,372538,353051,19487,5.2
17099,2016,57112,53247,3865,6.8
17101,2016,6175,5717,458,7.4
17103,2016,18020,17095,925,5.1
17105,2016,17018,16096,922,5.4
17107,2016,13076,12380,696,5.3
17109,2016,14027,13147,880,6.3
17111,2016,167954,159180,8774,5.2
17113,2016,90137,85557,4580,5.1
17115,2016,50284,46946,3338,6.6
17117,2016,23358,21965,1393,6
17119,2016,135105,127143,7962,5.9
17121,2016,18025,16874,1151,6.4
17123,2016,5636,5263,373,6.6
17125,2016,6441,5981,460,7.1
17127,2016,5992,5564,428,7.1
17129,2016,6901,6585,316,4.6
17131,2016,8219,7708,511,6.2
17133,2016,18485,17734,751,4.1
17135,2016,12140,11280,860,7.1
17137,2016,17000,16163,837,4.9
17139,2016,7437,7095,342,4.6
17141,2016,25804,24279,1525,5.9
17143,2016,88138,82056,6082,6.9
17145,2016,8705,8086,619,7.1
17147,2016,8539,8117,422,4.9
17149,2016,7507,7124,383,5.1
17151,2016,1761,1640,121,6.9
17153,2016,2194,2008,186,8.5
17155,2016,3107,2933,174,5.6
17157,2016,14546,13818,728,5
17159,2016,7540,7093,447,5.9
17161,2016,72048,67527,4521,6.3
17163,2016,127187,119457,7730,6.1
17165,2016,10049,9188,861,8.6
17167,2016,106304,101124,5180,4.9
17169,2016,3358,3169,189,5.6
17171,2016,2534,2391,143,5.6
17173,2016,10384,9788,596,5.7
17175,2016,2762,2559,203,7.3
17177,2016,21413,20157,1256,5.9
17179,2016,65843,61613,4230,6.4
17181,2016,7524,6966,558,7.4
17183,2016,35080,32546,2534,7.2
17185,2016,5753,5392,361,6.3
17187,2016,8696,8237,459,5.3
17189,2016,9644,9281,363,3.8
17191,2016,7301,6678,623,8.5
17193,2016,6889,6437,452,6.6
17195,2016,28727,27060,1667,5.8
17197,2016,363016,341403,21613,6
17199,2016,32322,30334,1988,6.2
17201,2016,141580,132144,9436,6.7
17203,2016,19372,18310,1062,5.5
18001,2016,17040,16431,609,3.6
18003,2016,180882,173176,7706,4.3
18005,2016,44452,42949,1503,3.4
18007,2016,4566,4373,193,4.2
18009,2016,5337,5052,285,5.3
18011,2016,34859,33685,1174,3.4
18013,2016,7523,7221,302,4
18015,2016,10109,9681,428,4.2
18017,2016,18051,17214,837,4.6
18019,2016,60539,58023,2516,4.2
18021,2016,12386,11809,577,4.7
18023,2016,17153,16488,665,3.9
18025,2016,4999,4718,281,5.6
18027,2016,15975,15411,564,3.5
18029,2016,25600,24396,1204,4.7
18031,2016,14556,14039,517,3.6
18033,2016,22236,21366,870,3.9
18035,2016,55087,52268,2819,5.1
18037,2016,23397,22670,727,3.1
18039,2016,108476,104705,3771,3.5
18041,2016,9351,8814,537,5.7
18043,2016,40988,39313,1675,4.1
18045,2016,7980,7518,462,5.8
18047,2016,11479,10982,497,4.3
18049,2016,9889,9426,463,4.7
18051,2016,19200,18506,694,3.6
18053,2016,32144,30563,1581,4.9
18055,2016,13742,12846,896,6.5
18057,2016,174507,168927,5580,3.2
18059,2016,38689,37227,1462,3.8
18061,2016,19958,19121,837,4.2
18063,2016,85792,82802,2990,3.5
18065,2016,22117,21098,1019,4.6
18067,2016,38083,36313,1770,4.6
18069,2016,18688,17932,756,4
18071,2016,22348,21532,816,3.7
18073,2016,16571,15691,880,5.3
18075,2016,9946,9496,450,4.5
18077,2016,15287,14576,711,4.7
18079,2016,13267,12638,629,4.7
18081,2016,80261,77350,2911,3.6
18083,2016,19066,18235,831,4.4
18085,2016,41502,39951,1551,3.7
18087,2016,19425,18757,668,3.4
18089,2016,232251,217590,14661,6.3
18091,2016,48653,45798,2855,5.9
18093,2016,20596,19428,1168,5.7
18095,2016,58972,56005,2967,5
18097,2016,481513,460005,21508,4.5
18099,2016,24328,23418,910,3.7
18101,2016,5150,4940,210,4.1
18103,2016,16088,15330,758,4.7
18105,2016,67995,64840,3155,4.6
18107,2016,19160,18424,736,3.8
18109,2016,36042,34512,1530,4.2
18111,2016,7038,6645,393,5.6
18113,2016,23332,22387,945,4.1
18115,2016,3225,3067,158,4.9
18117,2016,8881,8431,450,5.1
18119,2016,9260,8746,514,5.6
18121,2016,7268,6890,378,5.2
18123,2016,9462,9031,431,4.6
18125,2016,6332,6057,275,4.3
18127,2016,86283,81870,4413,5.1
18129,2016,13453,12923,530,3.9
18131,2016,6380,6095,285,4.5
18133,2016,16606,15858,748,4.5
18135,2016,12670,12101,569,4.5
18137,2016,14067,13423,644,4.6
18139,2016,8979,8641,338,3.8
18141,2016,134142,128072,6070,4.5
18143,2016,10477,9970,507,4.8
18145,2016,22958,22043,915,4
18147,2016,10977,10528,449,4.1
18149,2016,10861,10274,587,5.4
18151,2016,20085,19351,734,3.7
18153,2016,8700,8190,510,5.9
18155,2016,4996,4753,243,4.9
18157,2016,94397,90572,3825,4.1
18159,2016,8529,8201,328,3.8
18161,2016,3638,3491,147,4
18163,2016,93237,89412,3825,4.1
18165,2016,7272,6794,478,6.6
18167,2016,49382,46726,2656,5.4
18169,2016,15481,14822,659,4.3
18171,2016,4112,3913,199,4.8
18173,2016,32487,31177,1310,4
18175,2016,13685,13060,625,4.6
18177,2016,30951,29472,1479,4.8
18179,2016,14170,13666,504,3.6
18181,2016,13644,13103,541,4
18183,2016,17237,16568,669,3.9
19001,2016,4232,4108,124,2.9
19003,2016,2215,2158,57,2.6
19005,2016,7668,7290,378,4.9
19007,2016,6157,5868,289,4.7
19009,2016,3275,3168,107,3.3
19011,2016,13596,13109,487,3.6
19013,2016,69257,66068,3189,4.6
19015,2016,15112,14693,419,2.8
19017,2016,13904,13410,494,3.6
19019,2016,11200,10742,458,4.1
19021,2016,11510,11108,402,3.5
19023,2016,8027,7680,347,4.3
19025,2016,4521,4351,170,3.8
19027,2016,11277,10990,287,2.5
19029,2016,7262,7027,235,3.2
19031,2016,10856,10498,358,3.3
19033,2016,23113,22288,825,3.6
19035,2016,6319,6091,228,3.6
19037,2016,6424,6142,282,4.4
19039,2016,4830,4668,162,3.4
19041,2016,8718,8384,334,3.8
19043,2016,10300,9865,435,4.2
19045,2016,23809,22641,1168,4.9
19047,2016,8435,7977,458,5.4
19049,2016,45815,44616,1199,2.6
19051,2016,4289,4108,181,4.2
19053,2016,4405,4264,141,3.2
19055,2016,10726,10357,369,3.4
19057,2016,20035,19052,983,4.9
19059,2016,10300,9860,440,4.3
19061,2016,54679,52745,1934,3.5
19063,2016,5595,5358,237,4.2
19065,2016,10710,10238,472,4.4
19067,2016,8689,8375,314,3.6
19069,2016,5944,5739,205,3.4
19071,2016,3987,3857,130,3.3
19073,2016,5666,5490,176,3.1
19075,2016,6634,6406,228,3.4
19077,2016,5623,5422,201,3.6
19079,2016,7141,6873,268,3.8
19081,2016,6390,6219,171,2.7
19083,2016,8571,8240,331,3.9
19085,2016,7449,7199,250,3.4
19087,2016,9562,9224,338,3.5
19089,2016,5328,5138,190,3.6
19091,2016,5387,5232,155,2.9
19093,2016,4024,3922,102,2.5
19095,2016,10557,10231,326,3.1
19097,2016,11062,10601,461,4.2
19099,2016,19246,18565,681,3.5
19101,2016,9184,8849,335,3.6
19103,2016,84310,82138,2172,2.6
19105,2016,10686,10232,454,4.2
19107,2016,5320,5093,227,4.3
19109,2016,8894,8663,231,2.6
19111,2016,17458,16411,1047,6
19113,2016,118783,114458,4325,3.6
19115,2016,6101,5864,237,3.9
19117,2016,4381,4243,138,3.1
19119,2016,7087,6944,143,2
19121,2016,8250,7959,291,3.5
19123,2016,11798,11363,435,3.7
19125,2016,17446,16923,523,3
19127,2016,19133,18202,931,4.9
19129,2016,7406,7138,268,3.6
19131,2016,5879,5726,153,2.6
19133,2016,4725,4533,192,4.1
19135,2016,3957,3776,181,4.6
19137,2016,5112,4933,179,3.5
19139,2016,22429,21581,848,3.8
19141,2016,8360,8130,230,2.8
19143,2016,3643,3547,96,2.6
19145,2016,6466,6143,323,5
19147,2016,4966,4813,153,3.1
19149,2016,15008,14627,381,2.5
19151,2016,4317,4195,122,2.8
19153,2016,257323,248455,8868,3.4
19155,2016,48263,46637,1626,3.4
19157,2016,10422,10067,355,3.4
19159,2016,2606,2516,90,3.5
19161,2016,5494,5330,164,3
19163,2016,86680,82794,3886,4.5
19165,2016,6823,6624,199,2.9
19167,2016,20685,20214,471,2.3
19169,2016,56963,55637,1326,2.3
19171,2016,9767,9361,406,4.2
19173,2016,3230,3135,95,2.9
19175,2016,6514,6268,246,3.8
19177,2016,3859,3719,140,3.6
19179,2016,17889,16859,1030,5.8
19181,2016,27108,26247,861,3.2
19183,2016,12355,11995,360,2.9
19185,2016,2841,2734,107,3.8
19187,2016,20430,19620,810,4
19189,2016,5198,5019,179,3.4
19191,2016,12061,11639,422,3.5
19193,2016,55748,53775,1973,3.5
19195,2016,4269,4124,145,3.4
19197,2016,6690,6417,273,4.1
20001,2016,6439,6080,359,5.6
20003,2016,4174,3996,178,4.3
20005,2016,7046,6608,438,6.2
20007,2016,2527,2434,93,3.7
20009,2016,14024,13396,628,4.5
20011,2016,7127,6782,345,4.8
20013,2016,5165,4978,187,3.6
20015,2016,32197,30854,1343,4.2
20017,2016,1407,1358,49,3.5
20019,2016,1541,1461,80,5.2
20021,2016,10290,9834,456,4.4
20023,2016,1345,1307,38,2.8
20025,2016,1116,1085,31,2.8
20027,2016,4035,3871,164,4.1
20029,2016,4256,4081,175,4.1
20031,2016,4283,4018,265,6.2
20033,2016,971,941,30,3.1
20035,2016,16909,16162,747,4.4
20037,2016,18918,18006,912,4.8
20039,2016,1293,1242,51,3.9
20041,2016,9167,8762,405,4.4
20043,2016,4274,4109,165,3.9
20045,2016,65276,62968,2308,3.5
20047,2016,1654,1604,50,3
20049,2016,1189,1130,59,5
20051,2016,17014,16489,525,3.1
20053,2016,2834,2725,109,3.8
20055,2016,20152,19531,621,3.1
20057,2016,17885,17320,565,3.2
20059,2016,14227,13631,596,4.2
20061,2016,12058,11379,679,5.6
20063,2016,1451,1416,35,2.4
20065,2016,1225,1171,54,4.4
20067,2016,3773,3639,134,3.6
20069,2016,3410,3333,77,2.3
20071,2016,912,893,19,2.1
20073,2016,3323,3161,162,4.9
20075,2016,1643,1599,44,2.7
20077,2016,2881,2778,103,3.6
20079,2016,17206,16479,727,4.2
20081,2016,2305,2245,60,2.6
20083,2016,1030,1003,27,2.6
20085,2016,7259,7009,250,3.4
20087,2016,10217,9820,397,3.9
20089,2016,1331,1274,57,4.3
20091,2016,328359,317670,10689,3.3
20093,2016,2058,1993,65,3.2
20095,2016,3528,3373,155,4.4
20097,2016,1420,1381,39,2.7
20099,2016,10734,10156,578,5.4
20101,2016,810,785,25,3.1
20103,2016,35787,34247,1540,4.3
20105,2016,1737,1678,59,3.4
20107,2016,4343,4064,279,6.4
20109,2016,1723,1679,44,2.6
20111,2016,16819,16132,687,4.1
20113,2016,16340,15825,515,3.2
20115,2016,6121,5880,241,3.9
20117,2016,5563,5395,168,3
20119,2016,2377,2313,64,2.7
20121,2016,17022,16315,707,4.2
20123,2016,3696,3574,122,3.3
20125,2016,15999,15020,979,6.1
20127,2016,3051,2934,117,3.8
20129,2016,1344,1292,52,3.9
20131,2016,5897,5739,158,2.7
20133,2016,6057,5623,434,7.2
20135,2016,1423,1374,49,3.4
20137,2016,2872,2802,70,2.4
20139,2016,8058,7703,355,4.4
20141,2016,2059,1989,70,3.4
20143,2016,3163,3043,120,3.8
20145,2016,3210,3104,106,3.3
20147,2016,2857,2767,90,3.2
20149,2016,12152,11728,424,3.5
20151,2016,5104,4897,207,4.1
20153,2016,1545,1508,37,2.4
20155,2016,30136,28813,1323,4.4
20157,2016,2544,2474,70,2.8
20159,2016,5305,5094,211,4
20161,2016,34889,33707,1182,3.4
20163,2016,2668,2543,125,4.7
20165,2016,1732,1663,69,4
20167,2016,3574,3424,150,4.2
20169,2016,30113,28991,1122,3.7
20171,2016,2887,2816,71,2.5
20173,2016,247301,235810,11491,4.6
20175,2016,10232,9787,445,4.3
20177,2016,91684,88015,3669,4
20179,2016,1449,1414,35,2.4
20181,2016,2942,2845,97,3.3
20183,2016,2034,1969,65,3.2
20185,2016,2095,2018,77,3.7
20187,2016,1071,1041,30,2.8
20189,2016,2908,2793,115,4
20191,2016,10933,10470,463,4.2
20193,2016,4352,4233,119,2.7
20195,2016,1476,1417,59,4
20197,2016,3706,3574,132,3.6
20199,2016,860,837,23,2.7
20201,2016,3084,2983,101,3.3
20203,2016,1206,1178,28,2.3
20205,2016,4116,3869,247,6
20207,2016,1617,1524,93,5.8
20209,2016,76434,72196,4238,5.5
21001,2016,7081,6610,471,6.7
21003,2016,8845,8461,384,4.3
21005,2016,11449,10985,464,4.1
21007,2016,3641,3314,327,9
21009,2016,18845,17952,893,4.7
21011,2016,4756,4403,353,7.4
21013,2016,8655,7855,800,9.2
21015,2016,67213,64634,2579,3.8
21017,2016,9872,9399,473,4.8
21019,2016,18539,17026,1513,8.2
21021,2016,12304,11690,614,5
21023,2016,3829,3597,232,6.1
21025,2016,3745,3374,371,9.9
21027,2016,7730,7242,488,6.3
21029,2016,40495,38800,1695,4.2
21031,2016,5158,4875,283,5.5
21033,2016,5351,5058,293,5.5
21035,2016,18678,17827,851,4.6
21037,2016,48680,46805,1875,3.9
21039,2016,2562,2396,166,6.5
21041,2016,5179,4921,258,5
21043,2016,9939,8883,1056,10.6
21045,2016,6684,6359,325,4.9
21047,2016,24878,23338,1540,6.2
21049,2016,17009,16185,824,4.8
21051,2016,5451,4895,556,10.2
21053,2016,3748,3464,284,7.6
21055,2016,4019,3807,212,5.3
21057,2016,2888,2722,166,5.7
21059,2016,46651,44552,2099,4.5
21061,2016,4802,4502,300,6.2
21063,2016,2098,1855,243,11.6
21065,2016,5238,4927,311,5.9
21067,2016,171309,165151,6158,3.6
21069,2016,5941,5569,372,6.3
21071,2016,11453,10150,1303,11.4
21073,2016,24424,23422,1002,4.1
21075,2016,2066,1922,144,7
21077,2016,3900,3710,190,4.9
21079,2016,7520,7152,368,4.9
21081,2016,11341,10785,556,4.9
21083,2016,15299,14340,959,6.3
21085,2016,10722,9997,725,6.8
21087,2016,4996,4770,226,4.5
21089,2016,13884,12674,1210,8.7
21091,2016,4037,3819,218,5.4
21093,2016,47758,45602,2156,4.5
21095,2016,6744,5851,893,13.2
21097,2016,8487,8084,403,4.7
21099,2016,7896,7520,376,4.8
21101,2016,21589,20556,1033,4.8
21103,2016,7920,7592,328,4.1
21105,2016,1920,1804,116,6
21107,2016,19624,18495,1129,5.8
21109,2016,4166,3834,332,8
21111,2016,386432,369244,17188,4.4
21113,2016,25643,24630,1013,4
21115,2016,7012,6285,727,10.4
21117,2016,84655,81154,3501,4.1
21119,2016,4559,4028,531,11.6
21121,2016,9894,9098,796,8
21123,2016,5895,5621,274,4.6
21125,2016,23901,22408,1493,6.2
21127,2016,5042,4488,554,11
21129,2016,1898,1711,187,9.9
21131,2016,2791,2412,379,13.6
21133,2016,6425,5623,802,12.5
21135,2016,4743,4273,470,9.9
21137,2016,9143,8583,560,6.1
21139,2016,3685,3418,267,7.2
21141,2016,11722,11204,518,4.4
21143,2016,2960,2784,176,5.9
21145,2016,28986,27303,1683,5.8
21147,2016,4601,4227,374,8.1
21149,2016,4329,4119,210,4.9
21151,2016,45073,43173,1900,4.2
21153,2016,3147,2520,627,19.9
21155,2016,9393,8993,400,4.3
21157,2016,14903,14032,871,5.8
21159,2016,3084,2764,320,10.4
21161,2016,7134,6675,459,6.4
21163,2016,12082,11455,627,5.2
21165,2016,2393,2184,209,8.7
21167,2016,9881,9400,481,4.9
21169,2016,4117,3927,190,4.6
21171,2016,4599,4403,196,4.3
21173,2016,11848,11080,768,6.5
21175,2016,4484,4122,362,8.1
21177,2016,11357,10520,837,7.4
21179,2016,21688,20693,995,4.6
21181,2016,3217,3031,186,5.8
21183,2016,9519,8877,642,6.7
21185,2016,31895,30804,1091,3.4
21187,2016,5484,5247,237,4.3
21189,2016,1120,1010,110,9.8
21191,2016,6845,6514,331,4.8
21193,2016,8553,7620,933,10.9
21195,2016,20235,18019,2216,11
21197,2016,4956,4598,358,7.2
21199,2016,25368,23976,1392,5.5
21201,2016,804,754,50,6.2
21203,2016,6679,6268,411,6.2
21205,2016,10567,9936,631,6
21207,2016,6136,5616,520,8.5
21209,2016,27963,26893,1070,3.8
21211,2016,23784,22929,855,3.6
21213,2016,8384,8006,378,4.5
21215,2016,9646,9276,370,3.8
21217,2016,12213,11601,612,5
21219,2016,5299,5061,238,4.5
21221,2016,5816,5487,329,5.7
21223,2016,3866,3656,210,5.4
21225,2016,6160,5738,422,6.9
21227,2016,61929,59489,2440,3.9
21229,2016,6076,5814,262,4.3
21231,2016,7258,6696,562,7.7
21233,2016,5829,5476,353,6.1
21235,2016,13344,12457,887,6.6
21237,2016,1918,1722,196,10.2
21239,2016,14745,14268,477,3.2
22001,2016,24508,22701,1807,7.4
22003,2016,8898,8328,570,6.4
22005,2016,61985,58960,3025,4.9
22007,2016,9206,8435,771,8.4
22009,2016,15683,14577,1106,7.1
22011,2016,15063,14154,909,6
22013,2016,5664,5234,430,7.6
22015,2016,57582,54526,3056,5.3
22017,2016,107033,99969,7064,6.6
22019,2016,102880,97972,4908,4.8
22021,2016,3983,3679,304,7.6
22023,2016,3818,3651,167,4.4
22025,2016,3423,3105,318,9.3
22027,2016,5950,5554,396,6.7
22029,2016,7250,6652,598,8.2
22031,2016,10889,10090,799,7.3
22033,2016,232123,220186,11937,5.1
22035,2016,2139,1892,247,11.5
22037,2016,8103,7637,466,5.8
22039,2016,12671,11734,937,7.4
22041,2016,7278,6620,658,9
22043,2016,8325,7744,581,7
22045,2016,30109,27287,2822,9.4
22047,2016,14108,13144,964,6.8
22049,2016,7083,6689,394,5.6
22051,2016,216487,205085,11402,5.3
22053,2016,13575,12760,815,6
22055,2016,114348,107348,7000,6.1
22057,2016,43292,40577,2715,6.3
22059,2016,6270,5856,414,6.6
22061,2016,21464,20133,1331,6.2
22063,2016,68676,65206,3470,5.1
22065,2016,3834,3491,343,8.9
22067,2016,10620,9593,1027,9.7
22069,2016,16711,15590,1121,6.7
22071,2016,179964,169433,10531,5.9
22073,2016,71554,67212,4342,6.1
22075,2016,10184,9641,543,5.3
22077,2016,9959,9315,644,6.5
22079,2016,57274,53751,3523,6.2
22081,2016,3809,3580,229,6
22083,2016,8445,7819,626,7.4
22085,2016,9138,8507,631,6.9
22087,2016,19546,18360,1186,6.1
22089,2016,25323,23980,1343,5.3
22091,2016,4390,4055,335,7.6
22093,2016,9606,8889,717,7.5
22095,2016,20055,18687,1368,6.8
22097,2016,32807,30164,2643,8.1
22099,2016,22962,21186,1776,7.7
22101,2016,21937,19883,2054,9.4
22103,2016,117490,111662,5828,5
22105,2016,54160,50516,3644,6.7
22107,2016,1626,1467,159,9.8
22109,2016,48950,45547,3403,7
22111,2016,9242,8638,604,6.5
22113,2016,24701,22825,1876,7.6
22115,2016,16928,15705,1223,7.2
22117,2016,16944,15757,1187,7
22119,2016,15198,13905,1293,8.5
22121,2016,13241,12537,704,5.3
22123,2016,4103,3614,489,11.9
22125,2016,5328,5053,275,5.2
22127,2016,5184,4783,401,7.7
23001,2016,55265,53284,1981,3.6
23003,2016,31428,29723,1705,5.4
23005,2016,161752,157049,4703,2.9
23007,2016,14427,13783,644,4.5
23009,2016,29139,27826,1313,4.5
23011,2016,62216,59952,2264,3.6
23013,2016,20683,19956,727,3.5
23015,2016,16992,16364,628,3.7
23017,2016,26532,25306,1226,4.6
23019,2016,76882,73553,3329,4.3
23021,2016,7466,7095,371,5
23023,2016,19165,18598,567,3
23025,2016,23453,22136,1317,5.6
23027,2016,20836,19962,874,4.2
23029,2016,13989,13214,775,5.5
23031,2016,111002,107258,3744,3.4
24001,2016,32431,30399,2032,6.3
24003,2016,303551,291922,11629,3.8
24005,2016,445314,424500,20814,4.7
24009,2016,48799,46903,1896,3.9
24011,2016,17669,16821,848,4.8
24013,2016,93109,89703,3406,3.7
24015,2016,52648,49884,2764,5.2
24017,2016,83915,80334,3581,4.3
24019,2016,15896,14903,993,6.2
24021,2016,128673,123623,5050,3.9
24023,2016,15511,14627,884,5.7
24025,2016,136366,130580,5786,4.2
24027,2016,179270,173325,5945,3.3
24029,2016,10246,9745,501,4.9
24031,2016,545139,526217,18922,3.5
24033,2016,500516,478131,22385,4.5
24035,2016,26594,25549,1045,3.9
24037,2016,54797,52456,2341,4.3
24039,2016,9242,8568,674,7.3
24041,2016,19541,18717,824,4.2
24043,2016,75424,71535,3889,5.2
24045,2016,50465,47306,3159,6.3
24047,2016,25244,22888,2356,9.3
24510,2016,289714,270515,19199,6.6
25001,2016,111689,106206,5483,4.9
25003,2016,64454,61553,2901,4.5
25005,2016,290092,275783,14309,4.9
25007,2016,9357,8873,484,5.2
25009,2016,410886,394525,16361,4
25011,2016,39568,38181,1387,3.5
25013,2016,222185,210509,11676,5.3
25015,2016,88113,84914,3199,3.6
25017,2016,874454,846752,27702,3.2
25019,2016,7053,6740,313,4.4
25021,2016,372849,360254,12595,3.4
25023,2016,271026,259990,11036,4.1
25025,2016,427583,412442,15141,3.5
25027,2016,430379,412716,17663,4.1
26001,2016,3829,3537,292,7.6
26003,2016,3264,2996,268,8.2
26005,2016,61308,58928,2380,3.9
26007,2016,13653,12845,808,5.9
26009,2016,10071,9362,709,7
26011,2016,6122,5617,505,8.2
26013,2016,3221,2957,264,8.2
26015,2016,30760,29532,1228,4
26017,2016,51898,49081,2817,5.4
26019,2016,8840,8261,579,6.5
26021,2016,73829,70173,3656,5
26023,2016,19110,18192,918,4.8
26025,2016,64433,61344,3089,4.8
26027,2016,24350,23213,1137,4.7
26029,2016,13057,12340,717,5.5
26031,2016,10817,9803,1014,9.4
26033,2016,16393,15139,1254,7.6
26035,2016,11958,11086,872,7.3
26037,2016,40517,39025,1492,3.7
26039,2016,5368,4963,405,7.5
26041,2016,17124,16005,1119,6.5
26043,2016,12508,11861,647,5.2
26045,2016,56913,54574,2339,4.1
26047,2016,17600,16459,1141,6.5
26049,2016,182592,172324,10268,5.6
26051,2016,9889,9200,689,7
26053,2016,6337,5950,387,6.1
26055,2016,49398,47286,2112,4.3
26057,2016,18175,17236,939,5.2
26059,2016,21183,20114,1069,5
26061,2016,16570,15558,1012,6.1
26063,2016,16002,15177,825,5.2
26065,2016,148976,142603,6373,4.3
26067,2016,29666,28418,1248,4.2
26069,2016,10112,9378,734,7.3
26071,2016,5217,4882,335,6.4
26073,2016,35364,33709,1655,4.7
26075,2016,74432,70838,3594,4.8
26077,2016,132066,126724,5342,4
26079,2016,7722,7169,553,7.2
26081,2016,350491,338188,12303,3.5
26083,2016,942,861,81,8.6
26085,2016,3754,3473,281,7.5
26087,2016,40747,38113,2634,6.5
26089,2016,10577,10065,512,4.8
26091,2016,47366,45198,2168,4.6
26093,2016,100082,95969,4113,4.1
26095,2016,2403,2241,162,6.7
26097,2016,5191,4680,511,9.8
26099,2016,436145,413316,22829,5.2
26101,2016,10536,9848,688,6.5
26103,2016,33331,31434,1897,5.7
26105,2016,14280,13451,829,5.8
26107,2016,19110,18039,1071,5.6
26109,2016,11253,10674,579,5.1
26111,2016,41039,39110,1929,4.7
26113,2016,7027,6610,417,5.9
26115,2016,76438,73147,3291,4.3
26117,2016,27926,26454,1472,5.3
26119,2016,3060,2750,310,10.1
26121,2016,77463,73253,4210,5.4
26123,2016,23332,22199,1133,4.9
26125,2016,653406,626153,27253,4.2
26127,2016,12326,11425,901,7.3
26129,2016,8238,7598,640,7.8
26131,2016,2203,2015,188,8.5
26133,2016,10436,9842,594,5.7
26135,2016,2907,2695,212,7.3
26137,2016,11690,10997,693,5.9
26139,2016,155450,150226,5224,3.4
26141,2016,5288,4784,504,9.5
26143,2016,7871,7206,665,8.4
26145,2016,88627,83913,4714,5.3
26147,2016,74741,70164,4577,6.1
26149,2016,29134,27935,1199,4.1
26151,2016,19418,18214,1204,6.2
26153,2016,3389,3081,308,9.1
26155,2016,33499,31740,1759,5.3
26157,2016,24228,22712,1516,6.3
26159,2016,35477,33443,2034,5.7
26161,2016,191582,184589,6993,3.7
26163,2016,780340,731188,49152,6.3
26165,2016,14703,13843,860,5.8
27001,2016,7047,6553,494,7
27003,2016,192442,185277,7165,3.7
27005,2016,18610,17760,850,4.6
27007,2016,23742,22504,1238,5.2
27009,2016,21838,20875,963,4.4
27011,2016,2711,2581,130,4.8
27013,2016,39730,38456,1274,3.2
27015,2016,14561,13951,610,4.2
27017,2016,17790,16849,941,5.3
27019,2016,56485,54623,1862,3.3
27021,2016,14195,13229,966,6.8
27023,2016,6985,6671,314,4.5
27025,2016,29227,27965,1262,4.3
27027,2016,35713,34487,1226,3.4
27029,2016,4728,4275,453,9.6
27031,2016,3102,2962,140,4.5
27033,2016,5548,5151,397,7.2
27035,2016,31924,30302,1622,5.1
27037,2016,235749,227759,7990,3.4
27039,2016,11589,11159,430,3.7
27041,2016,20287,19581,706,3.5
27043,2016,7341,7019,322,4.4
27045,2016,11530,11066,464,4
27047,2016,16331,15708,623,3.8
27049,2016,26922,25922,1000,3.7
27051,2016,3296,3142,154,4.7
27053,2016,687472,664578,22894,3.3
27055,2016,10629,10214,415,3.9
27057,2016,9821,9185,636,6.5
27059,2016,20731,19765,966,4.7
27061,2016,22086,20201,1885,8.5
27063,2016,6115,5839,276,4.5
27065,2016,9016,8431,585,6.5
27067,2016,24256,23336,920,3.8
27069,2016,2411,2301,110,4.6
27071,2016,6180,5656,524,8.5
27073,2016,3629,3474,155,4.3
27075,2016,5432,5087,345,6.4
27077,2016,2389,2274,115,4.8
27079,2016,15602,14841,761,4.9
27081,2016,3393,3269,124,3.7
27083,2016,15229,14688,541,3.6
27085,2016,19831,18957,874,4.4
27087,2016,2395,2257,138,5.8
27089,2016,5632,5221,411,7.3
27091,2016,10491,10060,431,4.1
27093,2016,13298,12702,596,4.5
27095,2016,12758,11999,759,5.9
27097,2016,17914,16911,1003,5.6
27099,2016,20576,19926,650,3.2
27101,2016,4970,4735,235,4.7
27103,2016,20413,19835,578,2.8
27105,2016,11488,11055,433,3.8
27107,2016,3452,3287,165,4.8
27109,2016,85455,82912,2543,3
27111,2016,31381,30017,1364,4.3
27113,2016,9068,8547,521,5.7
27115,2016,14878,14011,867,5.8
27117,2016,4915,4728,187,3.8
27119,2016,17194,16448,746,4.3
27121,2016,6320,6096,224,3.5
27123,2016,283182,272995,10187,3.6
27125,2016,2296,2128,168,7.3
27127,2016,8343,8001,342,4.1
27129,2016,8439,7996,443,5.2
27131,2016,36206,34938,1268,3.5
27133,2016,5927,5790,137,2.3
27135,2016,8272,7849,423,5.1
27137,2016,102893,97020,5873,5.7
27139,2016,80937,78337,2600,3.2
27141,2016,50837,48770,2067,4.1
27143,2016,8517,8153,364,4.3
27145,2016,89193,85836,3357,3.8
27147,2016,21250,20493,757,3.6
27149,2016,5667,5497,170,3
27151,2016,5060,4789,271,5.4
27153,2016,12943,12334,609,4.7
27155,2016,1712,1645,67,3.9
27157,2016,12048,11604,444,3.7
27159,2016,6266,5895,371,5.9
27161,2016,9494,9087,407,4.3
27163,2016,139211,134566,4645,3.3
27165,2016,6596,6275,321,4.9
27167,2016,3730,3609,121,3.2
27169,2016,29347,28309,1038,3.5
27171,2016,73309,70485,2824,3.9
27173,2016,5493,5283,210,3.8
28001,2016,11266,10338,928,8.2
28003,2016,15843,15022,821,5.2
28005,2016,4514,4184,330,7.3
28007,2016,7024,6555,469,6.7
28009,2016,3053,2848,205,6.7
28011,2016,13420,12452,968,7.2
28013,2016,6194,5863,331,5.3
28015,2016,3569,3310,259,7.3
28017,2016,7103,6637,466,6.6
28019,2016,3732,3522,210,5.6
28021,2016,3096,2745,351,11.3
28023,2016,6085,5674,411,6.8
28025,2016,8030,7380,650,8.1
28027,2016,9230,8430,800,8.7
28029,2016,11295,10560,735,6.5
28031,2016,8167,7724,443,5.4
28033,2016,87410,83736,3674,4.2
28035,2016,33432,31522,1910,5.7
28037,2016,2857,2653,204,7.1
28039,2016,8825,8174,651,7.4
28041,2016,4292,3980,312,7.3
28043,2016,9622,9131,491,5.1
28045,2016,18899,17752,1147,6.1
28047,2016,86859,82078,4781,5.5
28049,2016,110150,104176,5974,5.4
28051,2016,5985,5329,656,11
28053,2016,2377,2107,270,11.4
28055,2016,401,345,56,14
28057,2016,10417,9891,526,5
28059,2016,59189,55308,3881,6.6
28061,2016,6201,5727,474,7.6
28063,2016,2229,1898,331,14.8
28065,2016,4187,3843,344,8.2
28067,2016,25830,24255,1575,6.1
28069,2016,3558,3249,309,8.7
28071,2016,26028,24763,1265,4.9
28073,2016,29650,28308,1342,4.5
28075,2016,31827,29963,1864,5.9
28077,2016,4682,4350,332,7.1
28079,2016,7765,7296,469,6
28081,2016,40869,38887,1982,4.8
28083,2016,10350,9413,937,9.1
28085,2016,14444,13625,819,5.7
28087,2016,25555,23992,1563,6.1
28089,2016,53442,51148,2294,4.3
28091,2016,10279,9608,671,6.5
28093,2016,14577,13701,876,6
28095,2016,15659,14676,983,6.3
28097,2016,4243,3973,270,6.4
28099,2016,10716,10102,614,5.7
28101,2016,8653,8145,508,5.9
28103,2016,3970,3643,327,8.2
28105,2016,23087,21838,1249,5.4
28107,2016,13202,12234,968,7.3
28109,2016,23252,21868,1384,6
28111,2016,4363,4053,310,7.1
28113,2016,14692,13698,994,6.8
28115,2016,14456,13775,681,4.7
28117,2016,11079,10475,604,5.5
28119,2016,2621,2366,255,9.7
28121,2016,75055,72093,2962,3.9
28123,2016,13281,12673,608,4.6
28125,2016,1716,1566,150,8.7
28127,2016,10946,10354,592,5.4
28129,2016,6747,6393,354,5.2
28131,2016,6502,6066,436,6.7
28133,2016,8351,7577,774,9.3
28135,2016,5743,5355,388,6.8
28137,2016,12099,11393,706,5.8
28139,2016,9410,8889,521,5.5
28141,2016,8267,7815,452,5.5
28143,2016,4616,4288,328,7.1
28145,2016,13679,13076,603,4.4
28147,2016,5042,4655,387,7.7
28149,2016,20836,19522,1314,6.3
28151,2016,17783,16188,1595,9
28153,2016,7545,6995,550,7.3
28155,2016,3910,3667,243,6.2
28157,2016,2839,2551,288,10.1
28159,2016,7115,6612,503,7.1
28161,2016,4894,4588,306,6.3
28163,2016,9259,8578,681,7.4
29001,2016,10387,9796,591,5.7
29003,2016,10046,9671,375,3.7
29005,2016,2845,2715,130,4.6
29007,2016,11151,10674,477,4.3
29009,2016,15214,14529,685,4.5
29011,2016,5327,5048,279,5.2
29013,2016,8168,7730,438,5.4
29015,2016,7267,6826,441,6.1
29017,2016,5468,5181,287,5.2
29019,2016,98295,95049,3246,3.3
29021,2016,46761,44845,1916,4.1
29023,2016,18823,17743,1080,5.7
29025,2016,4480,4269,211,4.7
29027,2016,21855,20956,899,4.1
29029,2016,18747,17659,1088,5.8
29031,2016,40818,39043,1775,4.3
29033,2016,4775,4518,257,5.4
29035,2016,2546,2365,181,7.1
29037,2016,54589,52318,2271,4.2
29039,2016,5804,5514,290,5
29041,2016,3861,3693,168,4.4
29043,2016,43419,41711,1708,3.9
29045,2016,3376,3127,249,7.4
29047,2016,134195,128947,5248,3.9
29049,2016,11027,10560,467,4.2
29051,2016,39481,38071,1410,3.6
29053,2016,7492,7123,369,4.9
29055,2016,10844,10263,581,5.4
29057,2016,3591,3431,160,4.5
29059,2016,6966,6583,383,5.5
29061,2016,4122,3962,160,3.9
29063,2016,5091,4868,223,4.4
29065,2016,6212,5876,336,5.4
29067,2016,5090,4779,311,6.1
29069,2016,12856,11795,1061,8.3
29071,2016,52747,50440,2307,4.4
29073,2016,7711,7378,333,4.3
29075,2016,3593,3459,134,3.7
29077,2016,148797,143137,5660,3.8
29079,2016,4910,4685,225,4.6
29081,2016,3978,3810,168,4.2
29083,2016,9906,9410,496,5
29085,2016,3701,3492,209,5.6
29087,2016,2689,2601,88,3.3
29089,2016,5038,4814,224,4.4
29091,2016,16140,15114,1026,6.4
29093,2016,3720,3453,267,7.2
29095,2016,364728,346001,18727,5.1
29097,2016,57819,55408,2411,4.2
29099,2016,117804,112724,5080,4.3
29101,2016,23218,22076,1142,4.9
29103,2016,1986,1914,72,3.6
29105,2016,16183,15299,884,5.5
29107,2016,17217,16472,745,4.3
29109,2016,17813,17032,781,4.4
29111,2016,5145,4912,233,4.5
29113,2016,27268,26041,1227,4.5
29115,2016,5280,4925,355,6.7
29117,2016,7360,7072,288,3.9
29119,2016,10490,10033,457,4.4
29121,2016,7625,7260,365,4.8
29123,2016,5486,5184,302,5.5
29125,2016,3916,3718,198,5.1
29127,2016,14594,13968,626,4.3
29129,2016,1932,1843,89,4.6
29131,2016,11900,11283,617,5.2
29133,2016,6224,5810,414,6.7
29135,2016,7483,7157,326,4.4
29137,2016,4168,3966,202,4.8
29139,2016,5757,5493,264,4.6
29141,2016,7978,7509,469,5.9
29143,2016,8255,7486,769,9.3
29145,2016,28261,27024,1237,4.4
29147,2016,10868,10359,509,4.7
29149,2016,4121,3873,248,6
29151,2016,7237,6990,247,3.4
29153,2016,3636,3371,265,7.3
29155,2016,7043,6416,627,8.9
29157,2016,10094,9733,361,3.6
29159,2016,20656,19634,1022,4.9
29161,2016,19536,18605,931,4.8
29163,2016,8077,7712,365,4.5
29165,2016,56790,54728,2062,3.6
29167,2016,14244,13548,696,4.9
29169,2016,14499,13710,789,5.4
29171,2016,2457,2345,112,4.6
29173,2016,5635,5408,227,4
29175,2016,10509,9956,553,5.3
29177,2016,11163,10612,551,4.9
29179,2016,2688,2513,175,6.5
29181,2016,5344,4966,378,7.1
29183,2016,221460,213663,7797,3.5
29185,2016,3923,3676,247,6.3
29186,2016,9003,8583,420,4.7
29187,2016,26280,24828,1452,5.5
29189,2016,532450,509958,22492,4.2
29195,2016,10755,10252,503,4.7
29197,2016,1910,1788,122,6.4
29199,2016,2459,2357,102,4.1
29201,2016,20003,18855,1148,5.7
29203,2016,3331,3086,245,7.4
29205,2016,3075,2946,129,4.2
29207,2016,13320,12465,855,6.4
29209,2016,13448,12506,942,7
29211,2016,2776,2615,161,5.8
29213,2016,26367,24415,1952,7.4
29215,2016,9337,8751,586,6.3
29217,2016,9621,9154,467,4.9
29219,2016,17524,16789,735,4.2
29221,2016,10357,9699,658,6.4
29223,2016,5668,5364,304,5.4
29225,2016,16926,16092,834,4.9
29227,2016,1213,1177,36,3
29229,2016,7616,7164,452,5.9
29510,2016,157634,149016,8618,5.5
30001,2016,5074,4906,168,3.3
30003,2016,5536,5135,401,7.2
30005,2016,2371,2263,108,4.6
30007,2016,2552,2427,125,4.9
30009,2016,5421,5208,213,3.9
30011,2016,697,678,19,2.7
30013,2016,37812,36313,1499,4
30015,2016,2515,2421,94,3.7
30017,2016,6242,6022,220,3.5
30019,2016,936,912,24,2.6
30021,2016,4605,4429,176,3.8
30023,2016,5301,5100,201,3.8
30025,2016,1813,1747,66,3.6
30027,2016,5768,5542,226,3.9
30029,2016,45973,43409,2564,5.6
30031,2016,62146,60399,1747,2.8
30033,2016,764,742,22,2.9
30035,2016,5820,5323,497,8.5
30037,2016,379,362,17,4.5
30039,2016,1632,1536,96,5.9
30041,2016,7802,7466,336,4.3
30043,2016,5673,5412,261,4.6
30045,2016,933,901,32,3.4
30047,2016,13085,12466,619,4.7
30049,2016,35206,34045,1161,3.3
30051,2016,989,958,31,3.1
30053,2016,7931,7218,713,9
30055,2016,1043,1023,20,1.9
30057,2016,4415,4249,166,3.8
30059,2016,916,879,37,4
30061,2016,1688,1560,128,7.6
30063,2016,61420,59118,2302,3.7
30065,2016,2294,2177,117,5.1
30067,2016,8412,8052,360,4.3
30069,2016,277,264,13,4.7
30071,2016,1936,1834,102,5.3
30073,2016,2865,2745,120,4.2
30075,2016,1068,1043,25,2.3
30077,2016,2869,2725,144,5
30079,2016,527,509,18,3.4
30081,2016,19580,18641,939,4.8
30083,2016,6215,5907,308,5
30085,2016,4688,4439,249,5.3
30087,2016,4109,3884,225,5.5
30089,2016,4756,4388,368,7.7
30091,2016,1961,1897,64,3.3
30093,2016,17197,16462,735,4.3
30095,2016,4812,4621,191,4
30097,2016,1797,1742,55,3.1
30099,2016,2830,2728,102,3.6
30101,2016,2227,2150,77,3.5
30103,2016,353,338,15,4.2
30105,2016,4406,4257,149,3.4
30107,2016,797,757,40,5
30109,2016,513,493,20,3.9
30111,2016,81210,78293,2917,3.6
31001,2016,16640,16120,520,3.1
31003,2016,3589,3496,93,2.6
31005,2016,227,214,13,5.7
31007,2016,416,402,14,3.4
31009,2016,265,253,12,4.5
31011,2016,3000,2922,78,2.6
31013,2016,5638,5436,202,3.6
31015,2016,1098,1065,33,3
31017,2016,1378,1328,50,3.6
31019,2016,27191,26512,679,2.5
31021,2016,3543,3413,130,3.7
31023,2016,4622,4474,148,3.2
31025,2016,13131,12691,440,3.4
31027,2016,4565,4449,116,2.5
31029,2016,2289,2242,47,2.1
31031,2016,3468,3390,78,2.2
31033,2016,5447,5294,153,2.8
31035,2016,3319,3216,103,3.1
31037,2016,5546,5389,157,2.8
31039,2016,4711,4576,135,2.9
31041,2016,6345,6197,148,2.3
31043,2016,10897,10446,451,4.1
31045,2016,5209,5056,153,2.9
31047,2016,12952,12570,382,2.9
31049,2016,1061,1033,28,2.6
31051,2016,3065,2964,101,3.3
31053,2016,19112,18527,585,3.1
31055,2016,287729,278212,9517,3.3
31057,2016,1195,1169,26,2.2
31059,2016,3180,3093,87,2.7
31061,2016,1500,1455,45,3
31063,2016,1568,1524,44,2.8
31065,2016,2712,2637,75,2.8
31067,2016,11040,10679,361,3.3
31069,2016,1186,1147,39,3.3
31071,2016,1155,1126,29,2.5
31073,2016,1055,1028,27,2.6
31075,2016,452,442,10,2.2
31077,2016,1233,1195,38,3.1
31079,2016,31377,30230,1147,3.7
31081,2016,4648,4519,129,2.8
31083,2016,1756,1712,44,2.5
31085,2016,589,575,14,2.4
31087,2016,1305,1258,47,3.6
31089,2016,5854,5710,144,2.5
31091,2016,391,377,14,3.6
31093,2016,3296,3188,108,3.3
31095,2016,4217,4116,101,2.4
31097,2016,2090,2024,66,3.2
31099,2016,3737,3649,88,2.4
31101,2016,4613,4480,133,2.9
31103,2016,619,606,13,2.1
31105,2016,1970,1890,80,4.1
31107,2016,4715,4571,144,3.1
31109,2016,168872,164201,4671,2.8
31111,2016,18692,18119,573,3.1
31113,2016,482,469,13,2.7
31115,2016,395,382,13,3.3
31117,2016,463,452,11,2.4
31119,2016,19140,18615,525,2.7
31121,2016,4030,3885,145,3.6
31123,2016,2646,2562,84,3.2
31125,2016,1997,1943,54,2.7
31127,2016,3612,3482,130,3.6
31129,2016,2364,2296,68,2.9
31131,2016,8252,7973,279,3.4
31133,2016,1652,1615,37,2.2
31135,2016,1818,1779,39,2.1
31137,2016,4924,4801,123,2.5
31139,2016,4142,4033,109,2.6
31141,2016,16957,16369,588,3.5
31143,2016,2879,2803,76,2.6
31145,2016,5970,5802,168,2.8
31147,2016,4233,4097,136,3.2
31149,2016,890,867,23,2.6
31151,2016,7343,7117,226,3.1
31153,2016,91966,89296,2670,2.9
31155,2016,10863,10531,332,3.1
31157,2016,18825,18169,656,3.5
31159,2016,8744,8495,249,2.8
31161,2016,2735,2657,78,2.9
31163,2016,1714,1660,54,3.2
31165,2016,783,762,21,2.7
31167,2016,3438,3348,90,2.6
31169,2016,2901,2830,71,2.4
31171,2016,447,433,14,3.1
31173,2016,2975,2833,142,4.8
31175,2016,2090,2032,58,2.8
31177,2016,11096,10742,354,3.2
31179,2016,5619,5470,149,2.7
31181,2016,1710,1657,53,3.1
31183,2016,565,553,12,2.1
31185,2016,7316,7119,197,2.7
32001,2016,10703,10125,578,5.4
32003,2016,1046103,984714,61389,5.9
32005,2016,22339,21084,1255,5.6
32007,2016,27037,25830,1207,4.5
32009,2016,524,500,24,4.6
32011,2016,991,945,46,4.6
32013,2016,8336,7894,442,5.3
32015,2016,3162,2966,196,6.2
32017,2016,2030,1924,106,5.2
32019,2016,21773,20171,1602,7.4
32021,2016,1983,1855,128,6.5
32023,2016,16164,14984,1180,7.3
32027,2016,2530,2384,146,5.8
32029,2016,1901,1781,120,6.3
32031,2016,229320,217784,11536,5
32033,2016,4565,4356,209,4.6
32510,2016,24684,23176,1508,6.1
33001,2016,31380,30489,891,2.8
33003,2016,23667,22968,699,3
33005,2016,41393,40259,1134,2.7
33007,2016,14639,14088,551,3.8
33009,2016,48738,47586,1152,2.4
33011,2016,231936,224926,7010,3
33013,2016,81909,79817,2092,2.6
33015,2016,181666,176168,5498,3
33017,2016,72400,70554,1846,2.5
33019,2016,23588,23039,549,2.3
34001,2016,122574,113483,9091,7.4
34003,2016,478787,458743,20044,4.2
34005,2016,230271,219995,10276,4.5
34007,2016,252713,238823,13890,5.5
34009,2016,46661,42076,4585,9.8
34011,2016,66335,61374,4961,7.5
34013,2016,367908,345779,22129,6
34015,2016,148968,141431,7537,5.1
34017,2016,359152,342335,16817,4.7
34019,2016,64215,61793,2422,3.8
34021,2016,196995,188408,8587,4.4
34023,2016,436159,416825,19334,4.4
34025,2016,326476,311922,14554,4.5
34027,2016,257919,247799,10120,3.9
34029,2016,267872,253889,13983,5.2
34031,2016,243533,228488,15045,6.2
34033,2016,30010,28092,1918,6.4
34035,2016,171907,164924,6983,4.1
34037,2016,74770,71240,3530,4.7
34039,2016,275097,260860,14237,5.2
34041,2016,56365,53782,2583,4.6
35001,2016,326580,307771,18809,5.8
35003,2016,1204,1107,97,8.1
35005,2016,28020,26156,1864,6.7
35006,2016,9296,8540,756,8.1
35007,2016,5825,5478,347,6
35009,2016,21959,20859,1100,5
35011,2016,832,793,39,4.7
35013,2016,95562,88772,6790,7.1
35015,2016,28675,26827,1848,6.4
35017,2016,12455,11659,796,6.4
35019,2016,1690,1582,108,6.4
35021,2016,277,258,19,6.9
35023,2016,2201,2080,121,5.5
35025,2016,27718,25184,2534,9.1
35027,2016,8636,8127,509,5.9
35028,2016,8792,8423,369,4.2
35029,2016,10768,9218,1550,14.4
35031,2016,24367,22106,2261,9.3
35033,2016,2236,2043,193,8.6
35035,2016,25462,23934,1528,6
35037,2016,3208,2992,216,6.7
35039,2016,16750,15509,1241,7.4
35041,2016,8064,7608,456,5.7
35043,2016,64067,59884,4183,6.5
35045,2016,54194,49479,4715,8.7
35047,2016,11083,10238,845,7.6
35049,2016,73464,69614,3850,5.2
35051,2016,4059,3719,340,8.4
35053,2016,6676,6190,486,7.3
35055,2016,14932,13685,1247,8.4
35057,2016,5504,5007,497,9
35059,2016,1893,1818,75,4
35061,2016,29900,27764,2136,7.1
36001,2016,158283,151867,6416,4.1
36003,2016,20033,18768,1265,6.3
36005,2016,608798,565436,43362,7.1
36007,2016,85773,81119,4654,5.4
36009,2016,34815,32737,2078,6
36011,2016,36657,34804,1853,5.1
36013,2016,56060,52807,3253,5.8
36015,2016,36168,34099,2069,5.7
36017,2016,22808,21653,1155,5.1
36019,2016,35761,33845,1916,5.4
36021,2016,31430,30272,1158,3.7
36023,2016,22960,21652,1308,5.7
36025,2016,19201,18142,1059,5.5
36027,2016,142889,136948,5941,4.2
36029,2016,444647,422760,21887,4.9
36031,2016,17220,16300,920,5.3
36033,2016,19770,18649,1121,5.7
36035,2016,23196,21870,1326,5.7
36037,2016,29697,28336,1361,4.6
36039,2016,20540,19503,1037,5
36041,2016,2361,2208,153,6.5
36043,2016,28138,26601,1537,5.5
36045,2016,45611,42764,2847,6.2
36047,2016,1217585,1152734,64851,5.3
36049,2016,11728,10941,787,6.7
36051,2016,31001,29471,1530,4.9
36053,2016,32663,30944,1719,5.3
36055,2016,362830,345801,17029,4.7
36057,2016,22282,21008,1274,5.7
36059,2016,699134,671823,27311,3.9
36061,2016,916777,875013,41764,4.6
36063,2016,100111,94277,5834,5.8
36065,2016,101533,96620,4913,4.8
36067,2016,220909,210943,9966,4.5
36069,2016,55001,52630,2371,4.3
36071,2016,178694,170975,7719,4.3
36073,2016,17728,16715,1013,5.7
36075,2016,53235,49800,3435,6.5
36077,2016,28170,26787,1383,4.9
36079,2016,50626,48612,2014,4
36081,2016,1161534,1108791,52743,4.5
36083,2016,81464,77981,3483,4.3
36085,2016,221377,209784,11593,5.2
36087,2016,152331,145961,6370,4.2
36089,2016,43305,40451,2854,6.6
36091,2016,117328,112854,4474,3.8
36093,2016,75692,72414,3278,4.3
36095,2016,14704,13907,797,5.4
36097,2016,8266,7769,497,6
36099,2016,15469,14733,736,4.8
36101,2016,43110,40600,2510,5.8
36103,2016,773132,739429,33703,4.4
36105,2016,33993,32369,1624,4.8
36107,2016,22987,21808,1179,5.1
36109,2016,50303,48211,2092,4.2
36111,2016,88055,84163,3892,4.4
36113,2016,31951,30270,1681,5.3
36115,2016,28312,26993,1319,4.7
36117,2016,43937,41749,2188,5
36119,2016,477240,456792,20448,4.3
36121,2016,18085,17121,964,5.3
36123,2016,11703,11186,517,4.4
37001,2016,78947,75206,3741,4.7
37003,2016,17835,17077,758,4.3
37005,2016,4426,4183,243,5.5
37007,2016,10660,10043,617,5.8
37009,2016,12509,11909,600,4.8
37011,2016,7576,7195,381,5
37013,2016,20308,19152,1156,5.7
37015,2016,8437,7879,558,6.6
37017,2016,14570,13563,1007,6.9
37019,2016,49708,46502,3206,6.4
37021,2016,134377,129183,5194,3.9
37023,2016,39859,37920,1939,4.9
37025,2016,101188,96565,4623,4.6
37027,2016,35900,34037,1863,5.2
37029,2016,4659,4419,240,5.2
37031,2016,31575,29946,1629,5.2
37033,2016,9691,9164,527,5.4
37035,2016,76892,73252,3640,4.7
37037,2016,34527,33063,1464,4.2
37039,2016,11146,10513,633,5.7
37041,2016,5602,5244,358,6.4
37043,2016,4052,3830,222,5.5
37045,2016,46817,44257,2560,5.5
37047,2016,22598,21148,1450,6.4
37049,2016,41761,39575,2186,5.2
37051,2016,127349,119201,8148,6.4
37053,2016,13154,12486,668,5.1
37055,2016,20005,18653,1352,6.8
37057,2016,79522,75688,3834,4.8
37059,2016,20172,19264,908,4.5
37061,2016,26507,25093,1414,5.3
37063,2016,162119,154819,7300,4.5
37065,2016,22423,20477,1946,8.7
37067,2016,182659,173770,8889,4.9
37069,2016,29348,27815,1533,5.2
37071,2016,105658,100022,5636,5.3
37073,2016,5191,4925,266,5.1
37075,2016,3102,2828,274,8.8
37077,2016,29284,28018,1266,4.3
37079,2016,9525,9021,504,5.3
37081,2016,258494,244964,13530,5.2
37083,2016,20685,19046,1639,7.9
37085,2016,51464,48484,2980,5.8
37087,2016,28487,27192,1295,4.5
37089,2016,52301,50070,2231,4.3
37091,2016,9316,8704,612,6.6
37093,2016,19917,18604,1313,6.6
37095,2016,2110,1910,200,9.5
37097,2016,84567,80503,4064,4.8
37099,2016,18832,17809,1023,5.4
37101,2016,91595,87307,4288,4.7
37103,2016,4515,4277,238,5.3
37105,2016,26232,24690,1542,5.9
37107,2016,27653,26031,1622,5.9
37109,2016,41097,39159,1938,4.7
37111,2016,21016,20007,1009,4.8
37113,2016,15219,14399,820,5.4
37115,2016,9702,9229,473,4.9
37117,2016,9815,9152,663,6.8
37119,2016,583509,555857,27652,4.7
37121,2016,6189,5810,379,6.1
37123,2016,11701,11097,604,5.2
37125,2016,39513,37531,1982,5
37127,2016,43930,41041,2889,6.6
37129,2016,116062,110582,5480,4.7
37131,2016,7815,7248,567,7.3
37133,2016,63722,60212,3510,5.5
37135,2016,74934,71762,3172,4.2
37137,2016,5409,5123,286,5.3
37139,2016,17398,16304,1094,6.3
37141,2016,26854,25432,1422,5.3
37143,2016,5101,4773,328,6.4
37145,2016,18036,17047,989,5.5
37147,2016,88214,83301,4913,5.6
37149,2016,8826,8416,410,4.6
37151,2016,66896,63601,3295,4.9
37153,2016,16791,15629,1162,6.9
37155,2016,50555,46543,4012,7.9
37157,2016,40856,38547,2309,5.7
37159,2016,64236,60662,3574,5.6
37161,2016,24812,23152,1660,6.7
37163,2016,29517,27906,1611,5.5
37165,2016,11637,10574,1063,9.1
37167,2016,29289,27930,1359,4.6
37169,2016,21875,20829,1046,4.8
37171,2016,33526,31923,1603,4.8
37173,2016,7118,6684,434,6.1
37175,2016,13960,13280,680,4.9
37177,2016,1530,1401,129,8.4
37179,2016,115777,110677,5100,4.4
37181,2016,18005,16717,1288,7.2
37183,2016,556722,532808,23914,4.3
37185,2016,7143,6621,522,7.3
37187,2016,4866,4505,361,7.4
37189,2016,27950,26694,1256,4.5
37191,2016,53558,50436,3122,5.8
37193,2016,30205,28758,1447,4.8
37195,2016,36489,33515,2974,8.2
37197,2016,17612,16840,772,4.4
37199,2016,7479,7093,386,5.2
38001,2016,1133,1104,29,2.6
38003,2016,5623,5444,179,3.2
38005,2016,2435,2337,98,4
38007,2016,438,425,13,3
38009,2016,3230,3080,150,4.6
38011,2016,1837,1797,40,2.2
38013,2016,1146,1094,52,4.5
38015,2016,50638,49334,1304,2.6
38017,2016,100237,98000,2237,2.2
38019,2016,2117,2061,56,2.6
38021,2016,2547,2498,49,1.9
38023,2016,1684,1640,44,2.6
38025,2016,3249,3147,102,3.1
38027,2016,1279,1224,55,4.3
38029,2016,1585,1516,69,4.4
38031,2016,1686,1636,50,3
38033,2016,971,945,26,2.7
38035,2016,38826,37912,914,2.4
38037,2016,1297,1258,39,3
38039,2016,1160,1127,33,2.8
38041,2016,1540,1494,46,3
38043,2016,1376,1324,52,3.8
38045,2016,2316,2261,55,2.4
38047,2016,959,926,33,3.4
38049,2016,3377,3212,165,4.9
38051,2016,1241,1203,38,3.1
38053,2016,7949,7650,299,3.8
38055,2016,5070,4894,176,3.5
38057,2016,4654,4450,204,4.4
38059,2016,16798,16252,546,3.3
38061,2016,7133,6921,212,3
38063,2016,1534,1482,52,3.4
38065,2016,898,849,49,5.5
38067,2016,3660,3477,183,5
38069,2016,1899,1824,75,3.9
38071,2016,6148,5973,175,2.8
38073,2016,2840,2776,64,2.3
38075,2016,1309,1258,51,3.9
38077,2016,8905,8662,243,2.7
38079,2016,4986,4448,538,10.8
38081,2016,2333,2288,45,1.9
38083,2016,737,695,42,5.7
38085,2016,1339,1280,59,4.4
38087,2016,436,425,11,2.5
38089,2016,18090,17384,706,3.9
38091,2016,1075,1052,23,2.1
38093,2016,11082,10809,273,2.5
38095,2016,1332,1303,29,2.2
38097,2016,4600,4472,128,2.8
38099,2016,5663,5449,214,3.8
38101,2016,33545,32166,1379,4.1
38103,2016,2192,2107,85,3.9
38105,2016,22636,21652,984,4.3
39001,2016,10942,10119,823,7.5
39003,2016,48262,45840,2422,5
39005,2016,26258,24927,1331,5.1
39007,2016,44220,41522,2698,6.1
39009,2016,28017,26223,1794,6.4
39011,2016,24622,23704,918,3.7
39013,2016,31008,28694,2314,7.5
39015,2016,19492,18363,1129,5.8
39017,2016,189443,180906,8537,4.5
39019,2016,13437,12517,920,6.8
39021,2016,19882,18987,895,4.5
39023,2016,63577,60244,3333,5.2
39025,2016,103911,99294,4617,4.4
39027,2016,17169,16169,1000,5.8
39029,2016,48381,45146,3235,6.7
39031,2016,14993,13930,1063,7.1
39033,2016,19167,18013,1154,6
39035,2016,613975,579779,34196,5.6
39037,2016,26376,25289,1087,4.1
39039,2016,18380,17473,907,4.9
39041,2016,104863,101072,3791,3.6
39043,2016,37419,35365,2054,5.5
39045,2016,75958,72676,3282,4.3
39047,2016,14487,13846,641,4.4
39049,2016,666877,639357,27520,4.1
39051,2016,22677,21622,1055,4.7
39053,2016,12126,11299,827,6.8
39055,2016,49190,46983,2207,4.5
39057,2016,81100,77572,3528,4.4
39059,2016,18888,17550,1338,7.1
39061,2016,404955,387023,17932,4.4
39063,2016,41465,39935,1530,3.7
39065,2016,14378,13659,719,5
39067,2016,6969,6436,533,7.6
39069,2016,13605,12878,727,5.3
39071,2016,16930,15856,1074,6.3
39073,2016,13011,12284,727,5.6
39075,2016,20993,20236,757,3.6
39077,2016,28114,26284,1830,6.5
39079,2016,12800,11794,1006,7.9
39081,2016,28904,26487,2417,8.4
39083,2016,31232,29786,1446,4.6
39085,2016,124922,118779,6143,4.9
39087,2016,24751,23139,1612,6.5
39089,2016,88252,84380,3872,4.4
39091,2016,23323,22345,978,4.2
39093,2016,152716,143518,9198,6
39095,2016,210421,199510,10911,5.2
39097,2016,20339,19537,802,3.9
39099,2016,105950,99182,6768,6.4
39101,2016,27740,26330,1410,5.1
39103,2016,96165,91913,4252,4.4
39105,2016,8953,8189,764,8.5
39107,2016,23427,22661,766,3.3
39109,2016,53014,50703,2311,4.4
39111,2016,5320,4728,592,11.1
39113,2016,250063,237713,12350,4.9
39115,2016,6752,6192,560,8.3
39117,2016,16767,15920,847,5.1
39119,2016,39735,37339,2396,6
39121,2016,4892,4465,427,8.7
39123,2016,21030,19672,1358,6.5
39125,2016,8876,8468,408,4.6
39127,2016,15889,14876,1013,6.4
39129,2016,26203,24938,1265,4.8
39131,2016,10807,9995,812,7.5
39133,2016,87129,82748,4381,5
39135,2016,21019,20017,1002,4.8
39137,2016,18902,18209,693,3.7
39139,2016,53413,50450,2963,5.5
39141,2016,33840,31972,1868,5.5
39143,2016,31026,29561,1465,4.7
39145,2016,29875,27562,2313,7.7
39147,2016,27151,25820,1331,4.9
39149,2016,24074,23074,1000,4.2
39151,2016,186472,176293,10179,5.5
39153,2016,272399,258493,13906,5.1
39155,2016,90427,84306,6121,6.8
39157,2016,45021,42431,2590,5.8
39159,2016,27796,26733,1063,3.8
39161,2016,14306,13727,579,4
39163,2016,5455,5070,385,7.1
39165,2016,114608,109844,4764,4.2
39167,2016,27778,25837,1941,7
39169,2016,61223,58782,2441,4
39171,2016,19026,18166,860,4.5
39173,2016,70655,67701,2954,4.2
39175,2016,12676,12205,471,3.7
40001,2016,8162,7686,476,5.8
40003,2016,2970,2871,99,3.3
40005,2016,5066,4733,333,6.6
40007,2016,2889,2799,90,3.1
40009,2016,11044,10249,795,7.2
40011,2016,4395,4233,162,3.7
40013,2016,19529,18686,843,4.3
40015,2016,11935,11302,633,5.3
40017,2016,69479,66705,2774,4
40019,2016,22742,21564,1178,5.2
40021,2016,19307,18243,1064,5.5
40023,2016,5761,5321,440,7.6
40025,2016,1417,1382,35,2.5
40027,2016,139280,133958,5322,3.8
40029,2016,2323,2153,170,7.3
40031,2016,49496,47212,2284,4.6
40033,2016,2893,2754,139,4.8
40035,2016,6259,5956,303,4.8
40037,2016,31532,29698,1834,5.8
40039,2016,15212,14519,693,4.6
40041,2016,17987,17106,881,4.9
40043,2016,2678,2569,109,4.1
40045,2016,2257,2171,86,3.8
40047,2016,29026,27757,1269,4.4
40049,2016,12727,12046,681,5.4
40051,2016,26117,24819,1298,5
40053,2016,3008,2911,97,3.2
40055,2016,2192,2030,162,7.4
40057,2016,1293,1244,49,3.8
40059,2016,1912,1839,73,3.8
40061,2016,4508,4135,373,8.3
40063,2016,5520,5119,401,7.3
40065,2016,11013,10529,484,4.4
40067,2016,2713,2519,194,7.2
40069,2016,4378,4121,257,5.9
40071,2016,18965,17767,1198,6.3
40073,2016,8457,8177,280,3.3
40075,2016,4113,3894,219,5.3
40077,2016,3729,3407,322,8.6
40079,2016,19778,18412,1366,6.9
40081,2016,15896,15050,846,5.3
40083,2016,21598,20723,875,4.1
40085,2016,6578,6371,207,3.1
40087,2016,18979,18198,781,4.1
40089,2016,14825,13764,1061,7.2
40091,2016,7069,6438,631,8.9
40093,2016,3998,3833,165,4.1
40095,2016,6622,6287,335,5.1
40097,2016,19465,18470,995,5.1
40099,2016,6350,6064,286,4.5
40101,2016,29661,28043,1618,5.5
40103,2016,5766,5562,204,3.5
40105,2016,4692,4406,286,6.1
40107,2016,4558,4280,278,6.1
40109,2016,375493,359384,16109,4.3
40111,2016,16172,15010,1162,7.2
40113,2016,21092,19877,1215,5.8
40115,2016,14482,13754,728,5
40117,2016,7500,7002,498,6.6
40119,2016,38949,37501,1448,3.7
40121,2016,17651,16566,1085,6.1
40123,2016,18476,17723,753,4.1
40125,2016,33092,31563,1529,4.6
40127,2016,4881,4525,356,7.3
40129,2016,1813,1720,93,5.1
40131,2016,44930,42674,2256,5
40133,2016,9452,8798,654,6.9
40135,2016,16861,15805,1056,6.3
40137,2016,19048,17238,1810,9.5
40139,2016,9411,9092,319,3.4
40141,2016,3315,3168,147,4.4
40143,2016,318576,303691,14885,4.7
40145,2016,36658,34904,1754,4.8
40147,2016,23960,22786,1174,4.9
40149,2016,5327,4958,369,6.9
40151,2016,5224,5056,168,3.2
40153,2016,9528,8936,592,6.2
41001,2016,6955,6517,438,6.3
41003,2016,46803,44974,1829,3.9
41005,2016,212716,203489,9227,4.3
41007,2016,19026,18131,895,4.7
41009,2016,23624,22185,1439,6.1
41011,2016,26446,24760,1686,6.4
41013,2016,9346,8699,647,6.9
41015,2016,9047,8437,610,6.7
41017,2016,89902,85535,4367,4.9
41019,2016,45714,42852,2862,6.3
41021,2016,838,789,49,5.8
41023,2016,3109,2872,237,7.6
41025,2016,3425,3211,214,6.2
41027,2016,13912,13338,574,4.1
41029,2016,101428,95610,5818,5.7
41031,2016,9864,9213,651,6.6
41033,2016,34296,32080,2216,6.5
41035,2016,29235,27258,1977,6.8
41037,2016,3454,3234,220,6.4
41039,2016,178520,169463,9057,5.1
41041,2016,20904,19733,1171,5.6
41043,2016,56842,53606,3236,5.7
41045,2016,12482,11794,688,5.5
41047,2016,157440,149485,7955,5.1
41049,2016,5768,5489,279,4.8
41051,2016,444006,425266,18740,4.2
41053,2016,38336,36406,1930,5
41055,2016,895,854,41,4.6
41057,2016,11643,11072,571,4.9
41059,2016,36023,34104,1919,5.3
41061,2016,11979,11273,706,5.9
41063,2016,3316,3093,223,6.7
41065,2016,13694,13038,656,4.8
41067,2016,313480,300651,12829,4.1
41069,2016,686,657,29,4.2
41071,2016,53203,50764,2439,4.6
42001,2016,55392,53195,2197,4
42003,2016,647442,613923,33519,5.2
42005,2016,33087,30609,2478,7.5
42007,2016,85311,80035,5276,6.2
42009,2016,24049,22643,1406,5.8
42011,2016,213186,202596,10590,5
42013,2016,60843,57635,3208,5.3
42015,2016,30170,28201,1969,6.5
42017,2016,340801,325087,15714,4.6
42019,2016,98598,93616,4982,5.1
42021,2016,61337,57173,4164,6.8
42023,2016,2231,2067,164,7.4
42025,2016,31552,29672,1880,6
42027,2016,78925,75635,3290,4.2
42029,2016,280310,269460,10850,3.9
42031,2016,18024,16916,1108,6.1
42033,2016,36302,33661,2641,7.3
42035,2016,18552,17241,1311,7.1
42037,2016,33892,32017,1875,5.5
42039,2016,40496,38066,2430,6
42041,2016,130104,124828,5276,4.1
42043,2016,142086,135338,6748,4.7
42045,2016,294152,279850,14302,4.9
42047,2016,16329,15430,899,5.5
42049,2016,133570,124886,8684,6.5
42051,2016,58428,53700,4728,8.1
42053,2016,1890,1742,148,7.8
42055,2016,77483,73493,3990,5.1
42057,2016,7303,6842,461,6.3
42059,2016,17295,15957,1338,7.7
42061,2016,19661,18289,1372,7
42063,2016,40161,37241,2920,7.3
42065,2016,20699,19284,1415,6.8
42067,2016,12198,11546,652,5.3
42069,2016,106753,100722,6031,5.6
42071,2016,279791,268250,11541,4.1
42073,2016,41501,38716,2785,6.7
42075,2016,70572,67413,3159,4.5
42077,2016,188952,178860,10092,5.3
42079,2016,158706,148726,9980,6.3
42081,2016,58711,54823,3888,6.6
42083,2016,18488,17266,1222,6.6
42085,2016,52527,49396,3131,6
42087,2016,20804,19615,1189,5.7
42089,2016,81853,76748,5105,6.2
42091,2016,447345,428861,18484,4.1
42093,2016,9126,8737,389,4.3
42095,2016,158771,150580,8191,5.2
42097,2016,43949,41207,2742,6.2
42099,2016,24281,23162,1119,4.6
42101,2016,703277,655784,47493,6.8
42103,2016,24853,23266,1587,6.4
42105,2016,7379,6801,578,7.8
42107,2016,67559,63388,4171,6.2
42109,2016,20514,19556,958,4.7
42111,2016,34171,31717,2454,7.2
42113,2016,2840,2636,204,7.2
42115,2016,20862,19679,1183,5.7
42117,2016,19863,18449,1414,7.1
42119,2016,19778,18833,945,4.8
42121,2016,23710,21993,1717,7.2
42123,2016,19774,18692,1082,5.5
42125,2016,107247,100697,6550,6.1
42127,2016,22518,21226,1292,5.7
42129,2016,182780,172101,10679,5.8
42131,2016,14084,13211,873,6.2
42133,2016,234861,224026,10835,4.6
44001,2016,26141,24931,1210,4.6
44003,2016,90748,86456,4292,4.7
44005,2016,44247,42165,2082,4.7
44007,2016,323291,305432,17859,5.5
44009,2016,68991,65718,3273,4.7
45001,2016,10272,9707,565,5.5
45003,2016,74052,70333,3719,5
45005,2016,2660,2431,229,8.6
45007,2016,88808,84714,4094,4.6
45009,2016,5312,4830,482,9.1
45011,2016,8063,7466,597,7.4
45013,2016,72435,68957,3478,4.8
45015,2016,96894,92439,4455,4.6
45017,2016,6894,6466,428,6.2
45019,2016,201534,193260,8274,4.1
45021,2016,23508,22098,1410,6
45023,2016,13378,12411,967,7.2
45025,2016,21611,20528,1083,5
45027,2016,12707,11856,851,6.7
45029,2016,16740,15798,942,5.6
45031,2016,29879,28010,1869,6.3
45033,2016,12673,11812,861,6.8
45035,2016,73092,69726,3366,4.6
45037,2016,10537,9937,600,5.7
45039,2016,9987,9263,724,7.2
45041,2016,65310,61854,3456,5.3
45043,2016,24941,23239,1702,6.8
45045,2016,245243,234813,10430,4.3
45047,2016,31315,29688,1627,5.2
45049,2016,8220,7738,482,5.9
45051,2016,140038,131823,8215,5.9
45053,2016,11986,11461,525,4.4
45055,2016,29217,27685,1532,5.2
45057,2016,38304,36255,2049,5.3
45059,2016,30003,28434,1569,5.2
45061,2016,6433,5976,457,7.1
45063,2016,147910,141860,6050,4.1
45065,2016,3390,3200,190,5.6
45067,2016,12670,11560,1110,8.8
45069,2016,9304,8518,786,8.4
45071,2016,19170,18315,855,4.5
45073,2016,34186,32415,1771,5.2
45075,2016,35586,32413,3173,8.9
45077,2016,56299,53486,2813,5
45079,2016,200219,190518,9701,4.8
45081,2016,8886,8481,405,4.6
45083,2016,142237,135490,6747,4.7
45085,2016,44230,41619,2611,5.9
45087,2016,11456,10742,714,6.2
45089,2016,12464,11497,967,7.8
45091,2016,130517,124468,6049,4.6
46003,2016,1521,1487,34,2.2
46005,2016,9410,9168,242,2.6
46007,2016,1123,1079,44,3.9
46009,2016,2945,2865,80,2.7
46011,2016,18884,18368,516,2.7
46013,2016,21087,20524,563,2.7
46015,2016,2471,2408,63,2.5
46017,2016,726,666,60,8.3
46019,2016,5047,4873,174,3.4
46021,2016,850,825,25,2.9
46023,2016,3888,3764,124,3.2
46025,2016,1920,1845,75,3.9
46027,2016,6986,6777,209,3
46029,2016,15204,14736,468,3.1
46031,2016,1453,1388,65,4.5
46033,2016,3993,3833,160,4
46035,2016,11235,10967,268,2.4
46037,2016,2858,2737,121,4.2
46039,2016,2239,2130,109,4.9
46041,2016,2251,2049,202,9
46043,2016,1671,1629,42,2.5
46045,2016,2163,2113,50,2.3
46047,2016,3022,2890,132,4.4
46049,2016,1113,1084,29,2.6
46051,2016,4457,4314,143,3.2
46053,2016,2075,2013,62,3
46055,2016,1105,1079,26,2.4
46057,2016,3173,3067,106,3.3
46059,2016,1831,1792,39,2.1
46061,2016,1769,1709,60,3.4
46063,2016,761,739,22,2.9
46065,2016,10062,9825,237,2.4
46067,2016,3650,3557,93,2.5
46069,2016,698,679,19,2.7
46071,2016,1304,1250,54,4.1
46073,2016,1071,1045,26,2.4
46075,2016,569,556,13,2.3
46077,2016,2740,2668,72,2.6
46079,2016,6456,6237,219,3.4
46081,2016,13060,12631,429,3.3
46083,2016,31436,30760,676,2.2
46085,2016,1775,1692,83,4.7
46087,2016,3132,3055,77,2.5
46089,2016,1088,1051,37,3.4
46091,2016,2460,2365,95,3.9
46093,2016,13675,13246,429,3.1
46095,2016,770,738,32,4.2
46097,2016,1200,1168,32,2.7
46099,2016,107699,104942,2757,2.6
46101,2016,3950,3805,145,3.7
46102,2016,3610,3223,387,10.7
46103,2016,54703,53022,1681,3.1
46105,2016,1577,1532,45,2.9
46107,2016,1157,1126,31,2.7
46109,2016,4840,4640,200,4.1
46111,2016,1209,1173,36,3
46115,2016,3285,3184,101,3.1
46117,2016,1870,1825,45,2.4
46119,2016,859,839,20,2.3
46121,2016,3059,2862,197,6.4
46123,2016,3063,2995,68,2.2
46125,2016,4676,4546,130,2.8
46127,2016,8048,7798,250,3.1
46129,2016,2241,2126,115,5.1
46135,2016,11582,11286,296,2.6
46137,2016,976,932,44,4.5
47001,2016,33610,31980,1630,4.8
47003,2016,19787,18808,979,4.9
47005,2016,6727,6249,478,7.1
47007,2016,4314,4015,299,6.9
47009,2016,60728,58084,2644,4.4
47011,2016,50035,47813,2222,4.4
47013,2016,14706,13693,1013,6.9
47015,2016,6009,5732,277,4.6
47017,2016,12000,11196,804,6.7
47019,2016,23626,22296,1330,5.6
47021,2016,20223,19423,800,4
47023,2016,8430,8012,418,5
47025,2016,12674,11888,786,6.2
47027,2016,3036,2838,198,6.5
47029,2016,14424,13516,908,6.3
47031,2016,24408,23263,1145,4.7
47033,2016,6874,6515,359,5.2
47035,2016,23517,22129,1388,5.9
47037,2016,373277,359869,13408,3.6
47039,2016,4652,4333,319,6.9
47041,2016,7534,7116,418,5.5
47043,2016,24740,23666,1074,4.3
47045,2016,16335,15326,1009,6.2
47047,2016,18249,17333,916,5
47049,2016,7094,6658,436,6.1
47051,2016,19804,18846,958,4.8
47053,2016,21198,19961,1237,5.8
47055,2016,15246,14635,611,4
47057,2016,9268,8768,500,5.4
47059,2016,30817,29142,1675,5.4
47061,2016,4780,4472,308,6.4
47063,2016,26801,25437,1364,5.1
47065,2016,171608,163729,7879,4.6
47067,2016,2029,1869,160,7.9
47069,2016,9178,8615,563,6.1
47071,2016,10187,9580,607,6
47073,2016,23666,22394,1272,5.4
47075,2016,7662,7167,495,6.5
47077,2016,11964,11149,815,6.8
47079,2016,13898,13082,816,5.9
47081,2016,10417,9937,480,4.6
47083,2016,3192,2953,239,7.5
47085,2016,8627,8110,517,6
47087,2016,4484,4172,312,7
47089,2016,23571,22331,1240,5.3
47091,2016,7527,7167,360,4.8
47093,2016,233285,224002,9283,4
47095,2016,1912,1764,148,7.7
47097,2016,9417,8692,725,7.7
47099,2016,17762,16742,1020,5.7
47101,2016,4879,4590,289,5.9
47103,2016,15937,15287,650,4.1
47105,2016,22242,21207,1035,4.7
47107,2016,22721,21491,1230,5.4
47109,2016,8749,8137,612,7
47111,2016,10219,9775,444,4.3
47113,2016,47714,45401,2313,4.8
47115,2016,11899,11153,746,6.3
47117,2016,15048,14356,692,4.6
47119,2016,44013,42242,1771,4
47121,2016,4889,4556,333,6.8
47123,2016,19370,18351,1019,5.3
47125,2016,79827,75777,4050,5.1
47127,2016,3380,3253,127,3.8
47129,2016,7790,7290,500,6.4
47131,2016,12547,11667,880,7
47133,2016,9199,8709,490,5.3
47135,2016,3184,2983,201,6.3
47137,2016,2321,2169,152,6.5
47139,2016,7378,6956,422,5.7
47141,2016,33199,31579,1620,4.9
47143,2016,13450,12498,952,7.1
47145,2016,22820,21555,1265,5.5
47147,2016,34696,33260,1436,4.1
47149,2016,163365,157344,6021,3.7
47151,2016,8008,7417,591,7.4
47153,2016,5911,5567,344,5.8
47155,2016,51117,48598,2519,4.9
47157,2016,433440,410379,23061,5.3
47159,2016,8667,8271,396,4.6
47161,2016,5158,4809,349,6.8
47163,2016,69645,66058,3587,5.2
47165,2016,92179,88612,3567,3.9
47167,2016,27459,25905,1554,5.7
47169,2016,3840,3655,185,4.8
47171,2016,6999,6504,495,7.1
47173,2016,7267,6848,419,5.8
47175,2016,2033,1908,125,6.1
47177,2016,17641,16797,844,4.8
47179,2016,58640,55849,2791,4.8
47181,2016,6077,5679,398,6.5
47183,2016,15835,14913,922,5.8
47185,2016,11742,11160,582,5
47187,2016,113370,109513,3857,3.4
47189,2016,67716,65120,2596,3.8
48001,2016,23520,22503,1017,4.3
48003,2016,8694,8284,410,4.7
48005,2016,37081,34894,2187,5.9
48007,2016,10243,9671,572,5.6
48009,2016,4091,3914,177,4.3
48011,2016,934,908,26,2.8
48013,2016,21031,19909,1122,5.3
48015,2016,14036,13289,747,5.3
48017,2016,2720,2601,119,4.4
48019,2016,9508,9118,390,4.1
48021,2016,39048,37589,1459,3.7
48023,2016,1606,1548,58,3.6
48025,2016,10314,9539,775,7.5
48027,2016,139567,133287,6280,4.5
48029,2016,905907,872008,33899,3.7
48031,2016,5937,5754,183,3.1
48033,2016,366,353,13,3.6
48035,2016,8192,7840,352,4.3
48037,2016,39644,37781,1863,4.7
48039,2016,169945,161140,8805,5.2
48041,2016,111348,107501,3847,3.5
48043,2016,3963,3814,149,3.8
48045,2016,548,524,24,4.4
48047,2016,2440,2152,288,11.8
48049,2016,16178,15476,702,4.3
48051,2016,7879,7514,365,4.6
48053,2016,22006,21245,761,3.5
48055,2016,17951,17175,776,4.3
48057,2016,10780,10179,601,5.6
48059,2016,5808,5561,247,4.3
48061,2016,166103,154196,11907,7.2
48063,2016,5064,4718,346,6.8
48065,2016,3099,2998,101,3.3
48067,2016,12275,11393,882,7.2
48069,2016,3496,3389,107,3.1
48071,2016,18221,17113,1108,6.1
48073,2016,21208,20132,1076,5.1
48075,2016,2962,2873,89,3
48077,2016,4798,4588,210,4.4
48079,2016,1174,1115,59,5
48081,2016,1422,1363,59,4.1
48083,2016,3066,2888,178,5.8
48085,2016,513282,495148,18134,3.5
48087,2016,1216,1174,42,3.5
48089,2016,9798,9337,461,4.7
48091,2016,65525,63157,2368,3.6
48093,2016,5361,5130,231,4.3
48095,2016,1332,1287,45,3.4
48097,2016,18924,18174,750,4
48099,2016,24428,23289,1139,4.7
48101,2016,525,498,27,5.1
48103,2016,1706,1560,146,8.6
48105,2016,1737,1606,131,7.5
48107,2016,2623,2508,115,4.4
48109,2016,1000,959,41,4.1
48111,2016,4002,3913,89,2.2
48113,2016,1299195,1247033,52162,4
48115,2016,4643,4410,233,5
48117,2016,8614,8345,269,3.1
48119,2016,2608,2509,99,3.8
48121,2016,452182,436692,15490,3.4
48123,2016,9504,8985,519,5.5
48125,2016,692,658,34,4.9
48127,2016,6241,5797,444,7.1
48129,2016,1557,1494,63,4
48131,2016,4886,4353,533,10.9
48133,2016,7424,7020,404,5.4
48135,2016,76244,71401,4843,6.4
48137,2016,867,827,40,4.6
48139,2016,85030,81849,3181,3.7
48141,2016,349941,332660,17281,4.9
48143,2016,20241,19421,820,4.1
48145,2016,6613,6322,291,4.4
48147,2016,15774,15181,593,3.8
48149,2016,12497,12041,456,3.6
48151,2016,1759,1684,75,4.3
48153,2016,2738,2600,138,5
48155,2016,540,520,20,3.7
48157,2016,367057,348745,18312,5
48159,2016,4511,4291,220,4.9
48161,2016,6871,6413,458,6.7
48163,2016,8784,8357,427,4.9
48165,2016,9187,8845,342,3.7
48167,2016,160181,151651,8530,5.3
48169,2016,2131,2048,83,3.9
48171,2016,13002,12633,369,2.8
48173,2016,749,720,29,3.9
48175,2016,3319,3127,192,5.8
48177,2016,9574,9169,405,4.2
48179,2016,8489,7905,584,6.9
48181,2016,61234,58878,2356,3.8
48183,2016,58384,54836,3548,6.1
48185,2016,11057,10327,730,6.6
48187,2016,76000,73276,2724,3.6
48189,2016,12596,11889,707,5.6
48191,2016,1166,1088,78,6.7
48193,2016,3601,3425,176,4.9
48195,2016,2947,2855,92,3.1
48197,2016,1625,1561,64,3.9
48199,2016,25169,23640,1529,6.1
48201,2016,2251321,2131500,119821,5.3
48203,2016,29961,28164,1797,6
48205,2016,2961,2901,60,2
48207,2016,2510,2404,106,4.2
48209,2016,104929,101434,3495,3.3
48211,2016,2116,2037,79,3.7
48213,2016,35400,33747,1653,4.7
48215,2016,337226,310913,26313,7.8
48217,2016,15812,15117,695,4.4
48219,2016,11176,10658,518,4.6
48221,2016,25278,24091,1187,4.7
48223,2016,17332,16642,690,4
48225,2016,10068,9604,464,4.6
48227,2016,13218,12488,730,5.5
48229,2016,1542,1450,92,6
48231,2016,40534,38800,1734,4.3
48233,2016,9639,9097,542,5.6
48235,2016,780,755,25,3.2
48237,2016,3856,3666,190,4.9
48239,2016,7278,6938,340,4.7
48241,2016,13471,12439,1032,7.7
48243,2016,1074,1042,32,3
48245,2016,107545,100017,7528,7
48247,2016,1945,1759,186,9.6
48249,2016,17469,15628,1841,10.5
48251,2016,76076,72766,3310,4.4
48253,2016,5627,5301,326,5.8
48255,2016,6279,5973,306,4.9
48257,2016,57944,55752,2192,3.8
48259,2016,20355,19705,650,3.2
48261,2016,218,208,10,4.6
48263,2016,470,456,14,3
48265,2016,21368,20601,767,3.6
48267,2016,1953,1879,74,3.8
48269,2016,178,171,7,3.9
48271,2016,1157,1090,67,5.8
48273,2016,14115,13168,947,6.7
48275,2016,1560,1494,66,4.2
48277,2016,23239,22165,1074,4.6
48279,2016,5249,4909,340,6.5
48281,2016,9165,8785,380,4.1
48283,2016,3888,3688,200,5.1
48285,2016,8745,8377,368,4.2
48287,2016,9288,8938,350,3.8
48289,2016,6513,6092,421,6.5
48291,2016,31553,29181,2372,7.5
48293,2016,8330,7864,466,5.6
48295,2016,1652,1579,73,4.4
48297,2016,5206,4898,308,5.9
48299,2016,8296,7951,345,4.2
48301,2016,86,82,4,4.7
48303,2016,153638,148437,5201,3.4
48305,2016,2731,2623,108,4
48307,2016,3711,3545,166,4.5
48309,2016,116155,111567,4588,3.9
48311,2016,862,844,18,2.1
48313,2016,4770,4528,242,5.1
48315,2016,4343,4039,304,7
48317,2016,2483,2374,109,4.4
48319,2016,1792,1727,65,3.6
48321,2016,16890,15656,1234,7.3
48323,2016,24244,21523,2721,11.2
48325,2016,21000,20077,923,4.4
48327,2016,817,781,36,4.4
48329,2016,85085,81341,3744,4.4
48331,2016,10272,9743,529,5.1
48333,2016,1925,1845,80,4.2
48335,2016,2610,2427,183,7
48337,2016,9036,8589,447,4.9
48339,2016,266006,252985,13021,4.9
48341,2016,11198,10866,332,3
48343,2016,4895,4360,535,10.9
48345,2016,508,490,18,3.5
48347,2016,28723,27380,1343,4.7
48349,2016,22778,21826,952,4.2
48351,2016,5355,4931,424,7.9
48353,2016,6867,6538,329,4.8
48355,2016,167828,158383,9445,5.6
48357,2016,4664,4420,244,5.2
48359,2016,909,882,27,3
48361,2016,37367,34865,2502,6.7
48363,2016,13257,12533,724,5.5
48365,2016,10234,9501,733,7.2
48367,2016,61299,58809,2490,4.1
48369,2016,4950,4826,124,2.5
48371,2016,6498,6117,381,5.9
48373,2016,17388,16290,1098,6.3
48375,2016,56183,54304,1879,3.3
48377,2016,3080,2751,329,10.7
48379,2016,5557,5334,223,4
48381,2016,70691,68607,2084,2.9
48383,2016,1702,1597,105,6.2
48385,2016,1041,982,59,5.7
48387,2016,5035,4744,291,5.8
48389,2016,6036,5716,320,5.3
48391,2016,3138,2930,208,6.6
48393,2016,442,422,20,4.5
48395,2016,7259,6892,367,5.1
48397,2016,47370,45712,1658,3.5
48399,2016,4650,4466,184,4
48401,2016,22384,21080,1304,5.8
48403,2016,3484,3158,326,9.4
48405,2016,2804,2554,250,8.9
48407,2016,11431,10715,716,6.3
48409,2016,30623,28340,2283,7.5
48411,2016,2449,2366,83,3.4
48413,2016,1421,1347,74,5.2
48415,2016,7411,6975,436,5.9
48417,2016,1878,1806,72,3.8
48419,2016,10959,10302,657,6
48421,2016,1350,1311,39,2.9
48423,2016,105490,100724,4766,4.5
48425,2016,4134,3935,199,4.8
48427,2016,26358,22841,3517,13.3
48429,2016,4019,3807,212,5.3
48431,2016,670,644,26,3.9
48433,2016,640,612,28,4.4
48435,2016,1592,1465,127,8
48437,2016,2717,2601,116,4.3
48439,2016,1011580,971375,40205,4
48441,2016,63326,60960,2366,3.7
48443,2016,406,390,16,3.9
48445,2016,5352,5097,255,4.8
48447,2016,743,717,26,3.5
48449,2016,12883,12090,793,6.2
48451,2016,54275,51847,2428,4.5
48453,2016,678536,656988,21548,3.2
48455,2016,5484,5151,333,6.1
48457,2016,7216,6690,526,7.3
48459,2016,17903,16757,1146,6.4
48461,2016,1582,1498,84,5.3
48463,2016,11813,11186,627,5.3
48465,2016,20147,18890,1257,6.2
48467,2016,24865,23796,1069,4.3
48469,2016,43733,41364,2369,5.4
48471,2016,23797,22551,1246,5.2
48473,2016,22180,20943,1237,5.6
48475,2016,5397,5090,307,5.7
48477,2016,15089,14323,766,5.1
48479,2016,113892,108333,5559,4.9
48481,2016,21081,20022,1059,5
48483,2016,2483,2366,117,4.7
48485,2016,55491,53081,2410,4.3
48487,2016,5050,4813,237,4.7
48489,2016,6504,5708,796,12.2
48491,2016,278740,269396,9344,3.4
48493,2016,23761,22834,927,3.9
48495,2016,3071,2834,237,7.7
48497,2016,29439,28049,1390,4.7
48499,2016,17249,16342,907,5.3
48501,2016,3761,3582,179,4.8
48503,2016,8312,7948,364,4.4
48505,2016,5209,4649,560,10.8
48507,2016,3887,3348,539,13.9
49001,2016,3078,2926,152,4.9
49003,2016,24696,23835,861,3.5
49005,2016,61265,59396,1869,3.1
49007,2016,8338,7843,495,5.9
49009,2016,464,440,24,5.2
49011,2016,164429,159244,5185,3.2
49013,2016,8116,7396,720,8.9
49015,2016,4266,4000,266,6.2
49017,2016,2796,2562,234,8.4
49019,2016,5729,5393,336,5.9
49021,2016,21478,20543,935,4.4
49023,2016,5221,5031,190,3.6
49025,2016,3695,3554,141,3.8
49027,2016,6215,6008,207,3.3
49029,2016,5145,4992,153,3
49031,2016,458,431,27,5.9
49033,2016,1096,1061,35,3.2
49035,2016,601889,582791,19098,3.2
49037,2016,5745,5281,464,8.1
49039,2016,11804,11335,469,4
49041,2016,9593,9173,420,4.4
49043,2016,23885,23134,751,3.1
49045,2016,30841,29672,1169,3.8
49047,2016,14138,12821,1317,9.3
49049,2016,279061,270441,8620,3.1
49051,2016,13909,13439,470,3.4
49053,2016,67287,64776,2511,3.7
49055,2016,1428,1316,112,7.8
49057,2016,120177,115566,4611,3.8
50001,2016,20858,20238,620,3
50003,2016,18451,17756,695,3.8
50005,2016,14907,14285,622,4.2
50007,2016,95242,92859,2383,2.5
50009,2016,2701,2566,135,5
50011,2016,27364,26513,851,3.1
50013,2016,3977,3828,149,3.7
50015,2016,13926,13334,592,4.3
50017,2016,15902,15407,495,3.1
50019,2016,13541,12829,712,5.3
50021,2016,31467,30278,1189,3.8
50023,2016,33910,32827,1083,3.2
50025,2016,23225,22451,774,3.3
50027,2016,29337,28475,862,2.9
51001,2016,15781,15002,779,4.9
51003,2016,54377,52428,1949,3.6
51005,2016,6924,6568,356,5.1
51007,2016,6190,5924,266,4.3
51009,2016,14970,14308,662,4.4
51011,2016,6988,6658,330,4.7
51013,2016,146165,142305,3860,2.6
51015,2016,36792,35432,1360,3.7
51017,2016,2491,2398,93,3.7
51019,2016,37910,36346,1564,4.1
51021,2016,2736,2591,145,5.3
51023,2016,17325,16690,635,3.7
51025,2016,6202,5830,372,6
51027,2016,6853,6112,741,10.8
51029,2016,6258,5916,342,5.5
51031,2016,25904,24744,1160,4.5
51033,2016,14838,14169,669,4.5
51035,2016,12945,12273,672,5.2
51036,2016,3715,3544,171,4.6
51037,2016,5246,4980,266,5.1
51041,2016,180468,173432,7036,3.9
51043,2016,7424,7156,268,3.6
51045,2016,2347,2234,113,4.8
51047,2016,23415,22498,917,3.9
51049,2016,4597,4383,214,4.7
51051,2016,4570,4112,458,10
51053,2016,13427,12766,661,4.9
51057,2016,5517,5247,270,4.9
51059,2016,615850,595783,20067,3.3
51061,2016,35872,34611,1261,3.5
51063,2016,8178,7842,336,4.1
51065,2016,13162,12715,447,3.4
51067,2016,26331,25190,1141,4.3
51069,2016,45273,43673,1600,3.5
51071,2016,7931,7501,430,5.4
51073,2016,19063,18359,704,3.7
51075,2016,10814,10402,412,3.8
51077,2016,7013,6651,362,5.2
51079,2016,9917,9589,328,3.3
51081,2016,4202,3987,215,5.1
51083,2016,14846,13971,875,5.9
51085,2016,57089,55067,2022,3.5
51087,2016,178588,171556,7032,3.9
51089,2016,22113,20865,1248,5.6
51091,2016,1305,1264,41,3.1
51093,2016,18904,18081,823,4.4
51095,2016,34812,33450,1362,3.9
51097,2016,3655,3501,154,4.2
51099,2016,12302,11771,531,4.3
51101,2016,8737,8402,335,3.8
51103,2016,5103,4813,290,5.7
51105,2016,8434,7855,579,6.9
51107,2016,206982,200302,6680,3.2
51109,2016,18542,17826,716,3.9
51111,2016,5245,5001,244,4.7
51113,2016,7162,6936,226,3.2
51115,2016,4033,3870,163,4
51117,2016,12445,11738,707,5.7
51119,2016,5020,4826,194,3.9
51121,2016,49659,47584,2075,4.2
51125,2016,7225,6962,263,3.6
51127,2016,11655,11256,399,3.4
51131,2016,5869,5525,344,5.9
51133,2016,5442,5142,300,5.5
51135,2016,7025,6742,283,4
51137,2016,16340,15669,671,4.1
51139,2016,11579,10929,650,5.6
51141,2016,7942,7553,389,4.9
51143,2016,29658,28234,1424,4.8
51145,2016,13617,13129,488,3.6
51147,2016,10141,9595,546,5.4
51149,2016,14911,14179,732,4.9
51153,2016,234613,225972,8641,3.7
51155,2016,16250,15272,978,6
51157,2016,3706,3574,132,3.6
51159,2016,3903,3757,146,3.7
51161,2016,49064,47292,1772,3.6
51163,2016,10447,9986,461,4.4
51165,2016,40499,39061,1438,3.6
51167,2016,11230,10497,733,6.5
51169,2016,9412,8947,465,4.9
51171,2016,20798,20007,791,3.8
51173,2016,13659,12859,800,5.9
51175,2016,9023,8665,358,4
51177,2016,64850,62172,2678,4.1
51179,2016,68194,65495,2699,4
51181,2016,3652,3458,194,5.3
51183,2016,3943,3693,250,6.3
51185,2016,15937,14730,1207,7.6
51187,2016,19671,18867,804,4.1
51191,2016,26810,25588,1222,4.6
51193,2016,8966,8551,415,4.6
51195,2016,13191,12062,1129,8.6
51197,2016,13641,12855,786,5.8
51199,2016,32065,30807,1258,3.9
51510,2016,96239,93414,2825,2.9
51520,2016,7438,7057,381,5.1
51530,2016,3271,3103,168,5.1
51540,2016,24842,23995,847,3.4
51550,2016,117771,112686,5085,4.3
51570,2016,8700,8306,394,4.5
51580,2016,2379,2238,141,5.9
51590,2016,19083,17914,1169,6.1
51595,2016,2242,2096,146,6.5
51600,2016,12953,12553,400,3.1
51610,2016,7968,7748,220,2.8
51620,2016,3533,3316,217,6.1
51630,2016,13541,12886,655,4.8
51640,2016,2898,2753,145,5
51650,2016,63883,60204,3679,5.8
51660,2016,24197,23017,1180,4.9
51670,2016,9765,9121,644,6.6
51678,2016,2262,2122,140,6.2
51680,2016,35471,33608,1863,5.3
51683,2016,21563,20777,786,3.6
51685,2016,8468,8156,312,3.7
51690,2016,5156,4788,368,7.1
51700,2016,88716,84126,4590,5.2
51710,2016,110200,104318,5882,5.3
51720,2016,1659,1544,115,6.9
51730,2016,13191,12147,1044,7.9
51735,2016,6158,5940,218,3.5
51740,2016,44009,41276,2733,6.2
51750,2016,8247,7796,451,5.5
51760,2016,114503,109125,5378,4.7
51770,2016,48866,46742,2124,4.3
51775,2016,12873,12361,512,4
51790,2016,11775,11310,465,3.9
51800,2016,42903,40871,2032,4.7
51810,2016,228884,219722,9162,4
51820,2016,10177,9750,427,4.2
51830,2016,6704,6329,375,5.6
51840,2016,14304,13726,578,4
53001,2016,8711,8150,561,6.4
53003,2016,9956,9462,494,5
53005,2016,94235,88317,5918,6.3
53007,2016,43265,40797,2468,5.7
53009,2016,27298,25231,2067,7.6
53011,2016,220633,207286,13347,6
53013,2016,1717,1606,111,6.5
53015,2016,44818,41623,3195,7.1
53017,2016,20526,19116,1410,6.9
53019,2016,2491,2235,256,10.3
53021,2016,39829,36877,2952,7.4
53023,2016,919,866,53,5.8
53025,2016,44550,41379,3171,7.1
53027,2016,27224,24965,2259,8.3
53029,2016,32715,30794,1921,5.9
53031,2016,11500,10691,809,7
53033,2016,1211626,1163875,47751,3.9
53035,2016,118087,111546,6541,5.5
53037,2016,21520,20243,1277,5.9
53039,2016,9638,8984,654,6.8
53041,2016,31899,29420,2479,7.8
53043,2016,4888,4616,272,5.6
53045,2016,23489,21723,1766,7.5
53047,2016,21396,19977,1419,6.6
53049,2016,8285,7621,664,8
53051,2016,4658,4244,414,8.9
53053,2016,404347,380137,24210,6
53055,2016,7870,7503,367,4.7
53057,2016,57929,54172,3757,6.5
53059,2016,5070,4720,350,6.9
53061,2016,414786,396826,17960,4.3
53063,2016,234348,220149,14199,6.1
53065,2016,17876,16410,1466,8.2
53067,2016,129691,122413,7278,5.6
53069,2016,1288,1177,111,8.6
53071,2016,28695,27149,1546,5.4
53073,2016,107044,100841,6203,5.8
53075,2016,23091,21940,1151,5
53077,2016,125788,116297,9491,7.5
54001,2016,6963,6489,474,6.8
54003,2016,54111,51966,2145,4
54005,2016,7992,7264,728,9.1
54007,2016,5494,5012,482,8.8
54009,2016,9984,9280,704,7.1
54011,2016,41232,39247,1985,4.8
54013,2016,2623,2286,337,12.8
54015,2016,3260,2922,338,10.4
54017,2016,3783,3587,196,5.2
54019,2016,15980,14712,1268,7.9
54021,2016,2541,2331,210,8.3
54023,2016,5958,5604,354,5.9
54025,2016,15692,14844,848,5.4
54027,2016,9900,9469,431,4.4
54029,2016,12863,11962,901,7
54031,2016,5720,5394,326,5.7
54033,2016,32361,30471,1890,5.8
54035,2016,12010,11231,779,6.5
54037,2016,28569,27607,962,3.4
54039,2016,85335,80673,4662,5.5
54041,2016,6831,6250,581,8.5
54043,2016,7293,6670,623,8.5
54045,2016,11163,10024,1139,10.2
54047,2016,5085,4467,618,12.2
54049,2016,25682,24002,1680,6.5
54051,2016,14072,12950,1122,8
54053,2016,10035,9319,716,7.1
54055,2016,21697,20245,1452,6.7
54057,2016,11914,11204,710,6
54059,2016,6731,5882,849,12.6
54061,2016,51304,49084,2220,4.3
54063,2016,5981,5709,272,4.5
54065,2016,7658,7322,336,4.4
54067,2016,9591,8745,846,8.8
54069,2016,20637,19492,1145,5.5
54071,2016,3656,3514,142,3.9
54073,2016,2955,2713,242,8.2
54075,2016,3728,3480,248,6.7
54077,2016,14859,14005,854,5.7
54079,2016,25786,24526,1260,4.9
54081,2016,29947,27853,2094,7
54083,2016,12211,11480,731,6
54085,2016,4566,4267,299,6.5
54087,2016,5204,4668,536,10.3
54089,2016,4572,4292,280,6.1
54091,2016,7822,7381,441,5.6
54093,2016,3477,3289,188,5.4
54095,2016,3549,3233,316,8.9
54097,2016,9810,9070,740,7.5
54099,2016,15538,14512,1026,6.6
54101,2016,3491,3200,291,8.3
54103,2016,7205,6539,666,9.2
54105,2016,2232,2036,196,8.8
54107,2016,36836,34720,2116,5.7
54109,2016,7423,6666,757,10.2
55001,2016,8299,7799,500,6
55003,2016,7971,7539,432,5.4
55005,2016,24401,23291,1110,4.5
55007,2016,7551,7030,521,6.9
55009,2016,141443,136333,5110,3.6
55011,2016,6586,6292,294,4.5
55013,2016,7192,6760,432,6
55015,2016,27773,26883,890,3.2
55017,2016,33430,32008,1422,4.3
55019,2016,17567,16881,686,3.9
55021,2016,31638,30499,1139,3.6
55023,2016,7939,7551,388,4.9
55025,2016,318384,309310,9074,2.9
55027,2016,47965,46217,1748,3.6
55029,2016,15540,14769,771,5
55031,2016,23618,22380,1238,5.2
55033,2016,24374,23379,995,4.1
55035,2016,58996,56984,2012,3.4
55037,2016,2233,2101,132,5.9
55039,2016,57047,55042,2005,3.5
55041,2016,4008,3759,249,6.2
55043,2016,28261,27157,1104,3.9
55045,2016,21251,20544,707,3.3
55047,2016,9783,9305,478,4.9
55049,2016,13726,13245,481,3.5
55051,2016,2644,2447,197,7.5
55053,2016,10349,9896,453,4.4
55055,2016,45797,44017,1780,3.9
55057,2016,13566,12965,601,4.4
55059,2016,88690,84565,4125,4.7
55061,2016,11057,10651,406,3.7
55063,2016,67699,65258,2441,3.6
55065,2016,9864,9550,314,3.2
55067,2016,9596,9098,498,5.2
55069,2016,15293,14625,668,4.4
55071,2016,41933,40128,1805,4.3
55073,2016,73771,71151,2620,3.6
55075,2016,20277,19166,1111,5.5
55077,2016,7570,7185,385,5.1
55078,2016,1578,1458,120,7.6
55079,2016,477610,453900,23710,5
55081,2016,23075,22193,882,3.8
55083,2016,20510,19601,909,4.4
55085,2016,18629,17721,908,4.9
55087,2016,104081,100418,3663,3.5
55089,2016,49144,47506,1638,3.3
55091,2016,4176,4017,159,3.8
55093,2016,24734,23734,1000,4
55095,2016,24933,23791,1142,4.6
55097,2016,39574,38064,1510,3.8
55099,2016,6897,6601,296,4.3
55101,2016,99941,95020,4921,4.9
55103,2016,9284,8935,349,3.8
55105,2016,84290,80583,3707,4.4
55107,2016,7018,6660,358,5.1
55109,2016,49769,47895,1874,3.8
55111,2016,35308,34049,1259,3.6
55113,2016,7937,7441,496,6.2
55115,2016,21339,20453,886,4.2
55117,2016,61857,59760,2097,3.4
55119,2016,11103,10645,458,4.1
55121,2016,16700,16084,616,3.7
55123,2016,15793,15216,577,3.7
55125,2016,9998,9430,568,5.7
55127,2016,57824,55517,2307,4
55129,2016,7993,7595,398,5
55131,2016,77359,74774,2585,3.3
55133,2016,225291,217528,7763,3.4
55135,2016,27028,25962,1066,3.9
55137,2016,11506,10927,579,5
55139,2016,93262,89943,3319,3.6
55141,2016,34692,33054,1638,4.7
56001,2016,20988,20315,673,3.2
56003,2016,5544,5268,276,5
56005,2016,24427,22667,1760,7.2
56007,2016,8369,7976,393,4.7
56009,2016,7883,7391,492,6.2
56011,2016,3742,3570,172,4.6
56013,2016,20051,18607,1444,7.2
56015,2016,7034,6790,244,3.5
56017,2016,2427,2310,117,4.8
56019,2016,4211,3985,226,5.4
56021,2016,48836,46805,2031,4.2
56023,2016,8731,8320,411,4.7
56025,2016,41038,38106,2932,7.1
56027,2016,1339,1295,44,3.3
56029,2016,15943,15188,755,4.7
56031,2016,4778,4548,230,4.8
56033,2016,16139,15377,762,4.7
56035,2016,4235,3962,273,6.4
56037,2016,22154,20811,1343,6.1
56039,2016,15257,14729,528,3.5
56041,2016,9433,8884,549,5.8
56043,2016,4217,4016,201,4.8
56045,2016,3962,3764,198,5
72001,2016,4465,3714,751,16.8
72003,2016,11898,10238,1660,14
72005,2016,14895,12681,2214,14.9
72007,2016,6781,5810,971,14.3
72009,2016,6668,5676,992,14.9
72011,2016,8886,7744,1142,12.9
72013,2016,23978,20818,3160,13.2
72015,2016,5136,4184,952,18.5
72017,2016,5857,5030,827,14.1
72019,2016,7475,6517,958,12.8
72021,2016,66306,60358,5948,9
72023,2016,14156,12396,1760,12.4
72025,2016,48226,43251,4975,10.3
72027,2016,9497,8324,1173,12.4
72029,2016,16261,14394,1867,11.5
72031,2016,62118,56753,5365,8.6
72033,2016,7906,7114,792,10
72035,2016,16207,14470,1737,10.7
72037,2016,3795,3299,496,13.1
72039,2016,3836,3218,618,16.1
72041,2016,15568,13976,1592,10.2
72043,2016,10859,8897,1962,18.1
72045,2016,5067,4385,682,13.5
72047,2016,9242,8108,1134,12.3
72049,2016,895,865,30,3.4
72051,2016,12915,11874,1041,8.1
72053,2016,11276,9721,1555,13.8
72054,2016,3367,2880,487,14.5
72055,2016,4138,3392,746,18
72057,2016,12041,10069,1972,16.4
72059,2016,5288,4299,989,18.7
72061,2016,37162,34951,2211,5.9
72063,2016,17500,16015,1485,8.5
72065,2016,13312,11245,2067,15.5
72067,2016,5617,4930,687,12.2
72069,2016,17452,14993,2459,14.1
72071,2016,12602,10827,1775,14.1
72073,2016,4218,3673,545,12.9
72075,2016,15584,13329,2255,14.5
72077,2016,12451,10809,1642,13.2
72079,2016,5627,4577,1050,18.7
72081,2016,7405,5976,1429,19.3
72083,2016,2862,2437,425,14.8
72085,2016,11357,9829,1528,13.5
72087,2016,8647,7669,978,11.3
72089,2016,6329,5431,898,14.2
72091,2016,11639,10288,1351,11.6
72093,2016,1953,1656,297,15.2
72095,2016,3018,2465,553,18.3
72097,2016,23206,20025,3181,13.7
72099,2016,10736,9067,1669,15.5
72101,2016,8113,7023,1090,13.4
72103,2016,8081,7085,996,12.3
72105,2016,7255,6315,940,13
72107,2016,5199,4394,805,15.5
72109,2016,4810,3818,992,20.6
72111,2016,6116,5096,1020,16.7
72113,2016,47774,41369,6405,13.4
72115,2016,6075,5106,969,16
72117,2016,4627,3905,722,15.6
72119,2016,17081,15292,1789,10.5
72121,2016,6440,5420,1020,15.8
72123,2016,7561,5924,1637,21.7
72125,2016,10348,8769,1579,15.3
72127,2016,135057,124410,10647,7.9
72129,2016,11900,10411,1489,12.5
72131,2016,10712,8688,2024,18.9
72133,2016,9889,8238,1651,16.7
72135,2016,26531,24327,2204,8.3
72137,2016,29730,27052,2678,9
72139,2016,27107,25157,1950,7.2
72141,2016,6879,5813,1066,15.5
72143,2016,9870,8734,1136,11.5
72145,2016,13722,11821,1901,13.9
72147,2016,3257,2912,345,10.6
72149,2016,7808,6231,1577,20.2
72151,2016,9073,7540,1533,16.9
72153,2016,10726,8713,2013,18.8
