GEOID,period,births,deaths,domesticmig,internationalmig,naturalinc,netmig,rbirth,rdeath,rdomesticmig,rinternationalmig,rnaturalinc,rnetmig
45001,2010,64,88,-67,2,-24,-65,NA,NA,NA,NA,NA,NA
45001,2011,228,290,-198,11,-62,-187,9.0458242412,11.50565364,-7.855584209,0.436421345,-2.459829399,-7.419162865
45001,2012,280,252,-104,15,28,-89,11.177421608,10.059679448,-4.15161374,0.5987904433,1.1177421608,-3.552823297
45001,2013,273,278,-112,1,-5,-111,10.9375,11.137820513,-4.487179487,0.0400641026,-0.200320513,-4.447115385
45001,2014,242,263,-75,-3,-21,-78,9.7382346432,10.583288063,-3.018047927,-0.120721917,-0.845053419,-3.138769844
45001,2015,247,318,79,-3,-71,76,9.9592758357,12.822063626,3.1853554292,-0.120962864,-2.862787791,3.0643925648
45001,2016,224,258,-45,-5,-34,-50,9.0470324522,10.420242735,-1.817484198,-0.201942689,-1.373210283,-2.019426887
45001,2017,225,261,48,-4,-36,44,9.1021258521,10.558465988,1.9417868484,-0.161815571,-1.456340136,1.7799712777
22001,2010,211,114,-9,6,97,-3,NA,NA,NA,NA,NA,NA
22001,2011,869,692,-228,22,177,-206,14.051825201,11.18971581,-3.686784978,0.3557424102,2.8621093908,-3.331042568
22001,2012,879,617,-139,41,262,-98,14.199176157,9.9668847428,-2.245375979,0.662305145,4.2322914143,-1.583070834
22001,2013,883,690,66,49,193,115,14.21122091,11.105031062,1.0622203624,0.7886181479,3.1061898477,1.8508385103
22001,2014,920,601,31,44,319,75,14.726126068,9.6200019208,0.4962064219,0.7042929859,5.1061241476,1.2004994078
22001,2015,901,676,-246,55,225,-191,14.374601149,10.784939375,-3.924696873,0.8774728781,3.5896617741,-3.047223995
22001,2016,932,653,-234,59,279,-175,14.853063046,10.40670619,-3.729202524,0.9402690126,4.446356856,-2.788933512
22001,2017,911,672,-508,59,239,-449,14.530664327,10.718558099,-8.102719515,0.9410638807,3.8121062286,-7.161655634
51001,2010,87,145,41,2,-58,43,NA,NA,NA,NA,NA,NA
51001,2011,473,465,19,54,8,73,14.253642514,14.012566108,0.5725564646,1.6272657415,0.2410764062,2.1998222062
51001,2012,457,425,-59,75,32,16,13.747255061,12.784646392,-1.774809734,2.2561140691,0.9626086695,0.4813043347
51001,2013,344,413,-292,59,-69,-233,10.388512238,12.472254519,-8.818155737,1.7817506455,-2.08374228,-7.036405092
51001,2014,380,406,-20,55,-26,35,11.527727218,12.316466448,-0.606722485,1.6684868341,-0.788739231,1.061764349
51001,2015,404,467,-54,69,-63,15,12.265468456,14.178152893,-1.639443804,2.09484486,-1.912684437,0.4554010565
51001,2016,363,443,-76,67,-80,-9,11.045352888,13.47959044,-2.312525674,2.0386739491,-2.434237551,-0.273851725
51001,2017,371,473,-237,66,-102,-171,11.351988128,14.473019904,-7.251809127,2.0194911494,-3.121031776,-5.232317978
16001,2010,1308,485,139,150,823,289,NA,NA,NA,NA,NA,NA
16001,2011,5152,2502,4324,504,2650,4828,12.970126164,6.2987685681,10.885641602,1.26881669,6.6713575961,12.154458292
16001,2012,5032,2551,4631,741,2481,5372,12.426072033,6.2994653727,11.43583855,1.8298329444,6.12660666,13.265671494
16001,2013,5043,2575,3990,675,2468,4665,12.225617554,6.2425074759,9.6728562441,1.6363854548,5.9831100778,11.309241699
16001,2014,4985,2659,6249,863,2326,7112,11.84506137,6.3181581108,14.84850321,2.0506094207,5.526903259,16.89911263
16001,2015,5187,2848,3827,964,2339,4791,12.085345325,6.6356397696,8.9166409404,2.2460522254,5.4497055551,11.162693166
16001,2016,5136,2914,8301,962,2222,9263,11.712162657,6.645101632,18.92964607,2.1937500926,5.0670610248,21.123396162
16001,2017,5170,2899,9322,946,2271,10268,11.474634842,6.4342294794,20.689854159,2.099614035,5.0404053631,22.789468194
19001,2010,10,16,4,0,-6,4,NA,NA,NA,NA,NA,NA
19001,2011,66,116,-85,0,-50,-85,8.6705202312,15.239096164,-11.16657909,0,-6.568575933,-11.16657909
19001,2012,80,104,-55,1,-24,-54,10.657430227,13.854659295,-7.326983281,0.1332178778,-3.197229068,-7.193765403
19001,2013,68,118,-31,0,-50,-31,9.1551666106,15.886906765,-4.173678896,0,-6.731740155,-4.173678896
19001,2014,72,102,12,0,-30,12,9.7600650671,13.826758845,1.6266775112,0,-4.066693778,1.6266775112
19001,2015,63,125,-167,0,-62,-167,8.6848635236,17.231872071,-23.02178109,0,-8.547008547,-23.02178109
19001,2016,74,104,-100,0,-30,-100,10.458624832,14.698607872,-14.1332768,0,-4.23998304,-14.1332768
19001,2017,70,91,65,0,-21,65,9.9544937429,12.940841866,9.2434584755,0,-2.986348123,9.2434584755
21001,2010,39,31,77,1,8,78,NA,NA,NA,NA,NA,NA
21001,2011,195,185,211,4,10,215,10.334410939,9.8044411469,11.182362605,0.2119879167,0.5299697917,11.394350522
21001,2012,179,187,-41,-2,-8,-43,9.4426713792,9.8646902118,-2.162846517,-0.105504708,-0.422018833,-2.268351225
21001,2013,231,203,140,10,28,150,12.145429691,10.673256395,7.3608664791,0.5257761771,1.4721732958,7.8866426562
21001,2014,221,182,94,5,39,99,11.523620816,9.4900406716,4.9014495776,0.2607154031,2.0335801439,5.1621649807
21001,2015,205,195,40,5,10,45,10.637193856,10.118306351,2.0755500208,0.2594437526,0.5188875052,2.3349937733
21001,2016,231,201,45,5,30,50,11.945083641,10.393774078,2.3269643457,0.258551594,1.5513095638,2.5855159397
21001,2017,221,223,104,5,-2,109,11.372993001,11.475916015,5.3519967065,0.257307534,-0.102923014,5.6093042404
29001,2010,68,29,-36,17,39,-19,NA,NA,NA,NA,NA,NA
29001,2011,243,205,-104,76,38,-28,9.4810768631,7.9984393289,-4.05774483,2.9652750683,1.4826375341,-1.092469762
29001,2012,274,219,-117,97,55,-20,10.681636551,8.5375124262,-4.561136776,3.7814552755,2.1441241253,-0.7796815
29001,2013,242,234,-43,78,8,35,9.4205578372,9.1091344376,-1.673900773,3.0363781459,0.3114233996,1.3624773731
29001,2014,242,214,-268,64,28,-204,9.4446395816,8.3518713656,-10.45935293,2.4977559224,1.0927682161,-7.961597003
29001,2015,274,230,-312,67,44,-245,10.771287051,9.0415913201,-12.26511518,2.6338548628,1.7296957308,-9.631260319
29001,2016,272,213,-246,68,59,-178,10.759068075,8.4252996321,-9.730627744,2.6897670187,2.3337684427,-7.040860725
29001,2017,265,196,20,68,69,88,10.4743083,7.7470355731,0.790513834,2.6877470356,2.7272727273,3.4782608696
40001,2010,63,25,19,0,38,19,NA,NA,NA,NA,NA,NA
40001,2011,232,196,-218,0,36,-218,10.243503985,8.6539947458,-9.625361503,0,1.589509239,-9.625361503
40001,2012,282,251,-287,5,31,-282,12.569085398,11.187377429,-12.79194152,0.2228561241,1.3817079693,-12.5690854
40001,2013,352,227,-131,2,125,-129,15.776971001,10.174353458,-5.871543185,0.0896418807,5.6026175429,-5.781901304
40001,2014,316,240,-151,5,76,-146,14.186625962,10.77465263,-6.77905228,0.2244719298,3.4119733327,-6.55458035
40001,2015,314,268,-182,6,46,-176,14.160409479,12.085954587,-8.207625877,0.2705810729,2.0744548919,-7.937044804
40001,2016,297,277,-25,8,20,-17,13.432835821,12.528267752,-1.130710086,0.3618272275,0.9045680687,-0.768882858
40001,2017,295,267,-238,8,28,-230,13.402998637,12.130849614,-10.8132667,0.3634711495,1.2721490232,-10.44979555
08001,2010,1806,670,699,84,1136,783,NA,NA,NA,NA,NA,NA
08001,2011,7291,2470,2310,625,4821,2935,16.290644219,5.5188439474,5.1613479832,1.3964686102,10.771800271,6.5578165934
08001,2012,6927,2732,3489,680,4195,4169,15.202391299,5.9958038152,7.6571594111,1.4923669818,9.2065874834,9.1495263929
08001,2013,7168,2793,4380,688,4375,5068,15.42769452,6.0113770638,9.4270789615,1.4807831793,9.4163174558,10.907862141
08001,2014,7041,2681,4948,697,4360,5645,14.840888851,5.6509619387,10.429302377,1.4691236372,9.1899269127,11.898426014
08001,2015,7370,2938,4967,877,4432,5844,15.206693421,6.0620441345,10.248527303,1.8095346174,9.1446492866,12.05806192
08001,2016,7221,3054,2488,905,4167,3393,14.629002539,6.1870895659,5.0404318402,1.8334368229,8.4419129735,6.8738686631
08001,2017,7016,3048,900,901,3968,1801,14.024118445,6.0925759723,1.7989889682,1.8009878448,7.9315424731,3.599976813
16003,2010,7,3,-22,0,4,-22,NA,NA,NA,NA,NA,NA
16003,2011,18,38,40,0,-20,40,4.5322925847,9.5681732343,10.071761299,0,-5.03588065,10.071761299
16003,2012,33,28,-79,0,5,-79,8.3671399594,7.0993914807,-20.03042596,0,1.2677484787,-20.03042596
16003,2013,32,36,-41,0,-4,-41,8.2368082368,9.2664092664,-10.55341055,0,-1.02960103,-10.55341055
16003,2014,25,34,26,0,-9,26,6.4557779212,8.7798579729,6.7140090381,0,-2.324080052,6.7140090381
16003,2015,28,38,17,0,-10,17,7.2062797581,9.7799511002,4.3752412817,0,-2.573671342,4.3752412817
16003,2016,33,29,57,-1,4,56,8.4205154376,7.3998468997,14.544526665,-0.255167134,1.0206685379,14.28935953
16003,2017,30,24,192,-1,6,191,7.4110671937,5.9288537549,47.43083004,-0.247035573,1.4822134387,47.183794466
17001,2010,201,153,19,5,48,24,NA,NA,NA,NA,NA,NA
17001,2011,812,769,-6,8,43,2,12.086300952,11.446262847,-0.089307643,0.1190768567,0.6400381046,0.0297692142
17001,2012,806,797,-82,16,9,-66,11.999404496,11.865416108,-1.220783088,0.2382015781,0.1339883877,-0.98258151
17001,2013,809,784,-190,24,25,-166,12.062474373,11.689715585,-2.832966787,0.3578484363,0.3727587878,-2.475118351
17001,2014,852,755,-101,31,97,-70,12.715279229,11.267647673,-1.507327702,0.4626451363,1.4476315554,-1.044682566
17001,2015,828,828,-26,32,0,6,12.355442811,12.355442811,-0.387972842,0.4775050362,0,0.0895321943
17001,2016,834,822,-386,35,12,-351,12.476905009,12.297381196,-5.774682654,0.5236111215,0.1795238131,-5.251071533
17001,2017,815,803,-483,35,12,-448,12.264214827,12.083637431,-7.268240198,0.5266840723,0.1805773962,-6.741556126
18001,2010,183,59,-63,1,124,-62,NA,NA,NA,NA,NA,NA
18001,2011,635,316,-411,7,319,-404,18.4531334,9.1829766212,-11.94368162,0.2034203682,9.270156779,-11.74026125
18001,2012,679,316,-341,5,363,-336,19.745547074,9.1893856779,-9.916394039,0.1454016721,10.556161396,-9.770992366
18001,2013,676,314,-122,8,362,-114,19.579447373,9.0945953774,-3.533568905,0.2317094364,10.484851996,-3.301859468
18001,2014,701,310,-284,4,391,-280,20.198236616,8.9321731113,-8.183023108,0.1152538466,11.266063505,-8.067769262
18001,2015,650,325,-135,4,325,-131,18.646814981,9.3234074903,-3.872800034,0.1147496306,9.3234074903,-3.758050404
18001,2016,668,267,-125,3,401,-122,19.035135212,7.6083549426,-3.561963924,0.0854871342,11.42678027,-3.47647679
18001,2017,666,248,-162,3,418,-159,18.834042674,7.0132771517,-4.581253623,0.0848380301,11.820765522,-4.496415593
19003,2010,16,20,-2,0,-4,-2,NA,NA,NA,NA,NA,NA
19003,2011,32,45,-16,0,-13,-16,7.9830360484,11.226144443,-3.991518024,0,-3.243108395,-3.991518024
19003,2012,51,52,-85,0,-1,-85,12.906491206,13.159559661,-21.51081868,0,-0.253068455,-21.51081868
19003,2013,54,53,-18,0,1,-18,13.844378926,13.588001538,-4.614792975,0,0.2563773875,-4.614792975
19003,2014,53,47,-22,0,6,-22,13.642213642,12.097812098,-5.662805663,0,1.5444015444,-5.662805663
19003,2015,41,63,-104,0,-22,-104,10.745642773,16.511597432,-27.2572402,0,-5.765954659,-27.2572402
19003,2016,41,32,-47,0,9,-47,10.97871201,8.5687508368,-12.58535279,0,2.4099611728,-12.58535279
19003,2017,33,39,-24,0,-6,-24,8.9165090516,10.537692516,-6.484733856,0,-1.621183464,-6.484733856
28001,2010,81,66,221,1,15,222,NA,NA,NA,NA,NA,NA
28001,2011,403,410,-181,33,-7,-148,12.404007449,12.619461672,-5.571030641,1.0157127687,-0.215454224,-4.555317872
28001,2012,395,398,-306,69,-3,-237,12.231374249,12.324270762,-9.475444355,2.1366198055,-0.092896513,-7.338824549
28001,2013,313,445,-15,87,-132,72,9.737734499,13.844382914,-0.466664593,2.7066546371,-4.106648415,2.2399900445
28001,2014,395,426,-223,105,-31,-118,12.329686451,13.29733273,-6.960810326,3.2775115883,-0.967646278,-3.683298737
28001,2015,411,405,-701,123,6,-578,12.973075345,12.783687384,-22.1268268,3.8824532054,0.1893879612,-18.2443736
28001,2016,376,402,-62,128,-26,66,11.966900064,12.794398472,-1.973265436,4.0738383195,-0.827498409,2.1005728835
28001,2017,374,421,-517,128,-47,-389,11.978924779,13.484297679,-16.5591019,4.0997389619,-1.5053729,-12.45936294
31001,2010,103,104,-38,-4,-1,-42,NA,NA,NA,NA,NA,NA
31001,2011,399,293,-230,5,106,-225,12.7618743,9.3715016792,-7.356468895,0.1599232368,3.3903726211,-7.196545658
31001,2012,402,289,49,6,113,55,12.848581702,9.2369157012,1.5661206552,0.1917698761,3.6116660008,1.7578905314
31001,2013,412,275,46,1,137,47,13.096827516,8.7418144828,1.4622671499,0.0317884163,4.3550130333,1.4940555662
31001,2014,410,304,-292,23,106,-269,13.029522992,9.660914609,-9.279562716,0.7309244605,3.3686083834,-8.548638256
31001,2015,410,334,64,27,76,91,13.029108936,10.613957036,2.0338121266,0.8580144909,2.4151519003,2.8918266175
31001,2016,415,322,-11,27,93,16,13.131664715,10.188906117,-0.348068221,0.8543492706,2.9427585989,0.5062810493
31001,2017,401,308,-102,30,93,-72,12.662824663,9.7260598405,-3.220967869,0.947343491,2.936764822,-2.273624378
38001,2010,8,6,6,0,2,6,NA,NA,NA,NA,NA,NA
38001,2011,19,23,-35,0,-4,-35,8.149260133,9.8648938452,-15.01179498,0,-1.715633712,-15.01179498
38001,2012,17,28,29,3,-11,32,7.3181231167,12.053379251,12.483857081,1.2914334912,-4.735256134,13.775290573
38001,2013,35,38,54,4,-3,58,14.811680068,16.081252645,22.85230639,1.6927634363,-1.269572577,24.545069826
38001,2014,22,31,4,5,-9,9,9.2030955867,12.967998327,1.6732901067,2.0916126333,-3.76490274,3.76490274
38001,2015,25,31,4,5,-6,9,10.455876202,12.965286491,1.6729401924,2.0911752405,-2.509410289,3.7641154329
38001,2016,21,22,-50,6,-1,-44,8.8588905294,9.2807424594,-21.0925965,2.5311115798,-0.42185193,-18.56148492
38001,2017,22,31,-26,6,-9,-20,9.4299185598,13.287612516,-11.14444921,2.5717959709,-3.857693956,-8.572653236
39001,2010,91,103,12,-1,-12,11,NA,NA,NA,NA,NA,NA
39001,2011,352,304,-126,-5,48,-131,12.348060969,10.664234473,-4.420044551,-0.175398593,1.6838264957,-4.595443145
39001,2012,333,326,-173,1,7,-172,11.732375013,11.485748511,-6.09519783,0.0352323574,0.2466265018,-6.059965472
39001,2013,366,338,-235,2,28,-233,12.979643946,11.986665721,-8.333924392,0.0709270161,0.9929782254,-8.262997376
39001,2014,315,329,-20,2,-14,-18,11.218148471,11.716732848,-0.712263395,0.0712263395,-0.498584377,-0.641037056
39001,2015,304,333,-119,2,-29,-117,10.861603873,11.897743716,-4.251746253,0.0714579202,-1.036139843,-4.180288333
39001,2016,348,337,-98,3,11,-95,12.485200732,12.090553582,-3.515947333,0.1076310408,0.3946471496,-3.408316292
39001,2017,322,341,-89,3,-19,-86,11.591489974,12.27545988,-3.20385903,0.1079952482,-0.683969905,-3.095863782
42001,2010,270,202,-13,2,68,-11,NA,NA,NA,NA,NA,NA
42001,2011,1053,923,-156,25,130,-131,10.378269697,9.0970018332,-1.537521437,0.2463976661,1.2812678638,-1.29112377
42001,2012,922,919,-275,46,3,-229,9.0977265551,9.068124408,-2.713530155,0.4538995895,0.0296021471,-2.259630565
42001,2013,1026,1021,-197,32,5,-165,10.144003322,10.094568608,-1.947727733,0.3163821699,0.049434714,-1.631345563
42001,2014,1026,967,73,55,59,128,10.143852884,9.5605319096,0.7217361214,0.5437737901,0.5833209748,1.2655099115
42001,2015,1015,1041,383,65,-26,448,10.006506694,10.262831003,3.7758542501,0.6408107735,-0.256324309,4.4166650236
42001,2016,1009,1029,-1,69,-20,68,9.9251921838,10.121925428,-0.009836662,0.6787296934,-0.196733244,0.6688930312
42001,2017,1016,998,567,73,18,640,9.959807862,9.7833545731,5.5582786001,0.7156161161,0.1764532889,6.2738947162
53001,2010,145,47,-37,-2,98,-39,NA,NA,NA,NA,NA,NA
53001,2011,424,116,-222,13,308,-209,22.505307856,6.1571125265,-11.78343949,0.6900212314,16.348195329,-11.09341826
53001,2012,401,97,-226,5,304,-221,21.178272466,5.1229237635,-11.93588423,0.2640682352,16.055348702,-11.671816
53001,2013,409,122,-129,5,287,-124,21.458551941,6.4008394544,-6.768100735,0.2623294858,15.057712487,-6.505771249
53001,2014,381,122,-210,0,259,-210,19.875841202,6.3644425896,-10.95518806,0,13.511398612,-10.95518806
53001,2015,384,144,-252,15,240,-237,20.001562622,7.5005859833,-13.12602547,0.7813110399,12.500976639,-12.34471443
53001,2016,348,127,-178,18,221,-160,18.095312378,6.6037490575,-9.255648285,0.9359644334,11.491563321,-8.319683852
53001,2017,357,123,-10,20,234,10,18.417251341,6.3454395378,-0.515889393,1.0317787866,12.071811804,0.5158893933
55001,2010,35,42,18,-1,-7,17,NA,NA,NA,NA,NA,NA
55001,2011,123,263,30,0,-140,30,5.9043778802,12.624807988,1.4400921659,0,-6.720430108,1.4400921659
55001,2012,123,229,-253,4,-106,-249,5.9702941462,11.115425687,-12.28036113,0.1941559072,-5.145131541,-12.08620522
55001,2013,145,255,99,5,-110,104,7.1000122414,12.486228425,4.8475945648,0.2448280083,-5.386216183,5.0924225731
55001,2014,132,285,-135,6,-153,-129,6.5098387335,14.055333629,-6.657789614,0.2959017606,-7.545494896,-6.361887853
55001,2015,138,232,-13,6,-94,-7,6.8713122713,11.551771355,-0.647297533,0.2987527074,-4.680459083,-0.348544825
55001,2016,129,267,98,5,-138,103,6.4453271378,13.340328262,4.8964500737,0.2498188813,-6.895001124,5.146268955
55001,2017,129,251,95,5,-122,100,6.4548411308,12.559419565,4.7535651739,0.2501876407,-6.1045784340000004,5.0037528146
50001,2010,90,57,-32,6,33,-26,NA,NA,NA,NA,NA,NA
50001,2011,322,311,-32,45,11,13,8.7415672381,8.4429422704,-0.868727179,1.2216475954,0.2986249678,0.3529204164
50001,2012,282,313,-67,48,-31,-19,7.6586730398,8.5005839059,-1.819613807,1.3036039217,-0.841910866,-0.516009886
50001,2013,329,304,-37,45,25,8,8.9376672417,8.2585131959999991,-1.005147988,1.2224772823,0.6791540457,0.2173292946
50001,2014,311,313,-7,60,-2,53,8.4401926861,8.4944704525,-0.189972183,1.6283329941,-0.054277766,1.4383608115
50001,2015,305,326,-105,65,-21,-40,8.2792692527,8.8493172996,-2.850240235,1.7644344309,-0.570048047,-1.085805804
50001,2016,322,293,-60,67,29,7,8.7438222995,7.956335198,-1.629283658,1.8193667518,0.7874871015,0.1900830935
50001,2017,315,317,-132,68,-2,-64,8.5574572127,8.6117902744,-3.58598207,1.8473240967,-0.054333062,-1.738657973
45003,2010,465,390,316,21,75,337,NA,NA,NA,NA,NA,NA
45003,2011,1928,1535,625,54,393,679,11.970768476,9.5306688853,3.8805655071,0.3352808598,2.4400995908,4.2158463669
45003,2012,1942,1540,888,63,402,951,11.96811379,9.4906772584,5.4725463672,0.3882549788,2.4774365311,5.860801346
45003,2013,1783,1682,590,89,101,679,10.917017199,10.298610728,3.6124734422,0.5449324345,0.6184064706,4.1574058767
45003,2014,1882,1694,229,82,188,311,11.479669639,10.332922619,1.3968354662,0.5001768918,1.1467470203,1.897012358
45003,2015,1928,1679,1019,114,249,1133,11.694558512,10.184213559,6.1808895871,0.6914832315,1.5103449531,6.8723728186
45003,2016,1979,1777,1064,108,202,1172,11.904761905,10.689621983,6.4005389928,0.6496787699,1.2151399216,7.0502177627
45003,2017,1980,1777,961,101,203,1062,11.817332685,10.605757667,5.735584197,0.6028033339,1.2115750177,6.3383875309
27001,2010,30,41,30,0,-11,30,NA,NA,NA,NA,NA,NA
27001,2011,116,212,51,3,-96,54,7.1611568972,13.087631571,3.1484396703,0.1852023335,-5.926474674,3.3336420039
27001,2012,137,196,-77,4,-59,-73,8.5037708327,12.16597871,-4.779491636,0.2482852798,-3.662207877,-4.531206356
27001,2013,104,207,-59,0,-103,-59,6.5152701644,12.9678935,-3.696162882,0,-6.452623336,-3.696162882
27001,2014,98,211,89,2,-113,91,6.1757570029,13.296782935,5.6085956455,0.1260358572,-7.121025932,5.7346315027
27001,2015,106,209,106,2,-103,108,6.6839018854,13.178636736,6.6839018854,0.1261113563,-6.494734851,6.8100132417
27001,2016,117,226,21,2,-109,23,7.3961691637,14.286617359,1.3275175422,0.1264302421,-6.890448195,1.4539477843
27001,2017,115,220,157,2,-105,159,7.2773295365,13.921847809,9.9351368454,0.1265622528,-6.644518272,10.061699098
12001,2010,695,357,-346,269,338,-77,NA,NA,NA,NA,NA,NA
12001,2011,2824,1763,-64,1259,1061,1195,11.354178812,7.0883205545,-0.2573185,5.0619373671,4.2658582577,4.8046188671
12001,2012,3003,1673,-553,1062,1330,509,11.976406121,6.6721703098,-2.205445416,4.2354123545,5.3042358112,2.0299669383
12001,2013,2823,1790,-1066,1075,1033,9,11.194429354,7.0981326756,-4.227156107,4.2628450426,4.0962966782,0.0356889352
12001,2014,2884,1837,811,1273,1047,2084,11.34287619,7.2249873651,3.1896922989,5.0067549895,4.1178888249,8.1964472885
12001,2015,2912,1859,1295,1373,1053,2668,11.301408407,7.2147384027,5.0258667194,5.3285830161,4.0866700043,10.354449736
12001,2016,2867,1970,2515,1395,897,3910,10.945547144,7.5210072805,9.6016920357,5.3257894194,3.4245398632,14.927481455
12001,2017,2893,2011,334,1390,882,1724,10.890576621,7.5703247786,1.2573289289,5.2325964407,3.3202518422,6.4899253696
37001,2010,479,389,175,30,90,205,NA,NA,NA,NA,NA,NA
37001,2011,1761,1456,927,135,305,1062,11.572317125,9.5680259704,6.0917308204,0.8871452651,2.0042911545,6.9788760855
37001,2012,1706,1497,330,99,209,429,11.138387611,9.7738371941,2.1545532893,0.6463659868,1.3645504165,2.8009192761
37001,2013,1799,1588,625,124,211,749,11.686067661,10.315439381,4.0599178922,0.8054877098,1.3706282804,4.865405602
37001,2014,1728,1549,957,151,179,1108,11.144252938,9.9898424778,6.1719039711,0.973832288,1.1544104606,7.1457362591
37001,2015,1779,1632,1362,184,147,1546,11.364253386,10.425217272,8.7004570615,1.1753921434,0.9390361146,9.8758492049
37001,2016,1841,1674,1581,188,167,1769,11.625630695,10.571051485,9.9837708469,1.1871909672,1.0545792103,11.170961814
37001,2017,1823,1604,2653,188,219,2841,11.332976911,9.9715276828,16.492807321,1.1687326711,1.3614492285,17.661539992
06001,2010,4876,2150,-1595,2110,2726,515,NA,NA,NA,NA,NA,NA
06001,2011,19222,9074,-1249,10100,10148,8851,12.622729647,5.9587269181,-0.820195054,6.6324820225,6.6640027292,5.8122869685
06001,2012,18974,9214,4127,10562,9760,14689,12.285426709,5.965949283,2.6721806697,6.8387623537,6.3194774258,9.5109430234
06001,2013,19470,9634,5802,10582,9836,16384,12.402917074,6.137118803,3.6960310665,6.7410204664,6.2657982714,10.437051533
06001,2014,19496,9300,6392,11941,10196,18333,12.205948459,5.8224928534,4.0018682063,7.4759556088,6.3834556057,11.477823815
06001,2015,19501,9720,2848,12964,9781,15812,12.005369511,5.9839080891,1.7533096953,7.9810066325,6.0214614218,9.7343163277
06001,2016,19592,10459,-6177,13145,9133,6968,11.908665785,6.3573262274,-3.754584961,7.9899658914,5.5513395577,4.2353809305
06001,2017,19483,10786,-11730,13016,8697,1286,11.749395283,6.5045925946,-7.073880135,7.8494137967,5.2448026882,0.7755336618
08003,2010,75,15,371,3,60,374,NA,NA,NA,NA,NA,NA
08003,2011,232,131,82,-3,101,79,14.475572471,8.1737068697,5.1163661322,-0.187184127,6.3018656018,4.9291820054
08003,2012,210,122,-115,1,88,-114,13.039833587,7.5755223695,-7.14086125,0.0620944457,5.4643112174,-7.078766804
08003,2013,225,147,35,-4,78,31,13.935340022,9.1044221479,2.167719559,-0.247739378,4.8309178744,1.9199801808
08003,2014,242,127,-97,-4,115,-101,14.932280258,7.8363619535,-5.985252831,-0.24681455,7.0959183044,-6.23206738
08003,2015,215,133,14,-3,82,11,13.223445476,8.1800848761,0.8610615659,-0.184513193,5.0433606003,0.6765483732
08003,2016,199,140,96,-3,59,93,12.148591313,8.5467476573,5.860626965,-0.183144593,3.6018436556,5.6774823723
08003,2017,211,125,12,-3,86,9,12.785166783,7.5741509377,0.72711849,-0.181779623,5.2110158451,0.5453388675
36001,2010,784,562,-597,275,222,-322,NA,NA,NA,NA,NA,NA
36001,2011,3092,2688,-950,1297,404,347,10.155301892,8.8284125115,-3.120160672,4.259840412,1.3268893805,1.1396797401
36001,2012,3126,2801,-117,1218,325,1101,10.231702567,9.1679459022,-0.382952399,3.9866326701,1.0637566648,3.6036802708
36001,2013,3197,2655,-502,1206,542,704,10.420129722,8.653564095,-1.63619178,3.9307714872,1.7665656269,2.2945797073
36001,2014,3170,2619,-1037,1295,551,258,10.29874482,8.5086475344,-3.369021571,4.2072159439,1.7900972858,0.8381943734
36001,2015,3131,2677,-1405,1372,454,-33,10.152514701,8.6803838565,-4.555823429,4.4488183232,1.4721308445,-0.107005105
36001,2016,3080,2687,-1318,1406,393,88,9.9728337419,8.7003260599,-4.267595738,4.5525338445,1.272507682,0.2849381069
36001,2017,3078,2727,-1205,1387,351,182,9.9500235982,8.8153717843,-3.895314632,4.4836526091,1.1346518138,0.5883379775
56001,2010,103,31,45,13,72,58,NA,NA,NA,NA,NA,NA
56001,2011,413,189,144,74,224,218,11.266299307,5.1557640897,3.9282012112,2.0186589558,6.1105352174,5.9468601669
56001,2012,443,192,93,102,251,195,11.938287408,5.1741561679,2.5062318938,2.7487704642,6.7641312403,5.255002358
56001,2013,410,189,-94,116,221,22,10.947199786,5.0463920967,-2.509845805,3.0972565249,5.9008076897,0.5874107202
56001,2014,427,198,-164,155,229,-9,11.331369583,5.2543587294,-4.352095109,4.1132606215,6.0770108537,-0.238834488
56001,2015,414,178,-161,171,236,10,10.919305279,4.6947737673,-4.246396497,4.5101478326,6.2245315117,0.2637513352
56001,2016,389,177,-441,176,212,-265,10.233745051,4.6564855373,-11.6017521,4.6301777094,5.5772595136,-6.971574392
56001,2017,393,198,-23,173,195,150,10.298877082,5.188747232,-0.602733264,4.5336023795,5.1101298497,3.9308691152
51003,2010,295,203,73,72,92,145,NA,NA,NA,NA,NA,NA
51003,2011,1106,694,393,255,412,648,11.089220095,6.9583352133,3.940382909,2.556737002,4.1308848817,6.497119911
51003,2012,1060,733,614,283,327,897,10.508835849,7.2669591296,6.0871935956,2.8056608918,3.2418767195,8.8928544873
51003,2013,1098,807,237,351,291,588,10.77394824,7.9185575862,2.3255243469,3.4441309947,2.8553906537,5.7696553416
51003,2014,1159,767,693,403,392,1096,11.242385442,7.4399565437,6.7221510883,3.9091297094,3.8024288985,10.631280798
51003,2015,1129,846,668,434,283,1102,10.801088719,8.0936413254,6.3907238834,4.1520571338,2.7074473937,10.542781017
51003,2016,1036,860,576,450,176,1026,9.7903485685,8.1271233291,5.4432826018,4.2525645327,1.6632252394,9.6958471345
51003,2017,1050,884,670,447,166,1117,9.8075387281,8.2570135578,6.2581437598,4.1752093442,1.5505251703,10.433353104
26001,2010,20,66,-17,0,-46,-17,NA,NA,NA,NA,NA,NA
26001,2011,61,176,-23,2,-115,-21,5.6439674315,16.284233901,-2.128053294,0.1850481125,-10.64026647,-1.943005181
26001,2012,59,200,-32,5,-141,-27,5.5375662865,18.771411141,-3.003425783,0.4692852785,-13.23384485,-2.534140504
26001,2013,66,182,91,3,-116,94,6.25,17.234848485,8.6174242424,0.2840909091,-10.98484848,8.9015151515
26001,2014,66,179,8,4,-113,12,6.2860136197,17.048430878,0.7619410448,0.3809705224,-10.76241726,1.1429115672
26001,2015,52,198,25,4,-146,29,5.0045714836,19.055868341,2.4060439825,0.3849670372,-14.05129686,2.7910110197
26001,2016,61,165,151,4,-104,155,5.8894520879,15.930485156,14.578807627,0.3861935795,-10.04103307,14.965001207
26001,2017,55,165,73,4,-110,77,5.3052956497,15.915886949,7.0415742259,0.3858396836,-10.6105913,7.4274139095
28003,2010,108,78,21,-1,30,20,NA,NA,NA,NA,NA,NA
28003,2011,446,442,164,-1,4,163,11.993761093,11.886193729,4.4102619265,-0.026891841,0.10756736410000001,4.3833700855
28003,2012,439,448,-61,9,-9,-52,11.789982543,12.031690614,-1.638243588,0.2417080704,-0.24170807,-1.396535518
28003,2013,437,465,96,8,-28,104,11.735481705,12.487411883,2.5780463243,0.2148371937,-0.751930178,2.792883518
28003,2014,438,467,-5,1,-29,-4,11.756968957,12.535398408,-0.134211974,0.0268423949,-0.778429451,-0.10736958
28003,2015,454,476,35,7,-22,42,12.190373901,12.781096865,0.9397865342,0.1879573068,-0.590722964,1.127743841
28003,2016,432,464,15,8,-32,23,11.598872332,12.45804806,0.4027386226,0.2147939321,-0.859175728,0.6175325547
28003,2017,443,445,-33,8,-2,-25,11.900604433,11.954331766,-0.886501007,0.2149093351,-0.053727334,-0.671591672
02013,2010,2,1,9,18,1,27,NA,NA,NA,NA,NA,NA
02013,2011,22,6,-4,81,16,77,6.8407960199,1.8656716418,-1.243781095,25.186567164,4.9751243781,23.94278607
02013,2012,15,4,-30,62,11,32,4.5689917758,1.2183978069,-9.137983552,18.885166007,3.3505939689,9.7471824551
02013,2013,15,7,-46,57,8,11,4.5262522631,2.1122510561,-13.88050694,17.1997586,2.414001207,3.3192516596
02013,2014,19,9,-81,69,10,-12,5.7151451346,2.7071740111000002,-24.3645661,20.755000752,3.0079711235,-3.609565348
02013,2015,10,7,-53,71,3,18,2.9980512667,2.0986358867,-15.88967171,21.286163993,0.89941538,5.39649228
02013,2016,14,6,-102,71,8,-31,4.1979010495,1.7991004498,-30.58470765,21.289355322,2.3988005997,-9.295352324
02013,2017,12,6,-31,71,6,40,3.5853002689,1.7926501344,-9.262025695,21.213026591,1.7926501344,11.951000896
02016,2010,5,0,-19,16,5,-3,NA,NA,NA,NA,NA,NA
02016,2011,28,5,-73,69,23,-4,5.0219711237,0.8967805578,-13.09299614,12.375571698,4.1251905659,-0.717424446
02016,2012,30,15,-2,91,15,89,5.3210358283,2.6605179142,-0.354735722,16.140475346,2.6605179142,15.785739624
02016,2013,40,16,-83,120,24,37,6.9923957696,2.7969583078,-14.50922122,20.977187309,4.1954374618,6.4679660869
02016,2014,37,16,-55,120,21,65,6.3842636528,2.7607626607,-9.490121646,20.705719955,3.6235009921,11.215598309
02016,2015,30,17,-163,125,13,-38,5.147121901,2.9167024106,-27.966029,21.446341254,2.2304194904,-6.519687741
02016,2016,31,11,-219,127,20,-92,5.3610030264,1.9022913965,-37.87289235,21.96281885,3.4587116299,-15.9100735
02016,2017,34,8,-137,126,26,-11,5.9079061685,1.3900955691,-23.80538662,21.894005213,4.5178105995,-1.911381407
17003,2010,30,38,-26,1,-8,-25,NA,NA,NA,NA,NA,NA
17003,2011,107,111,-213,-1,-4,-214,13.21232327,13.706241897,-26.30116688,-0.123479657,-0.493918627,-26.42464654
17003,2012,101,82,-301,0,19,-301,12.860508054,10.441204558,-38.32686064,0,2.4193034953,-38.32686064
17003,2013,95,97,-495,0,-2,-495,12.7090301,12.976588629,-66.22073579,0,-0.267558528,-66.22073579
17003,2014,112,116,-153,0,-4,-153,15.64901495,16.207908341,-21.37767221,0,-0.558893391,-21.37767221
17003,2015,99,103,-321,0,-4,-321,14.307392153,14.885468603,-46.39063516,0,-0.578076451,-46.39063516
17003,2016,82,66,-284,0,16,-284,12.377358491,9.9622641509,-42.86792453,0,2.4150943396,-42.86792453
17003,2017,70,81,-168,0,-11,-168,10.932375449,12.650320162,-26.23770108,0,-1.717944713,-26.23770108
37003,2010,80,57,26,5,23,31,NA,NA,NA,NA,NA,NA
37003,2011,353,331,-230,5,22,-225,9.5045772752,8.9122240172,-6.19278406,0.1346257404,0.5923532579,-6.05815832
37003,2012,363,365,-103,7,-2,-96,9.8135957501,9.8676651482,-2.784574001,0.1892428933,-0.054069398,-2.595331107
37003,2013,374,364,130,15,10,145,10.103875404,9.8337183072,3.5120422526,0.4052356445,0.2701570964,3.9172778971
37003,2014,348,339,-25,23,9,-2,9.3822034698,9.1395602766,-0.67400887,0.6200881604,0.2426431932,-0.05392071
37003,2015,350,402,0,23,-52,23,9.4403236682,10.842886042,0,0.6203641268,-1.402562374,0.6203641268
37003,2016,340,380,227,24,-40,251,9.1486384673,10.224948875,6.108061565,0.6457862448,-1.076310408,6.7538478097
37003,2017,344,378,28,24,-34,52,9.2279628735,10.140028972,0.7511132571,0.6438113633,-0.912066098,1.3949246204
51510,2010,641,210,-30,404,431,374,NA,NA,NA,NA,NA,NA
51510,2011,2687,743,8,1781,1944,1789,18.828327278,5.2063443124,0.0560575431,12.479810526,13.621982966,12.535868069
51510,2012,2672,682,-1169,2115,1990,946,18.293476103,4.6692180771,-8.003395795,14.480053128,13.624258026,6.4766573328
51510,2013,2854,734,-1467,2094,2120,627,19.167483781,4.9295490873,-9.852382168,14.063318513,14.237934694,4.2109363457
51510,2014,2721,726,-2638,2198,1995,-440,18.0141412,4.8064191515,-17.464647,14.551665696,13.207722049,-2.912981304
51510,2015,2811,678,-2247,2420,2133,173,18.374950974,4.4319518891,-14.68819454,15.819061315,13.942999085,1.13086678
51510,2016,2861,805,-1356,2458,2056,1102,18.373900199,5.1698670606,-8.708496564,15.785755571,13.204033139,7.0772590071
51510,2017,2842,794,-1697,2412,2048,715,17.912347986,5.0043646379,-10.69572644,15.202175701,12.907983348,4.5064492646
40003,2010,13,28,5,-1,-15,4,NA,NA,NA,NA,NA,NA
40003,2011,47,75,42,-1,-28,41,8.3392476934,13.307310149,7.4520936835,-0.177430802,-4.968062456,7.2746628815
40003,2012,57,68,30,-1,-11,29,10.083141695,12.029011145,5.3069166814,-0.176897223,-1.94586945,5.1300194587
40003,2013,65,81,202,-2,-16,200,11.291583427,14.071050117,35.090766959,-0.347433336,-2.77946669,34.743333623
40003,2014,60,74,-21,-1,-14,-22,10.288947955,12.689702478,-3.601131784,-0.171482466,-2.400754523,-3.77261425
40003,2015,69,55,73,0,14,73,11.780775141,9.3904729384,12.463718627,0,2.3903022025,12.463718627
40003,2016,62,39,-11,0,23,-11,10.495133305,6.6017774016,-1.86203978,0,3.8933559035,-1.86203978
40003,2017,63,47,-22,0,16,-22,10.658996701,7.9519499196,-3.722189324,0,2.7070467812,-3.722189324
26003,2010,14,15,-21,0,-1,-21,NA,NA,NA,NA,NA,NA
26003,2011,53,97,-22,1,-44,-21,5.5520636916,10.161324115,-2.304630212,0.1047559187,-4.609260423,-2.199874293
26003,2012,58,121,-4,-2,-63,-6,6.11975732,12.767079926,-0.422052229,-0.211026114,-6.647322606,-0.633078343
26003,2013,58,104,34,0,-46,34,6.1463466328,11.021035341,3.6030307847,0,-4.874688709,3.6030307847
26003,2014,60,117,-17,1,-57,-16,6.3873955395,12.455421302,-1.80976207,0.1064565923,-6.068025762,-1.703305477
26003,2015,58,139,-29,1,-81,-28,6.2358886141,14.94462961,-3.117944307,0.1075153209,-8.708740996,-3.010428986
26003,2016,60,119,-74,2,-59,-72,6.5355917434,12.962256958,-8.06056315,0.2178530581,-6.426665214,-7.842710092
26003,2017,57,117,64,2,-60,66,6.2513709147,12.831761351,7.0190831323,0.2193463479,-6.580390436,7.2384294801
19005,2010,50,21,1,16,29,17,NA,NA,NA,NA,NA,NA
19005,2011,159,170,-168,13,-11,-155,11.126272699,11.896014835,-11.75606172,0.9096952521,-0.769742136,-10.84636647
19005,2012,163,155,-98,18,8,-80,11.501552357,10.93705899,-6.915043748,1.2701100762,0.5644933672,-5.644933672
19005,2013,199,169,-130,14,30,-116,14.11998439,11.991343527,-9.224110406,0.993365736,2.1286408628,-8.23074467
19005,2014,173,154,-45,21,19,-24,12.315358605,10.96280477,-3.203416978,1.4949279230999999,1.3525538352,-1.708489055
19005,2015,181,167,-235,25,14,-210,12.976770863,11.97304273,-16.84829366,1.7923716662,1.0037281331,-15.055922
19005,2016,191,159,-40,26,32,-14,13.780166661,11.471447639,-2.885898777,1.8758342051,2.3087190217,-1.010064572
19005,2017,192,167,-36,26,25,-10,13.836342017,12.034734984,-2.594314128,1.8736713148,1.8016070335,-0.720642813
26005,2010,338,192,-41,16,146,-25,NA,NA,NA,NA,NA,NA
26005,2011,1356,908,-888,39,448,-849,12.180060092,8.1559694421,-7.976322538,0.3503114628,4.0240906498,-7.626011075
26005,2012,1347,917,-152,42,430,-110,12.103241458,8.2395489364,-1.36577038,0.3773839207,3.863692522,-0.988386459
26005,2013,1301,928,80,56,373,136,11.647582299,8.3081909093,0.7162233543,0.501356348,3.3393913892,1.2175797022
26005,2014,1363,915,831,66,448,897,12.102860999,8.124811309,7.3789269921,0.5860519633,3.9780496901,7.9649789554
26005,2015,1392,1047,393,71,345,464,12.244090159,9.2094557449,3.45684442,0.6245189665,3.0346344145,4.0813633865
26005,2016,1386,939,351,74,447,425,12.102689487,8.1994411457,3.064966818,0.6461753406,3.9032483409,3.7111421586
26005,2017,1356,919,987,73,437,1060,11.719864133,7.9428872698,8.5306090699,0.6309366384,3.7769768628,9.1615457083
24001,2010,193,182,-96,6,11,-90,NA,NA,NA,NA,NA,NA
24001,2011,702,908,-245,64,-206,-181,9.3874112408,12.142121662,-3.276233268,0.8558323638,-2.754710421,-2.420400904
24001,2012,676,911,-458,68,-235,-390,9.1014964961,12.265478266,-6.166398514,0.9155351505,-3.16398177,-5.250863363
24001,2013,678,898,-203,72,-220,-131,9.1891086023,12.170825258,-2.751311278,0.9758345418,-2.981716656,-1.7754767360000001
24001,2014,710,910,-436,77,-200,-359,9.6829845413,12.410585821,-5.946170789,1.0501264925,-2.727601279,-4.896044296
24001,2015,635,964,-296,83,-329,-213,8.7259435356,13.246944202,-4.067526435,1.1405563991,-4.521000666,-2.926970036
24001,2016,685,870,-203,84,-185,-119,9.4683880242,12.025543914,-2.805960247,1.1610869986,-2.55715589,-1.644873248
24001,2017,670,860,-473,84,-190,-389,9.3179147341,11.960308465,-6.578169656,1.1682161756,-2.642393731,-5.40995348
36003,2010,120,75,-5,15,45,10,NA,NA,NA,NA,NA,NA
36003,2011,540,471,-300,64,69,-236,11.046220249,9.6347587731,-6.136789027,1.3091816592,1.4114614763,-4.827607368
36003,2012,465,471,-648,61,-6,-587,9.5847633182,9.7084376836,-13.35683146,1.2573560482,-0.123674365,-12.09947541
36003,2013,496,489,-358,54,7,-304,10.316354333,10.170760623,-7.446078329,1.1231514799,0.1455937104,-6.32292685
36003,2014,493,446,-346,60,47,-286,10.311003284,9.3280070274,-7.236525631,1.2548888378,0.9829962562,-5.981636793
36003,2015,501,513,-377,65,-12,-312,10.540045863,10.792502051,-7.931331917,1.3674710201,-0.252456188,-6.563860897
36003,2016,496,445,-381,67,51,-314,10.499354374,9.4197836625,-8.065028259,1.4182595627,1.0795707119,-6.646768697
36003,2017,487,441,-331,67,46,-264,10.361261223,9.3825794647,-7.042253521,1.4254712565,0.9786817582,-5.616782265
37005,2010,25,48,10,2,-23,12,NA,NA,NA,NA,NA,NA
37005,2011,92,135,-77,4,-43,-73,8.3010015339,12.180817468,-6.947577371,0.3609131102,-3.879815934,-6.586664261
37005,2012,84,122,-35,3,-38,-32,7.6429643783,11.100495883,-3.184568491,0.2729630135,-3.457531504,-2.911605477
37005,2013,87,114,-9,2,-27,-7,7.9539221064,10.422380691,-0.822819528,0.1828487841,-2.468458585,-0.639970744
37005,2014,101,112,1,2,-11,3,9.2528972562,10.260638542,0.0916128441,0.1832256882,-1.007741285,0.2748385324
37005,2015,97,135,-3,2,-38,-1,8.9072543618,12.396694215,-0.275482094,0.1836547291,-3.489439853,-0.091827365
37005,2016,102,136,108,2,-34,110,9.3517924269,12.469056569,9.9018978638,0.183368479,-3.117264142,10.085266343
37005,2017,96,135,121,4,-39,125,8.7368037859,12.286130324,11.012013105,0.3640334911,-3.549326538,11.376046596
51005,2010,30,75,-15,1,-45,-14,NA,NA,NA,NA,NA,NA
51005,2011,171,220,3,4,-49,7,10.569256444,13.597873787,0.1854255516,0.2472340689,-3.028617343,0.4326596205
51005,2012,151,211,-70,1,-60,-69,9.3823785262,13.110475954,-4.349446999,0.0621349571,-3.728097428,-4.287312042
51005,2013,156,238,-28,-1,-82,-29,9.7661752277,14.899677591,-1.752903246,-0.062603687,-5.133502363,-1.815506933
51005,2014,123,239,-197,-2,-116,-199,7.8043209289,15.164493512,-12.49960344,-0.126899527,-7.360172583,-12.62650297
51005,2015,148,200,-124,1,-52,-123,9.5382334934,12.889504721,-7.991492927,0.0644475236,-3.351271227,-7.927045403
51005,2016,135,224,33,1,-89,34,8.7659491575,14.544982306,2.1427875718,0.0649329567,-5.779033148,2.2077205286
51005,2017,140,263,-128,1,-123,-127,9.1821341903,17.249294943,-8.395094117,0.0655866728,-8.067160753,-8.329507444
42003,2010,3274,3142,41,525,132,566,NA,NA,NA,NA,NA,NA
42003,2011,13006,13821,2159,2608,-815,4767,10.609936761,11.274791325,1.7612527655,2.1275346051,-0.664854564,3.8887873705
42003,2012,13154,13548,757,2888,-394,3645,10.700237571,11.020740353,0.6157883413,2.3492691276,-0.320502783,2.9650574688
42003,2013,13394,13884,398,3241,-490,3639,10.868392161,11.265996473,0.3229520741,2.6298685228,-0.397604312,2.9528205969
42003,2014,13356,13273,-3969,3653,83,-316,10.826093512,10.758815452,-3.217188166,2.961045193,0.0672780594,-0.256142973
42003,2015,13272,14159,-6359,3898,-887,-2461,10.77477378,11.494878086,-5.162506515,3.1645621003,-0.720104306,-1.997944415
42003,2016,13285,13628,-6080,3938,-343,-2142,10.811338681,11.090472228,-4.9479066,3.2047460841,-0.279133547,-1.743160516
42003,2017,13149,13699,-7835,3895,-550,-3940,10.731245111,11.180114592,-6.394349794,3.1788120547,-0.448869481,-3.21553774
18003,2010,1345,580,-332,147,765,-185,NA,NA,NA,NA,NA,NA
18003,2011,5261,2844,-172,704,2417,532,14.722714285,7.9588290111,-0.48133565,1.9701180112,6.7638852742,1.4887823607
18003,2012,5206,2929,-1057,667,2277,-390,14.472608795,8.1425799385,-2.938445543,1.8542508771,6.3300288563,-1.084194666
18003,2013,5180,3023,-226,642,2157,416,14.313128703,8.35300928,-0.624472411,1.7739437505,5.9601194234,1.1494713399
18003,2014,5143,3031,-788,639,2112,-149,14.124192933,8.3240188176,-2.164080115,1.7548822252,5.8001741151,-0.40919789
18003,2015,5274,3231,-163,720,2043,557,14.395794266,8.8192664532,-0.444921211,1.9652961456,5.576527813,1.5203749348
18003,2016,5265,3093,-562,736,2172,174,14.275991659,8.3866366957,-1.523857039,1.995656194,5.8893549638,0.4717991546
18003,2017,5234,3067,21,733,2167,754,14.091692928,8.2573982061,0.0565390813,1.9734831709,5.8342947221,2.0300222522
20001,2010,31,26,-14,0,5,-14,NA,NA,NA,NA,NA,NA
20001,2011,154,185,13,1,-31,14,11.53730896,13.85975427,0.9739286785,0.0749175907,-2.32244531,1.0488462691
20001,2012,156,192,-10,3,-36,-7,11.714789922,14.418202981,-0.750948072,0.2252844216,-2.703413059,-0.52566365
20001,2013,135,197,-186,6,-62,-180,10.247457112,14.953696675,-14.11871869,0.4554425383,-4.706239563,-13.66327615
20001,2014,158,189,-152,6,-31,-146,12.183837138,14.574336829,-11.72115978,0.4626773597,-2.390499692,-11.25848242
20001,2015,135,183,-184,8,-48,-176,10.572066252,14.331023141,-14.40933474,0.6264928149,-3.758956889,-13.78284193
20001,2016,153,163,-7,8,-10,1,12.092949731,12.883338603,-0.55327221,0.6323110971,-0.790388871,0.0790388871
20001,2017,137,163,-110,8,-26,-102,10.887705635,12.953985536,-8.741953429,0.6357784312,-2.066279901,-8.106174998
21003,2010,67,19,31,1,48,32,NA,NA,NA,NA,NA,NA
21003,2011,248,216,103,1,32,104,12.330027096,10.739055858,5.120938673,0.0497178512,1.5909712382,5.1706565242
21003,2012,240,204,31,-5,36,26,11.875309253,10.094012865,1.5338941118,-0.247402276,1.7812963878999999,1.2864918357
21003,2013,265,224,43,-2,41,41,13.067705508,11.045909562,2.1204201391,-0.098624193,2.0217959465,2.0217959465
21003,2014,263,194,112,-1,69,111,12.887103097,9.5060760486,5.4880439044,-0.049000392,3.3810270482,5.4390435123
21003,2015,244,248,169,-1,-4,168,11.856459098,12.05082728,8.2120556865,-0.048592045,-0.194368182,8.163463641
21003,2016,264,231,36,-1,33,35,12.756396318,11.161846778,1.7395085888,-0.048319683,1.5945495398,1.6911889058
21003,2017,255,240,189,-1,15,188,12.241371034,11.521290385,9.0730161778,-0.048005377,0.720080649,9.0250108012
39003,2010,339,220,-80,10,119,-70,NA,NA,NA,NA,NA,NA
39003,2011,1319,1080,-680,42,239,-638,12.423413283,10.172317169,-6.404792292,0.3955901121,2.2510961143,-6.00920218
39003,2012,1221,1067,-933,27,154,-906,11.562062043,10.103783948,-8.834892618,0.2556721336,1.4582780955,-8.579220484
39003,2013,1289,1138,-361,5,151,-356,12.261126806,10.824796203,-3.433876476,0.047560616,1.4363306034,-3.38631586
39003,2014,1322,1064,-450,17,258,-433,12.598395182,10.139706863,-4.288409858,0.1620065946,2.4586883184,-4.126403263
39003,2015,1250,1108,-921,23,142,-898,11.96538653,10.60611862,-8.816096795,0.2201631121,1.3592679098,-8.595933683
39003,2016,1258,1117,-630,23,141,-607,12.112517391,10.754914091,-6.065887088,0.2214530207,1.3576033006,-5.844434067
39003,2017,1242,1074,-618,22,168,-596,12.010211581,10.385641898,-5.9760956180000004,0.2127412679,1.6245696824,-5.76335435
22003,2010,79,84,-43,4,-5,-39,NA,NA,NA,NA,NA,NA
22003,2011,351,248,-94,11,103,-83,13.641133263,9.6381796277,-3.653180988,0.4274999028,4.0029536357,-3.225681085
22003,2012,314,243,-187,6,71,-181,12.224320168,9.4602222958,-7.280088763,0.2335857357,2.7640978724,-7.046503027
22003,2013,351,231,-73,1,120,-72,13.682076869,9.0044437515,-2.845560147,0.038980276,4.6776331176,-2.806579871
22003,2014,325,279,6,1,46,7,12.645914397,10.856031128,0.233463035,0.0389105058,1.7898832685,0.2723735409
22003,2015,310,270,-136,4,40,-132,12.073061495,10.515247108,-5.296568914,0.1557814386,1.5578143864,-5.140787475
22003,2016,291,219,-18,3,72,-15,11.341491932,8.5353495986,-0.701535583,0.1169225972,2.8061423338,-0.584612986
22003,2017,283,234,-116,3,49,-113,11.03163311,9.1215623599,-4.521800144,0.1169431072,1.9100707506,-4.404857037
45005,2010,20,11,-79,0,9,-79,NA,NA,NA,NA,NA,NA
45005,2011,134,124,-133,1,10,-132,13.017291626,12.045851953,-12.92014766,0.0971439674,0.9714396736,-12.82300369
45005,2012,104,119,-238,-1,-15,-239,10.287862301,11.771688594,-23.54337719,-0.098921753,-1.483826293,-23.64229894
45005,2013,87,105,-141,0,-18,-141,8.7834427057,10.600706714,-14.23523473,0,-1.817264008,-14.23523473
45005,2014,96,116,-106,0,-20,-106,9.8325395606,11.880985302,-10.85676243,0,-2.048445742,-10.85676243
45005,2015,90,121,-253,0,-31,-253,9.4137335913,12.656241828,-26.4630511,0,-3.242508237,-26.4630511
45005,2016,76,101,-336,0,-25,-336,8.2255533308,10.931327453,-36.3656042,0,-2.705774122,-36.3656042
45005,2017,68,104,-22,0,-36,-22,7.5300370965,11.516527324,-2.436188472,0,-3.986490228,-2.436188472
26007,2010,65,113,-39,2,-48,-37,NA,NA,NA,NA,NA,NA
26007,2011,282,363,-100,4,-81,-96,9.5840130506,12.336867863,-3.398586188,0.1359434475,-2.752854812,-3.262642741
26007,2012,243,367,-47,1,-124,-46,8.308118365,12.547652016,-1.606920013,0.0341897875,-4.239533651,-1.572730225
26007,2013,254,372,-85,-2,-118,-87,8.7414392401,12.802422824,-2.925284785,-0.06883023,-4.060983584,-2.994115015
26007,2014,276,334,-17,1,-58,-16,9.5457139399,11.551697304,-0.587960641,0.0345859201,-2.005983364,-0.553374721
26007,2015,276,368,-73,1,-92,-72,9.5868285312,12.782438042,-2.535646677,0.034734886,-3.19560951,-2.500911791
26007,2016,262,362,52,1,-100,53,9.1349674,12.621596179,1.8130469649,0.0348662878,-3.486628779,1.8479132527
26007,2017,258,341,-113,1,-83,-112,9.0337715996,11.939984944,-3.956651902,0.0350146186,-2.906213344,-3.921637284
06003,2010,2,4,-13,0,-2,-13,NA,NA,NA,NA,NA,NA
06003,2011,5,8,-66,0,-3,-66,4.4365572316,7.0984915705,-58.56255546,0,-2.661934339,-58.56255546
06003,2012,5,6,17,0,-1,17,4.5392646391,5.447117567,15.433499773,0,-0.907852928,15.433499773
06003,2013,6,8,17,1,-2,18,5.364327224,7.1524362986,15.198927135,0.8940545373,-1.788109075,16.092981672
06003,2014,6,5,-46,1,1,-45,5.4274084125,4.5228403437,-41.61013116,0.9045680687,0.9045680687,-40.70556309
06003,2015,5,4,1,1,1,2,4.6040515654,3.6832412523,0.9208103131,0.9208103131,0.9208103131,1.8416206262
06003,2016,1,4,-26,0,-3,-26,0.9324009324,3.7296037296,-24.24242424,0,-2.797202797,-24.24242424
06003,2017,4,7,66,0,-3,66,3.6747818098,6.4308681672,60.633899862,0,-2.756086357,60.633899862
06005,2010,78,84,-221,3,-6,-218,NA,NA,NA,NA,NA,NA
06005,2011,264,441,-185,15,-177,-170,7.0005170836,11.694045583,-4.905665381,0.3977566525,-4.693528499,-4.507908728
06005,2012,280,426,-292,9,-146,-283,7.501573991,11.413109001,-7.823070019,0.2411220211,-3.91153501,-7.581947998
06005,2013,252,420,-340,24,-168,-316,6.8341763055,11.390293842,-9.220714063,0.6508739339,-4.556117537,-8.569840129
06005,2014,287,422,224,25,-135,249,7.8219751169,11.501301391,6.1049561888,0.6813567175,-3.679326274,6.7863129063
06005,2015,306,436,403,25,-130,428,8.2932447998,11.816518734,10.922149197,0.6775526797,-3.523273935,11.599701877
06005,2016,300,411,513,26,-111,539,8.0515297907,11.030595813,13.768115942,0.6977992485,-2.979066023,14.465915191
06005,2017,309,408,1217,25,-99,1242,8.121000276,10.722874151,31.984651572,0.6570388573,-2.601873875,32.64169043
51007,2010,39,13,19,3,26,22,NA,NA,NA,NA,NA,NA
51007,2011,147,127,-28,15,20,-13,11.530316103,9.961565613,-2.196250686,1.1765628677,1.5687504902,-1.019687819
51007,2012,134,142,2,3,-8,5,10.510216087,11.137691674,0.1568688968,0.2353033452,-0.627475587,0.392172242
51007,2013,137,157,-67,-1,-20,-68,10.784853972,12.359285208,-5.274344643,-0.078721562,-1.574431237,-5.353066205
51007,2014,128,119,51,0,9,51,10.088272383,9.3789407314,4.0195460277,0,0.709331652,4.0195460277
51007,2015,138,135,66,0,3,66,10.823104976,10.587820085,5.1762675973,0,0.2352848908,5.1762675973
51007,2016,139,126,33,0,13,33,10.853439525,9.8383696416,2.5767158585,0,1.0150698837,2.5767158585
51007,2017,142,138,183,0,4,183,10.986460348,10.676982592,14.15860735,0,0.3094777563,14.15860735
51009,2010,86,53,8,-1,33,7,NA,NA,NA,NA,NA,NA
51009,2011,340,362,-256,-2,-22,-258,10.542962572,11.225154268,-7.938230643,-0.062017427,-0.682191696,-8.00024807
51009,2012,331,352,340,3,-21,343,10.256251356,10.906950082,10.535122238,0.0929569609,-0.650698726,10.628079199
51009,2013,307,353,-239,6,-46,-233,9.5058211543,10.930146148,-7.40029725,0.1857815209,-1.424324994,-7.21451573
51009,2014,312,301,-130,4,11,-126,9.7203832074,9.3776773892,-4.05015967,0.1246202975,0.3427058182,-3.925539372
51009,2015,351,348,-420,7,3,-413,11.024388712,10.930163167,-13.19157624,0.2198596039,0.0942255445,-12.97171663
51009,2016,358,338,3,8,20,11,11.310323039,10.678461417,0.0947792433,0.2527446489,0.6318616223,0.3475238923
51009,2017,358,372,-66,8,-14,-58,11.318189722,11.760800493,-2.086593636,0.2529204407,-0.442610771,-1.833673195
28005,2010,31,11,-18,0,20,-18,NA,NA,NA,NA,NA,NA
28005,2011,143,132,-4,-1,11,-5,10.889845029,10.052164642,-0.30461105,-0.076152762,0.8376803869,-0.380763812
28005,2012,148,141,-213,-1,7,-214,11.356660528,10.819521179,-16.34438306,-0.076734193,0.5371393493,-16.421117250000002
28005,2013,126,152,-55,0,-26,-55,9.7746402389,11.791629495,-4.266708041,0,-2.016989256,-4.266708041
28005,2014,139,143,-249,-1,-4,-250,10.924237661,11.238604213,-19.56931782,-0.078591638,-0.314366551,-19.64790946
28005,2015,125,169,-6,-1,-44,-7,9.9427298759,13.442570792,-0.477251034,-0.079541839,-3.499840916,-0.556792873
28005,2016,115,163,-65,-1,-48,-66,9.2088404869,13.052530429,-5.204996797,-0.080076874,-3.843689942,-5.285073671
28005,2017,111,149,55,-1,-38,54,8.9239056156,11.978936367,4.4217550348,-0.080395546,-3.055030751,4.3413594887
02020,2010,1162,317,362,315,845,677,NA,NA,NA,NA,NA,NA
02020,2011,4783,1498,-1138,808,3285,-330,16.222880604,5.0808854579,-3.859844894,2.7405577103,11.141995146,-1.119287184
02020,2012,4588,1503,-2264,1397,3085,-867,15.426749001,5.0537061352,-7.612502123,4.6972903998,10.373042866,-2.915211723
02020,2013,4698,1578,-1670,1135,3120,-535,15.67042083,5.2635002277,-5.570370963,3.7858509242,10.406920602,-1.784520039
02020,2014,4792,1620,-5047,1003,3172,-4044,15.936758473,5.3876353768,-16.78481219,3.3356779524,10.549123096,-13.44913424
02020,2015,4643,1680,-6487,1164,2963,-5323,15.52027865,5.6157803428,-21.68426612,3.8909335232,9.9044983069,-17.7933326
02020,2016,4535,1798,-4316,927,2737,-3389,15.233610013,6.0396980823,-14.49796269,3.1139044062,9.1939119306,-11.38405829
02020,2017,4479,1773,-6537,786,2706,-5751,15.138610046,5.992577721,-22.09446168,2.6566080591,9.1460323254,-19.43785362
20003,2010,25,14,-10,0,11,-10,NA,NA,NA,NA,NA,NA
20003,2011,98,96,-41,-3,2,-44,12.127211979,11.879717857,-5.073629501,-0.371241183,0.247494122,-5.444870684
20003,2012,99,117,-123,-3,-18,-126,12.392814671,14.646053702,-15.39713338,-0.375539839,-2.253239031,-15.77267322
20003,2013,93,86,-68,-3,7,-71,11.793050976,10.905401978,-8.622875983,-0.380420999,0.8876489982,-9.003296982
20003,2014,99,85,18,-3,14,15,12.582613116,10.803253686,2.2877478393,-0.381291307,1.7793594306,1.9064565328
20003,2015,88,85,-65,-3,3,-68,11.210905153,10.828715205,-8.280782215,-0.382189948,0.3821899484,-8.662972164
20003,2016,87,92,5,-3,-5,2,11.131725417,11.771479752,0.6397543343,-0.383852601,-0.639754334,0.2559017337
20003,2017,82,99,40,-3,-17,37,10.481242411,12.65418291,5.1128011759,-0.383460088,-2.1729405,4.7293410877
21005,2010,44,68,31,1,-24,32,NA,NA,NA,NA,NA,NA
21005,2011,247,196,46,-1,51,45,11.502014017,9.1271042399,2.1420754849,-0.046566858,2.3749097767,2.0955086265
21005,2012,264,173,46,0,91,46,12.22816647,8.0131545427,2.1306653697,0,4.2150119271,2.1306653697
21005,2013,239,189,1,1,50,2,11.023222563,8.7171090561,0.0461222701,0.0461222701,2.3061135069,0.0922445403
21005,2014,253,220,84,6,33,90,11.624167241,10.107971514,3.8594073053,0.2756719504,1.5161957271,4.1350792557
21005,2015,251,215,0,6,36,6,11.490306484,9.842294399,0,0.2746686809,1.6480120854,0.2746686809
21005,2016,267,185,190,6,82,196,12.133881706,8.4073712195,8.6345974687000009,0.272671499,3.7265104865,8.9072689677
21005,2017,267,197,325,6,70,331,11.949516649,8.8166845686,14.545291801,0.268528464,3.1328320802,14.813820265
45007,2010,532,433,58,30,99,88,NA,NA,NA,NA,NA,NA
45007,2011,2234,1949,635,165,285,800,11.893892002,10.376542306,3.3807616031,0.8784656134,1.5173496959,4.2592272165
45007,2012,2176,1949,336,148,227,484,11.531225988,10.328290188,1.780556954,0.784292944,1.2029357993,2.564849898
45007,2013,2282,2024,829,123,258,952,12.033326302,10.672853828,4.3714406243,0.6485973423,1.3604724742,5.0200379667
45007,2014,2219,2022,1423,130,197,1553,11.611022885,10.580211029,7.445915081,0.6802311739,1.0308118559,8.1261462549
45007,2015,2299,2059,1547,148,240,1695,11.914756885,10.670937115,8.0174549374,0.7670221918,1.2438197705,8.7844771293
45007,2016,2314,2192,1773,156,122,1929,11.870045064,11.244225921,9.0948962397,0.8002277571,0.6258191434,9.8951239968
45007,2017,2303,2118,2448,156,185,2604,11.668824276,10.731467571,12.403509261,0.7904197078,0.9373567048,13.193928969
47001,2010,217,194,-5,13,23,8,NA,NA,NA,NA,NA,NA
47001,2011,807,877,105,36,-70,141,10.73959477,11.671158133,1.3973450444,0.4790897295,-0.931563363,1.8764347739
47001,2012,801,934,136,28,-133,164,10.653791672,12.422773311,1.80888348,0.3724171871,-1.768981639,2.181300667
47001,2013,823,923,127,42,-100,169,10.940220931,12.269530887,1.6882236431,0.5583101812,-1.329309955,2.2465338243
47001,2014,761,934,7,53,-173,60,10.120421041,12.421121226,0.093091915,0.7048387848,-2.300700184,0.7979306997
47001,2015,816,949,407,59,-133,466,10.837373,12.60375855,5.4054054054,0.7835845674,-1.76638555,6.1889899728
47001,2016,785,911,193,62,-126,255,10.394322184,12.062710204,2.5555467281,0.8209528349,-1.668388019,3.376499563
47001,2017,784,882,713,62,-98,775,10.326523623,11.617339076,9.3913409992,0.8166383478,-1.290815453,10.207979347
48001,2010,149,105,-3,0,44,-3,NA,NA,NA,NA,NA,NA
48001,2011,593,640,-47,-15,-47,-62,10.147680408,10.951965364,-0.804284956,-0.256686688,-0.804284956,-1.060971645
48001,2012,571,625,-287,-1,-54,-288,9.8097324228,10.737447923,-4.930636086,-0.017179917,-0.927715501,-4.947816003
48001,2013,583,615,-72,38,-32,-34,10.052070761,10.603813925,-1.241422118,0.6551950067,-0.551743164,-0.586227111
48001,2014,589,702,-51,52,-113,1,10.17297512,12.124666442,-0.880851836,0.8981234402,-1.951691322,0.0172716046
48001,2015,581,616,-219,61,-35,-158,10.062522732,10.6686988,-3.792930255,1.0564782902,-0.606176068,-2.736451965
48001,2016,630,662,-114,62,-32,-52,10.937594944,11.493155323,-1.979183847,1.0763982326,-0.555560378,-0.902785614
48001,2017,620,663,165,62,-43,227,10.754646614,11.500533396,2.8621236958,1.0754646614,-0.745886781,3.9375883572
29003,2010,31,33,51,0,-2,51,NA,NA,NA,NA,NA,NA
29003,2011,175,140,-185,0,35,-185,10.134059125,8.1072473,-10.71314822,0,2.026811825,-10.71314822
29003,2012,185,171,101,-2,14,99,10.724015999,9.9124688424,5.854733059,-0.115935308,0.8115471567,5.7387977509
29003,2013,173,171,-2,-3,2,-5,9.9971106617,9.881537128,-0.115573534,-0.1733603,0.1155735337,-0.288933834
29003,2014,202,169,-51,-3,33,-54,11.681702521,9.7733055748,-2.949340736,-0.173490632,1.9083969466,-3.122831367
29003,2015,203,167,-1,-3,36,-4,11.736817761,9.6554116559,-0.057816836,-0.173450509,2.0814061055,-0.231267345
29003,2016,169,187,51,-3,-18,48,9.7546897547,10.793650794,2.9437229437,-0.173160173,-1.038961039,2.7705627706
29003,2017,191,163,191,-3,28,188,10.947440821,9.3425803863,10.947440821,-0.171949332,1.6048604345,10.775491489
48003,2010,58,13,10,7,45,17,NA,NA,NA,NA,NA,NA
48003,2011,261,124,390,3,137,393,17.265901498,8.2029570337,25.799622929,0.1984586379,9.0629444647,25.998081567
48003,2012,288,130,542,4,158,546,18.290359456,8.2560650324,34.421440366,0.2540327702,10.034294424,34.675473136
48003,2013,331,120,431,32,211,463,20.125250806,7.2961634341,26.205387001,1.9456435824,12.829087372,28.151030583
48003,2014,331,131,414,37,200,451,19.336371071,7.6527631733,24.185068349,2.1614674612,11.683607898,26.34653581
48003,2015,345,128,376,47,217,423,19.41474395,7.2031513787,21.159257175,2.6449071469,12.211592572,23.804164322
48003,2016,303,96,-511,49,207,-462,16.866598013,5.3438726377,-28.44498873,2.7276016588,11.522725375,-25.71738707
48003,2017,304,95,-371,48,209,-323,17.098343598,5.3432323744,-20.86672854,2.6997384628,11.755111224,-18.16699007
23001,2010,369,251,-157,29,118,-128,NA,NA,NA,NA,NA,NA
23001,2011,1340,1017,-709,89,323,-620,12.460190157,9.4567264105,-6.592742404,0.827579794,3.0034637469,-5.76516261
23001,2012,1318,1021,-275,87,297,-188,12.266741123,9.5025361813,-2.55944902,0.8097165992,2.7642049421,-1.749732421
23001,2013,1287,1049,-606,145,238,-461,11.985137312,9.7687715933,-5.643351368,1.3503068456,2.216365719,-4.293044523
23001,2014,1258,1010,-367,149,248,-218,11.726268986,9.4145720797,-3.420938568,1.3888824157,2.3116969067,-2.032056152
23001,2015,1265,1121,-481,157,144,-324,11.800703378,10.457382203,-4.487065869,1.4645932256,1.343321175,-3.022472644
23001,2016,1254,1093,-158,164,161,6,11.699234512,10.197179682,-1.47406623,1.530043429,1.5020548297,0.0559771986
23001,2017,1241,1041,23,165,200,188,11.548483157,9.6873255165,0.2140331286,1.535455053,1.8611576401,1.7494881816
48005,2010,280,180,39,3,100,42,NA,NA,NA,NA,NA,NA
48005,2011,1242,850,-7,7,392,0,14.260699831,9.7597382094,-0.080374315,0.0803743147,4.5009616213,0
48005,2012,1245,819,-180,-21,426,-201,14.246644315,9.3718889105,-2.059755805,-0.240304844,4.874755404,-2.300060648
48005,2013,1168,880,-447,30,288,-417,13.359182436,10.065137452,-5.112632319,0.3431296859,3.2940449843,-4.769502634
48005,2014,1209,851,-152,41,358,-111,13.819827852,9.7276042202,-1.737480425,0.468662483,4.092223632,-1.268817942
48005,2015,1200,898,-53,61,302,8,13.675057834,10.233501613,-0.603981721,0.6951487732,3.4415562216,0.0911670522
48005,2016,1226,897,-459,61,329,-398,13.953144294,10.208785018,-5.223893337,0.6942429053,3.7443592764,-4.529650432
48005,2017,1189,935,-337,61,254,-276,13.539442594,10.647080593,-3.837503914,0.6946223703,2.8923620007,-3.142881544
24003,2010,1811,892,403,300,919,703,NA,NA,NA,NA,NA,NA
24003,2011,6950,3747,1629,953,3203,2582,12.820430047,6.9119642282,3.0049612297,1.7579668827,5.9084658188,4.7629281124
24003,2012,6920,3879,1215,1462,3041,2677,12.632243802,7.0809933106,2.2179445404,2.6688353236,5.5512504917,4.886779864
24003,2013,6771,3981,1423,1185,2790,2608,12.237008683000001,7.1947321765,2.5717417451,2.1416120646,5.0422765065,4.7133538097
24003,2014,6872,4024,463,1208,2848,1671,12.310349059,7.2085047458,0.8294079765,2.1639845261,5.1018443131,2.9933925025
24003,2015,6964,4192,-263,1504,2772,1241,12.382183453,7.4534912459,-0.46762123,2.6741533478,4.9286922074,2.2065321174
24003,2016,6992,4259,526,1267,2733,1793,12.33912112,7.5160636227,0.9282576815,2.2359362785,4.8230574973,3.16419396
24003,2017,6933,4435,756,1077,2498,1833,12.140251158,7.7660484472,1.323817954,1.8859152599,4.3742027105,3.2097332139
27003,2010,1084,460,-156,124,624,-32,NA,NA,NA,NA,NA,NA
27003,2011,4068,1780,-1280,436,2288,-844,12.247570733,5.3590648733,-3.853709572,1.3126698229,6.8885058596,-2.541039749
27003,2012,4066,1730,515,465,2336,980,12.155310549,5.1718365102,1.5395929496,1.3901179059,6.9834740392,2.9297108555
27003,2013,4064,1867,467,476,2197,943,12.034884582,5.5288212387,1.3829456446,1.409597702,6.5060633431,2.7925433466
27003,2014,4321,1891,-110,579,2430,469,12.684145405,5.550964814,-0.322901179,1.6996343878,7.1331805913,1.3767332088
27003,2015,4122,2032,-266,634,2090,368,12.006955995,5.9190040227,-0.774830251,1.8467758614,6.0879519722,1.0719456104
27003,2016,4341,2016,-395,652,2325,257,12.553335772,5.8298836481,-1.142263909,1.8854584021,6.723452124,0.7431944928
27003,2017,4228,2008,1432,648,2220,2080,12.106495931,5.7497265444,4.1004025954,1.8554894426,6.3567693867,5.955892038
37007,2010,59,97,-43,5,-38,-38,NA,NA,NA,NA,NA,NA
37007,2011,280,302,-321,3,-22,-318,10.493179433,11.317643532,-12.02968071,0.1124269225,-0.824464098,-11.91725379
37007,2012,252,272,-183,6,-20,-177,9.5384091296,10.295425727,-6.926701868,0.2271049793,-0.757016598,-6.699596889
37007,2013,265,294,-329,3,-29,-326,10.134424537,11.243474769,-12.58198367,0.1147293344,-1.109050232,-12.46725434
37007,2014,253,292,27,8,-39,35,9.7395723057,11.240929301,1.0394009971,0.3079706658,-1.501356996,1.3473716628
37007,2015,237,312,-324,12,-75,-312,9.1910338944,12.099588924,-12.56495773,0.4653688048,-2.90855503,-12.09958892
37007,2016,241,360,-369,13,-119,-356,9.5044663104,14.197543036,-14.55248161,0.5126890541,-4.693076726,-14.03979256
37007,2017,246,290,-98,13,-44,-85,9.8183995211,11.574536021,-3.911394931,0.5188585113,-1.7561365,-3.39253642
31003,2010,30,9,-29,0,21,-29,NA,NA,NA,NA,NA,NA
31003,2011,74,80,-53,1,-6,-52,11.12865629,12.030979773,-7.9705240999999996,0.1503872472,-0.902323483,-7.820136852
31003,2012,73,69,-79,3,4,-76,11.085801063,10.478359909,-11.99696279,0.4555808656,0.6074411541,-11.54138193
31003,2013,85,84,-83,2,1,-81,13.055832885,12.902234851,-12.74863682,0.3071960679,0.15359803389999999,-12.44144075
31003,2014,92,66,-80,5,26,-75,14.271310013,10.238113705,-12.40983479,0.7756146746,4.0331963081,-11.63422012
31003,2015,79,76,-10,6,3,-4,12.304337668,11.837084339,-1.557511097,0.9345066584,0.4672533292,-0.623004439
31003,2016,84,83,-71,7,1,-64,13.150684932,12.994129159,-11.11545988,1.095890411,0.156555773,-10.01956947
31003,2017,78,68,-10,7,10,-3,12.266079572,10.693505268,-1.572574304,1.1008020129,1.5725743041,-0.471772291
26009,2010,41,83,-43,0,-42,-43,NA,NA,NA,NA,NA,NA
26009,2011,208,265,-117,2,-57,-115,8.8866102709,11.321883278,-4.998718277,0.0854481757,-2.435273007,-4.913270102
26009,2012,204,243,-30,0,-39,-30,8.7621338373,10.437247659,-1.288549094,0,-1.675113822,-1.288549094
26009,2013,157,261,-21,6,-104,-15,6.7717656193,11.257521189,-0.905777567,0.2587935905,-4.485755569,-0.646983976
26009,2014,227,282,74,5,-55,79,9.8119732008,12.189323536,3.1986168144,0.2161227577,-2.377350335,3.4147395721
26009,2015,210,291,-33,7,-81,-26,9.094452384,12.602312589,-1.429128232,0.3031484128,-3.507860205,-1.125979819
26009,2016,192,269,100,8,-77,108,8.3295373202,11.67002885,4.3383006876,0.347064055,-3.340491529,4.6853647426
26009,2017,201,263,279,8,-62,287,8.671642435,11.346477415,12.03675741,0.3451399974,-2.67483498,12.381897407
04001,2010,276,87,118,4,189,122,NA,NA,NA,NA,NA,NA
04001,2011,1074,585,-160,21,489,-139,14.914905879,8.1240409118,-2.221959908,0.2916322379,6.7908649673,-1.93032767
04001,2012,986,520,-461,32,466,-429,13.657077164,7.20251534,-6.385306869,0.4432317132,6.4545618239,-5.942075155
04001,2013,994,530,-450,62,464,-388,13.757119032,7.3352847959,-6.228071997,0.8580899195,6.4218342364,-5.369982077
04001,2014,977,598,-994,66,379,-928,13.56435781,8.3024421398,-13.80038041,0.9163230455,5.2619156705,-12.88405737
04001,2015,958,611,-1217,75,347,-1142,13.422912828,8.5609600605,-17.05186316,1.0508543446,4.8619527676,-16.00100882
04001,2016,1018,703,1,79,315,80,14.302573901,9.8769248061,0.0140496797,1.1099246937,4.4256490952,1.1239743734
04001,2017,1073,684,-234,79,389,-155,15.009197155,9.5678386336,-3.273207954,1.105057386,5.4413585212,-2.168150568
19007,2010,30,59,-1,1,-29,0,NA,NA,NA,NA,NA,NA
19007,2011,154,153,-10,0,1,-10,11.983503229,11.905688273,-0.77814956,0,0.077814956,-0.77814956
19007,2012,170,167,-145,1,3,-144,13.306199123,13.071383845,-11.34940513,0.0782717595,0.2348152786,-11.27113338
19007,2013,137,175,-18,1,-38,-17,10.806120839,13.803439028,-1.4197823,0.0788767944,-2.997318189,-1.340905506
19007,2014,153,168,32,3,-15,35,12.086740135,13.271714658,2.5279456492,0.2369949046,-1.184974523,2.7649405538
19007,2015,142,181,-61,3,-39,-58,11.25331854,14.344018703,-4.834172049,0.2377461663,-3.090700162,-4.596425883
19007,2016,149,165,-58,2,-16,-56,11.888139785,13.164718554,-4.627598037,0.1595723461,-1.276578769,-4.468025691
19007,2017,150,157,-138,1,-7,-137,12.072920439,12.636323393,-11.1070868,0.0804861363,-0.563402954,-11.02660067
13001,2010,62,28,58,0,34,58,NA,NA,NA,NA,NA,NA
13001,2011,260,194,71,-5,66,66,14.128515147,10.542045918,3.8581714441,-0.271702214,3.5864692297,3.5864692297
13001,2012,274,173,-174,2,101,-172,14.862629167,9.3840687803,-9.438311952,0.1084863443,5.4785603862,-9.329825608
13001,2013,263,188,-81,0,75,-81,14.294643585,10.218224312,-4.402532815,0,4.0764192733,-4.402532815
13001,2014,252,205,63,0,47,63,13.659647126,11.112014527,3.4149117814,0,2.5476325989,3.4149117814
13001,2015,258,218,-93,3,40,-90,13.964061485,11.799090712,-5.033557047,0.162372808,2.1649707729,-4.871184239
13001,2016,252,193,-28,4,59,-24,13.64559361,10.450791932,-1.516177068,0.216596724,3.1948016786,-1.299580344
13001,2017,245,193,-18,4,52,-14,13.241096038,10.430740961,-0.972815219,0.2161811598,2.8103550776,-0.756634059
51011,2010,48,27,48,0,21,48,NA,NA,NA,NA,NA,NA
51011,2011,147,170,36,-1,-23,35,9.7354217027,11.258650949,2.3841849068,-0.066227359,-1.523229246,2.3179575483
51011,2012,191,153,97,0,38,97,12.588564838,10.084033613,6.3931454935,0,2.5045312243,6.3931454935
51011,2013,175,133,37,-2,42,35,11.454003993,8.7050430343,2.4217037013,-0.130902903,2.7489609582,2.2908007985
51011,2014,174,188,40,-1,-14,39,11.35177453,12.265135699,2.6096033403,-0.065240084,-0.913361169,2.5443632568
51011,2015,174,177,133,-1,-3,132,11.295767333,11.490521942,8.6341210075,-0.064918203,-0.194754609,8.5692028045
51011,2016,169,166,35,-2,3,33,10.912730443,10.719013334,2.2600329319,-0.129144739,0.1937171084,2.1308881929
51011,2017,161,163,181,-2,-2,179,10.325145899,10.453408581,11.607772719,-0.128262682,-0.128262682,11.479510037
48007,2010,69,92,41,3,-23,44,NA,NA,NA,NA,NA,NA
48007,2011,233,323,116,23,-90,139,10.04115581,13.919713849,4.9990303605,0.9911870542,-3.878558038,5.9902174147
48007,2012,245,343,313,7,-98,320,10.494752624,14.692653673,13.407581923,0.299850075,-4.197901049,13.707431998
48007,2013,229,344,533,6,-115,539,9.670812306,14.52733377,22.508921219,0.2533837285,-4.856521464,22.762304947
48007,2014,294,330,691,11,-36,702,12.129213251,13.614423037,28.507776723,0.4538141012,-1.485209786,28.961590825
48007,2015,247,371,361,12,-124,373,9.9969644845,15.015683497,14.610948093,0.4856824851,-5.018719012,15.096630578
48007,2016,281,319,467,12,-38,479,11.215550101,12.732243709,18.639366182,0.4789558762,-1.516693608,19.118322058
48007,2017,266,357,374,12,-91,386,10.462760832,14.042126379,14.710799064,0.472004248,-3.579365548,15.182803312
08005,2010,2034,887,870,436,1147,1306,NA,NA,NA,NA,NA,NA
08005,2011,7704,3422,3949,2025,4282,5974,13.28728317,5.9020097361,6.8109399321,3.4925685902,7.3852734336,10.303508522
08005,2012,7716,3372,3591,2193,4344,5784,13.077423056,5.7150169188,6.0861879464,3.7167948111,7.3624061374,9.8029827575
08005,2013,7855,3574,5136,2261,4281,7397,13.070612089,5.9470869009,8.5462334423,3.7622729387,7.1235251882,12.308506381
08005,2014,7903,3483,3680,2437,4420,6117,12.911035889,5.6901351387,6.0119716653,3.9812975403,7.2209007502,9.9932692056
08005,2015,8131,3746,4280,2764,4385,7044,13.049070829,6.0117844456,6.8687766757,4.4358174607,7.0372863839,11.304594136
08005,2016,8096,4059,1280,2786,4037,4066,12.792082055,6.4134215738,2.022463566,4.4020183554,6.3786604813,6.4244819215
08005,2017,8108,4093,-648,2742,4015,2094,12.668740103,6.3953075037,-1.012499209,4.2843716528,6.2734325989,3.2718724438
48009,2010,21,12,47,0,9,47,NA,NA,NA,NA,NA,NA
48009,2011,65,63,-293,4,2,-289,7.2439540845,7.0210631896,-32.6535161,0.4457817898,0.2228908949,-32.20773431
48009,2012,70,73,-25,2,-3,-23,7.9356082077,8.2757057023,-2.834145788,0.2267316631,-0.340097495,-2.607414125
48009,2013,68,81,-2,1,-13,-1,7.7268337026,9.2040224987,-0.227259815,0.1136299074,-1.477188796,-0.113629907
48009,2014,68,83,56,1,-15,57,7.7149988654,9.4168368505,6.3535284774,0.1134558657,-1.701837985,6.4669843431
48009,2015,96,77,-101,1,19,-100,10.91529278,8.7549744173,-11.48379761,0.1137009665,2.1603183627,-11.37009665
48009,2016,79,96,35,1,-17,36,9.0136345485,10.953277426,3.9933823949,0.1140966399,-1.939642878,4.1074790347
48009,2017,83,75,26,1,8,27,9.440937269,8.5309674117,2.9574020361,0.1137462322,0.9099698572,3.0711482682
08007,2010,21,27,-35,1,-6,-34,NA,NA,NA,NA,NA,NA
08007,2011,137,80,-92,2,57,-90,11.388669521,6.6503179683,-7.647865664,0.1662579492,4.7383515524,-7.481607714
08007,2012,116,74,64,2,42,66,9.6114011103,6.1314110531,5.3028419919,0.1657138122,3.4799900572,5.4685558041
08007,2013,105,92,60,7,13,67,8.6316741337,7.5629906696,4.9323852193,0.5754449422,1.0686834642,5.5078301615
08007,2014,106,93,-3,8,13,5,8.6789208663,7.614524911,-0.245629836,0.6550128956,1.0643959553,0.4093830597
08007,2015,120,104,134,9,16,143,9.7545114616,8.4539099333,10.892537799,0.7315883596,1.3006015282,11.624126158
08007,2016,112,70,404,8,42,412,8.8825442144,5.551590134,32.040605916,0.6344674439,3.3309540804,32.67507336
08007,2017,130,99,438,8,31,446,9.9422584222,7.5714121831,33.497762992,0.6118312875,2.3708462391,34.109594279
26011,2010,19,61,-8,0,-42,-8,NA,NA,NA,NA,NA,NA
26011,2011,142,213,-150,2,-71,-148,9.0230341541,13.534551231,-9.531374106,0.1270849881,-4.511517077,-9.404289118
26011,2012,129,208,-53,1,-79,-52,8.2891566265,13.365461847,-3.40562249,0.0642570281,-5.076305221,-3.341365462
26011,2013,109,217,22,-1,-108,21,7.0536465411,14.042580729,1.4236717789,-0.064712354,-6.988934188,1.3589594254
26011,2014,117,217,10,-1,-100,9,7.6166916216,14.126684461,0.6509992839,-0.065099928,-6.509992839,0.5858993555
26011,2015,147,182,21,-1,-35,20,9.604704345,11.891538713,1.3721006207,-0.065338125,-2.286834368,1.3067624959
26011,2016,120,197,-91,-1,-77,-92,7.8885090718,12.950302393,-5.982119379,-0.065737576,-5.061793321,-6.047856955
26011,2017,127,202,-4,-1,-75,-5,8.4184011666,13.389897919,-0.265146493,-0.066286623,-4.971496752,-0.331433117
05001,2010,73,34,-39,2,39,-37,NA,NA,NA,NA,NA,NA
05001,2011,235,258,-141,14,-23,-127,12.405965422,13.620166293,-7.443579253,0.7390787911,-1.214200871,-6.704500462
05001,2012,284,255,46,15,29,61,15.016126474,13.482789616,2.4321894993,0.7931052715,1.5333368582,3.2252947708
05001,2013,243,249,-212,7,-6,-205,12.890220937,13.208497998,-11.24578946,0.3713232369,-0.31827706,-10.87446622
05001,2014,218,216,-283,12,2,-271,11.710985764,11.603545528,-15.20279345,0.6446414182,0.1074402364,-14.55815203
05001,2015,248,245,-151,13,3,-138,13.465819623,13.302926644,-8.198946625,0.705869577,0.1628929793,-7.493077048
05001,2016,243,201,-188,13,42,-175,13.291398879,10.99412006,-10.28305757,0.7110624915,2.2972788185,-9.571995077
05001,2017,233,223,-272,13,10,-259,12.879332265,12.326571223,-15.03510033,0.7185893538,0.5527610414,-14.31651097
51013,2010,817,238,521,523,579,1044,NA,NA,NA,NA,NA,NA
51013,2011,2986,934,2894,1959,2052,4853,14.024771146,4.3868507203,13.592661654,9.201114091,9.6379204261,22.793775745
51013,2012,3126,898,942,2080,2228,3022,14.268792835,4.0989686392,4.2998089735,9.4942703448,10.169824196,13.794079318
51013,2013,3261,971,-435,2048,2290,1613,14.579090785,4.3410908164,-1.94477292,9.1560803214,10.237999969,7.2113074015
51013,2014,3137,908,-3547,2146,2229,-1401,13.876632008,4.0165705654,-15.69028171,9.4929079661,9.8600614429,-6.197373747
51013,2015,3133,964,-2075,2369,2169,294,13.75715741,4.2329715109,-9.111427267,10.402395756,9.5241858995,1.2909684898
51013,2016,3193,980,-1928,2347,2213,419,13.865156683,4.2555131693,-8.372070807,10.191519804,9.6096435139,1.8194489979
51013,2017,3074,1063,-947,2296,2011,1349,13.176874029,4.556609334,-4.059368805,9.8419332369,8.6202646949,5.7825644323
42005,2010,182,219,-38,2,-37,-36,NA,NA,NA,NA,NA,NA
42005,2011,686,807,-252,3,-121,-249,9.9895153774,11.751514445,-3.669617894,0.0436859273,-1.761999068,-3.625931966
42005,2012,705,859,-260,3,-154,-257,10.325661099,12.58119558,-3.808045228,0.0439389834,-2.255534481,-3.764106244
42005,2013,728,855,-77,0,-127,-77,10.71178959,12.580467169,-1.132977745,0,-1.86867758,-1.132977745
42005,2014,601,836,-199,2,-235,-197,8.8856034005,12.360007392,-2.94215487,0.0295693957,-3.474403992,-2.912585474
42005,2015,582,882,-481,3,-300,-478,8.682873703,13.158581797,-7.176051978,0.0447570809,-4.475708094,-7.131294897
42005,2016,596,841,-261,2,-245,-259,8.9779317617,12.668524516,-3.931611057,0.0301272878,-3.690592754,-3.901483769
42005,2017,564,887,-165,2,-323,-163,8.5601104922,13.462443274,-2.504287644,0.0303550017,-4.902332782,-2.473932642
48011,2010,5,2,-2,0,3,-2,NA,NA,NA,NA,NA,NA
48011,2011,18,27,40,5,-9,45,9.3774420422,14.066163063,20.838760094,2.6048450117,-4.688721021,23.443605105
48011,2012,21,28,19,5,-7,24,10.791366906,14.388489209,9.7636176773,2.569373073,-3.597122302,12.33299075
48011,2013,29,36,-8,0,-7,-8,14.890885751,18.485237484,-4.107830552,0,-3.594351733,-4.107830552
48011,2014,18,29,-11,0,-11,-11,9.3336790251,15.037593985000001,-5.70391496,0,-5.70391496,-5.70391496
48011,2015,19,28,-7,0,-9,-7,9.9502487562,14.663524483,-3.665881121,0,-4.713275727,-3.665881121
48011,2016,17,29,-34,0,-12,-34,9.04736562,15.433741352,-18.09473124,0,-6.386375732,-18.09473124
48011,2017,18,21,27,0,-3,27,9.6385542169,11.24497992,14.457831325,0,-1.606425703,14.457831325
23003,2010,157,210,-124,5,-53,-119,NA,NA,NA,NA,NA,NA
23003,2011,656,854,-148,26,-198,-122,9.1703361991,11.938212064,-2.068917313,0.3634584469,-2.767875865,-1.705458866
23003,2012,643,860,-395,10,-217,-385,9.0471634399,12.100405223,-5.557744259,0.1407023863,-3.053241783,-5.417041873
23003,2013,688,848,-545,24,-160,-521,9.7682177972,12.039896355,-7.737905086,0.3407517836,-2.271678557,-7.397153303
23003,2014,693,795,-514,34,-102,-480,9.9278689464,11.389113726,-7.363527617,0.4870815933,-1.46124478,-6.876446023
23003,2015,654,910,-470,36,-256,-434,9.4551710678,13.156277785,-6.795000614,0.5204681322,-3.701106718,-6.274532482
23003,2016,667,869,-543,38,-202,-505,9.7414926245,12.691689791,-7.930480502,0.5549875858,-2.950197167,-7.375492917
23003,2017,664,832,-333,38,-168,-295,9.7813197416,12.256111483,-4.905390774,0.5597743226,-2.474791742,-4.345616451
31005,2010,2,0,3,0,2,3,NA,NA,NA,NA,NA,NA
31005,2011,6,4,1,0,2,1,12.861736334,8.5744908896,2.1436227224,0,4.2872454448,2.1436227224
31005,2012,5,2,9,0,3,9,10.559662091,4.2238648363,19.007391763,0,6.3357972545,19.007391763
31005,2013,4,6,-23,0,-2,-23,8.5744908896,12.861736334,-49.30332262,0,-4.287245445,-49.30332262
31005,2014,3,5,0,0,-2,0,6.6225165563,11.037527594,0,0,-4.415011038,0
31005,2015,3,6,2,0,-3,2,6.6371681416,13.274336283,4.4247787611,0,-6.637168142,4.4247787611
31005,2016,6,4,15,0,2,15,13.015184382,8.6767895879,32.537960954,0,4.3383947939,32.537960954
31005,2017,4,4,-11,0,0,-11,8.6299892125,8.6299892125,-23.73247033,0,0,-23.73247033
22005,2010,371,114,384,8,257,392,NA,NA,NA,NA,NA,NA
22005,2011,1658,663,1050,69,995,1119,15.220364811,6.0863099336,9.6389523836,0.6334168709,9.1340548778,10.272369254
22005,2012,1538,618,1196,75,920,1271,13.84344664,5.5625812897,10.765124956,0.6750705449,8.2808653504,11.4401955
22005,2013,1633,681,1319,79,952,1398,14.401940249,6.0059530372,11.632675559,0.6967258296,8.395987212,12.329401389
22005,2014,1715,737,1610,77,978,1687,14.795005068,6.3579701081,13.889188430999999,0.6642655337,8.4370349602,14.553453965
22005,2015,1713,759,1061,96,954,1157,14.477748807,6.4148344102,8.9672454667,0.811362455,8.062914397,9.7786079218
22005,2016,1686,765,1089,103,921,1192,13.999601435,6.3521323236,9.0424471901,0.8552544174,7.6474691112,9.8977016075
22005,2017,1665,857,553,102,808,655,13.623197892,7.0120604166,4.5247017624,0.8345742853,6.6111374757,5.3592760477
37009,2010,63,102,27,8,-39,35,NA,NA,NA,NA,NA,NA
37009,2011,251,329,-174,30,-78,-144,9.2553328786,12.131492099999999,-6.416047494,1.1062150851,-2.876159221,-5.309832408
37009,2012,247,318,2,23,-71,25,9.154081349,11.785416474,0.0741221162,0.8524043361,-2.631335125,0.9265264523
37009,2013,254,327,-2,13,-73,11,9.4343126695,12.145748988,-0.074285927,0.4828585225,-2.711436318,0.4085725959
37009,2014,220,335,51,17,-115,68,8.1895508776,12.470452473,1.8984867943,0.6328289314,-4.280901595,2.5313157258
37009,2015,220,360,14,20,-140,34,8.2143190516,13.441612994,0.5227293942,0.7467562774,-5.227293942,1.2694856716
37009,2016,215,333,123,22,-118,145,8.0402385894,12.453020699,4.5997644023,0.8227220882,-4.41278211,5.4224864905
37009,2017,206,335,311,22,-129,333,7.6706819832,12.474167303,11.580495615,0.8191990468,-4.80348532,12.399694662
39005,2010,167,90,92,11,77,103,NA,NA,NA,NA,NA,NA
39005,2011,594,569,-147,47,25,-100,11.147497912,10.678327125,-2.758724231,0.8820410806,0.46917078760000003,-1.87668315
39005,2012,605,537,-162,83,68,-79,11.363636364,10.086401202,-3.042824944,1.5589782119,1.2772351615,-1.483846732
39005,2013,629,576,-235,62,53,-173,11.828755724,10.832056116,-4.41932845,1.1659504847,0.9966996079,-3.253377965
39005,2014,651,529,-218,85,122,-133,12.257001647,9.959990586,-4.104495175,1.6003765592,2.2970110614,-2.504118616
39005,2015,622,548,-42,91,74,49,11.699316286,10.307436213,-0.789985987,1.7116363055,1.3918800726,0.9216503183
39005,2016,587,569,87,91,18,178,11.008899016,10.671317786,1.631642614,1.7066606652,0.3375812305,3.3383032792
39005,2017,620,580,86,89,40,175,11.583913307,10.836564062,1.6068008781,1.6628520716,0.7473492456,3.2696529497
55003,2010,38,62,11,0,-24,11,NA,NA,NA,NA,NA,NA
55003,2011,184,200,-103,0,-16,-103,11.439940313,12.434717732,-6.403879632,0,-0.994777419,-6.403879632
55003,2012,178,162,-214,8,16,-206,11.172132434,10.16789581,-13.43166484,0.5021183116,1.0042366233,-12.92954652
55003,2013,184,181,117,8,3,125,11.569780237,11.381142516,7.356871129,0.5030339234,0.1886377213,7.8599050523
55003,2014,184,191,27,6,-7,33,11.515473918,11.9535626,1.6897706293,0.3755045843,-0.438088682,2.0652752136
55003,2015,178,204,-169,7,-26,-162,11.196729045,12.832206322,-10.6306023,0.4403208052,-1.635477276,-10.19028149
55003,2016,175,171,-180,6,4,-174,11.132669614,10.878208594,-11.45074589,0.3816915296,0.2544610198,-11.06905436
55003,2017,176,172,-145,6,4,-139,11.305967752,11.04901394,-9.314575705,0.3854307188,0.2569538126,-8.929144986
05003,2010,60,51,-26,0,9,-26,NA,NA,NA,NA,NA,NA
05003,2011,303,271,-193,-1,32,-194,13.929113226,12.458051763,-8.872339447,-0.045970671,1.4710614628,-8.918310118
05003,2012,263,210,-205,-5,53,-210,12.178463106,9.7242481072,-9.49271839,-0.231529717,2.4542149985,-9.724248107
05003,2013,269,261,-241,-7,8,-248,12.570387159,12.196546648,-11.26194537,-0.327110447,0.3738405103,-11.58905582
05003,2014,262,263,-322,-6,-1,-328,12.405596723,12.452946329,-15.24657307,-0.284097635,-0.047349606,-15.53067071
05003,2015,253,270,-97,-5,-17,-102,12.106711329,12.920205766,-4.641703553,-0.23926307,-0.813494437,-4.880966623
05003,2016,215,258,-292,-5,-43,-297,10.402806338,12.483367606,-14.12846256,-0.241925729,-2.080561268,-14.37038829
05003,2017,214,250,-174,-5,-36,-179,10.495083495,12.260611559,-8.533385645,-0.245212231,-1.765528065,-8.778597876
39007,2010,283,277,-102,8,6,-94,NA,NA,NA,NA,NA,NA
39007,2011,1155,1154,-375,41,1,-334,11.409830236,11.399951595,-3.704490336,0.4050242768,0.0098786409,-3.299466059
39007,2012,1091,1171,-806,46,-80,-760,10.840243036,11.635127952,-8.008465524,0.4570588265,-0.794884916,-7.551406698
39007,2013,1120,1193,-495,57,-73,-438,11.20319291,11.933401019,-4.951411152,0.5701624963,-0.730208109,-4.381248656
39007,2014,1078,1136,-715,74,-58,-641,10.84850833,11.432194307,-7.195439199,0.7447027982,-0.583685977,-6.4507364
39007,2015,1113,1208,-604,74,-95,-530,11.275624693,12.238054474,-6.119027237,0.7496821449,-0.962429781,-5.369345092
39007,2016,1101,1132,-270,76,-31,-194,11.202401241,11.517818533,-2.747182866,0.7732811029,-0.315417292,-1.973901763
39007,2017,1088,1112,-412,76,-24,-336,11.103400416,11.348328367,-4.204596481,0.7756051761,-0.24492795,-3.428991305
53003,2010,62,33,70,1,29,71,NA,NA,NA,NA,NA,NA
53003,2011,252,216,221,-18,36,203,11.535028494,9.8871672808,10.116036894,-0.823930607,1.6478612135,9.292106287
53003,2012,230,241,-19,-25,-11,-44,10.484091531,10.985504604,-0.866077126,-1.139575166,-0.501413073,-2.005652293
53003,2013,251,269,256,-22,-18,234,11.400022709,12.217554218,11.627114795,-0.999205178,-0.817531509,10.627909617
53003,2014,241,228,72,-20,13,52,10.875696654,10.289040818,3.2491707845,-0.90254744,0.5866558361,2.3466233444
53003,2015,251,245,-43,-20,6,-63,11.325437112,11.054709532,-1.940214326,-0.902425268,0.2707275804,-2.842639594
53003,2016,218,255,235,-20,-37,215,9.8103188354,11.47537295,10.575343699,-0.900029251,-1.665054114,9.6753144477
53003,2017,224,263,284,-20,-39,264,9.9899654365,11.729289776,12.665849036,-0.8919612,-1.739324339,11.773887836
22007,2010,62,86,-62,1,-24,-61,NA,NA,NA,NA,NA,NA
22007,2011,252,203,-212,2,49,-210,10.836379273,8.7293055257,-9.116319071,0.0860030101,2.1070737476,-9.030316061
22007,2012,268,212,-172,6,56,-166,11.590943494,9.1689553013,-7.438963735,0.25949873490000003,2.4219881928,-7.179465
22007,2013,275,213,48,15,62,63,11.889835272,9.209217865,2.075316702,0.6485364694,2.6806174067,2.7238531713
22007,2014,245,223,-195,19,22,-176,10.599407298,9.6476237859,-8.436262952,0.8219948517,0.9517835125,-7.6142681
22007,2015,265,218,-211,19,47,-192,11.538545272,9.4920862996,-9.187294538,0.8272919252,2.0464589729,-8.360002613
22007,2016,255,234,-181,21,21,-160,11.17196057,10.251916758,-7.929901424,0.9200438116,0.9200438116,-7.009857612
22007,2017,250,225,-276,21,25,-255,11.042158963,9.9379430666,-12.1905435,0.9275413529,1.1042158963,-11.26300214
48013,2010,151,115,9,-2,36,7,NA,NA,NA,NA,NA,NA
48013,2011,669,386,268,-13,283,255,14.795483949,8.5367067332,5.927039908,-0.287505667,6.2587772163,5.6395342408
48013,2012,595,371,708,-14,224,694,12.949139263,8.0741691876,15.40838756,-0.30468563,4.8749700755,15.10370193
48013,2013,661,379,298,2,282,300,14.152357299,8.114589132,6.3803365735,0.0428210508,6.0377681668,6.4231576243
48013,2014,656,415,445,11,241,456,13.854715566,8.7647971953,9.3983969925,0.2323199257,5.0899183712,9.6307169182
48013,2015,749,408,294,15,341,309,15.596206103,8.4956636717,6.1218752928,0.3123405762,7.1005424315,6.434215869
48013,2016,661,385,26,17,276,43,13.626758749,7.9369169716,0.5359995877,0.3504612689,5.689841777,0.8864608566
48013,2017,684,412,28,18,272,46,14.009646994,8.4385593003,0.5734943214,0.3686749209,5.5710876934,0.9421692423
20005,2010,52,68,-51,1,-16,-50,NA,NA,NA,NA,NA,NA
20005,2011,216,186,-131,-4,30,-135,12.85255266,11.067475901,-7.794835178,-0.238010234,1.7850767583,-8.032845412
20005,2012,206,176,-5,-3,30,-8,12.288236698,10.498687664,-0.298258172,-0.178954903,1.7895490336,-0.477213076
20005,2013,197,167,-115,-2,30,-117,11.774550236,9.9814715199,-6.873468412,-0.119538581,1.7930787162,-6.993006993
20005,2014,220,166,-220,-2,54,-222,13.248223534,9.9963868481,-13.24822353,-0.120438396,3.2518366855,-13.36866193
20005,2015,199,190,-115,-2,9,-117,12.083308033,11.536826765,-6.9828162,-0.121440282,0.5464812678,-7.104256482
20005,2016,198,189,-49,-2,9,-51,12.077957727,11.528959649,-2.988989539,-0.121999573,0.5489980785,-3.110989112
20005,2017,207,169,-78,-2,38,-80,12.658614891,10.334811191,-4.769912857,-0.122305458,2.3238036997,-4.892218315
29005,2010,11,13,-28,0,-2,-28,NA,NA,NA,NA,NA,NA
29005,2011,61,92,-54,0,-31,-54,10.862790491,16.383225002,-9.616240762,0,-5.520434512,-9.616240762
29005,2012,46,83,-24,1,-37,-23,8.2980066745,14.972490304,-4.329394787,0.1803914494,-6.674483629,-4.149003337
29005,2013,68,79,-87,4,-11,-83,12.434854165,14.446374691,-15.90929871,0.7314620097,-2.011520527,-15.1778367
29005,2014,45,66,-45,5,-21,-40,8.3449235049,12.23922114,-8.344923505,0.9272137228,-3.894297636,-7.417709782
29005,2015,50,84,-30,6,-34,-24,9.3755859741,15.750984437,-5.625351584,1.1250703169,-6.375398462,-4.500281268
29005,2016,54,57,1,7,-3,8,10.175240249,10.740531374,0.188430375,1.3190126248,-0.565291125,1.5074429998
29005,2017,53,74,-20,7,-21,-13,10.014170997,13.982050071,-3.778932452,1.3226263581,-3.967879074,-2.456306094
39009,2010,140,155,338,46,-15,384,NA,NA,NA,NA,NA,NA
39009,2011,557,520,-381,241,37,-140,8.5522578268,7.9841545241,-5.849928603,3.7003485391,0.5681033027,-2.149580064
39009,2012,564,456,-866,249,108,-617,8.699005167,7.0332382201,-13.35698311,3.8405182386,1.6657669469,-9.516464872
39009,2013,536,446,-504,269,90,-235,8.3071152922,6.9122638439,-7.811168111,4.1690559955,1.3948514483,-3.642112115
39009,2014,562,460,-207,302,102,95,8.7060919407,7.1259827272,-3.206692227,4.6783625731,1.5801092134,1.4716703458
39009,2015,543,500,764,320,43,1084,8.3255393202,7.6662424679,11.714018491,4.9063951795,0.6592968522,16.62041367
39009,2016,506,476,167,328,30,495,7.660109149,7.2059524801,2.5281387903,4.9654462468,0.4541566689,7.4935850371
39009,2017,519,461,-107,326,58,219,7.8093848041,6.93665972,-1.61002731,4.9053168519,0.8727250841,3.2952895416
13003,2010,26,7,-37,-1,19,-38,NA,NA,NA,NA,NA,NA
13003,2011,137,65,-81,13,72,-68,16.369936671,7.7667582746,-9.678575696,1.5533516549,8.6031783965,-8.125224041
13003,2012,123,81,-151,6,42,-145,14.778325123,9.732067764,-18.1424967,0.7208939084,5.0462573591,-17.42160279
13003,2013,123,79,-38,7,44,-31,14.856866771,9.5422152434,-4.58992632,0.8455127431,5.314651528,-3.744413577
13003,2014,139,75,-117,10,64,-107,16.819941917,9.0755082285,-14.15779284,1.2100677638,7.7444336883,-12.94772507
13003,2015,120,64,62,14,56,76,14.44217114,7.7024912745,7.4617884222,1.6849199663,6.7396798652,9.1467083885
13003,2016,138,59,-152,16,79,-136,16.531895777,7.0679844265,-18.20904462,1.9167415394,9.4639113507,-16.29230308
13003,2017,137,61,-70,16,76,-54,16.444604489,7.322050174,-8.402352659,1.9205377506,9.1225543152,-6.481814908
34001,2010,803,546,-352,326,257,-26,NA,NA,NA,NA,NA,NA
34001,2011,3413,2571,-2049,1535,842,-514,12.413888424,9.3513352295,-7.452697738,5.5831581398,3.0625531946,-1.869539599
34001,2012,3380,2465,-1792,1496,915,-296,12.272188425,8.9499835705,-6.50643836,5.4317141669,3.3222048548,-1.074724193
34001,2013,3237,2651,-1714,1355,586,-359,11.734936177,9.6105393285,-6.213679521,4.9122145568,2.1243968489,-1.301464964
34001,2014,3182,2535,-3268,1462,647,-1806,11.554187031,9.2048598755,-11.86646236,5.3086805278,2.3493271556,-6.557781828
34001,2015,3014,2633,-3764,1590,381,-2174,11.001405289,9.6107166974,-13.73898126,5.8036610516,1.3906885916,-7.935320205
34001,2016,2910,2817,-3976,1622,93,-2354,10.700142301,10.35817899,-14.61985079,5.9641342997,0.3419633106,-8.655716487
34001,2017,2862,2758,-2630,1609,104,-1021,10.585337348,10.200684977,-9.727266675,5.9510160001,0.3846523704,-3.776250675
40005,2010,48,20,20,2,28,22,NA,NA,NA,NA,NA,NA
40005,2011,172,147,-84,4,25,-80,12.121212121,10.359408034,-5.919661734,0.281888654,1.7618040874,-5.63777308
40005,2012,162,136,-169,3,26,-166,11.494252874,9.6494962395,-11.99091812,0.2128565347,1.844756634,-11.77806159
40005,2013,149,176,-113,6,-27,-107,10.674499409,12.608804671,-8.095425726,0.4298456138,-1.934305262,-7.665580112
40005,2014,165,146,-1,8,19,7,11.866661872,10.500197778,-0.071919163,0.5753533029,1.3664640944,0.50343414
40005,2015,174,194,-27,8,-20,-19,12.521588946,13.960852044,-1.943005181,0.5757052389,-1.439263097,-1.367299942
40005,2016,148,142,36,8,6,44,10.647482014,10.215827338,2.5899280576,0.5755395683,0.4316546763,3.1654676259
40005,2017,153,117,-82,8,36,-74,11.002444988,8.4136344024,-5.896735222,0.5752912412,2.5888105854,-5.321443981
28007,2010,55,98,-32,0,-43,-32,NA,NA,NA,NA,NA,NA
28007,2011,288,273,-116,0,15,-116,14.815958021,14.044293541,-5.967538648,0,0.7716644803,-5.967538648
28007,2012,237,254,-220,-6,-17,-226,12.299548498,13.181794592,-11.4173024,-0.311380975,-0.882246095,-11.72868338
28007,2013,254,251,-29,-2,3,-31,13.275492604,13.118695448,-1.515705849,-0.104531438,0.1567971567,-1.620237286
28007,2014,242,293,-244,1,-51,-243,12.756648481,15.445033078,-12.86207533,0.0527134235,-2.688384597,-12.8093619
28007,2015,245,294,-105,2,-49,-103,13.068409121,15.682090945,-5.600746766,0.1066808908,-2.613681824,-5.494065875
28007,2016,247,301,-54,3,-54,-51,13.266374842,16.166715901,-2.900341059,0.1611300588,-2.900341059,-2.739211
28007,2017,240,264,-67,3,-24,-64,12.957913776,14.253705153,-3.617417596,0.1619739222,-1.295791378,-3.455443674
29007,2010,91,103,-68,1,-12,-67,NA,NA,NA,NA,NA,NA
29007,2011,362,279,-1,-3,83,-4,14.202204873,10.945898231,-0.03923261,-0.11769783,3.2563066421,-0.156930441
29007,2012,336,290,-43,1,46,-42,13.162533788,11.360520233,-1.684490931,0.0391742077,1.8020135543,-1.645316723
29007,2013,336,302,-11,-3,34,-14,13.158152376,11.826672671,-0.430772846,-0.117483503,1.3314797047,-0.548256349
29007,2014,345,277,208,0,68,208,13.434841021,10.786814385,8.0998461808,0,2.648026636,8.0998461808
29007,2015,348,303,79,2,45,81,13.447716207,11.708787387,3.0527861504,0.0772857253,1.7389288198,3.1300718757
29007,2016,335,293,-112,3,42,-109,12.930368998,11.309248109,-4.322989038,0.1157943492,1.6211208893,-4.207194689
29007,2017,342,270,-309,3,72,-306,13.277428372,10.482180294,-11.996273,0.1164686699,2.7952480783,-11.87980433
19009,2010,15,31,-4,0,-16,-4,NA,NA,NA,NA,NA,NA
19009,2011,61,83,-76,0,-22,-76,10.081811421,13.717874556,-12.56094538,0,-3.636063135,-12.56094538
19009,2012,54,95,-99,1,-41,-98,9.1001011122,16.009437142,-16.68351871,0.168520391,-6.90933603,-16.51499831
19009,2013,59,68,6,0,-9,6,10.063107624,11.59815794,1.023366877,0,-1.535050316,1.023366877
19009,2014,62,81,-76,1,-19,-75,10.662080825,13.929492691,-13.06964746,0.1719690456,-3.267411866,-12.89767842
19009,2015,69,72,-55,1,-3,-54,12.019858897,12.542461458,-9.581046947,0.1742008536,-0.522602561,-9.406846094
19009,2016,65,75,-67,1,-10,-66,11.456772715,13.219353133,-11.8092888,0.1762580418,-1.762580418,-11.63303076
19009,2017,68,71,-54,1,-3,-53,12.128779096,12.663872291,-9.631677517,0.1783643985,-0.535093195,-9.453313119
39011,2010,130,100,-55,4,30,-51,NA,NA,NA,NA,NA,NA
39011,2011,573,461,-306,25,112,-281,12.497546293,10.054744924,-6.674082314,0.5452681629,2.4428013697,-6.128814151
39011,2012,511,452,-58,28,59,-30,11.162079511,9.873307121,-1.26692879,0.6116207951,1.2887723897,-0.655307995
39011,2013,535,520,-21,29,15,8,11.680330106,11.352844215,-0.458480247,0.6331393889,0.3274858908,0.1746591418
39011,2014,526,490,-131,37,36,-94,11.488855155,10.702545677,-2.861292824,0.8081514083,0.7863094783,-2.053141416
39011,2015,564,469,-139,41,95,-98,12.327599397,10.251142052,-3.038184958,0.8961552753,2.0764573452,-2.142029682
39011,2016,557,504,-49,45,53,-4,12.168745767,11.010857929,-1.070500076,0.9831123151,1.1578878378,-0.087387761
39011,2017,565,493,-134,45,72,-89,12.33961234,10.767130767,-2.926562927,0.9828009828,1.5724815725,-1.943761944
51015,2010,156,161,-173,3,-5,-170,NA,NA,NA,NA,NA,NA
51015,2011,646,616,12,21,30,33,8.7757430854,8.3682008368,0.1630168994,0.285279574,0.4075422485,0.4482964734
51015,2012,706,647,-136,15,59,-121,9.5912836153,8.7897457495,-1.847612708,0.2037808134,0.8015378659,-1.643831894
51015,2013,686,706,280,19,-20,299,9.3065532515,9.5778813347,3.7985931639,0.257761679,-0.271328083,4.0563548429
51015,2014,692,746,89,18,-54,107,9.3683155985,10.099369128,1.2048845206,0.2436845098,-0.731053529,1.4485690304
51015,2015,670,702,432,20,-32,452,9.0426895928,9.474579245,5.8305103046,0.2699310326,-0.431889652,6.1004413372
51015,2016,693,731,492,21,-38,513,9.2973335569,9.807144055,6.6007043435,0.2817373805,-0.509810498,6.882441724
51015,2017,691,757,416,21,-66,437,9.2183727104,10.09885404,5.5497005029,0.2801531504,-0.88048133,5.8298536533
46003,2010,3,10,-1,0,-7,-1,NA,NA,NA,NA,NA,NA
46003,2011,34,24,5,0,10,5,12.553073657,8.8609931697,1.8460402437,0,3.6920804874,1.8460402437
46003,2012,37,31,37,2,6,39,13.513513514,11.322132944,13.513513514,0.7304601899,2.1913805698,14.243973703
46003,2013,29,29,-47,3,0,-44,10.589738908,10.589738908,-17.1626803,1.0954902319,0,-16.06719007
46003,2014,39,36,22,4,3,26,14.275256223,13.17715959,8.0527086384,1.4641288433,1.0980966325,9.5168374817
46003,2015,45,23,-32,4,22,-28,16.396429222,8.380397158,-11.659683,1.4574603753,8.0160320641,-10.20222263
46003,2016,37,18,-17,6,19,-11,13.47414421,6.554989075,-6.190823015,2.1849963583,6.9191551347,-4.005826657
46003,2017,37,18,-36,6,19,-30,13.483965015,6.5597667638,-13.11953353,2.1865889213,6.9241982507,-10.93294461
48015,2010,66,105,-21,9,-39,-12,NA,NA,NA,NA,NA,NA
48015,2011,351,252,84,34,99,118,12.331582553,8.8534438843,2.9511479614,1.1945122701,3.4781386688000002,4.1456602315
48015,2012,332,244,-170,29,88,-141,11.631573416,8.5485057632,-5.955926147,1.0160109309,3.0830676523,-4.939915216
48015,2013,332,263,47,20,69,67,11.615092623,9.20111253,1.644305281,0.6997043749,2.4139800934,2.3440096559
48015,2014,338,260,187,25,78,212,11.737945165,9.0291885885,6.494070254,0.8681912104,2.7087565765,7.3622614645
48015,2015,372,288,391,31,84,422,12.742562557,9.8652097213,13.393392365,1.0618802131,2.8773528354,14.455272578
48015,2016,347,269,77,36,78,113,11.745988762,9.1056800487,2.6064586013,1.2186040214,2.640308713,3.8250626227
48015,2017,351,277,42,36,74,78,11.813607526,9.3229894149,1.4135940629,1.2116520539,2.4906181108,2.6252461168
01001,2010,151,154,147,25,-3,172,NA,NA,NA,NA,NA,NA
01001,2011,636,507,325,0,129,325,11.569000173,9.2224576849,5.9118318493,0,2.3465424879,5.9118318493
01001,2012,614,560,-321,-15,54,-336,11.150863556,10.170168716,-5.829685996,-0.272415233,0.9806948405,-6.10210123
01001,2013,573,582,-224,2,-9,-222,10.454105928,10.618306544,-4.086770904,0.0364890259,-0.164200617,-4.050281878
01001,2014,639,576,102,13,63,115,11.664947654,10.514882392,1.8620104236,0.237315054,1.1500652616,2.0993254776
01001,2015,650,583,-107,16,67,-91,11.850285318,10.62879437,-1.950739275,0.2916993309,1.2214909482,-1.659039945
01001,2016,666,505,266,15,161,281,12.096334774,9.1721457372,4.8312688438,0.2724399724,2.924189037,5.1037088162
01001,2017,664,510,58,15,154,73,11.987506996,9.2072719395,1.0471015147,0.2708021159,2.7802350562,1.3179036306
37011,2010,37,56,-26,1,-19,-25,NA,NA,NA,NA,NA,NA
37011,2011,176,194,-16,3,-18,-13,9.9185663163,10.932965144,-0.901687847,0.1690664713,-1.014398828,-0.732621376
37011,2012,131,189,-104,9,-58,-95,7.4214655978,10.707305328,-5.891850551,0.5098716823,-3.28583973,-5.381978869
37011,2013,141,184,67,6,-43,73,8.0161459962,10.460786265,3.8090906507,0.3411125956,-2.444640268,4.1502032463
37011,2014,140,180,27,8,-40,35,7.9543194796,10.226982188,1.5340473282,0.4545325417,-2.272662708,1.9885798699
37011,2015,122,186,-104,11,-64,-93,6.9640665582,10.617347376,-5.936581328,0.6279076405,-3.653280817,-5.308673688
37011,2016,153,198,90,15,-45,105,8.7578706354,11.33371494,5.151688609,0.8586147682,-2.575844305,6.0103033772
37011,2017,145,199,75,15,-54,90,8.2772005937,11.359744263,4.2813106519,0.8562621304,-3.082543669,5.1375727823
22009,2010,126,81,-7,4,45,-3,NA,NA,NA,NA,NA,NA
22009,2011,567,514,-397,26,53,-371,13.515285144,12.251951612,-9.463083249,0.6197485251,1.263333532,-8.843334724
22009,2012,581,514,-307,32,67,-275,13.935694326,12.328652123,-7.363611288,0.7675425446,1.6070422028,-6.596068743
22009,2013,528,520,-340,33,8,-307,12.741620213,12.548565361,-8.204831198,0.7963512633,0.1930548517,-7.408479934
22009,2014,560,534,-229,36,26,-193,13.590418755,12.959435027,-5.557510527,0.8736697771,0.6309837279,-4.683840749
22009,2015,561,451,-222,38,110,-184,13.6557818,10.978177525,-5.403892263,0.9249905675,2.6776042744,-4.478901695
22009,2016,546,472,-117,41,74,-76,13.303769401,11.500694428,-2.850807729,0.999000999,1.8030749738,-1.85180673
22009,2017,538,455,-183,41,83,-142,13.118751524,11.094854913,-4.462326262,0.999756157,2.0238966106,-3.462570105
08009,2010,13,7,15,0,6,15,NA,NA,NA,NA,NA,NA
08009,2011,38,74,6,1,-36,7,10.018455049,19.50962299,1.5818613235,0.2636435539,-9.491167941,1.8455048774
08009,2012,55,71,-40,0,-16,-40,14.666666667,18.933333333,-10.66666667,0,-4.266666667,-10.66666667
08009,2013,46,54,-60,0,-8,-60,12.471194252,14.640097601,-16.26677511,0,-2.168903348,-16.26677511
08009,2014,37,49,-59,0,-12,-59,10.219582931,13.534042259,-16.2960917,0,-3.314459329,-16.2960917
08009,2015,30,56,-8,0,-26,-8,8.4057158868,15.690669655,-2.241524236,0,-7.284953769,-2.241524236
08009,2016,38,45,4,0,-7,4,10.704225352,12.676056338,1.1267605634,0,-1.971830986,1.1267605634
08009,2017,31,40,23,0,-9,23,8.7201125176,11.251758087,6.4697609001,0,-2.53164557,6.4697609001
13005,2010,38,57,-13,5,-19,-8,NA,NA,NA,NA,NA,NA
13005,2011,136,136,87,11,0,98,12.237919554,12.237919554,7.8286691262,0.9898317286,0,8.8185008549
13005,2012,170,113,-57,13,57,-44,15.220018801,10.116836027,-5.103182775,1.1638837907,5.1031827745,-3.939298984
13005,2013,142,117,-6,11,25,5,12.68876776,10.454829774,-0.536145117,0.9829327138,2.2339379859,0.4467875972
13005,2014,132,133,6,10,-1,16,11.773625295,11.862819426,0.5351647862,0.8919413103,-0.089194131,1.4271060964
13005,2015,167,127,18,14,40,32,14.841146412,11.286380804,1.5996445234,1.2441679627,3.5547656076,2.8438124861
13005,2016,151,118,32,14,33,46,13.332156101,10.418506092,2.8253575843,1.2360939431,2.9136500088,4.0614515275
13005,2017,149,110,-99,14,39,-85,13.137012873,9.698465879,-8.728619291,1.2343502028,3.4385469935,-7.494269088
48017,2010,21,29,-8,3,-8,-5,NA,NA,NA,NA,NA,NA
48017,2011,134,64,-89,24,70,-65,18.725544997,8.9435438793,-12.43711571,3.3538289547,9.7820011179,-9.083286752
48017,2012,126,51,-158,27,75,-131,17.66437684,7.1498668162,-22.15056778,3.7852236086,10.514510024,-18.36534417
48017,2013,107,64,-79,26,43,-53,15.066178541,9.0115460434,-11.12362715,3.6609405801,6.0546324979,-7.462686567
48017,2014,110,63,-242,32,47,-210,15.673981191,8.9769165004,-34.48275862,4.5597036193,6.6970646908,-29.923055
48017,2015,130,59,145,42,71,187,18.390154194,8.3463007498,20.512095063,5.941434432,10.043853445,26.453529495
48017,2016,131,48,-145,44,83,-101,18.221016761,6.6764030878,-20.16830099,6.1200361639,11.544613673,-14.04826483
48017,2017,133,46,-231,42,87,-189,18.657501578,6.4529704706,-32.40513432,5.8918426036,12.204531108,-26.51329172
12003,2010,81,79,-59,-1,2,-60,NA,NA,NA,NA,NA,NA
12003,2011,360,228,-162,8,132,-154,13.307703682,8.4282123318,-5.988466657,0.2957267485,4.87949135,-5.692739908
12003,2012,344,226,-127,12,118,-115,12.720717389,8.3572154941,-4.696311362,0.4437459554,4.3635018952,-4.252565406
12003,2013,314,247,-116,6,67,-110,11.620376367,9.1408693078,-4.292877894,0.2220454083,2.4795070592,-4.070832485
12003,2014,393,209,-63,9,184,-54,14.522476581,7.7231491233,-2.328030597,0.3325757996,6.7993274578,-1.995454797
12003,2015,313,237,156,9,76,165,11.488979023,8.6993227742,5.7261365096,0.3303540294,2.7896562483,6.056490539
12003,2016,360,223,405,9,137,414,13.024837642,8.068163317,14.652942347,0.325620941,4.9566743248,14.978563288
12003,2017,343,242,256,9,101,265,12.206840101,8.6124061354,9.1106445069,0.3202960959,3.5944339656,9.4309406029
13007,2010,4,2,-19,0,2,-19,NA,NA,NA,NA,NA,NA
13007,2011,35,27,-135,3,8,-132,10.368834247,7.9988149904,-39.99407495,0.8887572212,2.3700192564,-39.10531773
13007,2012,37,16,38,2,21,40,11.056327506,4.7811145973,11.355147169,0.5976393247,6.275212909,11.952786493
13007,2013,31,25,-34,2,6,-32,9.2152199762,7.4316290131,-10.10701546,0.594530321,1.7835909631,-9.512485137
13007,2014,25,23,-61,2,2,-59,7.5233222991,6.9214565152,-18.35690641,0.6018657839,0.6018657839,-17.75504063
13007,2015,38,44,-90,2,-6,-88,11.699507389,13.54679803,-27.70935961,0.6157635468,-1.84729064,-27.09359606
13007,2016,29,20,-6,3,9,-3,9.0497737557,6.2412232798,-1.872366984,0.936183492,2.8085504759,-0.936183492
13007,2017,27,27,-11,3,0,-8,8.4269662921,8.4269662921,-3.433208489,0.936329588,0,-2.496878901
41001,2010,44,43,-22,0,1,-22,NA,NA,NA,NA,NA,NA
41001,2011,172,210,-16,3,-38,-13,10.690866147,13.052801691,-0.994499176,0.1864685956,-2.361935544,-0.808030581
41001,2012,183,202,-54,8,-19,-46,11.417519341,12.602944847,-3.369104068,0.4991265286,-1.185425505,-2.869977539
41001,2013,165,192,47,7,-27,54,10.308312248,11.99512698,2.9363071252,0.4373223378,-1.686814732,3.373629463
41001,2014,172,207,28,2,-35,30,10.739931314,12.925382454,1.7483609116,0.1248829223,-2.18545114,1.8732438339
41001,2015,156,215,-85,2,-59,-83,9.7873141351,13.488926532,-5.33283142,0.1254783863,-3.701612397,-5.207353033
41001,2016,147,205,138,2,-58,140,9.2409240924,12.887002986,8.6751532296,0.1257268584,-3.646078894,8.800880088
41001,2017,149,193,148,2,-44,150,9.3119180051,12.061746141,9.2494219111,0.124992188,-2.749828136,9.3744140991
01003,2010,516,532,778,35,-16,813,NA,NA,NA,NA,NA,NA
01003,2011,2188,1825,2837,173,363,3010,11.838417504,9.8743656058,15.349904232,0.9360357533,1.9640518986,16.285939985
01003,2012,2094,1881,3090,148,213,3238,11.121083854,9.989856127,16.410768438,0.786017388,1.1312277273,17.196785826
01003,2013,2161,1904,4197,154,257,4351,11.23227577,9.8964613913,21.814836376,0.8004490831,1.335814379,22.615285459
01003,2014,2216,1989,3872,141,227,4013,11.25444388,10.101574403,19.664804469,0.7160995429,1.1528694769,20.380904012
01003,2015,2256,2090,3426,172,166,3598,11.225919135,10.399898489,17.047871877,0.8558768135,0.8260206455,17.903748691
01003,2016,2312,2045,4205,169,267,4374,11.26782529,9.9665669198,20.493600928,0.8236429386,1.3012583705,21.317243867
01003,2017,2325,2090,4702,164,235,4866,11.067818354,9.9491356391,22.383175012,0.7806977248,1.1186827154,23.163872737
13009,2010,120,129,-155,7,-9,-148,NA,NA,NA,NA,NA,NA
13009,2011,499,370,-713,25,129,-688,10.986591515,8.1463704617,-15.69827605,0.5504304366,2.8402210529,-15.14784562
13009,2012,466,397,1215,26,69,1241,10.169565502,8.6637714685,26.515068852,0.5674006503,1.5057940336,27.082469502
13009,2013,483,372,-472,24,111,-448,10.424647925,8.0289213835,-10.18723358,0.517994928,2.3957265418,-9.669238655
13009,2014,455,402,-389,24,53,-365,9.8892620002,8.737325987,-8.454775644,0.5216314022,1.1519360132,-7.933144242
13009,2015,490,413,-442,25,77,-417,10.725503716,9.0400674175,-9.674842127,0.5472195773,1.6854362982,-9.12762255
13009,2016,407,459,-303,28,-52,-275,8.9738501565,10.120386294,-6.680777881,0.6173656127,-1.146536138,-6.063412268
13009,2017,412,470,-255,28,-58,-227,9.1458000355,10.433315574,-5.660628663,0.6215592257,-1.287515539,-5.039069437
21007,2010,19,16,13,0,3,13,NA,NA,NA,NA,NA,NA
21007,2011,100,105,13,2,-5,15,12.098481641,12.703405723,1.5728026133,0.2419696328,-0.604924082,1.8147722461
21007,2012,81,102,36,3,-21,39,9.7837903128,12.320328542,4.3483512502,0.3623626042,-2.536538229,4.7107138543
21007,2013,79,107,-4,0,-28,-4,9.5508674364,12.935985009,-0.483588225,0,-3.385117572,-0.483588225
21007,2014,77,100,-43,1,-23,-42,9.3639790831,12.161011796,-5.229235072,0.121610118,-2.797032713,-5.107624954
21007,2015,86,116,56,1,-30,57,10.48269137,14.139444174,6.8259385666,0.1218917601,-3.656752804,6.9478303267
21007,2016,82,94,-149,1,-12,-148,10.077424112,11.552169104,-18.31141698,0.122895416,-1.474744992,-18.18852157
21007,2017,80,106,7,1,-26,8,9.9403578529,13.170974155,0.8697813121,0.1242544732,-3.230616302,0.9940357853
24510,2010,2120,1427,-1021,464,693,-557,NA,NA,NA,NA,NA,NA
24510,2011,8952,6271,-4958,2117,2681,-2841,14.417026005,10.099326416,-7.98476485,3.4093882991,4.3176995889,-4.575376551
24510,2012,9008,6075,-2388,2074,2933,-314,14.479684559,9.7651069822,-3.838530942,3.3337994866,4.7145775767,-0.504731456
24510,2013,9009,6408,-4683,2008,2601,-2675,14.452937312,10.280211155,-7.512832216,3.221389513,4.172726157,-4.291442703
24510,2014,8744,6176,-3765,2065,2568,-1700,14.02021258,9.9026570099,-6.03683673,3.3110405967,4.1175555702,-2.725796133
24510,2015,8930,6311,-5892,2267,2619,-3625,14.321305628,10.121137718,-9.449175001,3.6356550795,4.2001679105,-5.813519922
24510,2016,8477,6632,-10211,2291,1845,-7920,13.672701935,10.696869085,-16.46950094,3.6951940703,2.9758328501,-12.77430687
24510,2017,8340,6711,-9209,2282,1629,-6927,13.576362154,10.924576308,-14.99097351,3.7147791888,2.6517858451,-11.27619432
24005,2010,2409,1875,19,804,534,823,NA,NA,NA,NA,NA,NA
24005,2011,9950,7589,1132,3506,2361,4638,12.286339628,9.3709579332,1.3978026592,4.3292368578,2.9153816946,5.7270395169
24005,2012,9664,7510,-52,3337,2154,3285,11.844131523,9.2042040294,-0.06373084,4.0898041073,2.6399274939,4.0260732672
24005,2013,9539,7845,28,3182,1694,3210,11.619132652,9.5557286563,0.0341058512,3.8758863715,2.0634039954,3.9099922226
24005,2014,9852,7646,-2172,3244,2206,1072,11.942476828,9.2683899536,-2.63287248,3.9323380865,2.6740868739,1.2994656069
24005,2015,10071,8126,-2607,3572,1945,965,12.163601711,9.8144600839,-3.14869523,4.3142076569,2.3491416273,1.1655124269
24005,2016,9888,8431,-2987,3586,1457,599,11.907442754,10.152877211,-3.597039999,4.3183747689,1.7545655433,0.7213347704
24005,2017,9798,8437,-3867,3546,1361,-321,11.777157147,10.141240544,-4.648118666,4.2622779387,1.6359166031,-0.385840727
45009,2010,39,18,-36,-1,21,-37,NA,NA,NA,NA,NA,NA
45009,2011,172,210,-94,-7,-38,-101,10.815909448,13.205470838,-5.91102028,-0.440182361,-2.38956139,-6.351202641
45009,2012,163,177,-100,-8,-14,-108,10.335425781,11.223131063,-6.340752013,-0.507260161,-0.887705282,-6.848012174
45009,2013,155,195,-258,1,-40,-257,9.9601593625,12.530523069,-16.57884591,0.0642590927,-2.570363706,-16.51458681
45009,2014,150,154,-245,2,-4,-243,9.8077677521,10.069308225,-16.019354,0.1307702367,-0.261540473,-15.88858376
45009,2015,136,182,-430,5,-46,-425,9.1018605274,12.180431,-28.77794137,0.3346272253,-3.078570472,-28.44331415
45009,2016,127,172,-140,4,-45,-136,8.6864334325,11.764303546,-9.57559591,0.2735884546,-3.077870114,-9.302007455
45009,2017,118,179,-91,4,-61,-87,8.1629829477,12.382830065,-6.295181765,0.2767112864,-4.219847117,-6.018470478
48019,2010,40,30,62,0,10,62,NA,NA,NA,NA,NA,NA
48019,2011,172,203,7,6,-31,13,8.370848035,9.8795473902,0.3406740479,0.2920063268,-1.508699355,0.6326803747
48019,2012,179,179,48,10,0,58,8.7034740962,8.7034740962,2.3338924951,0.4862276031,0,2.8201200982
48019,2013,156,196,5,5,-40,10,7.5809116532,9.524735154,0.2429779376,0.2429779376,-1.943823501,0.4859558752
48019,2014,141,226,330,4,-85,334,6.8157099698,10.924471299,15.951661631,0.1933534743,-4.108761329,16.145015106
48019,2015,163,215,375,4,-52,379,7.7693040991,10.2478551,17.874165872,0.1906577693,-2.478551001,18.064823642
48019,2016,171,221,610,5,-50,615,7.9802128057,10.313608363,28.467425798,0.2333395557,-2.333395557,28.700765354
48019,2017,171,204,667,5,-33,672,7.7619663648,9.2598896984,30.276207984,0.2269580808,-1.497923334,30.503166065
13011,2010,50,21,2,2,29,4,NA,NA,NA,NA,NA,NA
13011,2011,181,135,-213,7,46,-206,9.8669864806,7.3593545573,-11.61142608,0.3815961622,2.5076319232,-11.22982992
13011,2012,182,171,-130,5,11,-125,9.9945085118,9.3904448105,-7.138934651,0.2745744097,0.6040637013,-6.864360242
13011,2013,161,133,62,3,28,65,8.8468829849,7.3082946397,3.4068741929,0.1648487513,1.5385883452,3.5717229442
13011,2014,211,141,-70,3,70,-67,11.56417845,7.7277211444,-3.836457306,0.1644195988,3.8364573057,-3.672037707
13011,2015,236,187,86,3,49,89,12.885612886,10.21021021,4.6956046956,0.1638001638,2.6754026754,4.8594048594
13011,2016,184,159,-101,3,25,-98,10.029707558,8.6669755526,-5.505437301,0.1635278406,1.3627320051,-5.34190946
13011,2017,197,135,260,2,62,262,10.665078635,7.3085564248,14.0757383,0.10827491,3.3565222099,14.18401321
31007,2010,2,1,-1,1,1,0,NA,NA,NA,NA,NA,NA
31007,2011,4,6,-36,2,-2,-34,5.9347181009,8.9020771513,-53.41246291,2.9673590504,-2.96735905,-50.44510386
31007,2012,8,2,21,2,6,23,11.931394482,2.9828486204,31.319910515,2.9828486204,8.9485458613,34.302759135
31007,2013,4,0,-13,2,4,-11,5.8651026393,0,-19.06158358,2.9325513196,5.8651026393,-16.12903226
31007,2014,6,10,-9,3,-4,-6,8.9020771513,14.836795252,-13.35311573,4.4510385757,-5.934718101,-8.902077151
31007,2015,4,6,44,3,-2,47,5.7803468208,8.6705202312,63.583815029,4.3352601156,-2.89017341,67.919075145
31007,2016,11,3,-1,3,8,2,15.288394719,4.169562196,-1.389854065,4.169562196,11.118832523,2.7797081306
31007,2017,8,2,8,3,6,11,10.914051842,2.7285129604,10.914051842,4.0927694407,8.1855388813,15.006821282
16005,2010,354,118,-58,13,236,-45,NA,NA,NA,NA,NA,NA
16005,2011,1422,658,-236,57,764,-179,17.06847194,7.8980692942,-2.832742178,0.684179255,9.1704026455,-2.148562923
16005,2012,1285,657,-606,106,628,-500,15.359514233,7.8530745923,-7.243475195,1.2670105126,7.5064396407,-5.976464682
16005,2013,1329,670,-1132,145,659,-987,15.903406847,8.0175188771,-13.54601697,1.7351346824,7.8858879701,-11.81088229
16005,2014,1267,716,-666,218,551,-448,15.180561213,8.5787544032,-7.979679375,2.6119671228,6.6018068103,-5.367712252
16005,2015,1294,696,-342,228,598,-114,15.450192829,8.3101500842,-4.083435817,2.7222905448,7.1400427447,-1.361145272
16005,2016,1230,681,-395,234,549,-161,14.610592085,8.0892790326,-4.69201941,2.7795760553,6.5213130527,-1.912443354
16005,2017,1210,662,109,235,548,344,14.264830708,7.8043949826,1.2850136754,2.7704423276,6.4604357257,4.055456003
26013,2010,22,11,-17,0,11,-17,NA,NA,NA,NA,NA,NA
26013,2011,80,113,2,7,-33,9,9.0477267587,12.779914047,0.226193169,0.7916760914,-3.732187288,1.0178692603
26013,2012,88,119,-82,4,-31,-78,10.028490028,13.561253561,-9.344729345,0.4558404558,-3.532763533,-8.888888889
26013,2013,74,90,1,4,-16,5,8.4906201595,10.326429924,0.1147381103,0.4589524411,-1.835809764,0.5736905513
26013,2014,77,109,-40,4,-32,-36,8.8760806916,12.564841499,-4.610951009,0.4610951009,-3.688760807,-4.149855908
26013,2015,81,93,-57,4,-12,-53,9.4103979088,10.804530932,-6.622131862,0.4647110078,-1.394133024,-6.157420854
26013,2016,64,99,-8,4,-35,-4,7.4805680556,11.571503711,-0.935071007,0.4675355035,-4.090935655,-0.467535503
26013,2017,66,103,-62,4,-37,-58,7.7752253048,12.134063733,-7.303999529,0.471225776,-4.358838428,-6.832773753
20007,2010,13,5,-20,0,8,-20,NA,NA,NA,NA,NA,NA
20007,2011,80,57,47,0,23,47,16.356573298,11.654058475,9.6094868125,0,4.7025148231,9.6094868125
20007,2012,57,54,-57,1,3,-56,11.635027557,11.022657685,-11.63502756,0.2041232905,0.6123698714,-11.43090427
20007,2013,64,72,46,1,-8,47,13.079910076000001,14.714898835,9.4011853669,0.2043735949,-1.634988759,9.6055589618
20007,2014,69,58,-37,0,11,-37,14.081632653,11.836734694,-7.551020408,0,2.2448979592,-7.551020408
20007,2015,54,70,-44,0,-16,-44,11.117974058,14.412188594,-9.059089973,0,-3.294214536,-9.059089973
20007,2016,59,57,-148,0,2,-148,12.407991588,11.987381703,-31.12513144,0,0.4206098843,-31.12513144
20007,2017,55,51,-101,0,4,-101,11.868795857,11.005610703,-21.79542512,0,0.8631851532,-21.79542512
01005,2010,70,128,-70,1,-58,-69,NA,NA,NA,NA,NA,NA
01005,2011,334,318,11,-4,16,7,12.215862334,11.630671324,0.4023188194,-0.146297753,0.58519101,0.2560210669
01005,2012,300,292,-175,-11,8,-186,11.003924733,10.71048674,-6.418956094,-0.40347724,0.2934379929,-6.822433335
01005,2013,283,294,-207,-10,-11,-217,10.457854477,10.86434352,-7.649384723,-0.369535494,-0.406489043,-8.018920217
01005,2014,264,313,-140,-9,-49,-149,9.8331346841,11.658224076,-5.21454112,-0.335220501,-1.825089392,-5.549761621
01005,2015,272,329,-430,-5,-57,-435,10.261633939,12.412049875,-16.22243601,-0.188632977,-2.150415936,-16.41106898
01005,2016,272,269,-488,-5,3,-493,10.453899074,10.338598716,-18.75552481,-0.192167262,0.1153003574,-18.94769207
01005,2017,270,286,-486,-3,-16,-489,10.57910822,11.206018337,-19.0423948,-0.117545647,-0.626910117,-19.15994044
54001,2010,38,31,15,0,7,15,NA,NA,NA,NA,NA,NA
54001,2011,153,176,11,1,-23,12,9.2140921409,10.599217103,0.662451069,0.0602228245,-1.385124962,0.7226738934
54001,2012,194,174,246,-4,20,242,11.593510025,10.398302806,14.701048794,-0.239041444,1.1952072191,14.462007351
54001,2013,180,216,38,-6,-36,32,10.672358591,12.806830309,2.2530534804,-0.355745286,-2.134471718,1.897308194
54001,2014,162,200,84,-5,-38,79,9.5957352288,11.846586702,4.9755664149,-0.296164668,-2.250851473,4.6794017474
54001,2015,172,200,102,-5,-28,97,10.155880964,11.809163911,6.0226735947,-0.295229098,-1.653282948,5.7274444969
54001,2016,160,210,-197,-5,-50,-202,9.4983674681,12.466607302,-11.69486495,-0.296823983,-2.968239834,-11.99168893
54001,2017,158,199,-176,-5,-41,-181,9.5132010717,11.98181654,-10.59698347,-0.301050667,-2.468615468,-10.89803414
38003,2010,33,46,4,4,-13,8,NA,NA,NA,NA,NA,NA
38003,2011,113,121,33,19,-8,52,10.198095754,10.920084834,2.9782049547,1.7147240648,-0.72198908,4.6929290194
38003,2012,118,135,-97,8,-17,-89,10.67969952,12.218300299,-8.779075029,0.7240474251,-1.538600778,-8.055027604
38003,2013,111,138,134,-1,-27,133,10.044794353,12.488122709,12.126148138,-0.090493643,-2.443328356,12.035654495
38003,2014,133,133,-46,7,0,-39,11.999278239,11.999278239,-4.150126308,0.6315409599,0,-3.518585348
38003,2015,101,131,-19,9,-30,-10,9.1456512881,11.862181374,-1.720469054,0.8149590257,-2.716530086,-0.905510029
38003,2016,110,122,-91,9,-12,-82,10.021865889,11.11516035,-8.290816327,0.8199708455,-1.093294461,-7.470845481
38003,2017,109,114,-199,9,-5,-190,10.063241472,10.524858053,-18.37233993,0.8309098463,-0.461616581,-17.54143009
25001,2010,446,707,200,89,-261,289,NA,NA,NA,NA,NA,NA
25001,2011,1650,2871,464,240,-1221,704,7.6527595155,13.315801557,2.1520487365,1.1131286568,-5.663042041,3.2651773933
25001,2012,1593,2680,231,347,-1087,578,7.4071146429,12.461435808,1.0741013701,1.6134769498,-5.054321166,2.6875783199
25001,2013,1541,2886,879,261,-1345,1140,7.1782426116,13.443483567,4.0945329368,1.2157828174,-6.265240956,5.3103157542
25001,2014,1547,2862,763,294,-1315,1057,7.214727932,13.347479859,3.5583952244,1.3711247654,-6.132751927,4.9295199897
25001,2015,1481,2998,721,317,-1517,1038,6.919720034,14.007643931,3.3687495912,1.481128461,-7.087923897,4.8498780522
25001,2016,1549,2835,650,318,-1286,968,7.2516519862,13.272068032,3.042978561,1.4887187422,-6.020416045,4.5316973032
25001,2017,1519,2832,1023,307,-1313,1330,7.1166874373,13.268241489,4.7928711313,1.4383298507,-6.151554052,6.231200982
45011,2010,67,37,-13,1,30,-12,NA,NA,NA,NA,NA,NA
45011,2011,292,237,-242,1,55,-241,12.950437964,10.511143142,-10.73289722,0.0443508149,2.439294822,-10.6885464
45011,2012,320,251,-166,-3,69,-169,14.280932723,11.201606605,-7.40823385,-0.133883744,3.0793261185,-7.542117595
45011,2013,301,280,-168,-2,21,-170,13.507449291,12.565069108,-7.539041465,-0.089750494,0.9423801831,-7.628791958
45011,2014,314,265,-240,-1,49,-241,14.197544819,11.982004386,-10.85162661,-0.045215111,2.2155404336,-10.89684172
45011,2015,246,256,-239,0,-10,-239,11.234159151,11.690832287,-10.91448796,0,-0.456673136,-10.91448796
45011,2016,241,269,-152,0,-28,-152,11.115210774,12.406604557,-7.010423393,0,-1.291393783,-7.010423393
45011,2017,247,274,-220,0,-27,-220,11.505496553,12.763182411,-10.24781069,0,-1.257685858,-10.24781069
21009,2010,112,121,-43,4,-9,-39,NA,NA,NA,NA,NA,NA
21009,2011,518,439,104,23,79,127,12.267904509,10.396930656,2.4630541872,0.5447139068,1.8709738537,3.007768094
21009,2012,532,468,191,32,64,223,12.527816698,11.02071093,4.497768777,0.7535528841,1.5071057682,5.2513216611
21009,2013,530,442,204,27,88,231,12.39316739,10.335433936,4.7702002783,0.6313500368,2.0577334534,5.4015503151
21009,2014,576,501,7,29,75,36,13.402829486,11.657669397,0.1628816083,0.6747952345,1.7451600894,0.8376768429
21009,2015,553,512,445,34,41,479,12.77475542,11.827621655,10.279866477,0.7854280005,0.9471337653,11.065294478
21009,2016,591,505,123,33,86,156,13.533627974,11.564267558,2.8166433855,0.7556848107,1.9693604159,3.5723281962
21009,2017,570,514,-76,33,56,-43,13.015184382,11.7364996,-1.735357918,0.7535106747,1.2786847814,-0.981847243
55005,2010,132,143,-50,5,-11,-45,NA,NA,NA,NA,NA,NA
55005,2011,523,513,48,18,10,66,11.407880817,11.189756901,1.0469947977,0.3926230492,0.2181239162,1.4396178469
55005,2012,569,500,-204,24,69,-180,12.417615992,10.911789097,-4.452009952,0.5237658767,1.5058268954,-3.928244075
55005,2013,515,505,-232,27,10,-205,11.277413421,11.05843452,-5.080310512,0.5912430337,0.2189789014,-4.489067478
55005,2014,491,490,-267,30,1,-237,10.802842622,10.780840906,-5.874458208,0.660051484,0.0220017161,-5.214406724
55005,2015,517,490,-24,37,27,13,11.39996913,10.804612908,-0.52920553,0.8158585257,0.5953562215,0.2866529955
55005,2016,468,478,-128,39,-10,-89,10.327136316,10.547801622,-2.824515915,0.860594693,-0.220665306,-1.963921222
55005,2017,484,469,-66,39,15,-27,10.694005612,10.362579818,-1.458273493,0.8617070638,0.3314257938,-0.596566429
13013,2010,264,138,169,20,126,189,NA,NA,NA,NA,NA,NA
13013,2011,1073,515,-456,91,558,-365,15.373594097,7.3787520596,-6.533419299,1.3038183251,7.9948420374,-5.229600974
13013,2012,1079,494,-298,30,585,-268,15.403283369,7.0521056388,-4.254104211,0.4282655246,8.3511777302,-3.825838687
13013,2013,1060,509,530,28,551,558,14.979685568,7.1930754284,7.489842784,0.3956898075,7.7866101396,7.8855325914
13013,2014,990,563,1147,44,427,1191,13.723506009,7.8043776598,15.899859993,0.6099336004,5.9191283494,16.509793593
13013,2015,1036,540,1525,61,496,1586,13.997540973,7.2960155648,20.604488401,0.824179536,6.7015254077,21.428667937
13013,2016,1078,583,1462,63,495,1525,14.169481723,7.6630870542,19.216866678,0.8280865942,6.5063946687,20.044953272
13013,2017,1108,584,1374,64,524,1438,14.191300784,7.4798913879,17.598237615,0.8197141247,6.711409396,18.417951739
26015,2010,157,97,-148,2,60,-146,NA,NA,NA,NA,NA,NA
26015,2011,630,489,-335,9,141,-326,10.677513665,8.2877844159,-5.67772552,0.1525359095,2.3897292488,-5.525189611
26015,2012,640,506,-39,8,134,-31,10.854632723,8.5819439969,-0.661454182,0.135682909,2.2726887264,-0.525771273
26015,2013,625,557,2,1,68,3,10.585415837,9.4337225944,0.0338733307,0.0169366653,1.1516932431,0.050809996
26015,2014,616,477,66,6,139,72,10.409801436,8.0608365019,1.1153358682,0.1013941698,2.3489649345,1.216730038
26015,2015,655,546,8,7,109,15,11.039666956,9.2025315389,0.1348356269,0.1179811736,1.8371354171,0.2528168005
26015,2016,615,571,272,9,44,281,10.327369208,9.5885005164,4.5675519097,0.1511322323,0.7388686913,4.718684142
26015,2017,627,554,790,9,73,799,10.424113452,9.2104606893,13.134050441,0.1496284228,1.2136527623,13.283678864
29009,2010,95,122,-18,4,-27,-14,NA,NA,NA,NA,NA,NA
29009,2011,424,399,-287,36,25,-251,11.964389012,11.258941547,-8.098536902,1.0158443501,0.7054474653,-7.082692552
29009,2012,434,392,-92,46,42,-46,12.286438207,11.097428058,-2.604498422,1.3022492109,1.1890101491,-1.302249211
29009,2013,404,406,-32,45,-2,13,11.436497714,11.493114039,-0.905861205,1.2738673196,-0.056616325,0.3680061146
29009,2014,403,395,-49,50,8,1,11.406736485,11.180300028,-1.386923295,1.4152278517,0.2264364563,0.028304557
29009,2015,404,422,-38,56,-18,18,11.435850258,11.945368339,-1.075649282,1.5851673625,-0.509518081,0.5095180808
29009,2016,450,420,-72,57,30,-15,12.736329673,11.887241028,-2.037812748,1.6132684252,0.8490886449,-0.424544322
29009,2017,420,403,255,57,17,312,11.829819595,11.350993564,7.1823904685,1.6054755165,0.4788260312,8.787865985
18005,2010,247,206,-72,58,41,-14,NA,NA,NA,NA,NA,NA
18005,2011,981,712,269,238,269,507,12.708241573,9.2235147809,3.4847267922,3.0831411768,3.4847267922,6.567867969
18005,2012,1067,704,692,268,363,960,13.636392682,8.9972075428,8.8438460506,3.425073326,4.6391851393,12.268919377
18005,2013,1049,680,-2,302,369,300,13.237762326,8.5811996012,-0.025238822,3.8110621758,4.6565627248,3.7858233535
18005,2014,1094,772,123,350,322,473,13.681669814,9.6547066695,1.5382498968,4.3771338528,4.0269631445,5.9153837496
18005,2015,1084,742,210,388,342,598,13.412853572,9.1811230171,2.5984310426,4.8009106882,4.2317305551,7.3993417308
18005,2016,1081,727,-159,393,354,234,13.250877978,8.9115525346,-1.949019055,4.8173867209,4.3393254433,2.8683676659
18005,2017,1109,700,-633,392,409,-241,13.531568576,8.5411163239,-7.723609476,4.7830251414,4.9904522521,-2.940584334
20009,2010,82,72,-10,5,10,-5,NA,NA,NA,NA,NA,NA
20009,2011,386,328,-19,-8,58,-27,13.940805750000001,11.84607328,-0.686205464,-0.288928617,2.0947324702,-0.975134081
20009,2012,370,310,-218,-8,60,-226,13.39608979,11.223750905,-7.892831282,-0.289645185,2.1723388849,-8.182476466
20009,2013,372,278,-178,5,94,-173,13.528502591,10.110010001,-6.473315756,0.1818347122,3.4184925902,-6.291481044
20009,2014,369,284,-228,16,85,-212,13.470348805,10.367422929,-8.323142351,0.584080165,3.1029258766,-7.739062186
20009,2015,334,305,-215,20,29,-195,12.258680173,11.194303751,-7.891066579,0.734052705,1.0643764222,-7.157013874
20009,2016,363,285,-351,20,78,-331,13.426045789,10.54111033,-12.98220956,0.7397270407,2.8849354588,-12.24248252
20009,2017,346,304,-498,21,42,-477,12.961957031,11.388540281,-18.65622717,0.7867083747,1.5734167494,-17.8695188
29011,2010,24,19,-21,1,5,-20,NA,NA,NA,NA,NA,NA
29011,2011,148,129,-64,2,19,-62,11.968300178,10.431829209,-5.175481158,0.1617337862,1.5364709688,-5.013747372
29011,2012,151,138,-64,1,13,-63,12.256493506,11.201298701,-5.194805195,0.0811688312,1.0551948052,-5.113636364
29011,2013,142,148,-118,5,-6,-113,11.604625506,12.094961795,-9.64328035,0.4086135741,-0.490336289,-9.234666776
29011,2014,147,161,-183,4,-14,-179,12.166859791,13.325608343,-15.14649892,0.3310710147,-1.158748552,-14.81542791
29011,2015,135,152,-141,4,-17,-137,11.334060952,12.761313072,-11.83779699,0.3358240282,-1.42725212,-11.50197297
29011,2016,145,141,14,5,4,19,12.239385498,11.901747278,1.1817337723,0.4220477758,0.3376382206,1.6037815481
29011,2017,142,123,-32,5,19,-27,11.978573537,10.375806656,-2.699396854,0.4217807584,1.6027668818,-2.277616095
13015,2010,351,234,-166,17,117,-149,NA,NA,NA,NA,NA,NA
13015,2011,1280,833,-399,74,447,-325,12.78031831,8.3171915251,-3.983864848,0.7388621523,4.4631267848,-3.245002696
13015,2012,1239,758,-353,26,481,-327,12.354296084,7.5581569265,-3.519827698,0.2592507653,4.7961391578,-3.260576933
13015,2013,1274,840,264,1,434,265,12.650120891,8.3407390491,2.6213751297,0.0099294512,4.309381842,2.631304581
13015,2014,1314,844,-116,7,470,-109,12.980790603,8.3377376478,-1.145944985,0.0691518525,4.6430529555,-1.076793132
13015,2015,1344,847,286,8,497,294,13.2041086,8.3213392739,2.8098028717,0.0785958845,4.882769326,2.8883987562
13015,2016,1330,914,829,10,416,839,12.937302718,8.8907478831,8.0639277846,0.0972729528,4.0465548352,8.1612007373
13015,2017,1350,919,1181,9,431,1190,12.950571984,8.8159819651,11.329352232,0.0863371466,4.1345900185,11.415689378
48021,2010,183,176,148,1,7,149,NA,NA,NA,NA,NA,NA
48021,2011,879,564,443,20,315,463,11.766516964,7.5498470621,5.9301103697,0.2677250731,4.2166699016999996,6.1978354428
48021,2012,800,577,-545,21,223,-524,10.674565845,7.699030616,-7.272047982,0.2802073534,2.9755352294,-6.991840629
48021,2013,893,623,830,-10,270,820,11.851753542,8.2683566144,11.015627592,-0.132718405,3.5833969276,10.882909187
48021,2014,1038,655,1607,-1,383,1606,13.496733088,8.5167246367,20.895231284,-0.013002633,4.9800084517,20.882228651
48021,2015,1031,649,1855,18,382,1873,13.040975986,8.2091109748,23.463637686,0.2276795032,4.8318650114,23.691317189
48021,2016,1108,688,2121,15,420,2136,13.599096667,8.4442044283,26.032205803,0.1841032942,5.1548922382,26.216309097
48021,2017,1134,697,1553,16,437,1569,13.539086052,8.321642838,18.541623138,0.1910276692,5.217443214,18.732650807
29013,2010,48,58,-4,1,-10,-3,NA,NA,NA,NA,NA,NA
29013,2011,194,223,-43,4,-29,-39,11.411429076,13.117261257,-2.529337372,0.2352871974,-1.705832181,-2.294050175
29013,2012,185,192,-349,2,-7,-347,11.016494968,11.433335318,-20.78246889,0.1190972429,-0.41684035,-20.66337164
29013,2013,185,228,-146,0,-43,-146,11.194820126,13.796859399,-8.834831019,0,-2.602039273,-8.834831019
29013,2014,202,207,92,1,-5,93,12.260257344,12.56372906,5.5838795824,0.0606943433,-0.303471716,5.6445739257
29013,2015,187,213,-127,1,-26,-126,11.372274759,12.953446651,-7.723416548,0.0608143035,-1.581171892,-7.662602244
29013,2016,180,197,21,1,-17,22,10.996395626,12.034944102,1.282912823,0.0610910868,-1.038548476,1.3440039098
29013,2017,180,191,-27,1,-11,-26,11.007491209,11.680171228,-1.651123681,0.0611527289,-0.672680018,-1.589970952
21011,2010,36,18,12,1,18,13,NA,NA,NA,NA,NA,NA
21011,2011,148,155,101,3,-7,104,12.68752679,13.287612516,8.6583797685,0.2571795971,-0.600085727,8.9155593656
21011,2012,149,133,50,2,16,52,12.683549691,11.321557778,4.2562247287,0.1702489891,1.3619919132,4.4264737178
21011,2013,183,129,142,-1,54,141,15.406634113,10.860414211,11.954874558,-0.084189257,4.5462199023,11.870685301
21011,2014,163,134,128,-2,29,126,13.524726187,11.118486558,10.620643877,-0.165947561,2.4062396283,10.454696316
21011,2015,161,140,47,-2,21,45,13.23849854,11.511737861,3.8646548534,-0.164453398,1.7267606792,3.7002014554
21011,2016,179,142,41,-2,37,39,14.633149397,11.608420192,3.3517269569,-0.163498876,3.024729205,3.1882280809
21011,2017,170,154,95,-2,16,93,13.793663029,12.49543592,7.7082234573,-0.162278389,1.2982271086,7.5459450688
51017,2010,3,4,-5,0,-1,-5,NA,NA,NA,NA,NA,NA
51017,2011,36,73,-32,3,-37,-29,7.6791808874,15.571672355,-6.825938567,0.6399317406,-7.892491468,-6.186006826
51017,2012,31,71,21,4,-40,25,6.6702528241,15.277030662,4.5185583647,0.8606777838,-8.606777838,5.3792361485
51017,2013,47,59,-42,3,-12,-39,10.18638925,12.787169484,-9.102730819,0.6501950585,-2.600780234,-8.452535761
51017,2014,35,76,-16,3,-41,-13,7.6745970837,16.664839382,-3.508387238,0.6578226072,-8.990242298,-2.850564631
51017,2015,49,74,-52,3,-25,-49,10.897364617,16.457244524,-11.56455021,0.6671855888,-5.559879907,-10.89736462
51017,2016,33,44,-38,3,-11,-35,7.438295954,9.9177279387,-8.565310493,0.6762087231,-2.479431985,-7.889101769
51017,2017,33,46,-107,3,-13,-104,7.5774971297,10.562571757,-24.56946039,0.6888633754,-2.985074627,-23.88059701
05005,2010,83,136,56,-2,-53,54,NA,NA,NA,NA,NA,NA
05005,2011,334,679,189,-12,-345,177,8.0625694009,16.390672525,4.562352146,-0.289673152,-8.328103124,4.2726789939
05005,2012,326,674,102,-14,-348,88,7.9109892377,16.355848915,2.4752174915,-0.339735734,-8.444859677,2.1354817574
05005,2013,343,666,233,-7,-323,226,8.3605518452,16.233607956,5.6793253059,-0.170623507,-7.873056111,5.5087017989
05005,2014,327,666,221,14,-339,235,7.990518895,16.274267841,5.4003201095,0.3421017264,-8.283748946,5.7424218359
05005,2015,387,640,483,15,-253,498,9.4402907707,15.61185037,11.782068326,0.3659027431,-6.171559599,12.147971069
05005,2016,404,716,324,17,-312,341,9.8221557687,17.407582996,7.8771744284,0.4133085348,-7.585427227,8.2904829632
05005,2017,372,678,499,17,-306,516,9.0181818182,16.436363636,12.096969697,0.4121212121,-7.418181818,12.509090909
12005,2010,519,406,167,78,113,245,NA,NA,NA,NA,NA,NA
12005,2011,2114,1606,-333,164,508,-169,12.48199145,9.4825346591,-1.966179353,0.9683285704,2.9994567913,-0.997850783
12005,2012,2283,1575,1068,454,708,1522,13.379200413,9.2300659876,6.2588637935,2.6606031482,4.1491344249,8.9194669417
12005,2013,2280,1758,2029,289,522,2318,13.164694368,10.150672237,11.71542319,1.6686827511,3.0140221317,13.384105941
12005,2014,2240,1841,2825,309,399,3134,12.696721242,10.435117771,16.01260603,1.7514673499,2.2616034712,17.76407338
12005,2015,2398,1956,2104,396,442,2500,13.344277347,10.884656585,11.708240008,2.2036421307,2.4596207621,13.911882139
12005,2016,2360,1883,1019,313,477,1332,12.960766223,10.341153728,5.5961952463,1.7189490796,2.6196124951,7.3151443258
12005,2017,2350,1933,-76,239,417,163,12.822086726,10.546848358,-0.414671741,1.3040335011,2.275238368,0.8893617602
26017,2010,298,309,-81,7,-11,-74,NA,NA,NA,NA,NA,NA
26017,2011,1152,1156,-333,48,-4,-285,10.713388946,10.750588213,-3.096838992,0.4463912061,-0.037199267,-2.650447786
26017,2012,1069,1188,-359,36,-119,-323,9.9761095972,11.086640039,-3.350255702,0.3359587891,-1.110530442,-3.014296913
26017,2013,1029,1133,-74,19,-104,-55,9.6307284818,10.604096569,-0.692588832,0.1778268622,-0.973368088,-0.514761969
26017,2014,1087,1146,-694,19,-59,-675,10.216837574,10.771385336,-6.522985535,0.1785831775,-0.554547762,-6.344402357
26017,2015,1031,1282,-547,21,-251,-526,9.7600689169,12.136186568,-5.17823249,0.1987986879,-2.376117651,-4.979433802
26017,2016,1021,1170,-632,20,-149,-612,9.7365597807,11.157468113,-6.026940041,0.1907259506,-1.420908332,-5.83621409
26017,2017,1019,1162,-114,20,-143,-94,9.764277501,11.134534304,-1.092372557,0.1916443082,-1.370256803,-0.900728248
55007,2010,29,57,21,0,-28,21,NA,NA,NA,NA,NA,NA
55007,2011,120,143,74,7,-23,81,7.9813767875,9.5111406718,4.921849019,0.4655803126,-1.529763884,5.3874293316
55007,2012,138,136,-5,4,2,-1,9.1615216092,9.0287459337,-0.331939189,0.265551351,0.1327756755,-0.066387838
55007,2013,116,161,96,5,-45,101,7.6872100729,10.669317429,6.3618290258,0.3313452618,-2.982107356,6.6931742876
55007,2014,121,165,-103,5,-44,-98,8.0420045195,10.966369799,-6.845673269,0.3323142363,-2.92436528,-6.513359032
55007,2015,131,153,25,5,-22,30,8.746745009,10.215664018,1.6692261468,0.3338452294,-1.468919009,2.0030713761
55007,2016,108,169,17,4,-61,21,7.2192513369,11.296791444,1.1363636364,0.2673796791,-4.077540107,1.4037433155
55007,2017,113,176,129,4,-63,133,7.5464137839,11.753706424,8.6149325498,0.2671296915,-4.2072926410000004,8.8820622412
48023,2010,8,28,2,0,-20,2,NA,NA,NA,NA,NA,NA
48023,2011,36,55,6,0,-19,6,9.7257868432,14.85884101,1.6209644739,0,-5.133054167,1.6209644739
48023,2012,40,70,-75,-1,-30,-76,10.981468771,19.21757035,-20.59025395,-0.274536719,-8.236101579,-20.86479067
48023,2013,42,72,17,0,-30,17,11.720385098,20.09208874,4.743965397,0,-8.371703642,4.743965397
48023,2014,37,40,-8,0,-3,-8,10.358342665,11.198208287,-2.239641657,0,-0.839865622,-2.239641657
48023,2015,41,63,104,0,-22,104,11.363636364,17.461197339,28.824833703,0,-6.097560976,28.824833703
48023,2016,39,56,6,0,-17,6,10.703993413,15.369836695,1.6467682174,0,-4.665843283,1.6467682174
48023,2017,43,53,-47,0,-10,-47,11.913007342,14.683474165,-13.02119407,0,-2.770466824,-13.02119407
46005,2010,69,65,-4,15,4,11,NA,NA,NA,NA,NA,NA
46005,2011,304,207,71,113,97,184,17.318976813,11.792855922,4.0448926109,6.4376459864,5.526120891,10.482538597
46005,2012,293,201,47,109,92,156,16.445429798,11.281677097,2.6380040973,6.1179243959,5.1637527011,8.7559284933
46005,2013,352,173,9,143,179,152,19.442679997,9.5556353393,0.4971139772,7.8985887487,9.8870446574,8.3957027258
46005,2014,320,192,-410,147,128,-263,17.576140389,10.545684234,-22.51942987,8.0740394914,7.0304561558,-14.44539038
46005,2015,348,196,-297,158,152,-139,19.171441164,10.797708242,-16.36183341,8.704275011,8.373732922,-7.657558396
46005,2016,330,189,-378,164,141,-214,18.208403454,10.428449251,-20.8568985,9.0490247469,7.7799542031,-11.80787376
46005,2017,310,188,-214,163,122,-51,17.10627966,10.374130891,-11.80885112,8.9945922084,6.7321487695,-2.814258912
16007,2010,31,26,-23,0,5,-23,NA,NA,NA,NA,NA,NA
16007,2011,65,62,-17,-2,3,-19,10.904210703,10.40093944,-2.851870492,-0.335514175,0.5032712632,-3.187384667
16007,2012,75,66,-76,1,9,-75,12.665709702,11.145824538,-12.83458583,0.1688761294,1.5198851642,-12.6657097
16007,2013,100,76,30,0,24,30,16.90188456,12.845432266,5.070565368,0,4.0564522944,5.070565368
16007,2014,70,55,-37,1,15,-36,11.799410029,9.2709650232,-6.236831016,0.1685630004,2.5284450063,-6.068268015
16007,2015,83,66,-65,2,17,-63,14.070181387,11.188337006,-11.01881675,0.3390405153,2.8818443804,-10.67977623
16007,2016,84,39,19,2,45,21,14.215603317,6.60010154,3.2154340836,0.3384667456,7.615501777,3.5539008292
16007,2017,80,59,64,2,21,66,13.366750209,9.857978279,10.693400167,0.3341687552,3.5087719298,11.027568922
37013,2010,143,115,8,3,28,11,NA,NA,NA,NA,NA,NA
37013,2011,510,535,-137,31,-25,-106,10.684879847,11.208648467,-2.870252037,0.6494730888,-0.52376862,-2.220778949
37013,2012,498,544,-179,2,-46,-177,10.473296249,11.440709156,-3.764498049,0.0420614307,-0.967412907,-3.722436619
37013,2013,510,547,0,-1,-37,-1,10.756430131,11.536798591,0,-0.021091039,-0.78036846,-0.021091039
37013,2014,498,603,70,2,-105,72,10.512871935,12.729441319,1.4777129226,0.0422203692,-2.216569384,1.5199332918
37013,2015,430,605,212,6,-175,218,9.0775710109,12.771931306,4.4754536147,0.1266637815,-3.694360295,4.6021173962
37013,2016,462,612,117,7,-150,124,9.7519788918,12.918205805,2.4696569921,0.1477572559,-3.166226913,2.617414248
37013,2017,457,597,-137,7,-140,-130,9.6771802772,12.641743163,-2.901036538,0.1482281443,-2.964562886,-2.752808394
45013,2010,514,358,298,150,156,448,NA,NA,NA,NA,NA,NA
45013,2011,2078,1303,93,215,775,308,12.718853957,7.9752967784,0.5692268614,1.315954572,4.7435571782,1.8851814334
45013,2012,2037,1276,1854,930,761,2784,12.292707654,7.70029208,11.18835542,5.6122818452,4.5924155744,16.800637266
45013,2013,2034,1389,2506,409,645,2915,12.01382121,8.2041286436,14.801689259,2.4157585423,3.8096925667,17.217447801
45013,2014,2049,1507,3171,327,542,3498,11.832269353,8.7024060103,18.311432952,1.8883123858,3.1298633428,20.199745338
45013,2015,2078,1494,3522,498,584,4020,11.702789691,8.4138439835,19.835045857,2.8046146612,3.2889457071,22.639660518
45013,2016,2021,1572,2849,302,449,3151,11.12294403,8.6517902106,15.679993836,1.6621123687,2.4711538197,17.342106205
45013,2017,1998,1600,2779,154,398,2933,10.790055651,8.6406852063,15.007790118,0.8316659511,2.1493704451,15.839456069
22011,2010,137,113,139,8,24,147,NA,NA,NA,NA,NA,NA
22011,2011,459,313,101,12,146,113,12.763472554,8.7036316111,2.8085201046,0.333685557,4.0598409432,3.1422056615
22011,2012,510,317,11,55,193,66,14.081979208,8.7529164883,0.3037289633,1.5186448166,5.32906272,1.8223737799
22011,2013,484,344,-238,33,140,-205,13.329477699,9.473843654,-6.554577877,0.908828025,3.8556340452,-5.645749852
22011,2014,492,390,-137,22,102,-115,13.565116696,10.752836405,-3.77727843,0.6065702588,2.8122802906,-3.170708171
22011,2015,497,360,103,29,137,132,13.656284776,9.8918762966,2.8301757182,0.7968455906,3.7644084795,3.6270213088
22011,2016,542,346,262,16,196,278,14.743485121,9.4118927153,7.1269245416,0.4352320331,5.3315924052,7.5621565747
22011,2017,525,387,-221,13,138,-208,14.203392582,10.469929389,-5.978951925,0.3517030544,3.7334631929,-5.62724887
40007,2010,7,5,9,0,2,9,NA,NA,NA,NA,NA,NA
40007,2011,51,32,-28,-2,19,-30,9.0409501861,5.672753058,-4.963658926,-0.354547066,3.3681971282,-5.318205992
40007,2012,47,50,-53,2,-3,-51,8.3793902656,8.9142449635,-9.449099661,0.3565697985,-0.534854698,-9.092529863
40007,2013,69,45,-55,4,24,-51,12.386679831,8.0782694552,-9.873440445,0.718068396,4.3084103761,-9.155372049
40007,2014,67,47,-65,6,20,-59,12.097138214,8.4860521802,-11.73602961,1.0833258102,3.6110860341,-10.6527038
40007,2015,53,52,-94,6,1,-88,9.6768303816,9.4942486763,-17.1626803,1.0954902319,0.1825817053,-16.06719007
40007,2016,48,45,-42,6,3,-36,8.8601753576,8.3064143978,-7.752653438,1.1075219197,0.5537609599,-6.645131518
40007,2017,46,48,-91,6,-2,-85,8.5860942604,8.9594027065,-16.9855343,1.1199253383,-0.373308446,-15.86560896
42007,2010,452,418,96,0,34,96,NA,NA,NA,NA,NA,NA
42007,2011,1718,1996,-38,10,-278,-28,10.077251104,11.707912226,-0.222896125,0.0586568749,-1.630661122,-0.16423925
42007,2012,1672,2089,201,25,-417,226,9.8233616225,12.273326812,1.1809184726,0.146880407,-2.449965189,1.3277988796
42007,2013,1774,2201,163,25,-427,188,10.437535118,12.94983923,0.9590294387,0.1470904047,-2.512304112,1.1061198434
42007,2014,1741,2068,-328,36,-327,-292,10.270871372,12.199978172,-1.935006209,0.2123787303,-1.9291068,-1.722627479
42007,2015,1710,2175,-205,37,-465,-168,10.127002082,12.880835981,-1.214055805,0.2191222673,-2.753833899,-0.994933538
42007,2016,1711,2101,-1052,39,-390,-1013,10.195174125,12.519030297,-6.268453057,0.2323856171,-2.323856171,-6.036067439
42007,2017,1639,2089,-564,39,-450,-525,9.8360754119,12.536645232,-3.384714175,0.2340493844,-2.70056982,-3.15066479
49001,2010,42,7,-10,0,35,-10,NA,NA,NA,NA,NA,NA
49001,2011,122,55,-173,5,67,-168,18.466661621,8.3251343374,-26.18633164,0.7568303943,10.141527284,-25.42950125
49001,2012,115,45,-129,5,70,-124,17.606981551,6.889688433,-19.75044017,0.765520937,10.717293118,-18.98491924
49001,2013,113,62,-99,4,51,-95,17.42885787,9.5627361764,-15.26953035,0.6169507211,7.8661216935,-14.65257963
49001,2014,97,61,-78,4,36,-74,15.052762259,9.4661700807,-12.10428305,0.6207324643,5.5865921788,-11.48355059
49001,2015,111,69,-132,5,42,-127,17.38449491,10.806577917,-20.67345341,0.7830853563,6.577916993,-19.89036805
49001,2016,104,49,50,5,55,55,16.252539459,7.657446476,7.8137208939,0.7813720894,8.5950929833,8.5950929833
49001,2017,114,49,-139,5,65,-134,17.757009346,7.6323987539000004,-21.65109034,0.7788161994,10.124610592,-20.87227414
30001,2010,19,9,-1,-1,10,-2,NA,NA,NA,NA,NA,NA
30001,2011,95,78,-70,6,17,-64,10.293639614,8.4516198938,-7.584787084,0.6501246072,1.8420197204,-6.934662477
30001,2012,93,70,122,4,23,126,10.021011799,7.542697053,13.145843435,0.4310112602,2.478314746,13.576854695
30001,2013,89,75,-67,-4,14,-71,9.540654982,8.0398777939,-7.182290829,-0.428793482,1.5007771882,-7.611084312
30001,2014,99,91,21,5,8,26,10.625737898,9.7670924117,2.2539444027,0.5366534292,0.8586454867,2.7905978319
30001,2015,87,98,-41,7,-11,-34,9.3442887063,10.525750497,-4.40363031,0.7518393212,-1.18146179,-3.651790989
30001,2016,85,77,141,7,8,148,9.0753790305,8.22122571,15.054452274,0.7473841555,0.8541533205,15.80183643
30001,2017,94,92,-19,7,2,-12,9.9586820638,9.7467952114,-2.012925098,0.7416039835,0.2118868524,-1.271321115
27005,2010,102,67,13,1,35,14,NA,NA,NA,NA,NA,NA
27005,2011,441,358,120,10,83,130,13.505236724,10.963434801,3.6748943468,0.3062411956,2.5418019232,3.9811355424
27005,2012,426,343,118,30,83,148,12.958963283,10.43409485,3.5895719892,0.9126030481,2.5248684331,4.5021750373
27005,2013,418,326,70,39,92,109,12.634506106,9.8537057188,2.1158263813,1.1788175553,2.7808003869,3.2946439366
27005,2014,427,325,-64,44,102,-20,12.853122225,9.7828213657,-1.926463284,1.324443508,3.0703008594,-0.602019776
27005,2015,398,341,91,50,57,141,11.930992101,10.222282177,2.727940405,1.4988683544,1.708709924,4.2268087594
27005,2016,427,358,181,49,69,230,12.706820617,10.653493632,5.3862635401,1.4581597429,2.0533269849,6.8444232829
27005,2017,410,359,249,49,51,298,12.085482682,10.582166544,7.3397199705,1.4443625645,1.5033161385,8.784082535
40009,2010,95,36,-127,1,59,-126,NA,NA,NA,NA,NA,NA
40009,2011,348,220,118,-4,128,114,15.690518058,9.9192930249,5.320348077,-0.180350782,5.7712250327,5.1399972947
40009,2012,351,246,650,-12,105,638,15.475508135,10.846082624,28.658348397,-0.529077201,4.6294255103,28.129271196
40009,2013,391,248,260,-2,143,258,16.806361487,10.659789383,11.175585644,-0.085966043,6.146572104,11.0896196
40009,2014,396,248,-21,10,148,-11,16.82671879,10.537945101,-0.892325996,0.4249171412,6.2887736891,-0.467408855
40009,2015,347,245,-155,15,102,-140,14.714924835,10.389500244,-6.572949134,0.6360918517,4.3254245913,-5.936857282
40009,2016,327,241,-1235,17,86,-1218,14.218936841,10.479399935,-53.70148929,0.7392107838,3.7395369062,-52.96227851
40009,2017,294,260,-692,17,34,-675,13.295647258,11.758055399,-31.29451668,0.7687959299,1.5375918598,-30.52572075
42009,2010,114,155,-30,0,-41,-30,NA,NA,NA,NA,NA,NA
42009,2011,487,551,-5,-2,-64,-7,9.8080679919,11.097013272,-0.10069885,-0.04027954,-1.28894528,-0.14097839
42009,2012,465,487,-5,0,-22,-5,9.3754725541,9.8190432986,-0.100811533,0,-0.443570744,-0.100811533
42009,2013,509,527,-221,7,-18,-214,10.290312146,10.654213165,-4.467895843,0.1415170629,-0.363901019,-4.326378781
42009,2014,469,546,-85,9,-77,-76,9.5195567012,11.082468995,-1.725292792,0.1826780604,-1.562912294,-1.542614732
42009,2015,446,559,-292,9,-113,-283,9.104363358,11.411074254,-5.960704261,0.1837203368,-2.306710896,-5.776983924
42009,2016,457,571,-31,10,-114,-21,9.3800350982,11.719912562,-0.636282468,0.2052524092,-2.339877464,-0.431030059
42009,2017,445,529,-96,10,-84,-86,9.1627887823,10.892393856,-1.976691513,0.2059053659,-1.729605074,-1.770786147
47003,2010,159,129,-14,19,30,5,NA,NA,NA,NA,NA,NA
47003,2011,615,436,-114,79,179,-35,13.619301762,9.6553098668,-2.524553497,1.7494712832,3.9639918949,-0.775082214
47003,2012,599,426,-200,63,173,-137,13.239178243,9.4155090674,-4.420426792,1.3924344395,3.8236691753,-3.027992353
47003,2013,638,480,140,29,158,169,14.045747749,10.56733373,3.0821390045,0.6384430795,3.4784140193,3.720582084
47003,2014,590,434,481,29,156,510,12.848012369,9.4509107934,10.474396525,0.6315124724,3.3971015755,11.105908997
47003,2015,627,490,450,47,137,497,13.46201329,10.520552651,9.6617320265,1.0091142339,2.9414606392,10.67084626
47003,2016,619,466,329,46,153,375,13.126643481,9.882093477,6.9768428196,0.9754856222,3.2445500042,7.9523284418
47003,2017,617,488,522,46,129,568,12.916461685,10.215937281,10.927703403,0.9629776945,2.7005244042,11.890681097
51019,2010,209,202,99,9,7,108,NA,NA,NA,NA,NA,NA
51019,2011,825,714,385,29,111,414,10.956175299,9.4820717131,5.1128818061,0.385126162,1.4741035857,5.4980079681
51019,2012,735,707,169,15,28,184,9.7146406905,9.3445591404,2.2337064989,0.1982579733,0.3700815501,2.4319644722
51019,2013,775,802,451,18,-27,469,10.20052253,10.555895573,5.9360460142000004,0.236915362,-0.355373043,6.1729613762
51019,2014,693,678,797,23,15,820,9.0452261307,8.8494420153,10.402662664,0.3002023103,0.19578411539999999,10.702864974
51019,2015,657,713,566,23,-56,589,8.4995181019,9.2239823541,7.3222636921,0.2975478179,-0.724464252,7.6198115099
51019,2016,616,804,432,25,-188,457,7.9284381234,10.348156252,5.5602033593,0.3217710277,-2.419718129,5.881974387
51019,2017,630,836,331,25,-206,356,8.0871875842,10.731569556,4.2489826831,0.3209201422,-2.644381972,4.5699028254
48025,2010,86,94,11,1,-8,12,NA,NA,NA,NA,NA,NA
48025,2011,337,243,334,14,94,348,10.502532139,7.573042462,10.409037787,0.4363069731,2.9294896767,10.84534476
48025,2012,381,238,14,9,143,23,11.761800389,7.3472663847,0.4321921403,0.2778378045,4.4145340043,0.7100299447
48025,2013,386,201,137,6,185,143,11.82652389,6.1583712487,4.1974968212,0.1838319776,5.6681526418,4.3813287988
48025,2014,386,280,-72,5,106,-67,11.761121268,8.5313833029,-2.193784278,0.1523461304,3.2297379647,-2.041438147
48025,2015,412,269,-385,9,143,-376,12.590532653,8.2205176787,-11.76542493,0.2750359075,4.3700149742,-11.49038902
48025,2016,400,240,55,10,160,65,12.224191675,7.3345150052,1.6808263554,0.3056047919,4.8896766701,1.9864311472
48025,2017,384,216,-453,11,168,-442,11.743478394,6.6057065965,-13.85363467,0.3364017248,5.1377717973,-13.51723294
33001,2010,154,129,-7,11,25,4,NA,NA,NA,NA,NA,NA
33001,2011,587,603,134,62,-16,196,9.7541521615,10.02002343,2.2266718733,1.0302511653,-0.265871268,3.2569230386
33001,2012,526,618,137,27,-92,164,8.7236300915,10.249436115,2.2721241873,0.4477908982,-1.525806024,2.7199150856
33001,2013,531,649,-143,42,-118,-101,8.8181810633,10.777776855,-2.374764392,0.6974832479,-1.959595792,-1.677281144
33001,2014,530,646,144,49,-116,193,8.8129167429,10.741781539,2.3944528509,0.8147790951,-1.928864797,3.209231946
33001,2015,532,696,195,49,-164,244,8.8357415712,11.559541604,3.2386646736,0.8138183026,-2.723800033,4.0524829762
33001,2016,508,691,494,47,-183,541,8.4068380029,11.435285551,8.175153491,0.7777980042,-3.028447548,8.9529514952
33001,2017,515,744,364,47,-229,411,8.4849782933,12.257910389,5.9971497063,0.7743572423,-3.772932095,6.7715069486
21013,2010,85,96,26,1,-11,27,NA,NA,NA,NA,NA,NA
21013,2011,352,378,-18,-6,-26,-24,12.272505404,13.178997281,-0.627571299,-0.209190433,-0.906491876,-0.836761732
21013,2012,387,375,-377,-5,12,-382,13.590630542,13.169215642,-13.23945146,-0.175589542,0.4214149005,-13.415041
21013,2013,377,362,-270,0,15,-270,13.383981823,12.851462653,-9.585345072,0,0.5325191707,-9.585345072
21013,2014,326,375,-149,2,-49,-147,11.66744211,13.421137397,-5.332665259,0.0715793994,-1.753695286,-5.261085859
21013,2015,339,397,-409,3,-58,-406,12.278160087,14.378848243,-14.81347338,0.108656284,-2.100688156,-14.7048171
21013,2016,320,402,-108,3,-82,-105,11.727840795,14.733099998,-3.958146268,0.1099485074,-3.005259204,-3.848197761
21013,2017,321,355,-268,4,-34,-264,11.869984839,13.1272418,-9.910143105,0.1479125837,-1.257256961,-9.762230522
48027,2010,1552,391,1009,435,1161,1444,NA,NA,NA,NA,NA,NA
48027,2011,6658,1879,-2302,470,4779,-1832,21.181459701,5.9777655119,-7.323478557,1.4952367167,15.203694189,-5.82824184
48027,2012,5891,1865,2743,2306,4026,5049,18.386449396,5.8208671063,8.5612002534,7.1972758966,12.56558229,15.75847615
48027,2013,6528,1930,-3932,1459,4598,-2473,20.020271752,5.9189835296,-12.05877888,4.4745062019,14.101288222,-7.584272678
48027,2014,6318,2072,-2562,1419,4246,-1143,19.2212328,6.3036395,-7.794365057,4.3170195224,12.9175933,-3.477345535
48027,2015,6375,2201,-111,1826,4174,1715,19.134318413,6.6062172278,-0.33316225,5.4806690858,12.528101185,5.1475068358
48027,2016,6256,2238,-202,1290,4018,1088,18.473431892,6.6086222145,-0.59648869,3.8092594534,11.864809677,3.2127707638
48027,2017,6314,2183,1552,940,4131,2492,18.327054029,6.3363888099,4.5048444493,2.7284496021,11.990665219,7.2332940514
39013,2010,202,222,-37,1,-20,-36,NA,NA,NA,NA,NA,NA
39013,2011,720,924,0,-7,-204,-7,10.252248019,13.157051624,0,-0.099674634,-2.904803605,-0.099674634
39013,2012,708,940,-160,-15,-232,-175,10.127523835,13.446147464,-2.288705951,-0.214566183,-3.318623629,-2.503272134
39013,2013,733,941,93,-21,-208,72,10.527449643,13.514775053,1.3356791498,-0.301604969,-2.98732541,1.0340741805
39013,2014,691,839,-27,-19,-148,-46,9.9493891421,12.080372634,-0.388760502,-0.273572205,-2.130983492,-0.662332707
39013,2015,706,864,-223,-16,-158,-239,10.21035353,12.495390156,-3.225083339,-0.23139611400000001,-2.285036626,-3.456479453
39013,2016,643,846,-153,-18,-203,-171,9.3519791144,12.304470188,-2.225276523,-0.261797238,-2.952491073,-2.487073761
39013,2017,638,835,-323,-18,-197,-341,9.3413471745,12.225744343,-4.729240027,-0.26354898,-2.884397168,-4.992789007
27007,2010,182,68,10,9,114,19,NA,NA,NA,NA,NA,NA
27007,2011,724,433,158,22,291,180,16.159451829,9.6644235383,3.5265102057,0.4910330666,6.4950282902,4.0175432723
27007,2012,705,381,-246,18,324,-228,15.637129866,8.4507042254,-5.456360208,0.3992458689,7.1864256405,-5.05711434
27007,2013,740,439,8,45,301,53,16.333016973,9.6894519611,0.1765731565,0.9932240051,6.643565012,1.1697971616
27007,2014,692,386,-214,60,306,-154,15.190429152,8.4732740643,-4.697618264,1.3170892328,6.7171550873,-3.380529031
27007,2015,621,422,-288,63,199,-225,13.61409201,9.251444168,-6.313781802,1.3811397692,4.3626478422,-4.932642033
27007,2016,695,411,63,65,284,128,15.172850422,8.9727216164,1.3753806857,1.4190435646,6.2001288055,2.7944242504
27007,2017,675,406,170,64,269,234,14.590808871,8.7761013359,3.6747222342,1.3834248411,5.8147075353,5.0581470754
13017,2010,60,62,-9,-1,-2,-10,NA,NA,NA,NA,NA,NA
13017,2011,262,208,-107,-4,54,-111,14.893556547,11.823892221,-6.082483017,-0.227382543,3.0696643265,-6.30986556
13017,2012,265,206,-41,-4,59,-45,15.082527035,11.72453045,-2.333523051,-0.227660785,3.3579965851,-2.561183836
13017,2013,191,213,-121,-5,-22,-126,10.913350284,12.170385396,-6.913693112,-0.285689798,-1.257035111,-7.19938291
13017,2014,226,208,-16,-5,18,-21,12.970243049,11.937214841,-0.918247295,-0.28695228,1.0330282074,-1.205199575
13017,2015,250,211,-134,-4,39,-138,14.390145628,12.14528291,-7.713118057,-0.23024233,2.244862718,-7.943360387
13017,2016,225,244,-111,-4,-19,-115,13.038565178,14.139599571,-6.432358821,-0.231796714,-1.101034393,-6.664155536
13017,2017,231,210,-210,-4,21,-214,13.514304101,12.285731001,-12.285731,-0.234013924,1.2285731001,-12.51974492
16009,2010,30,12,-12,0,18,-12,NA,NA,NA,NA,NA,NA
16009,2011,104,119,-107,0,-15,-107,11.267605634,12.892741062,-11.59263272,0,-1.625135428,-11.59263272
16009,2012,107,107,-46,1,0,-45,11.698463893,11.698463893,-5.02924616,0.1093314383,0,-4.919914721
16009,2013,122,110,-111,2,12,-109,13.443526171,12.121212121,-12.23140496,0.2203856749,1.3223140496,-12.01101928
16009,2014,107,131,28,1,-24,29,11.85201595,14.510412051,3.1014621179,0.1107665042,-2.658396101,3.2122286221
16009,2015,111,139,-14,1,-28,-13,12.321696176,15.429871788,-1.554087806,0.1110062719,-3.108175612,-1.443081534
16009,2016,108,126,52,1,-18,53,11.993337035,13.992226541,5.7745696835,0.111049417,-1.998889506,5.8856191005
16009,2017,106,113,167,1,-7,168,11.644512798,12.413490058,18.345600352,0.1098538943,-0.76897726,18.455454246
46007,2010,21,7,5,0,14,5,NA,NA,NA,NA,NA,NA
46007,2011,67,38,-31,0,29,-31,19.420289855,11.014492754,-8.985507246,0,8.4057971014,-8.985507246
46007,2012,83,35,-48,0,48,-48,24.064946361,10.147868948,-13.91707741,0,13.917077414,-13.91707741
46007,2013,67,27,-28,0,40,-28,19.392185239,7.8147612156,-8.104196816,0,11.577424023,-8.104196816
46007,2014,72,29,-72,0,43,-72,20.881670534,8.4106728538,-20.88167053,0,12.47099768,-20.88167053
46007,2015,54,38,-51,0,16,-51,15.798712697,11.117612639,-14.92100644,0,4.6811000585,-14.92100644
46007,2016,78,29,-2,0,49,-2,22.780373832,8.4696261682,-0.58411215,0,14.310747664,-0.58411215
46007,2017,65,35,-22,0,30,-22,18.837849587,10.14345747,-6.375887553,0,8.6943921171,-6.375887553
50003,2010,101,123,-19,1,-22,-18,NA,NA,NA,NA,NA,NA
50003,2011,314,436,-166,0,-122,-166,8.5005008257,11.803243185,-4.493895341,0,-3.302742359,-4.493895341
50003,2012,327,416,-100,-3,-89,-103,8.9102031363,11.335304296,-2.724832763,-0.081744983,-2.425101159,-2.806577746
50003,2013,351,419,18,0,-68,18,9.5965878799,11.455755902,0.4921327118,0,-1.859168022,0.4921327118
50003,2014,345,445,-268,6,-100,-262,9.4864920602,12.236199904,-7.369217021,0.1649824706,-2.749707844,-7.20423455
50003,2015,356,440,-18,9,-84,-9,9.8512625389,12.175717745,-0.498097544,0.2490487721,-2.324455206,-0.249048772
50003,2016,331,449,-131,15,-118,-116,9.2018570515,12.48227739,-3.641822579,0.4170025854,-3.280420339,-3.224819994
50003,2017,340,450,-164,15,-110,-149,9.5174112641,12.596573732,-4.590751316,0.4198857911,-3.079162468,-4.170865525
38005,2010,37,25,3,1,12,4,NA,NA,NA,NA,NA,NA
38005,2011,132,82,-46,5,50,-41,19.759000075,12.27453035,-6.885712147,0.7484469725,7.4844697253,-6.137265175
38005,2012,156,67,-6,1,89,-5,23.195301465,9.9620846034,-0.892126979,0.1486878299,13.233216861,-0.74343915
38005,2013,159,76,43,0,83,43,23.277944514,11.126564673,6.2952931703,0,12.15137984,6.2952931703
38005,2014,155,83,-86,0,72,-86,22.504537205,12.050816697,-12.48638838,0,10.453720508,-12.48638838
38005,2015,143,76,-134,0,67,-134,20.882009346,11.098130841,-19.56775701,0,9.7838785047,-19.56775701
38005,2016,169,62,-68,-1,107,-69,24.732913801,9.073613347,-9.951704961,-0.146348602,15.659300454,-10.09805356
38005,2017,165,69,-12,-1,96,-13,23.935591499,10.009429172,-1.740770291,-0.145064191,13.926162327,-1.885834482
08011,2010,12,25,12,3,-13,15,NA,NA,NA,NA,NA,NA
08011,2011,41,60,-165,7,-19,-158,6.3917686492,9.3538077793,-25.72297139,1.0912775742,-2.96203913,-24.63169382
08011,2012,54,57,-542,13,-3,-529,8.8932806324,9.3873517787,-89.26218709,2.1409749671,-0.494071146,-87.12121212
08011,2013,37,61,-70,11,-24,-59,6.4074811672,10.563685168,-12.12226167,1.9049268335,-4.156204,-10.21733483
08011,2014,31,49,54,14,-18,68,5.3833463576,8.5091603716,9.3774420422,2.4311886776,-3.125814014,11.80863072
08011,2015,40,55,108,13,-15,121,6.8510747624,9.4202277982,18.497901858,2.2265992978,-2.569153036,20.724501156
08011,2016,36,49,-213,13,-13,-200,6.2208398134,8.4672541904,-36.80663556,2.2464143771,-2.246414377,-34.56022119
08011,2017,35,48,255,13,-13,268,6.024614855,8.262328944,43.893622515,2.237714089,-2.237714089,46.131336604
05007,2010,829,296,527,101,533,628,NA,NA,NA,NA,NA,NA
05007,2011,3281,1592,3948,537,1689,4485,14.537479092,7.053845387,17.492827631,2.3793435759,7.4836337052,19.872171206
05007,2012,3363,1670,3080,658,1693,3738,14.522543842,7.2116111257,13.300456447,2.8414611501000002,7.3109327161,16.141917598
05007,2013,3230,1670,2377,618,1560,2995,13.651242453,7.0580727235,10.046131056,2.6119095468,6.5931697297,12.658040603
05007,2014,3427,1625,2745,706,1802,3451,14.18771502,6.7274691882,11.364247952,2.9228266135,7.4602458321,14.287074565
05007,2015,3545,1854,4297,779,1691,5076,14.3172162,7.4877627179,17.35432384,3.1461527277,6.8294534822,20.500476567
05007,2016,3688,1731,4916,810,1957,5726,14.47068979,6.7919642156,19.289021424,3.1782154909,7.6787255748,22.467236914
05007,2017,3692,1701,4784,802,1991,5586,14.064654745,6.4799506289,18.22462305,3.0552148174,7.5847041165,21.279837868
18007,2010,20,14,21,0,6,21,NA,NA,NA,NA,NA,NA
18007,2011,97,82,-22,3,15,-19,10.947463461,9.2545567406,-2.482929857,0.3385813442,1.6929067208,-2.144348513
18007,2012,97,78,-60,4,19,-56,10.972850679,8.8235294118,-6.787330317,0.4524886878,2.149321267,-6.334841629
18007,2013,104,99,-78,0,5,-78,11.839034663,11.269850305,-8.879275997,0,0.5691843588,-8.879275997
18007,2014,116,87,-63,2,29,-61,13.282189271,9.9616419534,-7.213602794,0.2290032633,3.3205473178,-6.984599531
18007,2015,112,94,-47,2,18,-45,12.864691018,10.79715139,-5.398575695,0.2297266253,2.0675396278,-5.16884907
18007,2016,103,80,-63,2,23,-61,11.875252205,9.2234968582,-7.263503776,0.2305874215,2.6517553467,-7.032916354
18007,2017,106,80,-71,2,26,-69,12.277044244,9.2656937688,-8.22330322,0.2316423442,3.0113504749,-7.991660876
19011,2010,73,86,-15,2,-13,-13,NA,NA,NA,NA,NA,NA
19011,2011,290,224,-38,5,66,-33,11.12645795,8.5942295887,-1.457949662,0.1918354819,2.532228361,-1.26611418
19011,2012,250,193,-314,8,57,-306,9.6311278051,7.4352306655,-12.09669652,0.3081960898,2.1958971396,-11.78850043
19011,2013,289,243,-182,4,46,-178,11.214155446,9.4292033681,-7.0622017,0.1552132242,1.7849520779,-6.906988475
19011,2014,276,209,-150,4,67,-146,10.752688172,8.1424341593,-5.843852267,0.1558360605,2.6102540128,-5.688016207
19011,2015,319,240,-102,4,79,-98,12.450966999,9.3674986827,-3.98118694,0.156124978,3.0834683164,-3.825061962
19011,2016,307,234,-45,4,73,-41,11.980020292,9.1313509717,-1.756029033,0.1560914696,2.8486693202,-1.599937563
19011,2017,301,228,-76,4,73,-72,11.738782833,8.891835501,-2.963945167,0.1559971141,2.8469473315,-2.807948053
27009,2010,151,95,-43,0,56,-43,NA,NA,NA,NA,NA,NA
27009,2011,583,311,-10,7,272,-3,15.104800891,8.0576210586,-0.259087494,0.1813612457,7.0471798326,-0.077726248
27009,2012,565,321,-311,4,244,-307,14.599105966,8.2943593189,-8.035968063,0.1033565024,6.3047466474,-7.93261156
27009,2013,550,318,74,8,232,82,14.165765209,8.1903878844,1.905939319,0.2060474939,5.9753773245,2.111986813
27009,2014,542,350,-77,8,192,-69,13.883196721,8.9651639344,-1.972336066,0.2049180328,4.9180327869,-1.767418033
27009,2015,624,336,-82,12,288,-70,15.915322324,8.5697889434,-2.091436587,0.3060638908,7.3455333801,-1.785372697
27009,2016,558,355,-62,13,203,-49,14.165492556,9.0120965183,-1.573943617,0.3300204359,5.1533960372,-1.243923181
27009,2017,580,318,197,13,262,210,14.608651848,8.0095711857,4.9619041622,0.3274353,6.5990806624,5.2893394623
28009,2010,20,39,-17,0,-19,-17,NA,NA,NA,NA,NA,NA
28009,2011,97,92,19,-4,5,15,11.143021252,10.568638713,2.1826536473,-0.459506031,0.5743825388,1.7231476163
28009,2012,80,87,-61,-5,-7,-66,9.2171208019,10.023618872,-7.028054611,-0.57607005,-0.80649807,-7.604124662
28009,2013,95,99,-141,-5,-4,-146,11.085827645,11.552599335,-16.45370208,-0.583464613,-0.46677169,-17.0371667
28009,2014,106,122,-184,-1,-16,-185,12.624307747,14.529863634,-21.91389269,-0.119097243,-1.905555886,-22.03298994
28009,2015,96,107,-128,-1,-11,-129,11.665350264,13.002004982,-15.55380035,-0.121514065,-1.336654718,-15.67531442
28009,2016,88,88,106,-1,0,105,10.714720565,10.714720565,12.906367953,-0.121758188,0,12.784609765
28009,2017,100,96,44,-1,4,43,12.064909212,11.582312843,5.3085600531,-0.120649092,0.4825963685,5.187910961
29015,2010,46,53,43,1,-7,44,NA,NA,NA,NA,NA,NA
29015,2011,181,259,14,-1,-78,13,9.495580096,13.587598038,0.7344647588,-0.052461768,-4.092017942,0.6820029903
29015,2012,130,280,109,0,-150,109,6.8392255892,14.730639731,5.7344276094,0,-7.891414141,5.7344276094
29015,2013,140,282,98,-3,-142,95,7.3824087745,14.870280532,5.1676861422,-0.158194474,-7.487871757,5.0094916684
29015,2014,149,282,72,-2,-133,70,7.8806791136,14.915110806,3.8081133972,-0.105780928,-7.034431692,3.7023324695
29015,2015,170,310,52,-2,-140,50,9.0291055874,16.464839601,2.761844062,-0.106224772,-7.435734013,2.6556192904
29015,2016,162,314,292,-2,-152,290,8.5934806249,16.656499483,15.489483595,-0.106092353,-8.063018858,15.383391242
29015,2017,162,288,282,-2,-126,280,8.5274378208,15.159889459,14.844058429,-0.10527701,-6.632451638,14.738781419
41003,2010,196,100,-208,71,96,-137,NA,NA,NA,NA,NA,NA
41003,2011,764,551,-127,335,213,208,8.9076992136,6.4242699826,-1.480730105,3.9058628751,2.483429231,2.4251327702
41003,2012,734,572,-158,396,162,238,8.5178480249,6.6378870167,-1.833542218,4.5954602423,1.8799610082,2.7619180244
41003,2013,712,546,-1014,392,166,-622,8.2645587399,6.3377093708,-11.77003169,4.5501503175,1.9268493691,-7.219881371
41003,2014,721,554,387,472,167,859,8.340563364,6.4086991729,4.4768349818,5.4601191509,1.9318641911,9.9369541327
41003,2015,719,575,505,506,144,1011,8.2142326719,6.5691012327,5.7693845609,5.7808090848,1.6451314391,11.550193646
41003,2016,762,578,493,512,184,1005,8.5906585044,6.5162737737,5.5579982187,5.7722009898,2.0743847307,11.330199209
41003,2017,760,582,966,508,178,1474,8.4328726692,6.457805123,10.718624998,5.6367096262,1.9750675462,16.355334624
47005,2010,34,44,31,0,-10,31,NA,NA,NA,NA,NA,NA
47005,2011,171,218,24,0,-47,24,10.363950423,13.212521592,1.454589533,0,-2.848571169,1.454589533
47005,2012,152,256,32,0,-104,32,9.2395599052,15.561364051,1.9451705064,0,-6.321804146,1.9451705064
47005,2013,173,225,-5,2,-52,-3,10.557793238,13.73123398,-0.305138533,0.1220554132,-3.173440742,-0.18308312
47005,2014,139,252,-71,3,-113,-68,8.5449068667,15.49148583,-4.364664659,0.1844224504,-6.946578964,-4.180242208
47005,2015,169,254,97,3,-85,100,10.442412259,15.694513099,5.9935739001,0.185368265,-5.25210084,6.1789421651
47005,2016,156,258,-34,4,-102,-30,9.674118632,15.999503891,-2.108461753,0.2480543239,-6.325385259,-1.860407429
47005,2017,155,255,24,4,-100,28,9.6738960836,15.915119363,1.4978935871,0.2496489312,-6.24122328,1.7475425183
53005,2010,657,264,810,31,393,841,NA,NA,NA,NA,NA,NA
53005,2011,2553,1288,2493,145,1265,2638,14.307650922,7.2182743393,13.971395907,0.8126162882,7.0893765832,14.784012195
53005,2012,2603,1219,398,223,1384,621,14.349385204,6.7199003316,2.194028164,1.2293172879,7.629484872,3.4233454519
53005,2013,2522,1268,521,225,1254,746,13.752450439,6.9143961764,2.8410097854,1.2269236117,6.8380542627,4.0679333971
53005,2014,2543,1299,579,267,1244,846,13.71558631,7.0061134947,3.1228173314,1.4400556606,6.7094728156,4.5628729919
53005,2015,2699,1336,2061,307,1363,2368,14.333167821,7.0948915188,10.945038488,1.630338096,7.2382763025,12.575376584
53005,2016,2714,1451,1745,311,1263,2056,14.148164753,7.5641072425,9.0967382068,1.6212524827,6.5840575102,10.71799069
53005,2017,2742,1444,3077,313,1298,3390,14.002119212,7.3738366675,15.712808467,1.5983454826,6.6282825446,17.311153949
26019,2010,38,52,0,0,-14,0,NA,NA,NA,NA,NA,NA
26019,2011,147,200,-60,-3,-53,-63,8.4243101522,11.461646466,-3.43849394,-0.171924697,-3.037336313,-3.610418637
26019,2012,147,204,4,-3,-57,1,8.4672541904,11.750475203,0.2304014746,-0.172801106,-3.283221013,0.0576003686
26019,2013,145,207,83,-3,-62,80,8.3616861773,11.937027853,4.7863445015,-0.173000404,-3.575341676,4.6133440978
26019,2014,169,226,182,-4,-57,178,9.7059499196,12.97955433,10.452561452,-0.229726625,-3.273604411,10.222834827
26019,2015,153,209,-22,-3,-56,-25,8.7769619091,11.989444699,-1.26204681,-0.172097292,-3.21248279,-1.434144103
26019,2016,145,218,210,-3,-73,207,8.3058857225,12.487469569,12.029213805,-0.171845911,-4.181583846,11.857367893
26019,2017,156,211,108,-3,-55,105,8.8896486879,12.0238197,6.1543721686,-0.170954782,-3.134171012,5.9834173861
34003,2010,2377,1683,-76,1216,694,1140,NA,NA,NA,NA,NA,NA
34003,2011,9361,6979,-447,5516,2382,5069,10.280531895,7.6645478147,-0.490908851,6.0578371896,2.6159840801,5.5669283383
34003,2012,8987,6875,-679,5472,2112,4793,9.7936650124,7.4920937977,-0.739946427,5.9631617835,2.3015712147,5.223215356
34003,2013,9237,7332,-872,5252,1905,4380,9.99547136,7.9340474192,-0.94360193,5.6832538251,2.0614239408,4.7396518953
34003,2014,9276,6936,-1807,5698,2340,3891,9.9712450619,7.4558598264,-1.942436376,6.1250705437,2.5153852355,4.1826341673
34003,2015,9428,7119,-3465,6109,2309,2644,10.074786159,7.6073825485,-3.70270832,6.5280938319,2.4674036107,2.8253855118
34003,2016,9514,7014,-4602,6229,2500,1627,10.117821467,7.4591549056,-4.894073407,6.6243336052,2.6586665617,1.7302601984
34003,2017,9389,7093,-2446,6188,2296,3742,9.9312828004,7.5026721592,-2.587274228,6.5454018499,2.4286106411,3.9581276216
45015,2010,612,223,593,89,389,682,NA,NA,NA,NA,NA,NA
45015,2011,2488,1136,2634,134,1352,2768,13.740845879,6.2739553533,14.547181691,0.740061635,7.4668905261,15.287243326
45015,2012,2589,1179,3665,663,1410,4328,13.914305292,6.3364101737,19.697152915,3.5632230239,7.5778951187,23.260375939
45015,2013,2629,1252,2588,407,1377,2995,13.751078798,6.5486309072,13.536626827,2.1288280984,7.2024478908,15.665454926
45015,2014,2556,1283,2536,374,1273,2910,13.074101923,6.5626262781,12.971800656,1.9130336929,6.5114756446,14.884834349
45015,2015,2774,1435,2822,550,1339,3372,13.871040328,7.1755381654,14.111058329,2.7502062655,6.6955021627,16.861264595
45015,2016,2727,1453,7797,413,1274,8210,13.166884344,7.0155786404,37.646570309,1.9941045963,6.151305704,39.640674905
45015,2017,2834,1496,4454,261,1338,4715,13.187529083,6.9613773848,20.725919032,1.2145183806,6.2261516985,21.940437413
54003,2010,322,226,319,7,96,326,NA,NA,NA,NA,NA,NA
54003,2011,1284,840,505,35,444,540,12.215483411,7.9914377453,4.8043762635,0.3329765727,4.2240456654,5.1373528362
54003,2012,1336,932,788,15,404,803,12.578142653,8.7745725691,7.4188446185,0.1412216615,3.8035700836,7.56006628
54003,2013,1430,912,1018,-34,518,984,13.292495317,8.4774515591,9.4627693938,-0.316045343,4.8150437583,9.1467240506
54003,2014,1378,912,1219,-15,466,1204,12.621301423,8.3531399838,11.164997413,-0.137387171,4.2681614391,11.027610242
54003,2015,1391,1006,1088,-10,385,1078,12.558515369,9.0825783327,9.8229077793,-0.090284079,3.4759370359,9.7326237005
54003,2016,1357,1019,1440,-5,338,1435,12.074726272,9.0671673333,12.813268852,-0.044490517,3.0075589388,12.768778335
54003,2017,1388,1013,1276,-5,375,1271,12.165300846,8.8785661072,11.183662737,-0.04382313,3.2867347386,11.139839607
42011,2010,1217,840,-94,214,377,120,NA,NA,NA,NA,NA,NA
42011,2011,4869,3664,-1548,1228,1205,-320,11.80584012,8.8840826045,-3.753427913,2.9775255017,2.9217575159,-0.775902411
42011,2012,4903,3678,-1647,1099,1225,-548,11.866226029,8.9014846699,-3.986064506,2.659796534,2.9647413596,-1.326267971
42011,2013,4892,3833,-1798,1234,1059,-564,11.82309346,9.2636789107,-4.345446043,2.9823584075,2.559414549,-1.363087635
42011,2014,4895,3706,-2109,1562,1189,-547,11.814354139,8.9446366573,-5.090188535,3.7699736802,2.8697174813,-1.320214855
42011,2015,4845,3950,-1921,1660,895,-261,11.676063347,9.5191847722,-4.629456696,4.0004675245,2.156878575,-0.628989171
42011,2016,4713,3875,-2101,1736,838,-365,11.343055838,9.3261916767,-5.056600958,4.1781338712,2.0168641613,-0.878467087
42011,2017,4696,3774,-522,1738,922,1216,11.26698385,9.0548545681,-1.252420266,4.1699356755,2.2121292824,2.9175154093
25003,2010,265,289,37,29,-24,66,NA,NA,NA,NA,NA,NA
25003,2011,1186,1428,-710,143,-242,-567,9.0609743985,10.909841013,-5.424360728,1.0925120902,-1.848866614,-4.331848637
25003,2012,1182,1405,-293,195,-223,-98,9.0699119866,10.781071355,-2.248294596,1.496305277,-1.711159368,-0.751989319
25003,2013,1064,1568,-551,219,-504,-332,8.2014283127,12.086315408,-4.247168233,1.6880759403,-3.884887095,-2.559092293
25003,2014,1100,1458,-556,257,-358,-299,8.5285201467,11.304165794,-4.310779274,1.9925724343,-2.775645648,-2.31820684
25003,2015,1076,1464,-908,280,-388,-628,8.3972950721,11.425315972,-7.086193239,2.1851697214,-3.0280209,-4.901023518
25003,2016,997,1463,-590,288,-466,-302,7.8354015545,11.497685531,-4.636797309,2.2633858051,-3.662283976,-2.373411504
25003,2017,1012,1387,-453,288,-375,-165,7.9945965375,10.957021144,-3.578608924,2.2751420976,-2.962424606,-1.303466827
35001,2010,2134,1158,348,183,976,531,NA,NA,NA,NA,NA,NA
35001,2011,8433,5043,1292,706,3390,1998,12.649484188,7.5644905444,1.9379975775,1.0589986763,5.0849936438,2.9969962538
35001,2012,8470,4970,-1480,1088,3500,-392,12.626046177,7.4086717235,-2.206204054,1.6218581157,5.2173744532,-0.584345939
35001,2013,8268,5091,-2385,844,3177,-1541,12.28301748,7.5632368158,-3.543178119,1.2538542276,4.7197806646,-2.289323892
35001,2014,8088,5226,-3801,988,2862,-2813,12.001638206,7.7547677131,-5.640235759,1.466075488,4.2468704927,-4.174160271
35001,2015,7939,5460,-3433,1201,2479,-2232,11.778914275,8.1008781886,-5.093464253,1.781896466,3.678036086,-3.311567787
35001,2016,7746,5738,-1677,1168,2008,-509,11.478208297,8.5027058105,-2.48501876,1.7307703706,2.9755024865,-0.754248389
35001,2017,7720,5752,-1860,1111,1968,-749,11.41706985,8.5066043756,-2.750744809,1.6430524098,2.9104654748,-1.107692399
13019,2010,58,21,33,0,37,33,NA,NA,NA,NA,NA,NA
13019,2011,224,203,-10,14,21,4,11.565170251,10.48093554,-0.516302243,0.7228231407,1.084234711,0.2065208973
13019,2012,216,183,-289,36,33,-253,11.207097829,9.494902327,-14.99468182,1.8678496381,1.7121955016,-13.12683218
13019,2013,213,208,-136,24,5,-112,11.143955843,10.882360635,-7.115389646,1.2556569964,0.2615952076,-5.85973265
13019,2014,237,186,-316,20,51,-296,12.512538937,9.8199672668,-16.68338525,1.0559104588,2.6925716699,-15.62747479
13019,2015,270,218,94,25,52,119,14.282313735,11.531645904,4.9723610781,1.3224364569,2.7506678304,6.294797535
13019,2016,247,195,-48,21,52,-27,12.999315825,10.262617757,-2.526182832,1.1052049892,2.7366980685,-1.420977843
13019,2017,261,220,112,20,41,132,13.664921466,11.518324607,5.8638743455,1.0471204188,2.1465968586,6.9109947644
26021,2010,482,425,-204,72,57,-132,NA,NA,NA,NA,NA,NA
26021,2011,1943,1612,-528,262,331,-266,12.394466824,10.283005929,-3.368130974,1.6713074153,2.1114608949,-1.696823559
26021,2012,1821,1674,-843,329,147,-514,11.627869852,10.689211495,-5.382918334,2.1008067992,0.9386583571,-3.282111534
26021,2013,1833,1654,-1081,322,179,-759,11.739915713,10.593464588,-6.923540036,2.0623310746,1.1464511253,-4.861208962
26021,2014,1867,1704,-703,381,163,-322,11.98623541,10.939767081,-4.513295926,2.4460394705,1.0464683299,-2.067256455
26021,2015,1792,1843,-1238,414,-51,-824,11.543453825,11.871978459,-7.974774461,2.6668470331,-0.328524635,-5.307927428
26021,2016,1712,1678,-1111,434,34,-677,11.082376626,10.862282698,-7.191892775,2.8094342615,0.2200939283,-4.382458514
26021,2017,1718,1639,-407,434,79,27,11.140796846,10.628501764,-2.639292384,2.8143805769,0.512295082,0.1750881926
37015,2010,48,33,-47,0,15,-47,NA,NA,NA,NA,NA,NA
37015,2011,196,266,-330,3,-70,-327,9.3089527428,12.633578722,-15.67323676,0.1424839706,-3.32462598,-15.53075279
37015,2012,193,223,-344,9,-30,-335,9.3322373193,10.782844156,-16.63362507,0.4351820512,-1.450606837,-16.19844302
37015,2013,182,257,-86,11,-75,-75,8.9102124743,12.582003329,-4.21032018,0.5385293254,-3.671790855,-3.671790855
37015,2014,170,246,57,21,-76,78,8.3531926394,12.087561113,2.8007763556,1.0318649731,-3.734368474,3.8326413286
37015,2015,163,269,-80,24,-106,-56,8.0412421993,13.270516267,-3.946621938,1.1839865815,-5.229274068,-2.762635357
37015,2016,182,244,-706,28,-62,-678,9.1833387996,12.31172894,-35.62328128,1.4128213538,-3.128390141,-34.21045992
37015,2017,171,248,-176,27,-77,-149,8.8433791017,12.825485481,-9.101957438,1.3963230161,-3.982106379,-7.705634422
02050,2010,116,31,-12,0,85,-12,NA,NA,NA,NA,NA,NA
02050,2011,465,106,-28,0,359,-28,26.955740413,6.1447494276,-1.623141358,0,20.810990986,-1.623141358
02050,2012,421,121,-62,5,300,-57,24.007755474,6.9000912409,-3.535583942,0.2851277372,17.107664234,-3.250456204
02050,2013,446,94,-168,5,352,-163,25.124637355,5.2953271555,-9.463988959,0.2816663381,19.829310199,-9.182322621
02050,2014,439,93,-272,4,346,-268,24.541592129,5.1990161002,-15.20572451,0.2236135957,19.342576029,-14.98211091
02050,2015,413,121,-279,5,292,-274,23.021181717,6.7447045708,-15.55183946,0.2787068004,16.276477146,-15.27313266
02050,2016,426,143,-257,4,283,-253,23.712114887,7.9597005371,-14.30519607,0.2226489661,15.75241435,-14.0825471
02050,2017,424,146,-187,4,278,-183,23.51897049,8.0985134236,-10.37275349,0.2218770801,15.420457067,-10.15087641
48029,2010,6213,2793,3577,834,3420,4411,NA,NA,NA,NA,NA,NA
48029,2011,26203,11406,13477,3860,14797,17337,15.068197351,6.5590909052,7.750032275,2.2197168941,8.5091064461,9.9697491691
48029,2012,25871,11404,13027,5477,14467,18504,14.602491189,6.4368137885,7.3528913734,3.0914090775,8.1656774007,10.444300451
48029,2013,26434,12278,13768,4942,14156,18710,14.646928351,6.803169641,7.6287701268,2.7383339604,7.8437587097,10.367104087
48029,2014,27456,12269,15640,5405,15187,21045,14.926261625,6.6699557067,8.5025761882,2.9383903003,8.2563059188,11.440966488
48029,2015,28139,12962,15614,6341,15177,21955,14.997684177,6.908560443,8.3220384784,3.3796622257,8.0891237342,11.701700704
48029,2016,28196,13574,12218,6086,14622,18304,14.752424947,7.1020505117,6.3925779543,3.1842551506,7.6503744351,9.576833105
48029,2017,28376,13647,10304,5788,14729,16092,14.602998977,7.023087364,5.3026959917,2.9786494953,7.5799116132,8.2813454871
01007,2010,44,34,-59,1,10,-58,NA,NA,NA,NA,NA,NA
01007,2011,266,277,-125,10,-11,-115,11.662318872,12.144595217000001,-5.480413004,0.4384330403,-0.482276344,-5.041979964
01007,2012,245,239,-107,14,6,-93,10.792238398,10.527938682,-4.713344933,0.616699337,0.2642997159,-4.096645596
01007,2013,258,282,-147,14,-24,-133,11.425787737,12.488651713,-6.51004185,0.6200039857,-1.062863976,-5.890037865
01007,2014,254,248,11,17,6,28,11.279864997,11.013411493,0.4884980904,0.7549515943,0.2664535039,1.2434496847
01007,2015,252,262,21,20,-10,41,11.176653213,11.620171198,0.9313877678,0.8870359693,-0.443517985,1.8184237371
01007,2016,290,207,-32,20,83,-12,12.833561977,9.160508032,-1.416117184,0.8850732398,3.6730539452,-0.531043944
01007,2017,270,233,-20,20,37,0,11.920266661,10.286748637,-0.882982716,0.8829827156,1.6335180239,0
13021,2010,565,391,-175,32,174,-143,NA,NA,NA,NA,NA,NA
13021,2011,2293,1609,-421,149,684,-272,14.697022138,10.312912613,-2.698406594,0.9550180107,4.3841095258,-1.743388583
13021,2012,2324,1543,-505,194,781,-311,14.855488189,9.8631748173,-3.228064344,1.2400880846,4.9923133715,-1.987976259
13021,2013,2166,1695,-2313,210,471,-2103,13.896373855,10.874586188,-14.83947956,1.347293864,3.0217876665,-13.4921857
13021,2014,2212,1534,-1550,212,678,-1338,14.294345914,9.9129867234,-10.01638163,1.3699825198,4.3813591907,-8.646399111
13021,2015,2226,1670,-1141,228,556,-913,14.432100726,10.827317257,-7.397586221,1.4782205596,3.6047834699,-5.919365662
13021,2016,2086,1678,-1489,231,408,-1258,13.577988817,10.922274801,-9.692054338,1.5036027885,2.6557140161,-8.188451549
13021,2017,2130,1685,-1017,230,445,-787,13.918521108,11.010661064,-6.64560374,1.502938899,2.9078600437,-5.142664841
22013,2010,30,69,-6,0,-39,-6,NA,NA,NA,NA,NA,NA
22013,2011,190,219,-13,-3,-29,-16,13.301130596,15.331303161,-0.910077357,-0.210017852,-2.030172565,-1.120095208
22013,2012,212,205,-70,-3,7,-73,14.900720436,14.408715515999999,-4.9200492,-0.210859251,0.49200492,-5.130908452
22013,2013,173,215,-189,1,-42,-188,12.286931818,15.269886364,-13.42329545,0.0710227273,-2.982954545,-13.35227273
22013,2014,157,217,-118,1,-60,-117,11.313276887,15.636822194,-8.502972437,0.0720590885,-4.323545307,-8.430913349
22013,2015,181,207,66,2,-26,68,13.10691915,14.989681017,4.779318585,0.1448278359,-1.882761867,4.9241464209
22013,2016,166,162,-29,1,4,-28,12.013315965,11.723838472,-2.098711825,0.0723693733,0.2894774931,-2.026342452
22013,2017,164,204,-131,1,-40,-130,11.951610552,14.866637516,-9.546713307,0.0728756741,-2.915026964,-9.473837633
30003,2010,70,26,4,0,44,4,NA,NA,NA,NA,NA,NA
30003,2011,252,102,-4,-2,150,-6,19.409997689,7.8564276361,-0.308095201,-0.154047601,11.553570053,-0.462142802
30003,2012,268,119,-210,0,149,-210,20.575815739,9.1362763916,-16.12284069,0,11.439539347,-16.12284069
30003,2013,254,131,2,-3,123,-1,19.454656863,10.03370098,0.1531862745,-0.229779412,9.4209558824,-0.076593137
30003,2014,313,113,9,3,200,12,23.673562001,8.5466853231,0.6807094505,0.2269031502,15.126876678,0.9076126007
30003,2015,292,131,-216,4,161,-212,21.951586228,9.8481431364,-16.23815968,0.3007066607,12.103443091,-15.93745301
30003,2016,258,175,6,5,83,11,19.363554488,13.134193936,0.4503152207,0.3752626839,6.2293605524,0.8255779045
30003,2017,274,162,-129,5,112,-124,20.500542441,12.12075867,-9.651715237,0.3740974898,8.3797837717,-9.277617747
56003,2010,25,50,23,1,-25,24,NA,NA,NA,NA,NA,NA
56003,2011,150,131,42,-1,19,41,12.824349164,11.199931603,3.590817766,-0.085495661,1.6244175608,3.5053221049
56003,2012,133,127,32,1,6,33,11.32348559,10.812651654,2.7244476608,0.0851389894,0.5108339364,2.8095866502
56003,2013,136,136,172,-1,0,171,11.474856564,11.474856564,14.512318596,-0.084373945,0,14.427944651
56003,2014,159,144,-95,-2,15,-97,13.362467434,12.101857299,-7.98386419,-0.168081351,1.2606101353,-8.151945542
56003,2015,158,123,64,-2,35,62,13.268948142,10.329624186,5.3747638043,-0.167961369,2.9393239555,5.2068024354
56003,2016,130,130,-13,-2,0,-15,10.880026782,10.880026782,-1.088002678,-0.167385027,0,-1.255387706
56003,2017,149,125,-56,-2,24,-58,12.496330775,10.483498973,-4.69660754,-0.167735984,2.0128318027,-4.864343523
27011,2010,15,9,0,0,6,0,NA,NA,NA,NA,NA,NA
27011,2011,57,85,-40,0,-28,-40,10.87682473,16.219826352,-7.63285946,0,-5.343001622,-7.63285946
27011,2012,60,88,-44,0,-28,-44,11.604293589,17.019630597,-8.509815298,0,-5.415337008,-8.509815298
27011,2013,55,73,-50,4,-18,-46,10.780086241,14.308114465,-9.800078401,0.7840062721,-3.528028224,-9.016072129
27011,2014,55,73,33,4,-18,37,10.827837386,14.371493257,6.4967024313,0.7874790826,-3.543655872,7.2841815139
27011,2015,51,74,-74,4,-23,-70,10.114030739,14.675260288,-14.67526029,0.7932573128,-4.561229549,-13.88200297
27011,2016,51,64,25,4,-13,29,10.191846523,12.789768185,4.9960031974,0.7993605116,-2.597921663,5.795363709
27011,2017,57,68,21,4,-11,25,11.356843993,13.548515641,4.1841004184,0.7969715083,-2.191671648,4.9810719267
38007,2010,1,0,-6,0,1,-6,NA,NA,NA,NA,NA,NA
38007,2011,5,4,47,6,1,53,6.2034739454,4.9627791563,58.312655087,7.4441687345,1.2406947891,65.756823821
38007,2012,9,1,60,6,8,66,10.327022375,1.1474469306,68.846815835,6.8846815835,9.1795754446,75.731497418
38007,2013,14,3,-24,3,11,-21,15.46961326,3.3149171271,-26.51933702,3.3149171271,12.154696133,-23.20441989
38007,2014,14,2,-4,6,12,2,15.426997245,2.2038567493,-4.407713499,6.6115702479,13.223140496,2.2038567493
38007,2015,18,1,10,7,17,17,19.334049409,1.0741138561,10.741138561,7.5187969925000004,18.259935553,18.259935553
38007,2016,19,8,-14,8,11,-6,19.989479221,8.4166228301,-14.72908995,8.4166228301,11.572856391,-6.312467123
38007,2017,20,5,-36,8,15,-28,21.130480718,5.2826201796,-38.03486529,8.4521922874,15.847860539,-29.58267301
16011,2010,223,60,1,-3,163,-2,NA,NA,NA,NA,NA,NA
16011,2011,742,322,-258,-41,420,-299,16.190445019,7.0260421781,-5.629561745,-0.894620277,9.164402841,-6.524182022
16011,2012,745,338,-779,-17,407,-796,16.300542622,7.3954139681,-17.04446,-0.371958691,8.9051286539,-17.41641869
16011,2013,772,309,-565,4,463,-561,16.977854017,6.7955400145,-12.42550197,0.0879681555,10.182314002,-12.33753381
16011,2014,700,351,-591,19,349,-572,15.446060151,7.7450958759,-13.04088793,0.4192502041,7.7009642755,-12.62163772
16011,2015,724,376,-564,26,348,-538,16.046277109,8.3334256807,-12.50013852,0.5762475205,7.7128514279,-11.923891
16011,2016,697,352,-140,23,345,-117,15.440679656,7.797875522,-3.101427764,0.5095202756,7.6428041338,-2.591907489
16011,2017,702,363,315,22,339,337,15.397775877,7.9620977825,6.9092584063,0.4825513808,7.4356780944,7.391809787
19013,2010,428,327,-41,20,101,-21,NA,NA,NA,NA,NA,NA
19013,2011,1661,1138,-354,167,523,-187,12.64931099,8.6664153559,-2.695879645,1.2717850303,3.9828956337,-1.424094615
19013,2012,1654,1168,-345,201,486,-144,12.565333657,8.8732223168,-2.620943236,1.5269843199,3.6921113407,-1.093958916
19013,2013,1755,1198,168,274,557,442,13.266559577,9.0560332609,1.2699612586,2.0712463385,4.2105263158,3.3412075971
19013,2014,1729,1221,-446,300,508,-146,13.004693423,9.1837655695,-3.354594139,2.2564534569,3.8209278537,-1.098140682
19013,2015,1775,1189,-586,323,586,-263,13.317927055,8.9211353627,-4.396791693,2.4234875712,4.3967916926,-1.973304121
19013,2016,1712,1171,-1489,325,541,-1164,12.860190499,8.796310207,-11.18506055,2.4413328926,4.0638802921,-8.743727652
19013,2017,1692,1205,-978,325,487,-653,12.747635246,9.0785463778,-7.36831399,2.4485705998,3.669088868,-4.91974339
18009,2010,33,22,-7,1,11,-6,NA,NA,NA,NA,NA,NA
18009,2011,146,146,-124,5,0,-119,11.485210824,11.485210824,-9.754562618,0.3933291378,0,-9.36123348
18009,2012,144,137,-146,7,7,-139,11.438557471,10.882516483,-11.59742632,0.5560409882,0.5560409882,-11.04138534
18009,2013,138,143,-64,-1,-5,-65,11.048839071,11.449159327,-5.124099279,-0.080064051,-0.400320256,-5.204163331
18009,2014,127,172,-71,-1,-45,-72,10.244413971,13.874324433,-5.727192063,-0.080664677,-3.629910462,-5.80785674
18009,2015,149,175,-88,0,-26,-88,12.132068558,14.24907381,-7.165248545,0,-2.117005252,-7.165248545
18009,2016,110,158,-101,0,-48,-101,9.0538705297,13.004650397,-8.313099304,0,-3.950779867,-8.313099304
18009,2017,117,164,-51,0,-47,-51,9.729325184,13.637686583,-4.240987901,0,-3.908361399,-4.240987901
37017,2010,89,120,36,8,-31,44,NA,NA,NA,NA,NA,NA
37017,2011,353,381,-305,56,-28,-249,10.069315686,10.868014947,-8.700116952,1.5973985224,-0.798699261,-7.10271843
37017,2012,357,385,-50,24,-28,-26,10.23127848,11.033731694,-1.432952168,0.6878170407,-0.802453214,-0.745135127
37017,2013,353,362,-173,22,-9,-151,10.148052321,10.406784534,-4.973408078,0.6324565186,-0.258732212,-4.34095156
37017,2014,377,389,-260,27,-12,-233,10.901309892,11.248301188,-7.518144753,0.7807304167,-0.346991296,-6.737414337
37017,2015,339,442,-183,37,-103,-146,9.8728758027,12.872599129,-5.329605522,1.0775705153,-2.999723326,-4.252035006
37017,2016,355,430,-375,37,-75,-338,10.440101754,12.645757054,-11.0282765,1.0881232814,-2.2056553,-9.94015322
37017,2017,328,446,-239,38,-118,-201,9.7511668698,13.25920861,-7.105270981,1.1297083569,-3.50804174,-5.975562624
16013,2010,60,39,-114,7,21,-107,NA,NA,NA,NA,NA,NA
16013,2011,243,108,-408,31,135,-377,11.471192201,5.0983076451,-19.26027333,1.4634031204,6.3728845564,-17.79687021
16013,2012,225,84,-140,24,141,-116,10.672611707,3.9844417038,-6.640736173,1.1384119154,6.6881700028,-5.502324258
16013,2013,221,86,6,21,135,27,10.43634303,4.06120136,0.2833396298,0.9916887042,6.3751416698,1.275028334
16013,2014,220,106,-10,34,114,24,10.317981428,4.9713910515,-0.468999156,1.5945971297,5.3465903761,1.1255979739
16013,2015,230,111,-34,34,119,0,10.72386059,5.1754283716,-1.585266348,1.5852663481,5.5484322182,0
16013,2016,211,103,89,39,108,128,9.7576766556,4.7632260451,4.1157972623,1.8035516093,4.9944506104,5.9193488716
16013,2017,222,104,125,39,118,164,10.145093111,4.7526562321,5.7123272021,1.7822460871,5.3924368788,7.4945732892
30005,2010,22,6,-3,0,16,-3,NA,NA,NA,NA,NA,NA
30005,2011,112,71,30,0,41,30,17.130620985,10.859590089,4.5885591924,0,6.2710308963,4.5885591924
30005,2012,114,78,41,4,36,45,17.234862801,11.792274548,6.1985032882,0.6047320281,5.4425882531,6.8032353164
30005,2013,101,59,-107,3,42,-104,15.242982191,8.9043163296,-16.14850589,0.4527618473,6.3386658618,-15.69574404
30005,2014,109,68,7,7,41,14,16.457798581,10.267250491,1.0569228446,1.0569228446,6.19054809,2.1138456893
30005,2015,120,81,-80,8,39,-72,18.088634308,12.209828158,-12.05908954,1.2059089539,5.8788061501,-10.85318058
30005,2016,119,64,-23,8,55,-15,17.928436911,9.6421845574,-3.465160075,1.2052730697,8.286252354,-2.259887006
30005,2017,120,67,-10,8,53,-2,17.957351291,10.026187804,-1.496445941,1.1971567527,7.9311634867,-0.299289188
31009,2010,0,0,0,0,0,0,NA,NA,NA,NA,NA,NA
31009,2011,8,3,-8,0,5,-8,16.789087093,6.29590766,-16.78908709,0,10.493179433,-16.78908709
31009,2012,5,8,24,0,-3,24,10.277492292,16.443987667,49.331963001,0,-6.166495375,49.331963001
31009,2013,5,7,-27,0,-2,-27,10.330578512,14.462809917,-55.78512397,0,-4.132231405,-55.78512397
31009,2014,3,2,19,0,1,19,6.25,4.1666666667,39.583333333,0,2.0833333333,39.583333333
31009,2015,6,5,-15,0,1,-15,12.409513961,10.341261634,-31.0237849,0,2.0682523268,-31.0237849
31009,2016,9,1,-14,0,8,-14,19.027484144,2.1141649049,-29.59830867,0,16.913319239,-29.59830867
31009,2017,6,3,10,0,3,10,12.61829653,6.309148265,21.030494217,0,6.309148265,21.030494217
40011,2010,40,15,-2344,-1,25,-2345,NA,NA,NA,NA,NA,NA
40011,2011,136,128,-260,13,8,-247,13.898824732,13.081246806,-26.57128258,1.3285641288,0.8175779254,-25.24271845
40011,2012,132,125,96,15,7,111,13.571171542,12.851488202,9.8699429394,1.5421785843,0.7196833393,11.412121524
40011,2013,176,128,-68,4,48,-64,18.000511378,13.091281002,-6.954743032,0.4091025313,4.9092303759,-6.545640501
40011,2014,162,134,21,7,28,28,16.537362189,13.679052675,2.1437321356,0.7145773785,2.8583095141,2.8583095141
40011,2015,162,137,-120,9,25,-111,16.562723648,14.006747776,-12.26868418,0.9201513138,2.5559758716,-11.34853287
40011,2016,136,102,-210,10,34,-200,14.085965821,10.564474366,-21.7503884,1.0357327809,3.5214914552,-20.71465562
40011,2017,131,104,-110,10,27,-100,13.739577324,10.907756044,-11.53704966,1.0488226965,2.8318212806,-10.48822697
42013,2010,361,387,-9,7,-26,-2,NA,NA,NA,NA,NA,NA
42013,2011,1388,1595,173,13,-207,186,10.928316386,12.558115732,1.3621028348,0.1023545483,-1.629799346,1.4644573831
42013,2012,1340,1502,-240,23,-162,-217,10.568573479,11.846266691,-1.892878832,0.1814008881,-1.277693212,-1.711477944
42013,2013,1385,1666,-338,14,-281,-324,10.967256602,13.19238231,-2.676485727,0.1108603555,-2.225125708,-2.565625371
42013,2014,1353,1526,-311,27,-173,-284,10.760341818,12.136202228,-2.473367558,0.2147296593,-1.37586041,-2.258637898
42013,2015,1336,1638,-401,28,-302,-373,10.674336849,13.087248322,-3.203899009,0.2237136465,-2.412911473,-2.980185363
42013,2016,1310,1639,-583,25,-329,-558,10.532875033,13.178154335,-4.687531408,0.2010090655,-2.645279302,-4.486522342
42013,2017,1285,1649,-123,24,-364,-99,10.388707435,13.331500825000001,-0.994405459,0.1940303334,-2.94279339,-0.800375125
48031,2010,20,40,26,3,-20,29,NA,NA,NA,NA,NA,NA
48031,2011,99,124,73,13,-25,86,9.3936806149,11.765822184,6.9266533827,1.2335136161,-2.372141569,8.1601669988
48031,2012,95,104,42,12,-9,54,8.9694566398,9.8191946372,3.9654439881,1.1329839966,-0.849737997,5.0984279847
48031,2013,71,110,50,11,-39,61,6.6823529412,10.352941176,4.7058823529,1.0352941176,-3.670588235,5.7411764706
48031,2014,87,96,155,19,-9,174,8.1156716418,8.9552238806,14.458955224,1.7723880597,-0.839552239,16.231343284
48031,2015,105,124,225,26,-19,251,9.6145041663,11.354271587,20.602508928,2.380734365,-1.739767421,22.983243293
48031,2016,102,117,290,29,-15,319,9.1156888154,10.456231288,25.917154475,2.5917154475,-1.340542473,28.508869923
48031,2017,111,126,270,29,-15,299,9.6660425828,10.972264553,23.511995472,2.5253624766,-1.306221971,26.037357948
51021,2010,6,24,-6,0,-18,-6,NA,NA,NA,NA,NA,NA
51021,2011,39,83,22,-1,-44,21,5.7458563536,12.228360958,3.241252302,-0.14732965,-6.482504604,3.0939226519
51021,2012,49,93,-36,0,-44,-36,7.2748867939,13.807438201,-5.344814787,0,-6.532551407,-5.344814787
51021,2013,60,95,18,-2,-35,16,8.9753178758,14.21091997,2.6925953628,-0.299177263,-5.235602094,2.3934181002
51021,2014,41,74,-54,-2,-33,-56,6.1830794752,11.159704419,-8.143568089,-0.301613633,-4.976624943,-8.445181722
51021,2015,46,89,-7,-2,-43,-9,7.0111263527,13.565005335,-1.066910532,-0.304831581,-6.553878982,-1.371742112
51021,2016,54,88,-23,-2,-34,-25,8.3013066872,13.528055342,-3.535741737,-0.307455803,-5.226748655,-3.84319754
51021,2017,46,84,-85,-2,-38,-87,7.1734892788,13.099415205,-13.25536062,-0.311890838,-5.925925926,-13.56725146
13023,2010,26,53,-4,1,-27,-3,NA,NA,NA,NA,NA,NA
13023,2011,144,154,48,10,-10,58,11.028989392,11.794891433,3.6763297974,0.7659020411,-0.765902041,4.4422318385
13023,2012,132,133,-208,10,-1,-198,10.166358595,10.243376463,-16.01971657,0.7701786815,-0.077017868,-15.24953789
13023,2013,121,141,-147,17,-20,-130,9.4427969408,11.003589824,-11.47182769,1.3266739504,-1.560792883,-10.14515374
13023,2014,135,158,-17,14,-23,-3,10.608203678,12.415527267,-1.335847871,1.100110011,-1.80732359,-0.23573786
13023,2015,142,137,-13,14,5,1,11.168351095,10.775099296,-1.022454678,1.1011050376,0.3932517991,0.0786503598
13023,2016,127,120,157,17,7,174,9.9160648058,9.3695100527,12.258442319,1.3273472575,0.5465547531,13.585789576
13023,2017,135,124,-97,17,11,-80,10.494402985,9.6393034826,-7.540422886,1.3215174129,0.8550995025,-6.218905473
47007,2010,30,15,-3,0,15,-3,NA,NA,NA,NA,NA,NA
47007,2011,129,131,28,-1,-2,27,10.004653327,10.159764231,2.1715526602,-0.077555452,-0.155110904,2.093997208
47007,2012,131,126,-59,-2,5,-61,10.17199208,9.7837481073,-4.581278876,-0.155297589,0.3882439725,-4.736576465
47007,2013,102,121,982,-2,-19,980,7.6413080121,9.0646889164,73.566318313,-0.149829569,-1.423380904,73.416488744
47007,2014,118,138,572,-2,-20,570,8.3495489121,9.7647266938,40.474084557,-0.141517778,-1.415177782,40.332566779
47007,2015,139,141,70,-2,-2,68,9.6187115079,9.7571102346,4.8439554356,-0.138398727,-0.138398727,4.7055567089
47007,2016,127,139,129,-2,-12,127,8.7339247645,9.5591774981,8.8714668867,-0.137542122,-0.825252734,8.7339247645
47007,2017,143,137,115,-1,6,114,9.7557647701,9.3464319825,7.8455450948,-0.068222131,0.4093327876,7.7773229636
01009,2010,183,132,9,4,51,13,NA,NA,NA,NA,NA,NA
01009,2011,744,569,27,-13,175,14,12.945546923,9.9005594077,0.4697980738,-0.226199073,3.0449875156,0.2435990012
01009,2012,712,593,-99,21,119,-78,12.36572679,10.298983127,-1.719391787,0.3647194699,2.066743663,-1.354672317
01009,2013,646,585,-64,36,61,-28,11.213525664,10.154663334,-1.110937527,0.624902359,1.0588623305,-0.486035168
01009,2014,619,587,-157,55,32,-102,10.749420417,10.193715323,-2.726428119,0.9551181307,0.5557050943,-1.771309988
01009,2015,716,635,-90,59,81,-31,12.437465258,11.030433574,-1.563368538,1.0248749305,1.4070316843,-0.538493608
01009,2016,675,662,-100,62,13,-38,11.723634848,11.497846325,-1.736834792,1.0768375712,0.225788523,-0.659997221
01009,2017,685,653,359,62,32,421,11.853774605,11.300021631,6.21241618,1.0728963876,0.5537529743,7.2853125676
47009,2010,298,260,72,18,38,90,NA,NA,NA,NA,NA,NA
47009,2011,1241,1259,416,55,-18,471,10.054037413,10.199865514,3.3702494471,0.4455858644,-0.145828101,3.8158353115
47009,2012,1302,1266,189,48,36,237,10.518789612,10.227947503,1.5269210727,0.3877894788,0.2908421091,1.9147105515
47009,2013,1274,1363,1015,7,-89,1022,10.243298439,10.958882081,8.1608696351,0.0562818596,-0.715583643,8.2171514947
47009,2014,1279,1338,1000,40,-59,1040,10.204610825,10.675347368,7.9785854766,0.3191434191,-0.470736543,8.2977288956
47009,2015,1296,1354,1016,49,-58,1065,10.258886483,10.718003317,8.0424603913,0.3878745661,-0.459116833,8.4303349574
47009,2016,1250,1338,1451,50,-88,1501,9.8010004861,10.49099092,11.377001364,0.3920400194,-0.689990434,11.769041384
47009,2017,1246,1349,1736,50,-103,1786,9.6524423545,10.450356931,13.448346651,0.3873371731,-0.797914577,13.835683824
27013,2010,207,96,-59,20,111,-39,NA,NA,NA,NA,NA,NA
27013,2011,767,476,-127,101,291,-26,11.944435793,7.4127137384,-1.977761859,1.5728657302,4.5317220544,-0.404896129
27013,2012,766,464,249,77,302,326,11.847315021,7.1764414749,3.8511507053,1.1909180896,4.6708735462,5.0420687949
27013,2013,727,476,-572,99,251,-473,11.208498108,7.3387140291,-8.818790808,1.5263291783,3.8697840784,-7.29246163
27013,2014,739,467,105,146,272,251,11.367219646,7.1833444852,1.6150988671,2.24575652,4.1838751605,3.8608553871
27013,2015,699,488,-27,152,211,125,10.682927948,7.4581814569,-0.412645286,2.3230401259,3.2247464906,1.9103948404
27013,2016,740,475,234,148,265,382,11.225813303,7.2057585388,3.5497842065,2.2451626605,4.0200547638,5.794946867
27013,2017,743,474,315,147,269,462,11.154732504,7.1162088923,4.7291261626,2.2069255425,4.0385236119,6.9360517051
16015,2010,7,18,-10,0,-11,-10,NA,NA,NA,NA,NA,NA
16015,2011,38,59,-8,8,-21,0,5.4320634694,8.4339932814,-1.143592309,1.1435923093,-3.001929812,0
16015,2012,32,44,-188,3,-12,-185,4.645423532,6.3874573565,-27.29186325,0.4355084561,-1.742033824,-26.85635479
16015,2013,40,48,-66,3,-8,-63,5.9197868877,7.1037442652,-9.767648365,0.4439840166,-1.183957378,-9.323664348
16015,2014,42,57,72,-2,-15,70,6.2222222222,8.4444444444,10.666666667,-0.296296296,-2.222222222,10.37037037
16015,2015,44,48,183,-1,-4,182,6.4055903334,6.9879167273,26.641432523,-0.145581598,-0.582326394,26.495850924
16015,2016,43,47,134,-1,-4,133,6.1218678815,6.6913439636,19.077448747,-0.142369021,-0.569476082,18.935079727
16015,2017,42,54,213,-1,-12,212,5.8422590068,7.5114758659,29.628599249,-0.139101405,-1.669216859,29.489497844
28011,2010,125,75,-103,0,50,-103,NA,NA,NA,NA,NA,NA
28011,2011,589,402,-494,-8,187,-502,17.350831455,11.842163404,-14.55231025,-0.235664943,5.5086680512,-14.7879752
28011,2012,569,423,44,6,146,50,16.789118055,12.481189696,1.2982797793,0.1770381517,4.3079283586,1.475317931
28011,2013,544,401,-162,9,143,-153,16.008946176,11.800712163,-4.767370001,0.2648538889,4.2082340131,-4.502516112
28011,2014,490,442,-226,11,48,-215,14.459182318,13.042772622,-6.668928988,0.3245938888,1.4164096965,-6.344335099
28011,2015,481,396,-657,11,85,-646,14.346645987,11.811375906,-19.59614639,0.3280937752,2.5352700808,-19.26805261
28011,2016,448,422,-657,15,26,-642,13.599453593,12.81019959,-19.94384154,0.455338848,0.7892540032,-19.48850269
28011,2017,434,400,-739,15,34,-724,13.440901841,12.387927964,-22.88669691,0.4645472987,1.052973877,-22.42214962
29017,2010,31,24,-24,0,7,-24,NA,NA,NA,NA,NA,NA
29017,2011,146,136,25,-1,10,24,11.808953775,11.000121325,2.0220811259,-0.080883245,0.8088324504,1.9411978809
29017,2012,161,125,31,0,36,31,12.969750675,10.069682201000001,2.4972811858,0,2.9000684738,2.4972811858
29017,2013,119,124,45,0,-5,45,9.5455821602,9.9466570409,3.6096739261,0,-0.401074881,3.6096739261
29017,2014,140,146,-60,0,-6,-60,11.242270939,11.72408255,-4.818116117,0,-0.481811612,-4.818116117
29017,2015,134,141,-92,0,-7,-92,10.832221818,11.398084152,-7.437047815,0,-0.565862334,-7.437047815
29017,2016,119,123,-113,0,-4,-113,9.7043832824,10.03058104,-9.215086646,0,-0.326197757,-9.215086646
29017,2017,117,132,118,0,-15,118,9.547123623,10.771113831,9.6287229702,0,-1.223990208,9.6287229702
46009,2010,17,25,-1,0,-8,-1,NA,NA,NA,NA,NA,NA
46009,2011,64,66,-51,3,-2,-48,9.0993104429,9.3836638942,-7.251013009,0.426530177,-0.284353451,-6.824482832
46009,2012,66,71,18,2,-5,20,9.4070695553,10.11972634,2.5655644242,0.2850627138,-0.712656784,2.850627138
46009,2013,69,88,-22,2,-19,-20,9.8529201771,12.566043124,-3.141510781,0.2855918892,-2.713122947,-2.855918892
46009,2014,56,63,4,1,-7,5,8.0206244629,9.0232025208,0.5729017474,0.1432254368,-1.002578058,0.7161271842
46009,2015,62,72,-24,1,-10,-23,8.9035686077,10.339628061,-3.446542687,0.1436059453,-1.436059453,-3.302936742
46009,2016,75,77,21,2,-2,23,10.78050884,11.067989076,3.0185424752,0.2874802357,-0.287480236,3.3060227109
46009,2017,74,66,6,2,8,8,10.607798165,9.4610091743,0.8600917431,0.2866972477,1.1467889908,1.1467889908
17005,2010,43,33,9,3,10,12,NA,NA,NA,NA,NA,NA
17005,2011,177,169,-92,15,8,-77,9.9701458908,9.519517828,-5.182222723,0.8449276179,0.4506280629,-4.337295105
17005,2012,174,168,-208,11,6,-197,9.8720603671,9.5316444924,-11.80108366,0.6240957703,0.3404158747,-11.17698789
17005,2013,163,169,-216,8,-6,-208,9.3533023469,9.6975956849,-12.39456017,0.4590577839,-0.344293338,-11.93550238
17005,2014,146,161,-189,10,-15,-179,8.4755601997,9.3463369325,-10.97178683,0.5805178219,-0.870776733,-10.39126901
17005,2015,164,188,-187,11,-24,-176,9.6303473384,11.039666461,-10.98094483,0.6459379312,-1.409319123,-10.3350069
17005,2016,138,172,-65,10,-34,-55,8.1729345573,10.186556115,-3.849570625,0.5922416346,-2.013621558,-3.25732899
17005,2017,143,164,118,10,-21,128,8.4642931131,9.7073011927,6.9845215899,0.5919086093,-1.24300808,7.5764301992
16017,2010,94,91,33,1,3,34,NA,NA,NA,NA,NA,NA
16017,2011,391,378,-149,-3,13,-152,9.5744159851,9.2560850189,-3.648562613,-0.073460992,0.3183309663,-3.722023605
16017,2012,378,423,-391,4,-45,-387,9.3206756257,10.430279867,-9.641227962,0.0986314881,-1.109604241,-9.542596474
16017,2013,400,386,178,-10,14,168,9.8931539375,9.5468935497,4.4024535022,-0.247328848,0.3462603878,4.1551246537
16017,2014,408,420,767,-5,-12,762,9.9746965419,10.26806997,18.751451587,-0.122238928,-0.293373428,18.629212659
16017,2015,392,421,312,-4,-29,308,9.4628847314,10.162945081,7.5316837658,-0.096560048,-0.70006035,7.4351237176
16017,2016,431,432,783,-4,-1,779,10.273156314,10.296991944,18.663297898,-0.095342518,-0.023835629,18.56795538
16017,2017,415,422,1226,-4,-7,1222,9.6620606964,9.8250352141,28.543822684,-0.093128296,-0.162974518,28.450694388
16019,2010,509,140,16,1,369,17,NA,NA,NA,NA,NA,NA
16019,2011,2013,700,-205,10,1313,-195,19.129162232,6.6519689828,-1.948076631,0.0950281283,12.477193249,-1.853048502
16019,2012,1891,794,-100,-7,1097,-107,17.793627792,7.4712535521,-0.940963923,-0.065867475,10.32237424,-1.006831398
16019,2013,1940,802,-551,6,1138,-545,18.120679993,7.4911264711,-5.14664674,0.0560433402,10.629553521,-5.0906034
16019,2014,1809,816,-131,28,993,-103,16.781465247,7.5697488346,-1.215241541,0.2597462835,9.2117164127,-0.955495257
16019,2015,2013,829,355,41,1184,396,18.464417243,7.6040744631,3.2562683165,0.3760760591,10.86034278,3.6323443756
16019,2016,1910,805,1075,40,1105,1115,17.220471625,7.2578427528,9.6921502599,0.3606381492,9.9626288718,10.052788409
16019,2017,1975,828,1378,44,1147,1422,17.43005913,7.3073868149,12.161327332,0.3883152414,10.122672315,12.549642573
05009,2010,91,128,16,-2,-37,14,NA,NA,NA,NA,NA,NA
05009,2011,421,413,187,-13,8,174,11.386841571,11.170464534,5.0578132396,-0.351612685,0.216377037,4.7062005545
05009,2012,479,398,181,-13,81,168,12.881365048,10.703096637,4.8674886717,-0.349598634,2.1782684111,4.5178900378
05009,2013,486,460,-8,-16,26,-24,13.027220458,12.330290968,-0.214439843,-0.428879686,0.6969294895,-0.643319529
05009,2014,458,402,-264,-6,56,-270,12.31265542,10.807177902,-7.097251159,-0.161301163,1.5054775187,-7.258552322
05009,2015,438,450,24,-6,-12,18,11.808953775,12.132486755,0.6470659603,-0.16176649,-0.32353298,0.4852994702
05009,2016,445,485,150,-7,-40,143,11.981368299,13.058345225,4.0386634716,-0.188470962,-1.076976926,3.8501925096
05009,2017,450,457,205,-7,-7,198,12.068873035,12.25661106,5.4980421606,-0.187738025,-0.187738025,5.3103041356
17007,2010,146,115,-91,-3,31,-94,NA,NA,NA,NA,NA,NA
17007,2011,610,344,-214,-27,266,-241,11.27166562,6.3564802838,-3.954322037,-0.49890979,4.9151853357,-4.453231827
17007,2012,614,365,-595,-43,249,-638,11.382596122,6.7665270105,-11.03036595,-0.797152497,4.6160691113,-11.82751845
17007,2013,527,401,-82,-10,126,-92,9.8008220044,7.4575514683,-1.524985587,-0.185973852,2.3432705362,-1.710959439
17007,2014,584,397,-221,-13,187,-234,10.862085,7.3839858644,-4.110480796,-0.241792988,3.4780991351,-4.352273784
17007,2015,607,401,-363,-5,206,-368,11.31133183,7.472560237,-6.764437322,-0.093174068,3.8387715931,-6.85761139
17007,2016,559,386,-187,-8,173,-195,10.434360592,7.2051219831,-3.490564277,-0.149328953,3.229238609,-3.63989323
17007,2017,562,351,-256,-4,211,-260,10.497314966,6.5561522297,-4.781695074,-0.074713986,3.9411627364,-4.856409059
18011,2010,162,88,176,13,74,189,NA,NA,NA,NA,NA,NA
18011,2011,696,436,677,31,260,708,12.126174941,7.5962820033,11.795144303,0.5401026195,4.5298929377,12.335246923
18011,2012,702,478,838,46,224,884,12.012012012,8.1791192902,14.33912545,0.7871118982,3.8328927218,15.126237348
18011,2013,727,528,1060,37,199,1097,12.186638281,8.8508184493,17.768688553,0.620227808,3.3358198322,18.388916361
18011,2014,757,506,979,49,251,1028,12.418590154,8.3009334449,16.060501665,0.8038453336,4.1176567088,16.864346999
18011,2015,768,537,1134,60,231,1194,12.323590529,8.6168855655,18.196551641,0.9627805101,3.7067049639,19.159332151
18011,2016,800,486,828,59,314,887,12.571105314,7.6369464785,13.011094,0.9271190169,4.9341588359,13.938213017
18011,2017,804,473,1244,60,331,1304,12.358393409,7.2705473662,19.121693284,0.9222681648,5.0878460427,20.043961449
19015,2010,75,85,-24,0,-10,-24,NA,NA,NA,NA,NA,NA
19015,2011,316,289,-12,1,27,-11,12.025268285,10.997792831,-0.456655758,0.0380546465,1.0274754548,-0.418601111
19015,2012,305,289,-163,-2,16,-165,11.636113919,11.025694829,-6.218644488,-0.076302386,0.6104190909,-6.294946874
19015,2013,321,307,144,-10,14,134,12.24723388,11.713086608,5.4940862266,-0.381533766,0.534147272,5.1125524609
19015,2014,272,294,43,-15,-22,28,10.349091601,11.18615048,1.6360696281,-0.570721963,-0.837058879,1.0653476648
19015,2015,286,279,166,-15,7,151,10.849566586,10.584017754,6.2973008858,-0.569033213,0.2655488325,5.7282676732
19015,2016,291,302,6,-15,-11,-9,11.01063226,11.426841727,0.2270233456,-0.567558364,-0.416209467,-0.340535018
19015,2017,291,290,81,-15,1,66,11.001266469,10.963461429,3.0622081924,-0.567075591,0.0378050394,2.4951326012
21015,2010,432,140,176,78,292,254,NA,NA,NA,NA,NA,NA
21015,2011,1480,677,1115,221,803,1336,12.288684447,5.6212428178,9.2580291607,1.8349995018,6.6674416287,11.093028663
21015,2012,1549,671,365,244,878,609,12.670963942,5.4888423532,2.9857339179,1.9959426739,7.1821215889,4.9816765918
21015,2013,1738,784,358,212,954,570,14.045522687,6.3358399231,2.8931513934,1.7132628363,7.7096827635,4.6064142298
21015,2014,1679,774,612,238,905,850,13.392572267,6.1738242614,4.8816284857,1.8984110778,7.2187480059,6.7800395635
21015,2015,1743,844,410,259,899,669,13.722572569,6.6447798326,3.2279143737,2.0390971287,7.0777927364,5.2670115024
21015,2016,1639,935,386,273,704,659,12.757494736,7.2777654536,3.0045106578,2.1249518383,5.4797292827,5.1294624962
21015,2017,1649,929,588,272,720,860,12.690374862,7.1493985732,4.5251306362,2.0932577093,5.5409762892,6.6183883455
29019,2010,494,296,195,128,198,323,NA,NA,NA,NA,NA,NA
29019,2011,2069,942,1063,640,1127,1703,12.570362742,5.72319077,6.458335232,3.8883674021,6.8471719722,10.346702634
29019,2012,2119,953,852,623,1166,1475,12.662350273,5.694771029,5.0912328612,3.7228146391,6.9675792443,8.8140475002
29019,2013,2178,1079,555,608,1099,1163,12.826439662,6.3543289234,3.2684453684,3.5805671783,6.4721107385,6.8490125467
29019,2014,2191,989,-23,692,1202,669,12.748600621,5.7546170765,-0.133828304,4.026486367,6.9939835449,3.8926580629
29019,2015,2044,1115,-30,726,929,696,11.774803993,6.423144057,-0.172820019,4.1822444712,5.3516599363,4.0094244517
29019,2016,2106,976,291,735,1130,1026,12.001709645,5.5620458755,1.6583558912,4.1886308591,6.4396637698,5.8469867502
29019,2017,2073,1056,-29,730,1017,701,11.684600339,5.9522131975,-0.1634604,4.1146928354,5.7323871419,3.9512324351
31011,2010,18,7,-6,0,11,-6,NA,NA,NA,NA,NA,NA
31011,2011,58,70,-95,3,-12,-92,10.623683487,12.821686968,-17.40086088,0.54950087,-2.19800348,-16.85136001
31011,2012,49,61,35,0,-12,35,9.0422587193,11.256689426,6.4587562281,0,-2.214430707,6.4587562281
31011,2013,77,62,-49,2,15,-47,14.221073045,11.45073414,-9.049773756,0.3693785206,2.7703389048,-8.680395235
31011,2014,55,71,-25,3,-16,-22,10.223048327,13.197026022,-4.646840149,0.5576208178,-2.973977695,-4.089219331
31011,2015,68,73,-43,3,-5,-40,12.736467503,13.672972467,-8.053942686,0.5619029781,-0.936504963,-7.492039708
31011,2016,62,53,28,3,9,31,11.615925059,9.9297423888,5.2459016393,0.5620608899,1.6861826698,5.8079625293
31011,2017,65,61,-12,3,4,-9,12.138188609,11.391223156,-2.240896359,0.5602240896,0.7469654528,-1.680672269
54005,2010,71,68,-24,0,3,-24,NA,NA,NA,NA,NA,NA
54005,2011,306,359,-141,-4,-53,-145,12.486228425,14.648875831,-5.753458196,-0.163218672,-2.162647407,-5.916676868
54005,2012,272,304,-14,-3,-32,-17,11.15577065,12.468214256,-0.574194078,-0.123041588,-1.312443606,-0.697235666
54005,2013,267,282,-251,-4,-15,-255,11.022809371,11.642068325,-10.36226649,-0.165135721,-0.619258953,-10.52740221
54005,2014,262,336,-308,-4,-74,-312,10.963031153,14.059459799,-12.88783815,-0.167374521,-3.096428646,-13.05521267
54005,2015,231,343,-355,-4,-112,-359,9.8404651856,14.611599821,-15.12279282,-0.170397666,-4.771134635,-15.29319048
54005,2016,231,321,-351,-4,-90,-355,10.035624294,13.945607785,-15.24893562,-0.173777044,-3.909983491,-15.42271266
54005,2017,220,298,-366,-4,-78,-370,9.746588694,13.202197413,-16.21477937,-0.177210704,-3.455608719,-16.39199008
48033,2010,1,0,4,0,1,4,NA,NA,NA,NA,NA,NA
48033,2011,6,6,-15,0,0,-15,9.3896713615,9.3896713615,-23.4741784,0,0,-23.4741784
48033,2012,3,6,-15,0,-3,-15,4.8154093098,9.6308186196,-24.07704655,0,-4.81540931,-24.07704655
48033,2013,8,4,28,0,4,28,12.698412698,6.3492063492,44.444444444,0,6.3492063492,44.444444444
48033,2014,8,3,13,0,5,13,12.195121951,4.5731707317,19.817073171,0,7.6219512195,19.817073171
48033,2015,5,7,-9,0,-2,-9,7.5642965204,10.590015129,-13.61573374,0,-3.025718608,-13.61573374
48033,2016,10,5,0,0,5,0,15.197568389,7.5987841945,0,0,7.5987841945,0
48033,2017,8,3,8,0,5,8,12.00300075,4.5011252813,12.00300075,0,7.5018754689,12.00300075
48035,2010,49,47,56,-2,2,54,NA,NA,NA,NA,NA,NA
48035,2011,178,255,73,-5,-77,68,9.7448812,13.960363517,3.9964962225,-0.273732618,-4.215482317,3.7227636045
48035,2012,185,246,-74,-3,-61,-77,10.169584696,13.522799109,-4.067833878,-0.164912184,-3.353214413,-4.232746063
48035,2013,199,239,-228,4,-40,-224,11.060163957,13.283312491,-12.67194664,0.2223148534,-2.223148534,-12.44963179
48035,2014,177,264,-64,8,-87,-56,9.949969082,14.840631851,-3.597728934,0.4497161167,-4.890662769,-3.148012817
48035,2015,175,230,195,8,-55,203,9.8372635543,12.928974957,10.961522246,0.4497034768,-3.091711403,11.411225723
48035,2016,201,255,194,8,-54,202,11.206199649,14.21682045,10.815933989,0.4460178965,-3.010620801,11.261951886
48035,2017,200,239,345,8,-39,353,11.008366358,13.154997798,18.989431968,0.4403346543,-2.14663144,19.429766623
22015,2010,435,169,304,60,266,364,NA,NA,NA,NA,NA,NA
22015,2011,1752,942,1469,87,810,1556,14.744371976,7.9276246581,12.362718283,0.7321691563,6.8167473175,13.09488744
22015,2012,1850,934,1774,364,916,2138,15.216756528,7.6824057281,14.591635719,2.9939996628,7.5343507997,17.585635382
22015,2013,1802,968,-286,298,834,12,14.585483316,7.835043202,-2.314899128,2.4120277626,6.7504401141,0.0971286347
22015,2014,1838,1012,-172,308,826,136,14.770111017,8.1324006252,-1.382186668,2.4750784511,6.6377103917,1.0928917836
22015,2015,1836,1024,-349,359,812,10,14.650611639,8.1711472323,-2.784892953,2.8646893129,6.4794644068,0.0797963597
22015,2016,1860,1075,-562,307,785,-255,14.763427973,8.5326263821,-4.460777699,2.4367593482,6.2308015906,-2.024018351
22015,2017,1816,1058,387,241,758,628,14.305633237,8.3344493198,3.0486123693,1.8984898734,5.9711839172,4.9471022427
51023,2010,54,50,47,1,4,48,NA,NA,NA,NA,NA,NA
51023,2011,251,305,-148,1,-54,-147,7.5837689217,9.2153367375,-4.471704384,0.0302142188,-1.631567816,-4.441490165
51023,2012,245,308,189,-1,-63,188,7.4112166495,9.3169580737,5.7172242725,-0.030249864,-1.905741424,5.6869744086
51023,2013,250,331,-42,-2,-81,-44,7.5633811339,10.013916621,-1.27064803,-0.060507049,-2.450535487,-1.33115508
51023,2014,269,323,148,-2,-54,146,8.1436183095,9.7783967062,4.4805037539,-0.060547348,-1.634778397,4.4199564059
51023,2015,238,324,352,-1,-86,351,7.1671635499,9.7569789502,10.600174662,-0.030114133,-2.5898154,10.570060529
51023,2016,227,344,-71,-1,-117,-72,6.8280944503,10.347420665,-2.135659498,-0.030079711,-3.519326214,-2.165739209
51023,2017,228,345,161,-1,-117,160,6.8734738175,10.400651171,4.8536372132,-0.030146815,-3.527177354,4.8234903982
38009,2010,16,11,3,1,5,4,NA,NA,NA,NA,NA,NA
38009,2011,77,96,62,10,-19,72,11.911207363,14.850336453,9.5908422925,1.5469100472,-2.9391290900000002,11.13775234
38009,2012,51,73,119,5,-22,124,7.7922077922,11.15355233,18.181818182,0.7639419404,-3.361344538,18.945760122
38009,2013,77,73,130,0,4,130,11.552021604,10.951916585,19.503413097,0,0.6001050184,19.503413097
38009,2014,84,72,-69,4,12,-65,12.523294819,10.734252702,-10.28699217,0.5963473723,1.789042117,-9.690644801
38009,2015,67,67,42,4,0,46,9.9917977779,9.9917977779,6.263515025,0.5965252405,0,6.8600402655
38009,2016,68,81,-142,5,-13,-137,10.219416892,12.173128945,-21.34054704,0.7514277127,-1.953712053,-20.58911933
38009,2017,65,88,-30,5,-23,-25,9.9168510184,13.42589061,-4.577008162,0.7628346937,-3.509039591,-3.814173469
08013,2010,768,346,715,157,422,872,NA,NA,NA,NA,NA,NA
08013,2011,2999,1507,2364,704,1492,3068,10.056199367,5.0532485648,7.9269274103,2.3606416653,5.0029508021,10.287569076
08013,2012,2962,1578,2444,659,1384,3103,9.7829066661,5.2118253609,8.072053981,2.176548107,4.5710813051,10.248602088
08013,2013,2957,1671,2732,678,1286,3410,9.619748299,5.4361174865,8.8877755674,2.2056778311,4.1836308125,11.093453399
08013,2014,2941,1701,783,778,1240,1561,9.4527315212,5.4672207812,2.516657185,2.5005865772,3.98551074,5.0172437622
08013,2015,2866,1788,3482,861,1078,4343,9.0915867928,5.6719320256,11.045675231,2.7312827036,3.4196547671,13.776957935
08013,2016,2830,1783,1293,862,1047,2155,8.8556359238,5.579363552,4.0460555652,2.6973703768,3.2762723718,6.743425942
08013,2017,2840,1853,-504,863,987,359,8.8241645396,5.7574566521,-1.565978496,2.681427464,3.0667078875,1.1154489682
16021,2010,28,43,40,1,-15,41,NA,NA,NA,NA,NA,NA
16021,2011,116,96,-209,2,20,-207,10.633909337,8.8004766925,-19.15937113,0.1833432644,1.8334326443,-18.97602787
16021,2012,127,97,-43,5,30,-38,11.74566474,8.9710982659,-3.976878613,0.4624277457,2.774566474,-3.514450867
16021,2013,127,104,3,4,23,7,11.735353909,9.6100535945,0.2772130845,0.3696174459,2.1253003142,0.6468305304
16021,2014,120,114,94,4,6,98,11.020295711,10.469280926,8.6325649738,0.3673431904,0.5510147856,8.9999081642
16021,2015,139,114,290,4,25,294,12.51970277,10.267957667,26.120243188,0.3602792164,2.2517451025,26.480522405
16021,2016,156,103,330,4,53,334,13.616129877,8.9901370341,28.803351663,0.3491315353,4.6259928428,29.152483198
16021,2017,161,126,233,4,35,237,13.660274902,10.690649924,19.769217716,0.3393857119,2.9696249788,20.108603428
20011,2010,43,66,-14,0,-23,-14,NA,NA,NA,NA,NA,NA
20011,2011,217,183,-241,9,34,-232,14.429630615,12.168766832,-16.02553446,0.5984639425,2.260863783,-15.42707052
20011,2012,198,181,-99,15,17,-84,13.281905081,12.141539494,-6.640952541,1.0062049304,1.1403655878,-5.63474761
20011,2013,205,180,-88,17,25,-71,13.803784257,12.120395933,-5.925526901,1.1447040603,1.683388324,-4.78082284
20011,2014,233,200,-97,29,33,-68,15.731550874,13.503477145,-6.549186416,1.9580041861,2.228073729,-4.591182229
20011,2015,210,201,-97,29,9,-68,14.222824247,13.613274636,-6.569590247,1.9641043007,0.6095496106,-4.605485946
20011,2016,217,170,-137,28,47,-109,14.75788901,11.561479869,-9.317192601,1.9042437432,3.1964091404,-7.412948857
20011,2017,204,145,-6,28,59,22,13.8652892,9.8552300686,-0.407802624,1.9030789098,4.0100591314,1.4952762863
21017,2010,47,76,-24,3,-29,-21,NA,NA,NA,NA,NA,NA
21017,2011,221,199,2,30,22,32,11.0743636,9.9719382642,0.1002204851,1.503307276,1.1024253357,1.6035277611
21017,2012,246,199,-78,12,47,-66,12.316627447,9.9634506584,-3.905272117,0.600811095,2.3531767887,-3.304461022
21017,2013,235,199,-81,10,36,-71,11.78210624,9.9771878369,-4.061066406,0.501366223,1.8049184026,-3.559700183
21017,2014,217,187,11,11,30,22,10.876102646,9.3724939856,0.5513231756,0.5513231756,1.5036086608,1.1026463512
21017,2015,228,218,94,16,10,110,11.380368864,10.881229878,4.6919064614,0.7986223764,0.4991389853,5.4905288378
21017,2016,210,225,-40,20,-15,-20,10.460772105,11.207970112,-1.99252802,0.99626401,-0.747198007,-0.99626401
21017,2017,204,229,-22,20,-25,-2,10.178117048,11.425435314,-1.097640074,0.9978546126,-1.247318266,-0.099785461
48037,2010,302,274,48,1,28,49,NA,NA,NA,NA,NA,NA
48037,2011,1211,971,17,28,240,45,13.053648231,10.466632892,0.1832469198,0.3018184562,2.5870153388,0.485065376
48037,2012,1223,921,-121,35,302,-86,13.149053064,9.9021078265,-1.30092839,0.3763016004,3.2469452374,-0.924626789
48037,2013,1197,1008,128,37,189,165,12.831644959,10.805595755,1.3721391435,0.3966339712,2.0260492041,1.7687731146
48037,2014,1213,976,-310,54,237,-256,12.981314612,10.444981914,-3.317565977,0.5778985895,2.5363326984,-2.739667387
48037,2015,1220,1034,-275,68,186,-207,13.060140878,11.069004646,-2.943884214,0.7279422785,1.9911362323,-2.215941936
48037,2016,1282,1018,150,68,264,218,13.690657354,10.87136442,1.6018709853,0.7261815133,2.8192929341,2.3280524987
48037,2017,1244,981,-197,69,263,-128,13.241578984,10.44211333,-2.096938151,0.7344605706,2.7994656533,-1.36247758
38011,2010,11,21,0,2,-10,2,NA,NA,NA,NA,NA,NA
38011,2011,39,47,9,0,-8,9,12.410501193,14.956245028,2.8639618138,0,-2.545743835,2.8639618138
38011,2012,43,44,70,0,-1,70,13.536911695,13.851723595,22.036832992,0,-0.3148119,22.036832992
38011,2013,45,54,12,0,-9,12,14.005602241,16.806722689,3.7348272642,0,-2.801120448,3.7348272642
38011,2014,41,46,30,0,-5,30,12.703330751,14.252517428,9.295120062,0,-1.549186677,9.295120062
38011,2015,48,45,36,0,3,36,14.72392638,13.803680982,11.042944785,0,0.9202453988,11.042944785
38011,2016,40,24,-65,0,16,-65,12.288786482,7.3732718894,-19.96927803,0,4.9155145929,-19.96927803
38011,2017,39,24,-80,0,15,-80,12.195121951,7.5046904315,-25.01563477,0,4.6904315197,-25.01563477
31013,2010,25,18,-44,0,7,-44,NA,NA,NA,NA,NA,NA
31013,2011,143,119,0,-5,24,-5,12.672249546,10.545438433,0,-0.443085648,2.1268111126,-0.443085648
31013,2012,135,126,-38,1,9,-37,11.968085106,11.170212766,-3.368794326,0.0886524823,0.7978723404,-3.280141844
31013,2013,178,123,-31,7,55,-24,15.778743019,10.903288716,-2.747983335,0.6205123659,4.8754543037,-2.127470969
31013,2014,149,114,-39,8,35,-31,13.187591273,10.089834934,-3.451785635,0.7080585918,3.0977563393,-2.743727043
31013,2015,184,111,-54,8,73,-46,16.26375569,9.8112874,-4.773058735,0.7071198126,6.4524682901,-4.065938923
31013,2016,152,107,-187,8,45,-179,13.499711355,9.5030862827,-16.60819752,0.7105111239,3.9966250722,-15.8976864
31013,2017,157,104,-369,8,53,-361,14.222302745,9.4211432195,-33.42694085,0.7247033246,4.8011595253,-32.70223752
49003,2010,227,66,27,7,161,34,NA,NA,NA,NA,NA,NA
49003,2011,907,330,-537,24,577,-513,18.066469469,6.5732468852,-10.69646539,0.4780543189,11.493222584,-10.21841107
49003,2012,853,321,-594,13,532,-581,16.985095728,6.3918121086,-11.82783923,0.2588584343,10.593283619,-11.56898079
49003,2013,859,375,59,-5,484,54,17.020855006,7.430524595,1.169069203,-0.099073661,9.5903304107,1.0699955417
49003,2014,861,350,69,-6,511,63,16.876396566,6.8603238073,1.3524638363000001,-0.117605551,10.016072759,1.2348582853
49003,2015,902,404,33,-5,498,28,17.493672605,7.8353034726,0.6400124124,-0.096971578,9.658369132,0.5430408347
49003,2016,891,334,599,-3,557,596,17.004628083,6.3743499213,11.431843122,-0.05725464,10.630278162,11.374588482
49003,2017,908,340,541,-3,568,538,16.963560106,6.3519938722,10.107143191,-0.056047005,10.611566234,10.051096186
21019,2010,129,116,59,-2,13,57,NA,NA,NA,NA,NA,NA
21019,2011,575,606,-143,-12,-31,-155,11.613346259,12.239457101,-2.888188722,-0.242365487,-0.626110842,-3.130554209
21019,2012,591,567,-177,-7,24,-184,11.979325023,11.492854971,-3.587716631,-0.141887098,0.4864700517,-3.72960373
21019,2013,576,611,-302,-8,-35,-310,11.73594132,12.449062755,-6.153219234,-0.162999185,-0.713121434,-6.316218419
21019,2014,625,582,-106,0,43,-106,12.788116259,11.908293861,-2.168864518,0,0.8798223986,-2.168864518
21019,2015,641,627,-348,2,14,-346,13.169383751,12.881752905,-7.149681038,0.0410901209,0.2876308464,-7.108590917
21019,2016,596,589,-323,4,7,-319,12.326401456,12.181628285,-6.680247769,0.0827275266,0.1447731715,-6.597520242
21019,2017,565,574,-209,4,-9,-205,11.749415129,11.936573954,-4.346243826,0.0831817,-0.187158825,-4.263062126
31015,2010,4,6,9,0,-2,9,NA,NA,NA,NA,NA,NA
31015,2011,21,21,-27,0,0,-27,10.040640689,10.040640689,-12.90939517,0,0,-12.90939517
31015,2012,24,34,-8,1,-10,-7,11.59980667,16.433059449,-3.866602223,0.4833252779,-4.833252779,-3.383276945
31015,2013,15,35,-26,1,-20,-25,7.3601570167,17.173699706,-12.7576055,0.4906771344,-9.813542689,-12.26692836
31015,2014,13,31,23,1,-18,24,6.440426059,15.357939064,11.39459995,0.4954173892,-8.917513005,11.89001734
31015,2015,16,36,0,1,-20,1,7.9542629878,17.897091723,0,0.4971414367,-9.942828735,0.4971414367
31015,2016,19,30,-12,1,-11,-11,9.5429432446,15.067805123,-6.027122049,0.5022601708,-5.524861878,-5.524861878
31015,2017,18,24,2,1,-6,3,9.0978013647,12.13040182,1.0108668183,0.5054334091,-3.032600455,1.5163002274
21021,2010,83,58,182,1,25,183,NA,NA,NA,NA,NA,NA
21021,2011,302,322,142,-4,-20,138,10.522098148,11.21892584,4.9474766127,-0.139365538,-0.696827692,4.8081110743
21021,2012,292,328,252,0,-36,252,10.114655859,11.361668225,8.7290865634,0,-1.247012366,8.7290865634
21021,2013,302,265,539,9,37,548,10.314736069,9.0510101269,18.409413051,0.3073927968,1.2637259422,18.716805847
21021,2014,340,310,140,17,30,157,11.459579703,10.448440317,4.718650466,0.5729789852,1.0111393856,5.2916294511
21021,2015,324,335,-49,17,-11,-32,10.895517369,11.265426909,-1.647778861,0.5716783805,-0.36990954,-1.076100481
21021,2016,301,304,161,17,-3,178,10.100332204,10.200999966,5.4025032717,0.570450656,-0.100667763,5.9729539277
21021,2017,315,312,16,17,3,33,10.533003411,10.432689092,0.5350096971,0.5684478031,0.1003143182,1.1034575002
21023,2010,24,7,8,1,17,9,NA,NA,NA,NA,NA,NA
21023,2011,101,90,-22,2,11,-20,11.86908749,10.576414595,-2.58534579,0.2350314355,1.292672895,-2.350314355
21023,2012,100,87,-68,0,13,-68,11.795234725,10.261854211,-8.020759613,0,1.5333805143,-8.020759613
21023,2013,114,85,-71,2,29,-69,13.522329636,10.082438764,-8.421801791,0.2372338533,3.4398908724,-8.184567938
21023,2014,105,106,-66,3,-1,-63,12.532076147,12.651429253,-7.877305007,0.3580593185,-0.119353106,-7.519245688
21023,2015,108,112,-68,3,-4,-65,12.992481203,13.473684211,-8.180451128,0.3609022556,-0.481203008,-7.819548872
21023,2016,91,93,71,3,-2,74,10.945393312,11.185951407,8.5398123647,0.3608371422,-0.240558095,8.9006495069
21023,2017,98,103,-79,3,-5,-76,11.795149546,12.39694289,-9.508334838,0.3610760065,-0.601793344,-9.147258831
12007,2010,84,90,20,0,-6,20,NA,NA,NA,NA,NA,NA
12007,2011,315,269,-158,9,46,-149,11.058840051,9.4438983289,-5.54697374,0.3159668586,1.6149417217,-5.231006881
12007,2012,326,269,-1511,15,57,-1496,11.751559064,9.6968386143,-54.46811579,0.5407159079,2.0547204499,-53.92739988
12007,2013,321,291,-278,1,30,-277,11.920677362,10.806595365,-10.3238265,0.0371360665,1.1140819964,-10.28669043
12007,2014,301,302,-247,1,-1,-246,11.280802024,11.318279771,-9.257003654,0.0374777476,-0.037477748,-9.219525906
12007,2015,285,283,182,1,2,183,10.693581975,10.618539294,6.8288839277,0.0375213403,0.0750426805,6.866405268
12007,2016,295,296,-15,1,-1,-14,11.033812089,11.071214841,-0.561041293,0.0374027528,-0.037402753,-0.52363854
12007,2017,293,329,347,1,-36,348,10.899081204,12.238217461,12.907785589,0.0371982294,-1.339136257,12.944983819
42015,2010,181,159,-1,2,22,1,NA,NA,NA,NA,NA,NA
42015,2011,721,717,327,14,4,341,11.4633681,11.399771051,5.1990587637,0.2225896718,0.0635970491,5.4216484355
42015,2012,731,623,-225,21,108,-204,11.599768322,9.8859858613,-3.570380126,0.3332354785,1.7137824607,-3.237144648
42015,2013,739,678,-579,18,61,-561,11.782149804,10.809604286,-9.231210739,0.2869806447,0.9725455183,-8.944230095
42015,2014,700,613,-720,23,87,-697,11.258453893,9.8591889088,-11.580124,0.3699206279,1.3992649838,-11.21020338
42015,2015,684,735,-305,24,-51,-281,11.084552121,11.911031884,-4.942673095,0.3889316534,-0.826479763,-4.553741441
42015,2016,707,714,-569,24,-7,-545,11.540501938,11.654764334,-9.287900428,0.3917567843,-0.114262395,-8.896143644
42015,2017,694,706,-142,24,-12,-118,11.392082995,11.589064257,-2.330944936,0.3939625243,-0.196981262,-1.936982411
05011,2010,34,59,-13,6,-25,-7,NA,NA,NA,NA,NA,NA
05011,2011,148,152,-40,-2,-4,-42,12.927457746,13.276848495,-3.493907499,-0.17469537500000001,-0.34939075000000003,-3.668602874
05011,2012,129,147,-144,-3,-18,-147,11.372151452,12.958963283,-12.69449464,-0.264468638,-1.586811831,-12.95896328
05011,2013,153,157,-139,0,-4,-139,13.671700474,14.029130551,-12.4206952,0,-0.357430078,-12.4206952
05011,2014,120,167,-65,-2,-47,-67,10.846477155,15.094680707,-5.875175125,-0.180774619,-4.248203552,-6.055949745
05011,2015,135,142,-2,2,-7,0,12.26993865,12.906157691,-0.181776869,0.1817768689,-0.636219041,0
05011,2016,135,125,-33,4,10,-29,12.285571279,11.375528962,-3.003139646,0.3640169268,0.910042317,-2.639122719
05011,2017,135,134,-121,4,1,-117,12.360939431,12.269376917,-11.07906423,0.3662500572,0.0915625143,-10.71281417
47011,2010,296,196,55,17,100,72,NA,NA,NA,NA,NA,NA
47011,2011,1094,952,528,75,142,603,10.998622659,9.571013502,5.3082932028,0.7540189208,1.4276091568,6.0623121236
47011,2012,1198,939,874,79,259,953,11.926390873,9.3479808262,8.7008895017,0.7864648405,2.5784100468,9.4873543422
47011,2013,1182,957,374,93,225,467,11.656344917,9.4374975346,3.6882174273,0.9171235849,2.2188473827,4.6053410122
47011,2014,1224,968,691,129,256,820,11.9669735,9.4640770814,6.7558649414,1.2612251482,2.5028964182,8.0170900896
47011,2015,1203,1086,729,145,117,874,11.644677618,10.512152862,7.0565004017,1.4035563213,1.1325247558,8.460056723
47011,2016,1174,994,274,154,180,428,11.277130191,9.5480983051,2.6319707601,1.479282836,1.7290318862,4.1112535961
47011,2017,1163,1012,846,154,151,1000,11.077931294,9.639610034,8.0584091786,1.4668971791,1.43832126,9.5253063577
26023,2010,132,77,-136,7,55,-129,NA,NA,NA,NA,NA,NA
26023,2011,549,434,-1469,37,115,-1432,12.324338886,9.742737844,-32.97714722,0.8306020743,2.5816010416,-32.14654514
26023,2012,478,447,-213,37,31,-176,10.903035971,10.195935312,-4.85846582,0.8439588513,0.7071006592,-4.014506968
26023,2013,553,450,-358,39,103,-319,12.665620741,10.30656299,-8.199443446,0.8932354592,2.3590577511,-7.306207986
26023,2014,550,419,-29,43,131,14,12.608316904,9.6052450598,-0.664802164,0.9857411398,3.0030718445,0.3209389757
26023,2015,519,475,-177,49,44,-128,11.890851605,10.882763993,-4.05526153,1.1226430224,1.008087612,-2.932618508
26023,2016,531,421,-306,50,110,-256,12.19834369,9.6713798371,-7.029553991,1.1486199332,2.5269638529,-5.880934058
26023,2017,507,407,-194,50,100,-144,11.673017371,9.3706470812,-4.466598363,1.1511851451,2.3023702902,-3.315413218
13025,2010,50,20,22,-1,30,21,NA,NA,NA,NA,NA,NA
13025,2011,192,185,84,-11,7,73,10.378097889,9.999729737,4.5404178265,-0.594578525,0.3783681522,3.9458393016
13025,2012,188,183,-24,-13,5,-37,10.148721963,9.8788091446,-1.295581527,-0.701773327,0.2699128182,-1.997354854
13025,2013,225,190,-291,-21,35,-312,12.246230882,10.341261634,-15.83845861,-1.142981549,1.9049692484,-16.98144016
13025,2014,199,172,99,-23,27,76,10.882047356,9.4055886695,5.4136818505,-1.257724066,1.4764586865,4.1559577842
13025,2015,217,177,41,-23,40,18,11.815954261,9.6378981759,2.2325074871,-1.252382249,2.1780560849,0.9801252382
13025,2016,239,194,-61,-23,45,-84,13.007510613000001,10.558397736,-3.319908566,-1.251768804,2.4491128769,-4.57167737
13025,2017,223,196,371,-23,27,348,12.026101494,10.570026425,20.007550019,-1.240360244,1.4560750688,18.767189775
54007,2010,35,19,9,1,16,10,NA,NA,NA,NA,NA,NA
54007,2011,170,162,-23,2,8,-21,11.693895099,11.143594153,-1.582115219,0.1375752365,0.5503009458,-1.444539983
54007,2012,152,175,-58,2,-23,-56,10.490355085,12.077711446,-4.002898651,0.138030988,-1.587356362,-3.864867663
54007,2013,167,184,-46,-2,-17,-48,11.584752523,12.764038708,-3.191009677,-0.138739551,-1.179286185,-3.329749228
54007,2014,153,184,53,-2,-31,51,10.631644778,12.785768883,3.6828573414,-0.138975749,-2.154124105,3.5438815927
54007,2015,177,169,-38,-2,8,-40,12.306194813,11.749982618,-2.642007926,-0.139053049,0.556212195,-2.781060975
54007,2016,157,182,2,-2,-25,0,10.938098722,12.679834187,0.1393388372,-0.139338837,-1.741735465,0
54007,2017,166,176,-91,-2,-10,-93,11.617328015,12.317167052,-6.368535237,-0.139967807,-0.699839037,-6.508503044
48039,2010,1203,503,515,94,700,609,NA,NA,NA,NA,NA,NA
48039,2011,4699,1967,1714,380,2732,2094,14.829729521,6.2077203591,5.409269291,1.1992545686,8.6220091617,6.6085238596
48039,2012,4502,1958,2159,458,2544,2617,13.987730443,6.0835131512,6.7080208853,1.4230076727,7.9042172914,8.131028558
48039,2013,4549,2134,2826,469,2415,3295,13.898500312,6.5199823404,8.6342409063,1.4329295772,7.378517972,10.067170483
48039,2014,4764,2252,4446,581,2512,5027,14.264498048,6.742999497,13.31233382,1.7396459626,7.5214985508,15.051979783
48039,2015,4881,2147,4507,681,2734,5188,14.281952247,6.2821863296,13.187617041,1.9926264045,7.9997659176000004,15.180243446
48039,2016,4916,2414,4889,697,2502,5586,14.054428031,6.9014217386,13.977237316,1.9926640231,7.1530062925,15.969901339
48039,2017,4982,2459,5401,701,2523,6102,13.910664051,6.8659821161,15.08058943,1.9573214572,7.0446819353,17.037910887
48041,2010,669,227,77,300,442,377,NA,NA,NA,NA,NA,NA
48041,2011,2611,825,-1173,1193,1786,20,13.282293243,4.1968180489,-5.967112208,6.0688532513,9.0854751943,0.1017410436
48041,2012,2588,869,-157,1230,1719,1073,13.012806653,4.3694470563,-0.789416787,6.184602853,8.6433595969,5.395186066
48041,2013,2632,925,938,1238,1707,2176,13.016171307,4.5744523021,4.638741902,6.122348054,8.441719005,10.761089956
48041,2014,2703,932,1395,1385,1771,2780,13.093678171,4.5147273604,6.7575586563,6.7091173756,8.5789508103,13.466676032
48041,2015,2896,1079,3756,1524,1817,5280,13.640720565,5.0822988571,17.691487032,7.1783349937,8.5584217083,24.869822025
48041,2016,2866,1011,252,1557,1855,1809,13.163333731,4.6434509429,1.1574180392,7.1511900278,8.5198827885,8.308608067
48041,2017,2910,1039,-151,1548,1871,1397,13.155783006,4.6972022487,-0.682654032,6.9983340529,8.4585807577,6.3156800206
21025,2010,38,68,10,0,-30,10,NA,NA,NA,NA,NA,NA
21025,2011,170,169,-77,4,1,-73,12.300567997,12.228211714,-5.57143374,0.2894251293,0.0723562823,-5.28200861
21025,2012,166,182,-165,1,-16,-164,12.119884642,13.288066294,-12.04687329,0.0730113533,-1.168181652,-11.97386194
21025,2013,178,199,-63,0,-21,-63,13.121037889,14.669025505,-4.643962848,0,-1.547987616,-4.643962848
21025,2014,181,218,-126,1,-37,-125,13.46425649,16.216618314,-9.372907833,0.0743881574,-2.752361824,-9.298519676
21025,2015,181,187,7,1,-6,8,13.546383265,13.995434644,0.5238932755,0.0748418965,-0.449051379,0.5987351719
21025,2016,159,189,-142,0,-30,-142,11.97740113,14.237288136,-10.69679849,0,-2.259887006,-10.69679849
21025,2017,155,193,-206,0,-38,-206,11.861488425,14.769466233,-15.76430075,0,-2.907977808,-15.76430075
21027,2010,45,70,17,0,-25,17,NA,NA,NA,NA,NA,NA
21027,2011,206,210,232,-2,-4,230,10.224339885,10.422870756,11.51479055,-0.099265436,-0.198530872,11.415525114
21027,2012,232,253,-171,-1,-21,-172,11.503656874,12.54493616,-8.478988472,-0.049584728,-1.041279286,-8.528573199
21027,2013,215,223,-18,-3,-8,-21,10.719984045,11.118867172,-0.897487036,-0.149581173,-0.398883127,-1.047068209
21027,2014,223,217,-165,-2,6,-167,11.172904454,10.872288191,-8.266947242,-0.100205421,0.3006162633,-8.367152663
21027,2015,224,241,114,-2,-17,112,11.242440212,12.095661121,5.7215990364,-0.10037893,-0.853220909,5.6212201059
21027,2016,244,229,-29,-2,15,-31,12.222917971,11.47150908,-1.452723857,-0.100187852,0.7514088917,-1.552911709
21027,2017,236,200,124,-2,36,122,11.780856109,9.9837763634,6.1899413453,-0.099837764,1.7970797454,6.0901035817
19017,2010,48,40,11,2,8,13,NA,NA,NA,NA,NA,NA
19017,2011,230,210,60,6,20,66,9.4512132481,8.6293686179,2.4655338908,0.2465533891,0.8218446303,2.7120872799
19017,2012,263,196,43,9,67,52,10.763910205,8.0217733849,1.7598788549,0.3683467371,2.7421368203,2.1282255919
19017,2013,243,216,21,37,27,58,9.9054296429,8.8048263493,0.856024784,1.5082341432,1.1006032937,2.3642589271
19017,2014,262,204,-1,43,58,42,10.640242045,8.2847686153,-0.040611611,1.746299267,2.3554734299,1.7056876561
19017,2015,267,228,5,45,39,50,10.802063315,9.2242338424,0.2022858299,1.8205724689,1.577829473,2.0228582988
19017,2016,278,214,-87,46,64,-41,11.222121304,8.6386113634,-3.511958825,1.8568977697,2.5835099405,-1.655061056
19017,2017,267,214,29,46,53,75,10.745547842,8.6125364725,1.1671194285,1.8512928866,2.1330113694,3.0184123151
12009,2010,1167,1360,602,232,-193,834,NA,NA,NA,NA,NA,NA
12009,2011,5046,6196,688,1007,-1150,1695,9.272198564,11.38536312,1.2642236647,1.8503971371,-2.113164556,3.1146208018
12009,2012,5120,6112,2683,1224,-992,3907,9.3795913283,11.196887148,4.9151256902,2.2423085519,-1.81729582,7.1574342421
12009,2013,5012,6552,3903,1114,-1540,5017,9.1289352824,11.933915397,7.1089853167,2.029057044,-2.804980115,9.1380423607
12009,2014,5236,6521,5417,1354,-1285,6771,9.4595363635,11.781061235,9.786537143,2.4461826272,-2.321524871,12.23271977
12009,2015,5200,6998,10760,1463,-1798,12223,9.260091942,12.46194681,19.161267172,2.6052912522,-3.201854868,21.766558425
12009,2016,5279,7339,11669,1464,-2060,13133,9.2232081005,12.822338369,20.387500535,2.5578285014,-3.599130268,22.945329037
12009,2017,5309,7208,11689,1437,-1899,13126,9.0980677103,12.352396319,20.031515062,2.4625962139,-3.254328608,22.494111276
48043,2010,25,43,40,2,-18,42,NA,NA,NA,NA,NA,NA
48043,2011,136,85,39,2,51,41,14.61422738,9.1338921126,4.1908446164,0.2149151085,5.4803352676,4.4057597249
48043,2012,100,66,-124,-1,34,-125,10.744600838,7.0914365531,-13.32330504,-0.107446008,3.6531642849,-13.43075105
48043,2013,125,61,-36,-1,64,-37,13.47563605,6.5761103924,-3.880983182,-0.107805088,6.8995256576,-3.988788271
48043,2014,102,66,-178,-1,36,-179,11.062906725,7.15835141,-19.30585683,-0.10845987,3.9045553145,-19.4143167
48043,2015,104,69,-51,-1,35,-52,11.377311016,7.5484082704,-5.579258287,-0.109397221,3.8289027459,-5.688655508
48043,2016,95,82,48,-1,13,47,10.36834925,8.9495225102,5.238744884,-0.109140518,1.4188267394,5.1296043656
48043,2017,99,76,122,-1,23,121,10.685375067,8.2029141932,13.167835942,-0.107933081,2.4824608743,13.05990286
48045,2010,7,10,-2,0,-3,-2,NA,NA,NA,NA,NA,NA
48045,2011,19,21,26,0,-2,26,11.553663728,12.769838857,15.81027668,0,-1.216175129,15.81027668
48045,2012,12,13,-86,0,-1,-86,7.4303405573,8.0495356037,-53.25077399,0,-0.619195046,-53.25077399
48045,2013,10,15,-9,2,-5,-7,6.3856960409,9.5785440613,-5.747126437,1.2771392082,-3.19284802,-4.469987229
48045,2014,11,24,1,2,-13,3,7.0785070785,15.444015444,0.6435006435,1.287001287,-8.365508366,1.9305019305
48045,2015,13,19,-32,2,-6,-30,8.4911822338,12.410189419,-20.90137165,1.3063357283,-3.919007185,-19.59503592
48045,2016,9,17,-20,2,-8,-18,6.0020006669,11.337112371,-13.33777926,1.333777926,-5.335111704,-12.00400133
48045,2017,12,9,37,2,3,39,7.9628400796,5.9721300597,24.552090246,1.3271400133,1.9907100199,25.879230259
02060,2010,3,3,5,0,0,5,NA,NA,NA,NA,NA,NA
02060,2011,16,8,21,0,8,21,15.748031496,7.874015748,20.669291339,0,7.874015748,20.669291339
02060,2012,8,10,-51,0,-2,-51,7.960199005,9.9502487562,-50.74626866,0,-1.990049751,-50.74626866
02060,2013,14,7,-35,0,7,-35,14.492753623,7.2463768116,-36.23188406,0,7.2463768116,-36.23188406
02060,2014,5,8,0,0,-3,0,5.2603892688,8.4166228301,0,0,-3.156233561,0
02060,2015,10,6,-50,0,4,-50,10.793308149,6.4759848894,-53.96654074,0,4.3173232596,-53.96654074
02060,2016,12,6,-4,0,6,-4,13.266998342,6.6334991708,-4.422332781,0,6.6334991708,-4.422332781
02060,2017,10,8,-40,0,2,-40,11.286681716,9.0293453725,-45.14672686,0,2.2573363431,-45.14672686
51520,2010,70,29,-8,-3,41,-11,NA,NA,NA,NA,NA,NA
51520,2011,177,269,29,11,-92,40,9.9737976502,15.157918463,1.6341250387,0.6198405319,-5.184120813,2.2539655707
51520,2012,199,243,30,-2,-44,28,11.235637862,13.7198995,1.6938147531,-0.112920984,-2.484261638,1.5808937696
51520,2013,181,247,-241,-3,-66,-244,10.313390313,14.074074074,-13.73219373,-0.170940171,-3.760683761,-13.9031339
51520,2014,182,280,-84,-1,-98,-85,10.517191563,16.180294713,-4.854088414,-0.057786767,-5.663103149,-4.911875181
51520,2015,197,320,-28,-1,-123,-29,11.496936096,18.675226145,-1.634082288,-0.058360082,-7.17829005,-1.692442369
51520,2016,141,263,-8,-1,-122,-9,8.2977784317,15.477416507,-0.470795939,-0.058849492,-7.179638076,-0.529645432
51520,2017,152,231,-57,-1,-79,-58,9.0162232702,13.70228668,-3.381083726,-0.059317258,-4.68606341,-3.440400985
25005,2010,1477,1091,387,166,386,553,NA,NA,NA,NA,NA,NA
25005,2011,5828,5110,-1446,949,718,-497,10.610350007,9.3031723636,-2.632561103,1.7277320104,1.3071776433,-0.904829093
25005,2012,5800,4918,8,1079,882,1087,10.539533244,8.9367973266,0.0145372872,1.9607166156,1.6027359175,1.9752539028
25005,2013,5647,5132,-274,1228,515,954,10.230962113,9.2979099632,-0.496419979,2.2248311447,0.9330521495,1.7284111662
25005,2014,5559,5188,1047,1424,371,2471,10.033888515,9.364240622,1.8898149443,2.5702927228,0.6696478934,4.4601076671
25005,2015,5664,5436,191,1518,228,1709,10.181282187,9.7714424382,0.343330667,2.7286699082,0.4098397491,3.0720005752
25005,2016,5611,5215,-899,1582,396,683,10.059602833,9.3496397744,-1.61175957,2.8362665624,0.7099630586,1.2245069925
25005,2017,5627,5271,1266,1583,356,2849,10.050053804,9.4142231391,2.2611281529,2.8273032117,0.6358306654,5.0884313647
44001,2010,106,145,1,5,-39,6,NA,NA,NA,NA,NA,NA
44001,2011,361,472,-542,29,-111,-513,7.2914562715,9.5334275904,-10.94728338,0.5857402545,-2.241971319,-10.36154312
44001,2012,342,444,49,62,-102,111,6.949383293,9.0220063804,0.9956718753,1.2598297198,-2.072623087,2.2555015951
44001,2013,345,482,64,70,-137,134,7.0106989362,9.7946576442,1.3005354548,1.4224606537,-2.783958708,2.7229961086
44001,2014,356,521,-74,82,-165,8,7.2465243145,10.605166202,-1.506299998,1.669143241,-3.358641887,0.162843243
44001,2015,345,529,153,88,-184,241,7.0305574519,10.780188093,3.1178993917,1.7933016109,-3.749630641,4.9112010026
44001,2016,331,548,-89,89,-217,0,6.7568946863,11.186641354,-1.816808541,1.816808541,-4.429746667,0
44001,2017,351,529,127,88,-178,215,7.1786481235,10.819102158,2.5974025974,1.7997750281,-3.640454034,4.3971776255
30007,2010,13,6,16,0,7,16,NA,NA,NA,NA,NA,NA
30007,2011,51,54,97,-4,-3,93,8.9741333803,9.5020235791,17.068449762,-0.703853598,-0.527890199,16.364596164
30007,2012,53,55,41,-6,-2,35,9.2238078663,9.5718760877,7.1353985381,-1.044204664,-0.348068221,6.091193874
30007,2013,56,65,-73,-1,-9,-74,9.7867878364,11.359664453,-12.757777,-0.174764069,-1.572876617,-12.93254107
30007,2014,48,50,-20,-1,-2,-21,8.4671017816,8.8198976892,-3.527959076,-0.176397954,-0.352795908,-3.704357029
30007,2015,43,47,64,-1,-4,63,7.5624340485,8.2659162856,11.255715793,-0.175870559,-0.703482237,11.079845234
30007,2016,51,55,79,-1,-4,78,8.8672520212,9.562722768,13.735547249,-0.173867687,-0.695470747,13.561679562
30007,2017,53,58,153,-1,-5,152,9.0412828386,9.8942340498,26.100307062,-0.170590242,-0.852951211,25.92971682
36005,2010,5430,2167,-3407,3345,3263,-62,NA,NA,NA,NA,NA,NA
36005,2011,22098,8894,-17006,16270,13204,-736,15.846420662,6.3778652079,-12.19496017,11.667176403,9.4685554537,-0.527783764
36005,2012,21737,8946,-12366,16459,12791,4093,15.423077428,6.3474651824,-8.7740615300000009,11.678172305,9.0756122455,2.9041107748
36005,2013,21401,9261,-14103,16888,12140,2785,15.014320818,6.4972489647,-9.894255712,11.848130927,8.5170718531,1.9538752151
36005,2014,21294,9165,-16530,17166,12129,636,14.794275573,6.3674995597,-11.48442637,11.926295411,8.426776013,0.4418690365
36005,2015,21602,9360,-16513,18784,12242,2271,14.866086851,6.4413745453,-11.36393353,12.926792677,8.4247123059,1.5628591445
36005,2016,21182,10181,-22039,19580,11001,-2459,14.461723746,6.9509399233,-15.04682889,13.367979933,7.5107838224,-1.678848961
36005,2017,21092,10612,-27949,19568,10480,-8381,14.34763562,7.2187136922,-19.0120457,13.310948881,7.1289219274,-5.70109682
54009,2010,56,107,-22,1,-51,-21,NA,NA,NA,NA,NA,NA
54009,2011,191,365,14,-6,-174,8,7.9871202459,15.263344973,0.5854433688,-0.250904301,-7.276224727,0.3345390679
54009,2012,166,327,29,-2,-161,27,6.9866790126,13.762915886,1.2205644058,-0.084176856,-6.776236874,1.1363875502
54009,2013,203,328,49,-6,-125,43,8.5844169574,13.87038799,2.0721006449,-0.25372661,-5.285971033,1.8183740353
54009,2014,182,302,-91,-7,-120,-98,7.7469884646,12.854892947,-3.873494232,-0.297961095,-5.107904482,-4.171455327
54009,2015,211,344,-41,-7,-133,-48,9.0592932893,14.769653514,-1.760336611,-0.300545275,-5.710360225,-2.060881886
54009,2016,190,325,-350,-7,-135,-357,8.2776047226,14.15906071,-15.24821923,-0.304964385,-5.881455987,-15.55318361
54009,2017,190,323,-124,-7,-133,-131,8.4163898117,14.30786268,-5.492801772,-0.310077519,-5.891472868,-5.802879291
46011,2010,92,53,-12,14,39,2,NA,NA,NA,NA,NA,NA
46011,2011,370,185,-133,85,185,-48,11.537622003,5.7688110013,-4.147307368,2.6505347844,5.7688110013,-1.496772584
46011,2012,393,205,278,101,188,379,12.120651369,6.3224771774,8.5738958796,3.1149765606,5.798174192,11.68887244
46011,2013,410,197,41,105,213,146,12.466742683,5.9901178259,1.2466742683,3.1927023945,6.4766248575,4.4393766629
46011,2014,425,198,-99,109,227,10,12.807570027,5.9668208598,-2.98341043,3.2847650188,6.8407491675,0.3013545889
46011,2015,443,195,146,117,248,263,13.202205335,5.8113544926,4.351065415,3.4868126956,7.3908508419,7.8378781106
46011,2016,440,184,-130,122,256,-8,12.96691962,5.4225300228,-3.831135342,3.5953731673,7.544389597,-0.235762175
46011,2017,442,200,-166,122,242,-44,12.940625366,5.8554865909,-4.86005387,3.5718468205,7.085138775,-1.28820705
13027,2010,45,61,-51,-1,-16,-52,NA,NA,NA,NA,NA,NA
13027,2011,195,176,-293,6,19,-287,12.093398245,10.915067134,-18.17110608,0.3721045614,1.178331111,-17.79900152
13027,2012,222,156,-445,8,66,-437,14.039525692,9.8656126482,-28.14229249,0.5059288538,4.1739130435,-27.63636364
13027,2013,225,202,-1,11,23,10,14.378834356,12.908997955,-0.06390593,0.7029652352,1.4698364008,0.6390593047
13027,2014,214,196,-157,7,18,-150,13.71838841,12.564505273,-10.06442514,0.4487323312,1.1538831373,-9.615692811
13027,2015,191,201,134,7,-10,141,12.242804948,12.883789501,8.5891930004,0.4486891866,-0.640984552,9.037882187
13027,2016,179,203,41,9,-24,50,11.415452313,12.946015752,2.6147125411,0.5739612895,-1.530563439,3.1886738306
13027,2017,162,198,-79,9,-36,-70,10.358056266,12.659846547,-5.051150895,0.5754475703,-2.301790281,-4.475703325
48047,2010,25,12,-34,5,13,-29,NA,NA,NA,NA,NA,NA
48047,2011,135,74,-80,30,61,-50,18.711018711,10.256410256,-11.08801109,4.158004158,8.4546084546,-6.93000693
48047,2012,132,80,-110,32,52,-78,18.307905687,11.095700416,-15.25658807,4.4382801664,7.2122052705,-10.81830791
48047,2013,111,85,-14,53,26,39,15.353758904,11.757382945,-1.936510132,7.3310740715,3.5963759596,5.3945639394
48047,2014,130,94,-104,62,36,-42,17.910036509,12.950334091,-14.32802921,8.5417097196,4.9597024179,-5.786319487
48047,2015,116,89,-109,63,27,-46,16.00662343,12.280943839,-15.0407065,8.6932523803,3.7256795916,-6.347454119
48047,2016,118,71,-87,64,47,-23,16.274739673,9.7924281084,-11.99917247,8.8269774498,6.4823115647,-3.172195021
48047,2017,111,72,-132,64,39,-68,15.312456891,9.9324044696,-18.20940819,8.828803973,5.380052421,-9.380604221
36007,2010,497,432,-356,110,65,-246,NA,NA,NA,NA,NA,NA
36007,2011,2057,2161,-1455,483,-104,-972,10.286080038,10.806134644,-7.275763955,2.4152536016,-0.520054606,-4.860510354
36007,2012,2099,2040,-1255,522,59,-733,10.541593845,10.245284156,-6.302858635,2.6215874164,0.2963096888,-3.681271219
36007,2013,2036,2134,-976,506,-98,-470,10.257056134,10.750765123,-4.9169385,2.5491504931,-0.493708989,-2.367788007
36007,2014,2153,2116,-1164,556,37,-608,10.877555506,10.690621203,-5.880852117,2.8090668189,0.1869343027,-3.071785298
36007,2015,2042,2169,-1830,588,-127,-1242,10.367034657,11.01180126,-9.290731353,2.9852185987,-0.644766602,-6.305512754
36007,2016,1947,2074,-1922,585,-127,-1337,9.9559728167,10.605386555,-9.828135467,2.9913939896,-0.649413738,-6.836741477
36007,2017,1927,2115,-1591,584,-188,-1007,9.9209975571,10.888899758,-8.191129794,3.0066749213,-0.967902201,-5.184454873
08014,2010,163,91,250,18,72,268,NA,NA,NA,NA,NA,NA
08014,2011,678,318,758,95,360,853,11.93042346,5.5956853395,13.338143042,1.6716670039,6.3347381202,15.009810046
08014,2012,677,327,1010,77,350,1087,11.637901396,5.6212610878,17.362304889,1.3236608678,6.0166403081,18.685965757
08014,2013,679,328,735,75,351,810,11.415218049,5.5142732255,12.356679332,1.2608856461,5.9009448236,13.617564978
08014,2014,704,349,1154,105,355,1259,11.562687339,5.7320708543,18.953609644,1.7245485378,5.830616485,20.678158182
08014,2015,674,367,2615,116,307,2731,10.655958009,5.8022798059,41.34321987,1.8339630994,4.8536782027,43.177182969
08014,2016,736,351,1212,114,385,1326,11.210540345,5.3463310613,18.460835459,1.7364152165,5.8642092837,20.197250676
08014,2017,744,361,1331,112,383,1443,11.034482759,5.354097145,19.740452354,1.6611049314,5.6803856136,21.401557286
12011,2010,5071,3740,383,3239,1331,3622,NA,NA,NA,NA,NA,NA
12011,2011,21125,14465,13382,14536,6660,27918,11.933012446,8.1709360961,7.559175032,8.2110423155,3.7620763498,15.770217347000001
12011,2012,21160,14221,8183,14053,6939,22236,11.740788253,7.8906308954,4.5404002965,7.7974148072,3.8501573576,12.337815104
12011,2013,21153,14409,2816,14419,6744,17235,11.567239879,7.8793721657,1.5398925684,7.8848405342,3.6878677136,9.4247331026
12011,2014,22089,14026,2475,16100,8063,18575,11.916174093,7.5664927262,1.3351682231,8.685336724,4.3496813668,10.020504947
12011,2015,22155,14776,100,17671,7379,17771,11.789211767,7.8626672566,0.0532124205,9.4031668308,3.9265445105,9.4563792513
12011,2016,22558,15508,85,18335,7050,18420,11.845181928,8.1432343889,0.0446334101,9.6276890973,3.7019475395,9.6723225074
12011,2017,22363,15976,-5858,18285,6387,12427,11.608097586,8.2927588892,-3.04074747,9.4913054763,3.3153386971,6.4505580067
17009,2010,10,9,-19,0,1,-19,NA,NA,NA,NA,NA,NA
17009,2011,43,56,-29,1,-13,-28,6.23323911,8.1177067478,-4.203812423,0.1449590491,-1.884467638,-4.058853374
17009,2012,63,48,-9,4,15,-5,9.1529856167,6.973703327,-1.307569374,0.5811419439,2.1792822897,-0.72642743
17009,2013,50,45,-33,1,5,-32,7.2732562368,6.5459306131,-4.800349116,0.1454651247,0.7273256237,-4.654883992
17009,2014,54,68,-13,2,-14,-11,7.8860898138,9.9306316174,-1.898503103,0.2920774005,-2.044541804,-1.606425703
17009,2015,56,49,-44,2,7,-42,8.2147572246,7.1879125715,-6.454452105,0.2933841866,1.0268446531,-6.161067918
17009,2016,54,44,-69,3,10,-66,7.974010632,6.4973419965,-10.18901359,0.4430005907,1.4766686356,-9.746012995
17009,2017,53,62,-23,3,-9,-20,7.8751857355,9.2124814264,-3.417533432,0.4457652303,-1.337295691,-2.971768202
18013,2010,19,54,-2,0,-35,-2,NA,NA,NA,NA,NA,NA
18013,2011,109,138,-100,-3,-29,-103,7.1994715984,9.1149273448,-6.605019815,-0.198150594,-1.915455746,-6.80317041
18013,2012,124,154,10,-5,-30,5,8.2334583845,10.225424123,0.6639885794,-0.33199429,-1.991965738,0.3319942897
18013,2013,128,150,31,-1,-22,30,8.5049833887,9.9667774086,2.0598006645,-0.066445183,-1.46179402,1.9933554817
18013,2014,108,140,-77,-2,-32,-79,7.200960128,9.3345779437,-5.134017869,-0.133351113,-2.133617816,-5.267368983
18013,2015,110,147,90,-1,-37,89,7.3487657414,9.8206233089,6.0126265157,-0.066806961,-2.471857568,5.9458195544
18013,2016,118,172,68,-1,-54,67,7.8661422572,11.465902273,4.5330311313,-0.066662223,-3.599760016,4.4663689087
18013,2017,121,138,46,-1,-17,45,8.0551209932,9.1868322072,3.0622774024,-0.066571248,-1.131711214,2.9957061545
20013,2010,30,42,-5,0,-12,-5,NA,NA,NA,NA,NA,NA
20013,2011,137,122,-9,0,15,-9,13.741223671,12.23671013,-0.902708124,0,1.5045135406,-0.902708124
20013,2012,150,133,-128,2,17,-126,15.123254524,13.409285678,-12.90517719,0.2016433937,1.7139688461,-12.7035338
20013,2013,138,123,29,3,15,32,13.95631068,12.439320388,2.9328478964,0.3033980583,1.5169902913,3.2362459547
20013,2014,141,137,-135,2,4,-133,14.319081954,13.912866863,-13.70975932,0.2031075454,0.4062150909,-13.50665177
20013,2015,116,116,-80,2,0,-78,11.905372813,11.905372813,-8.21060194,0.2052650485,0,-8.005336891
20013,2016,130,98,-98,3,32,-95,13.439470692,10.131293291,-10.13129329,0.3101416313,3.308177401,-9.821151659
20013,2017,128,121,-9,3,7,-6,13.27594254,12.549914432,-0.93346471,0.3111549033,0.7260281077,-0.622309807
27015,2010,57,85,-22,0,-28,-22,NA,NA,NA,NA,NA,NA
27015,2011,250,282,-164,5,-32,-159,9.7096805515,10.952519662,-6.369550442,0.194193611,-1.242839111,-6.175356831
27015,2012,292,277,-266,3,15,-263,11.436852516,10.849342968,-10.41850263,0.11750190939999999,0.587509547,-10.30100072
27015,2013,257,321,-88,9,-64,-79,10.142868419,12.66871892,-3.473044439,0.3551977267,-2.525850501,-3.117846712
27015,2014,290,303,-1,12,-13,11,11.478329705,11.992875519,-0.039580447,0.4749653671,-0.514545814,0.4353849198
27015,2015,262,312,6,13,-50,19,10.377881645,12.358393409,0.2376614117,0.5149330587,-1.980511764,0.7525944704
27015,2016,293,268,-3,13,25,10,11.606258665,10.615963557,-0.118835413,0.5149534561,0.9902951079,0.3961180432
27015,2017,290,270,-99,13,20,-86,11.495164103,10.702394165,-3.924211194,0.5153004598,0.7927699382,-3.408910734
31017,2010,10,10,12,0,0,12,NA,NA,NA,NA,NA,NA
31017,2011,29,47,-40,0,-18,-40,9.27703135,15.03518874,-12.79590531,0,-5.75815739,-12.79590531
31017,2012,27,35,-38,0,-8,-38,8.7804878049,11.382113821,-12.35772358,0,-2.601626016,-12.35772358
31017,2013,27,50,-71,0,-23,-71,8.9835301946,16.636167027,-23.62335718,0,-7.652636832,-23.62335718
31017,2014,28,38,25,0,-10,25,9.4387325131,12.809708411,8.4274397438,0,-3.370975898,8.4274397438
31017,2015,25,46,29,0,-21,29,8.3948959033,15.446608462,9.7380792478,0,-7.051712559,9.7380792478
31017,2016,28,23,-3,0,5,-3,9.3865236339,7.7103586993,-1.005698961,0,1.6761649346,-1.005698961
31017,2017,30,33,34,0,-3,34,10.003334445,11.003667889,11.337112371,0,-1.000333444,11.337112371
39015,2010,136,103,9,0,33,9,NA,NA,NA,NA,NA,NA
39015,2011,510,485,-263,-5,25,-268,11.394229158,10.835688513,-5.875847585,-0.111708129,0.558540645,-5.987555714
39015,2012,520,451,-412,-7,69,-419,11.694196755,10.142466801,-9.265402044,-0.157421879,1.551729954,-9.422823924
39015,2013,504,493,-169,-9,11,-178,11.400135716,11.15132323,-3.822664556,-0.203573852,0.2488124859,-4.026238408
39015,2014,486,475,-188,-5,11,-193,11.036675372,10.786874077,-4.269331214,-0.113546043,0.2498012944,-4.382877257
39015,2015,485,497,-223,-5,-12,-228,11.067121522,11.340947209,-5.088594019,-0.114094036,-0.273825687,-5.202688055
39015,2016,501,531,-23,-4,-30,-27,11.471487286,12.158402693,-0.526635145,-0.091588721,-0.686915406,-0.618223866
39015,2017,491,493,-60,-4,-2,-64,11.258885577,11.304746618,-1.375831231,-0.091722082,-0.045861041,-1.467553313
46013,2010,125,83,67,13,42,80,NA,NA,NA,NA,NA,NA
46013,2011,497,367,56,130,130,186,13.501765825,9.9701168160999991,1.5213257267,3.5316490084,3.5316490084,5.0529747351
46013,2012,454,388,395,129,66,524,12.182850089,10.411774966,10.599616267,3.4616468315,1.7710751231,14.061263099
46013,2013,519,380,410,112,139,522,13.695015437,10.027178932,10.818798322,2.9553790538,3.6678365042,13.774177376
46013,2014,491,392,-37,68,99,31,12.822856546,10.237392599,-0.966284505,1.7758742263,2.5854639471,0.8095897208
46013,2015,483,400,-3,76,83,73,12.568633064,10.40880585,-0.078066044,1.9776731115,2.1598272138,1.8996070676
46013,2016,525,340,152,77,185,229,13.561861462,8.7829198042,3.9264817948,1.9890730145,4.7789416582,5.9155548093
46013,2017,521,354,19,77,167,96,13.342552756,9.065765212,0.4865806187,1.9719319812,4.2767875435,2.4585125999
48049,2010,109,159,25,4,-50,29,NA,NA,NA,NA,NA,NA
48049,2011,432,473,-71,20,-41,-51,11.359453063,12.437549303,-1.866947147,0.5259006048,-1.07809624,-1.341046542
48049,2012,417,460,-201,19,-43,-182,11.011936199,12.147459596,-5.307911693,0.5017428964,-1.135523397,-4.806168797
48049,2013,407,503,-78,34,-96,-44,10.800769588,13.34837126,-2.069926358,0.9022755921,-2.547601672,-1.167650766
48049,2014,448,496,-97,36,-48,-61,11.92917055,13.207295966,-2.582878445,0.958594062,-1.278125416,-1.624284383
48049,2015,390,484,262,44,-94,306,10.371099204,12.870800037,6.9672512598,1.1700727307,-2.499700834,8.1373239905
48049,2016,436,500,376,46,-64,422,11.507905086,13.19713886,9.9242484229,1.2141367751,-1.689233774,11.138385198
48049,2017,417,466,-6,45,-49,39,10.956672535,12.244147245,-0.157649965,1.182374734,-1.28747471,1.0247247694
55009,2010,884,411,-53,71,473,18,NA,NA,NA,NA,NA,NA
55009,2011,3345,1780,187,335,1565,522,13.40678676,7.13425424,0.749497496,1.34268268,6.27253252,2.092180176
55009,2012,3453,1842,341,324,1611,665,13.721820198,7.3198936589,1.3550943201,1.2875382983,6.4019265388,2.6426326184
55009,2013,3389,1855,-329,325,1534,-4,13.368177112,7.3171934323,-1.297766382,1.2819880676,6.0509836793,-0.015778315
55009,2014,3482,1756,-62,357,1726,295,13.641340863,6.8794355415,-0.242895788,1.3986096175,6.7619053216,1.1557138296
55009,2015,3324,2022,-29,393,1302,364,12.930883571,7.8658984902,-0.112814568,1.5288319024,5.0649850812,1.4160173345
55009,2016,3366,1937,-121,405,1429,284,13.009676092,7.4865545423,-0.467668095,1.5653353586,5.5231215493,1.0976672638
55009,2017,3357,1871,584,409,1486,993,12.870994828,7.1735571412,2.239100679,1.5681372906,5.6974376867,3.8072379696
46015,2010,32,15,9,0,17,9,NA,NA,NA,NA,NA,NA
46015,2011,68,59,5,0,9,5,12.856872755,11.155227831,0.9453582908,0,1.7016449234,0.9453582908
46015,2012,83,71,-17,0,12,-17,15.679607065,13.412675923,-3.211485784,0,2.266931142,-3.211485784
46015,2013,71,57,52,0,14,52,13.335837716,10.706235913,9.7670924117,0,2.6296018032,9.7670924117
46015,2014,72,54,-100,0,18,-100,13.541470754,10.156103066,-18.80759827,0,3.3853676885,-18.80759827
46015,2015,79,56,-62,0,23,-62,15.023295617,10.649424741,-11.79043453,0,4.3738708757,-11.79043453
46015,2016,67,46,-48,0,21,-48,12.819286329,8.8013010619,-9.183966325,0,4.0179852674,-9.183966325
46015,2017,63,48,84,0,15,84,11.971496437,9.1211401425,15.961995249,0,2.8503562945,15.961995249
37019,2010,254,244,577,3,10,580,NA,NA,NA,NA,NA,NA
37019,2011,1041,1022,2081,13,19,2094,9.5371155035,9.363047113,19.065069513,0.1190994251,0.1740683906,19.184168938
37019,2012,1014,1204,1961,25,-190,1986,9.1220683885,10.831331696,17.641396558,0.2249030668,-1.709263308,17.866299625
37019,2013,1087,1203,2978,-11,-116,2967,9.5737185133,10.595384886,26.228641888,-0.096882156,-1.021666373,26.131759732
37019,2014,989,1233,3526,-13,-244,3513,8.4753388207,10.566322311,30.216425361,-0.111404858,-2.090983491,30.105020503
37019,2015,1111,1333,4052,1,-222,4053,9.2321371442,11.076902622,33.67112485,0.0083097544,-1.844765478,33.679434604
37019,2016,998,1407,4456,-1,-409,4455,8.0273476775,11.317112407,35.841544339,-0.008043435,-3.28976473,35.833500905
37019,2017,1011,1482,4973,-2,-471,4971,7.860058309,11.521865889,38.662779397,-0.015549077,-3.66180758,38.647230321
51025,2010,37,52,-3,1,-15,-2,NA,NA,NA,NA,NA,NA
51025,2011,151,192,-238,0,-41,-238,8.7442453021,11.118510583,-13.78232041,0,-2.374265281,-13.78232041
51025,2012,153,181,-67,2,-28,-65,8.9562723175,10.595328689,-3.922027747,0.1170754551,-1.639056372,-3.804952292
51025,2013,146,167,-376,13,-21,-363,8.6657169991,9.9121557455,-22.31718898,0.7716049383,-1.246438746,-21.54558405
51025,2014,141,217,-103,15,-76,-88,8.5052479189,13.089636868,-6.213053444,0.9048136084,-4.584388949,-5.308239836
51025,2015,154,190,31,15,-36,46,9.3341818953,11.516198442,1.8789586932,0.9091735612,-2.182016547,2.7881322544
51025,2016,133,217,-160,17,-84,-143,8.1154468072,13.240992159,-9.762943527,1.0373127498,-5.125545352,-8.725630778
51025,2017,134,222,42,17,-88,59,8.2413358344,13.653556382,2.5831052615,1.0455426059,-5.412220548,3.6286478674
13029,2010,112,32,85,-1,80,84,NA,NA,NA,NA,NA,NA
13029,2011,429,238,679,15,191,694,13.917952212,7.7213814135,22.028646974,0.4866416857,6.1965707983,22.51528866
13029,2012,515,219,569,113,296,682,16.213068048,6.8944891309,17.913079066,3.5574304648,9.3185789167,21.470509531
13029,2013,493,237,460,59,256,519,15.100465572,7.2592501838,14.089683901,1.807155109,7.8412153884,15.89683901
13029,2014,497,237,338,43,260,381,14.898974759,7.1047424906,10.132501949,1.2890461059,7.7942322681,11.421548054
13029,2015,540,234,747,61,306,808,15.771949296,6.8345113616,21.817863193,1.7816461242,8.9374379345,23.599509317
13029,2016,513,243,748,27,270,775,14.524348811,6.8799546999,21.177802945,0.7644394111,7.644394111,21.942242356
13029,2017,537,248,922,6,289,928,14.732106115,6.8036542207,25.294230611,0.1646045376,7.9284518943,25.458835149
40013,2010,129,74,102,2,55,104,NA,NA,NA,NA,NA,NA
40013,2011,554,409,392,0,145,392,12.92746386,9.5439218752,9.1472307459,0,3.3835419851,9.1472307459
40013,2012,619,446,118,22,173,140,14.302052888,10.304871709,2.7264010351,0.5083120574,3.9971811786,3.2347130925
40013,2013,576,510,596,-3,66,593,13.160450106,11.652481864,13.617410179,-0.068544011,1.5079682413,13.548866168
40013,2014,607,522,275,-3,85,272,13.708375207,11.788751002,6.2105488996,-0.067751443,1.9196242053,6.1427974571
40013,2015,577,498,432,0,79,432,12.904091514,11.137326818,9.6612955529,0,1.766764696,9.6612955529
40013,2016,563,522,475,7,41,482,12.447077811,11.540629871,10.501531013,0.1547594044,0.90644794,10.656290417
40013,2017,573,532,776,7,41,783,12.482164447,11.58902528,16.904292514,0.1524871747,0.8931391663,17.056779689
19019,2010,80,28,-31,0,52,-31,NA,NA,NA,NA,NA,NA
19019,2011,275,217,-127,3,58,-124,13.130252101,10.360962567,-6.063789152,0.1432391138,2.769289534,-5.920550038
19019,2012,295,197,-13,4,98,-9,14.078121645,9.4013219118,-0.620391801,0.190889785,4.6767997328,-0.429502016
19019,2013,284,213,-45,6,71,-39,13.515764426,10.136823319,-2.141582391,0.2855443189,3.3789411065,-1.856038073
19019,2014,287,219,33,8,68,41,13.614154926,10.388501494,1.5653906361,0.3794886391,3.225653432,1.9448792752
19019,2015,286,216,-103,9,70,-94,13.540384433,10.226304327,-4.876432156,0.4260960136,3.3140801061,-4.450336142
19019,2016,290,183,-193,10,107,-183,13.762665211,8.684716323,-9.159290985,0.4745746625,5.0779488883,-8.684716323
19019,2017,283,184,61,10,99,71,13.400890236,8.7129463017,2.8885311109,0.4735296903,4.6879439341,3.3620608012
29021,2010,315,235,-250,31,80,-219,NA,NA,NA,NA,NA,NA
29021,2011,1211,972,225,140,239,365,13.550332604,10.876072082,2.5176092782,1.5665124398,2.6742605222,4.084121718
29021,2012,1237,983,-227,225,254,-2,13.776973409,10.948071836,-2.528191563,2.5059167479,2.8289015732,-0.022274816
29021,2013,1140,1007,-410,216,133,-194,12.684424861,11.204575294,-4.561942275,2.4033647106,1.4798495672,-2.158577564
29021,2014,1163,942,-708,284,221,-424,12.959589037,10.496932823,-7.889414478,3.164680384,2.4626562143,-4.724734094
29021,2015,1164,984,-904,306,180,-598,13.015620982,11.002896087,-10.10835169,3.4216323199,2.0127248941,-6.68671937
29021,2016,1146,873,-460,319,273,-141,12.834799554,9.7772949484,-5.151839263,3.5726885321,3.0575046059,-1.57915073
29021,2017,1123,855,-878,319,268,-559,12.588345412,9.584181057,-9.842001132,3.5758523476,3.0041643547,-6.266148785
51027,2010,61,39,-40,0,22,-40,NA,NA,NA,NA,NA,NA
51027,2011,234,295,-212,8,-61,-204,9.7703549061,12.317327766,-8.85177453,0.3340292276,-2.54697286,-8.517745303
51027,2012,205,280,56,17,-75,73,8.6078394323,11.757048981,2.3514097961,0.713820831,-3.149209548,3.0652306271
51027,2013,234,301,-138,8,-67,-130,9.8671726755,12.692388783,-5.819101834,0.3373392368,-2.825216108,-5.481762598
51027,2014,183,274,-406,5,-91,-401,7.8287095463,11.721674403,-17.36861244,0.2138991679,-3.892964856,-17.15471327
51027,2015,192,340,-309,6,-148,-303,8.3804369176,14.840357042,-13.48726566,0.2618886537,-6.459920124,-13.22537701
51027,2016,175,311,-456,7,-136,-449,7.8144187189,13.887338409,-20.36214249,0.3125767488,-6.07291969,-20.04956574
51027,2017,168,298,-470,7,-130,-463,7.703595011,13.664710198,-21.55172414,0.3209831255,-5.961115187,-21.23074101
51029,2010,42,54,-39,1,-12,-38,NA,NA,NA,NA,NA,NA
51029,2011,165,165,111,9,0,120,9.619869403,9.619869403,6.4715485075,0.5247201493,0,6.9962686567
51029,2012,155,153,-158,10,2,-148,9.0431738623,8.926487748,-9.218203034,0.5834305718,0.1166861144,-8.634772462
51029,2013,189,139,37,2,50,39,11.044880785,8.1229546517,2.1622253389,0.1168770453,2.9219261337,2.2791023843
51029,2014,169,164,-232,5,5,-227,9.9137678184,9.6204610782,-13.60943274,0.2933067402,0.2933067402,-13.316126
51029,2015,141,157,95,5,-16,100,8.3038869258,9.246171967,5.5948174323,0.2944640754,-0.942285041,5.8892815077
51029,2016,125,144,53,5,-19,58,7.3352502787,8.4502083211,3.1101461182,0.2934100111,-1.114958042,3.4035561293
51029,2017,125,152,27,5,-27,32,7.326007326,8.9084249084,1.5824175824,0.293040293,-1.582417582,1.8754578755
42017,2010,1572,1225,-324,202,347,-122,NA,NA,NA,NA,NA,NA
42017,2011,5999,5474,-616,768,525,152,9.5869110458,8.7479164969,-0.984420271,1.2273291687,0.8389945489,0.242908898
42017,2012,5652,5368,-1541,785,284,-756,9.0313580833,8.5775531124,-2.462371339,1.2543552893,0.4538049709,-1.208016049
42017,2013,5604,5624,-1008,806,-20,-202,8.9599989767,8.9919761323,-1.611648638,1.2886793675,-0.031977156,-0.322969271
42017,2014,5943,5607,-698,913,336,215,9.5002345885,8.963118852,-1.115794,1.4594841291,0.5371157365,0.343690129
42017,2015,6004,5930,-609,989,74,380,9.5909394057,9.4727299593,-0.972831795,1.5798532765,0.1182094464,0.6070214814
42017,2016,5999,5944,-502,1004,55,502,9.5757246839,9.4879325757,-0.801302516,1.6026050313,0.0877921083,0.8013025156
42017,2017,5960,5981,651,1002,-21,1653,9.4973117509,9.5307754332,1.0373741527,1.5966957004,-0.033463682,2.634069853
51530,2010,26,4,-18,-1,22,-19,NA,NA,NA,NA,NA,NA
51530,2011,76,66,88,0,10,88,11.393448767,9.8943107713,13.192414362,0,1.4991379957,13.192414362
51530,2012,86,81,26,3,5,29,12.763431285,12.021371327,3.8587117839,0.4452359751,0.7420599584,4.303947759
51530,2013,82,76,-102,2,6,-100,12.22147701,11.327222595,-15.20232506,0.2980848051,0.8942544154,-14.90424026
51530,2014,73,77,-104,2,-4,-102,11.041367315,11.646373743,-15.73016713,0.3025032141,-0.605006428,-15.42766392
51530,2015,67,87,0,2,-20,2,10.226665649,13.279401664,0,0.3052736015,-3.052736015,0.3052736015
51530,2016,1,71,-91,2,-70,-89,0.1547149377,10.984760579,-14.07905933,0.3094298755,-10.83004564,-13.76962946
51530,2017,0,75,16,2,-75,18,0,11.800802455,2.5175045236,0.3146880655,-11.80080245,2.8321925891
19021,2010,85,33,14,8,52,22,NA,NA,NA,NA,NA,NA
19021,2011,295,228,-185,65,67,-120,14.527368084,11.227931943,-9.110383375,3.2009455101,3.2994361411,-5.909437865
19021,2012,322,168,47,80,154,127,15.767309764,8.2264224856,2.3014396239,3.9173440407,7.5408872784,6.2187836647
19021,2013,334,186,-180,80,148,-100,16.223830573,9.034827804,-8.743381746,3.8859474426,7.1890027687,-4.857434303
19021,2014,341,205,-266,66,136,-200,16.568277336,9.9604013313,-12.92422807,3.2067633554,6.6078760052,-9.717464713
19021,2015,303,196,-439,79,107,-360,14.833671946,9.5953785524,-21.49168972,3.8675250288,5.2382933934,-17.62416469
19021,2016,319,174,-264,84,145,-180,15.725905842,8.5777668228,-13.01454277,4.14099088,7.148139019,-8.873551886
19021,2017,295,165,-373,83,130,-290,14.611917381,8.1727673486,-18.4754074,4.1111496359,6.4391500322,-14.36425776
31019,2010,162,67,-36,21,95,-15,NA,NA,NA,NA,NA,NA
31019,2011,666,359,240,114,307,354,14.319039377,7.7185212259,5.16001419,2.4510067403,6.6005181514,7.6110209303
31019,2012,681,298,316,124,383,440,14.411020939,6.3061442583,6.6870523008,2.6240331813,8.104876681,9.3110854821
31019,2013,689,344,-88,129,345,41,14.396456257,7.1877807727,-1.838734616,2.6954177898,7.2086754842,0.8566831735
31019,2014,740,359,-324,154,381,-170,15.366884364,7.4550155226,-6.728203424,3.1979732325,7.9118688416,-3.530230192
31019,2015,723,371,-27,163,352,136,14.90660179,7.6491691064,-0.556678075,3.3606861573,7.2574326832,2.8040080821
31019,2016,717,332,90,165,385,255,14.614012739,6.7668789809,1.8343949045,3.3630573248,7.847133758,5.1974522293
31019,2017,715,363,-164,164,352,0,14.427830579,7.3248986016,-3.30932058,3.3093205803,7.1029319773,0
46017,2010,6,1,15,0,5,15,NA,NA,NA,NA,NA,NA
46017,2011,51,18,10,0,33,10,26.080286372,9.2048069547,5.1137816415,0,16.875479417,5.1137816415
46017,2012,60,16,-4,0,44,-4,30.052592036,8.014024543,-2.003506136,0,22.038567493,-2.003506136
46017,2013,45,17,-19,0,28,-19,22.271714922,8.4137589706,-9.403612967,0,13.857955951,-9.403612967
46017,2014,55,14,20,0,41,20,26.757479932,6.8109948918,9.7299927025,0,19.94648504,9.7299927025
46017,2015,51,20,-21,0,31,-21,24.384413101,9.5625149414,-10.04064069,0,14.821898159,-10.04064069
46017,2016,48,34,-77,0,14,-77,23.250181642,16.468878663,-37.29716638,0,6.7813029789,-37.29716638
46017,2017,45,37,-41,0,8,-41,22.326966013,18.357727611,-20.34234681,0,3.9692384024,-20.34234681
55011,2010,33,52,-18,0,-19,-18,NA,NA,NA,NA,NA,NA
55011,2011,130,147,-92,3,-17,-89,9.6321268477,10.891712666,-6.816582077,0.2222798503,-1.259585819,-6.594302227
55011,2012,145,116,-131,2,29,-129,10.825338758,8.6602710068,-9.780133637,0.1493150174,2.1650677517,-9.63081862
55011,2013,158,118,-18,8,40,-10,11.826347305,8.8323353293,-1.347305389,0.5988023952,2.994011976,-0.748502994
55011,2014,123,138,-124,12,-15,-112,9.2408249127,10.36775478,-9.31595357,0.9015438939,-1.126929867,-8.414409677
55011,2015,156,112,-38,12,44,-26,11.768255884,8.4490042245,-2.866626433,0.9052504526,3.3192516596,-1.961375981
55011,2016,149,121,-145,12,28,-133,11.277199622,9.1579943236,-10.97445601,0.908230842,2.119205298,-10.06622517
55011,2017,145,122,-27,12,23,-15,11.015307479,9.2680518099,-2.05112622,0.9116116534,1.7472556691,-1.139514567
21029,2010,197,104,101,-1,93,100,NA,NA,NA,NA,NA,NA
21029,2011,761,454,415,-19,307,396,10.16577833,6.0647350352,5.5437555938,-0.253810497,4.1010432947,5.2899450968
21029,2012,764,468,420,2,296,422,10.110233303,6.1931795625,5.5579816587,0.0264665793,3.9170537404,5.584448238
21029,2013,732,552,780,3,180,783,9.5797725458,7.2240907723,10.207954352,0.0392613629,2.3556817736,10.247215715
21029,2014,804,558,891,5,246,896,10.377541142,7.2023233301,11.500484027,0.0645369474,3.1752178122,11.565020975
21029,2015,785,571,442,5,214,447,10.015310028,7.2850216892,5.6391936719,0.0637917836,2.7302883389,5.7029854555
21029,2016,793,662,366,6,131,372,10.043314167,8.3842042605,4.6353757694,0.0759897667,1.6591099065,4.7113655361
21029,2017,757,627,900,7,130,907,9.4948418049,7.8642877301,11.288451286999999,0.0877990656,1.6305540748,11.376250353
13031,2010,186,146,232,27,40,259,NA,NA,NA,NA,NA,NA
13031,2011,843,490,1579,125,353,1704,11.768976253,6.840804702,22.044144132,1.7451032403,4.9281715506,23.789247372
13031,2012,812,465,-1,144,347,143,11.134422093,6.376239253,-0.013712342,1.974577317,4.7581828404,1.9608649746
13031,2013,861,486,-1839,117,375,-1722,11.872586873,6.7015995587,-25.35852179,1.6133480419,5.1709873138,-23.74517375
13031,2014,837,464,359,129,373,488,11.576203088,6.4173933489,4.9651814919,1.7841459957,5.1588097395,6.7493274876
13031,2015,928,516,-46,140,412,94,12.715202751,7.070091185,-0.630279447,1.9182417944,5.6451115663,1.2879623477
13031,2016,885,555,1010,145,330,1155,11.963177744,7.5023318058,13.652892115,1.96006867,4.4608459386,15.612960785
13031,2017,894,546,930,146,348,1076,11.851262676,7.238019487,12.328494731,1.9354411082,4.6132431895,14.263935839
01011,2010,39,52,-24,4,-13,-20,NA,NA,NA,NA,NA,NA
01011,2011,169,132,-261,13,37,-248,15.680816516,12.247738344,-24.217119,1.2062166551,3.4330781721,-23.01090234
01011,2012,122,117,-83,15,5,-68,11.462394889,10.992624607,-7.798186687,1.409310847,0.4697702823,-6.38887584
01011,2013,132,121,-85,11,11,-74,12.475780918,11.436132508,-8.033646803,1.0396484098,1.0396484098,-6.993998393
01011,2014,124,116,98,14,8,112,11.685986241,10.932051645,9.2356988031,1.3193855433,0.7539345962,10.555084346
01011,2015,124,133,-266,17,-9,-249,11.758012517,12.611416651,-25.2228333,1.611985587,-0.853404134,-23.61084771
01011,2016,146,117,-26,18,29,-8,13.998082454,11.217641419,-2.492809204,1.7257909875,2.7804410355,-0.767018217
01011,2017,138,118,-170,18,20,-152,13.301204819,11.373493976,-16.38554217,1.734939759,1.9277108434,-14.65060241
37021,2010,610,591,353,24,19,377,NA,NA,NA,NA,NA,NA
37021,2011,2566,2364,2105,145,202,2250,10.692624548,9.8508824749,8.7716191242,0.6042207948,0.8417420727,9.375839919
37021,2012,2555,2273,2155,49,282,2204,10.536842865,9.3738723413,8.8872392853,0.2020764385,1.1629705236,9.0893157238
37021,2013,2652,2448,2826,119,204,2945,10.80929061,9.9778067167,11.51849746,0.4850322709,0.8314838931,12.003529731
37021,2014,2587,2445,2004,169,142,2173,10.426196474,9.8539042821,8.0765743073,0.6811083123,0.5722921914,8.7576826196
37021,2015,2644,2575,2549,201,69,2750,10.545397257,10.270195892,10.166496826,0.8016735434,0.2752013656,10.96817037
37021,2016,2595,2636,3005,215,-41,3220,10.226943563,10.38852533,11.842761235,0.8473190235,-0.161581767,12.690080259
37021,2017,2620,2639,2078,209,-19,2287,10.215599845,10.289682439,8.1022963655,0.8149085372,-0.074082594,8.9172049027
17011,2010,94,64,-55,2,30,-53,NA,NA,NA,NA,NA,NA
17011,2011,329,393,-285,8,-64,-277,9.4576919207,11.297486094,-8.192833427,0.2299742716,-1.839794173,-7.962859155
17011,2012,330,374,-252,14,-44,-238,9.5717372703,10.847968906,-7.309326643,0.4060737024,-1.276231636,-6.90325294
17011,2013,359,380,-228,17,-21,-211,10.49048113,11.104130444,-6.662478267,0.4967637304,-0.613649314,-6.165714536
17011,2014,325,386,-215,15,-61,-200,9.5655757005,11.360960678,-6.327996233,0.4414881093,-1.795384978,-5.886508123
17011,2015,364,388,-371,15,-24,-356,10.814986481,11.528062513,-11.02296699,0.4456725198,-0.713076032,-10.57729447
17011,2016,367,356,-59,14,11,-45,10.971435405,10.642591292,-1.763800242,0.418528871,0.3288441129,-1.345271371
17011,2017,364,377,-192,15,-13,-177,10.918471414,11.308416822,-5.759193713,0.4499370088,-0.389945408,-5.309256704
13033,2010,81,89,20,0,-8,20,NA,NA,NA,NA,NA,NA
13033,2011,324,239,86,3,85,89,13.837579278,10.207350146,3.6729377095,0.1281257341,3.6302291315,3.8010634436
13033,2012,318,227,-560,-1,91,-561,13.663608825,9.7535824006,-24.06170108,-0.042967323,3.9100264249,-24.1046684
13033,2013,308,216,-315,1,92,-314,13.428671085,9.4175095919,-13.73386815,0.0435995814,4.0111614928,-13.69026857
13033,2014,325,265,-264,4,60,-260,14.299857001,11.659883401,-11.61588384,0.17599824,2.6399736003,-11.4398856
13033,2015,319,233,-75,5,86,-70,14.093218467,10.293792799,-3.313452618,0.2208968412,3.7994256682,-3.092555776
13033,2016,326,271,-95,5,55,-90,14.408839779,11.977900552,-4.198895028,0.2209944751,2.4309392265,-3.977900552
13033,2017,295,242,-143,5,53,-138,13.073343674,10.724573454,-6.33724795,0.2215820962,2.3487702194,-6.115665854
37023,2010,233,298,-219,18,-65,-201,NA,NA,NA,NA,NA,NA
37023,2011,809,995,1,103,-186,104,8.9359187483,10.990406866,0.011045635,1.1377004092,-2.054488118,1.1487460443
37023,2012,881,989,-720,88,-108,-632,9.7755832339,10.973952121,-7.989125912,0.9764487226,-1.198368887,-7.012677189
37023,2013,860,1031,-488,51,-171,-437,9.61452464,11.526249888,-5.455683749,0.5701636705,-1.911725248,-4.885520079
37023,2014,853,993,-446,56,-140,-390,9.5976956529,11.172932923,-5.018255875,0.630094908,-1.57523727,-4.388160967
37023,2015,896,1046,125,72,-150,197,10.109785957,11.802272445,1.4104054069,0.8123935144,-1.692486488,2.2227989213
37023,2016,902,1016,197,78,-114,275,10.166473181,11.451371121,2.2203938099,0.8791406963,-1.284897941,3.0995345063
37023,2017,886,1006,537,78,-120,615,9.9497459221,11.297341307,6.0304893456,0.8759369999,-1.347595384,6.9064263455
38013,2010,1,0,2,0,1,2,NA,NA,NA,NA,NA,NA
38013,2011,25,25,89,0,0,89,12.39771882,12.39771882,44.135878998,0,0,44.135878998
38013,2012,28,22,110,-1,6,109,13.195098963,10.367577757,51.837888784,-0.471253534,2.8275212064,51.36663525
38013,2013,37,23,106,0,14,106,16.492088255,10.251838645,47.24760419,0,6.24024961,47.24760419
38013,2014,39,29,-54,0,10,-54,17.082785808,12.702584319,-23.65308804,0,4.3802014893,-23.65308804
38013,2015,44,25,62,0,19,62,19.113814075,10.860121633,26.933101651,0,8.2536924414,26.933101651
38013,2016,37,17,-137,0,20,-137,16.192560175,7.4398249453,-59.95623632,0,8.7527352298,-59.95623632
38013,2017,33,19,-111,0,14,-111,15.144561726,8.719596145,-50.94079853,0,6.4249655805,-50.94079853
38015,2010,296,162,238,2,134,240,NA,NA,NA,NA,NA,NA
38015,2011,1106,665,1345,12,441,1357,13.388290693,8.0499216192,16.281420418,0.1452617435,5.3383690738,16.426682161
38015,2012,1197,646,1858,5,551,1863,14.123560506,7.6222390032,21.922786483,0.0589956579,6.5013215027,21.981782141
38015,2013,1186,656,2058,26,530,2084,13.584093096,7.5136299079,23.571723095,0.2977963073,6.0704631878,23.869519403
38015,2014,1316,650,1226,62,666,1288,14.68364882,7.252562107,13.679447913,0.6917828471,7.4310867127,14.37123076
38015,2015,1405,717,1762,69,688,1831,15.291019111,7.8033172261,19.176352793,0.750946846,7.487701885,19.927299639
38015,2016,1336,751,611,78,585,689,14.244209292,8.00703681,6.5143801477,0.8316229976,6.2371724818,7.3460031452
38015,2017,1339,734,-81,78,605,-3,14.13498435,7.7483782771,-0.855066268,0.8233971466,6.3866060731,-0.031669121
48051,2010,50,24,17,4,26,21,NA,NA,NA,NA,NA,NA
48051,2011,184,193,65,16,-9,81,10.655239309,11.176419492,3.7640791036,0.9265425486,-0.521180184,4.6906216521
48051,2012,189,189,86,21,0,107,10.889292196,10.889292196,4.9549160257,1.2099213551,0,6.1648373808
48051,2013,200,211,-173,19,-11,-154,11.543012149,12.177877817,-9.984705509,1.0965861542,-0.634865668,-8.888119355
48051,2014,189,208,104,24,-19,128,10.925802815,12.024163945,6.0120819724,1.3874035321,-1.09836113,7.3994855045
48051,2015,207,210,184,25,-3,209,11.858386801,12.030247479,10.540788268,1.432172319,-0.171860678,11.972960587
48051,2016,222,222,224,29,0,253,12.553011026,12.553011026,12.666101216,1.6398077467,0,14.305908962
48051,2017,218,216,168,29,2,197,12.171291385,12.059628161,9.3797107923,1.6191167439,0.1116632237,10.998827536
34005,2010,1189,933,-5,263,256,258,NA,NA,NA,NA,NA,NA
34005,2011,4669,3704,-484,848,965,364,10.379176735,8.2339838566,-1.075930936,1.8851021356,2.1451928784,0.8091711997
34005,2012,4571,3690,-1255,1173,881,-82,10.138154816,8.1841591054,-2.783501268,2.6016310652,1.9539957105,-0.181870202
34005,2013,4397,3933,-2791,911,464,-1880,9.7590315987,8.7291951962,-6.19455474,2.0219417299,1.0298364025,-4.17261301
34005,2014,4526,3822,-1175,977,704,-198,10.055811308,8.4916727396,-2.610600594,2.1706866213,1.5641385685,-0.439913972
34005,2015,4502,4101,-3013,1130,401,-1883,10.013768375,9.1218267676,-6.701795672,2.5134514136,0.8919416079,-4.188344258
34005,2016,4342,4059,-1814,1029,283,-785,9.679152372,9.0482909898,-4.043754584,2.2938387358,0.6308613821,-1.749915848
34005,2017,4384,4032,-1018,930,352,-88,9.7754805795,8.9905879782,-2.26994508,2.0737219295,0.7848926013,-0.19622315
48053,2010,111,120,47,12,-9,59,NA,NA,NA,NA,NA,NA
48053,2011,461,437,395,37,24,432,10.724546649,10.166218841,9.1891451769,0.860755371,0.5583278082,10.049900548
48053,2012,459,412,95,20,47,115,10.601318813,9.5157807213,2.1941727391,0.461931103,1.085538092,2.6561038421
48053,2013,458,445,209,6,13,215,10.530914442,10.232002023,4.8055919616,0.1379595778,0.2989124187,4.9435515394
48053,2014,464,452,361,3,12,364,10.595542565,10.321519912,8.2435147972,0.0685056631,0.2740226525,8.3120204604
48053,2015,485,538,838,7,-53,845,10.928346102,12.122577738,18.88237945,0.1577287066,-1.194231636,19.040108157
48053,2016,549,489,1066,6,60,1072,12.106510833,10.783394895,23.507359832,0.1323115938,1.323115938,23.639671426
48053,2017,542,484,823,6,58,829,11.691365215,10.440259712,17.752755668,0.1294247072,1.2511055027,17.882180375
55013,2010,32,52,-7,0,-20,-7,NA,NA,NA,NA,NA,NA
55013,2011,140,140,29,4,0,33,9.0644221431,9.0644221431,1.8776303011,0.2589834898,0,2.1366137909
55013,2012,138,172,-94,3,-34,-91,8.9622028835,11.170281855,-6.104688921,0.1948304975,-2.208078971,-5.909858423
55013,2013,129,176,-25,0,-47,-25,8.4327504494,11.5051479,-1.634253963,0,-3.072397451,-1.634253963
55013,2014,115,191,34,2,-76,36,7.5451891218,12.531574976,2.2307515664,0.1312206804,-4.986385854,2.3619722468
55013,2015,134,192,-35,3,-58,-32,8.829440253,12.651138273,-2.306197081,0.1976740355,-3.82169802,-2.108523045
55013,2016,145,173,125,3,-28,128,9.552356797,11.396949834,8.2347903422,0.1976349682,-1.844593037,8.4324253105
55013,2017,143,155,132,3,-12,135,9.3522121579,10.137013178,8.6328112227,0.1962002551,-0.78480102,8.8290114777
31021,2010,24,33,-9,0,-9,-9,NA,NA,NA,NA,NA,NA
31021,2011,59,105,-15,1,-46,-14,8.6637298091,15.418502203,-2.202643172,0.1468428781,-6.754772394,-2.055800294
31021,2012,85,90,-99,1,-5,-98,12.630953265,13.373950516,-14.71134557,0.1485994502,-0.742997251,-14.56274612
31021,2013,59,100,-72,1,-41,-71,8.9076772099,15.097757983,-10.87038575,0.1509775798,-6.190080773,-10.71940817
31021,2014,68,100,7,1,-32,8,10.372178157,15.253203173,1.0677242221,0.1525320317,-4.881025015,1.2202562538
31021,2015,76,92,8,1,-16,9,11.621683615,14.06835385,1.2233351174,0.1529168897,-2.446670235,1.376252007
31021,2016,64,86,32,1,-22,33,9.7844366305,13.147836722,4.8922183152,0.1528818224,-3.363400092,5.0451001376
31021,2017,71,94,11,1,-23,12,10.854609387,14.370891301,1.6817000459,0.1528818224,-3.516281914,1.8345818682
01013,2010,65,60,-4,0,5,-4,NA,NA,NA,NA,NA,NA
01013,2011,276,261,-78,1,15,-77,13.198163734,12.480872226,-3.729915838,0.0478194338,0.7172915073,-3.682096404
01013,2012,242,272,-168,5,-30,-163,11.643571978,13.086989992,-8.083140878,0.240569669,-1.443418014,-7.842571209
01013,2013,240,262,-303,5,-22,-298,11.69020945,12.761811982,-14.75888943,0.2435460302,-1.071602533,-14.5153434
01013,2014,250,288,-11,6,-38,-5,12.285314135,14.152681884,-0.540553822,0.2948475393,-1.867367749,-0.245706283
01013,2015,239,277,-153,7,-38,-146,11.811801918,13.689829001,-7.561530098,0.3459523574,-1.878027083,-7.21557774
01013,2016,236,266,-153,7,-30,-146,11.768812646,13.264848152,-7.62978108,0.3490749514,-1.496035506,-7.280706129
01013,2017,228,253,-121,7,-25,-114,11.460165871,12.716763006,-6.081930133,0.3518471978,-1.256597135,-5.730082935
19023,2010,39,37,47,1,2,48,NA,NA,NA,NA,NA,NA
19023,2011,152,183,76,7,-31,83,10.171646535,12.246127079,5.0858232676,0.4684310904,-2.074480543,5.5542543581
19023,2012,172,174,3,10,-2,13,11.487343886,11.620917652,0.2003606492,0.6678688306,-0.133573766,0.8682294797
19023,2013,161,184,19,8,-23,27,10.74945752,12.285094308,1.2685695209,0.5341345351,-1.535636789,1.8027040561
19023,2014,161,184,-7,10,-23,3,10.756280064,12.292891502,-0.467664351,0.6680919294,-1.536611438,0.2004275788
19023,2015,157,192,-51,11,-35,-40,10.523493532,12.869495274,-3.418459682,0.7373148334,-2.346001743,-2.681144849
19023,2016,133,185,-151,12,-52,-139,8.9965163865,12.513951365,-10.21409003,0.8117157642,-3.517434978,-9.402374269
19023,2017,135,173,-56,12,-38,-44,9.2172191309,11.811695627,-3.823439047,0.8193083672,-2.594476496,-3.00413068
20015,2010,199,179,2,4,20,6,NA,NA,NA,NA,NA,NA
20015,2011,782,604,-304,38,178,-266,11.872589804,9.1701333009,-4.61543133,0.5769289163,2.7024565026,-4.038502414
20015,2012,757,615,-348,34,142,-314,11.514358725,9.3544658068,-5.2932587,0.5171574592,2.159892918,-4.776101241
20015,2013,753,635,-159,32,118,-127,11.468169357,9.6710325921,-2.421565641,0.4873591228,1.7971367652,-1.934206518
20015,2014,747,612,54,30,135,84,11.359057213,9.3062155484,0.821136666,0.4561870367,2.0528416651,1.2773237027
20015,2015,755,619,220,32,136,252,11.429263456,9.3704822241,3.3303814044,0.4844191134,2.0587812318,3.8148005177
20015,2016,746,629,255,29,117,284,11.226655029,9.4659061837,3.8375295339,0.4364249274,1.760748845,4.2739544613
20015,2017,740,624,88,29,116,117,11.083983644,9.3464943157,1.3180953522,0.43437233200000003,1.7374893279,1.7524676842
21031,2010,36,15,13,4,21,17,NA,NA,NA,NA,NA,NA
21031,2011,144,154,-25,19,-10,-6,11.322089869,12.10834611,-1.965640602,1.4938868577,-0.786256241,-0.471753745
21031,2012,147,154,4,20,-7,24,11.557512383,12.107870116,0.3144901329,1.5724506644,-0.550357733,1.8869407972
21031,2013,145,135,-45,-1,10,-46,11.407891114,10.621140002,-3.540380001,-0.078675111,0.7867511113,-3.619055112
21031,2014,175,148,6,2,27,8,13.769227743,11.644832606,0.4720878083,0.1573626028,2.1243951375,0.6294504111
21031,2015,154,140,-18,2,14,-16,12.102636646,11.002396951,-1.414593894,0.1571770993,1.1002396951,-1.257416794
21031,2016,148,129,-42,2,19,-40,11.64254248,10.147891756,-3.303964758,0.1573316551,1.4946507237,-3.146633103
21031,2017,144,125,109,2,19,111,11.2799624,9.7916340279,8.5383048723,0.1566661444,1.4883283722,8.6949710168
29023,2010,125,146,17,1,-21,18,NA,NA,NA,NA,NA,NA
29023,2011,543,566,230,-8,-23,222,12.661474607,13.197780161,5.3630555426,-0.186541062,-0.536305554,5.1765144802
29023,2012,580,514,-53,-1,66,-54,13.492608144,11.95724239,-1.232945227,-0.023263117,1.5353657544,-1.256208344
29023,2013,582,589,-8,2,-7,-6,13.541654548,13.704526682,-0.186139581,0.0465348954,-0.162872134,-0.139604686
29023,2014,581,561,-118,1,20,-117,13.53775893,13.071743132,-2.749493208,0.0233007899,0.4660157979,-2.726192418
29023,2015,528,628,79,3,-100,82,12.321334811,14.65492095,1.8435330494,0.0700075842,-2.333586138,1.9135406336
29023,2016,544,525,-73,3,19,-70,12.705975779,12.26220089,-1.705029838,0.0700697194,0.4437748893,-1.634960119
29023,2017,539,515,-148,3,24,-145,12.614826517,12.053127377,-3.463811363,0.0702123925,0.5616991399,-3.39359897
31023,2010,19,39,-1,0,-20,-1,NA,NA,NA,NA,NA,NA
31023,2011,91,96,-116,1,-5,-115,10.945393312,11.546788549,-13.9523695,0.1202790474,-0.601395237,-13.83209045
31023,2012,99,98,-5,1,1,-4,11.996364738,11.875189337,-0.605877007,0.1211754014,0.1211754014,-0.484701606
31023,2013,85,101,-7,2,-16,-5,10.314908076,12.256537831,-0.849463018,0.2427037194,-1.941629755,-0.606759299
31023,2014,105,94,-66,3,11,-63,12.798634812,11.457825451,-8.044856168,0.3656752804,1.3408093613,-7.679180887
31023,2015,83,106,-102,3,-23,-99,10.224822913,13.058207576,-12.56544503,0.3695719125,-2.833384663,-12.19587311
31023,2016,79,98,-37,4,-19,-33,9.8368820819,12.202714481,-4.607147304,0.4980699788,-2.365832399,-4.109077325
31023,2017,80,88,54,4,-8,58,9.9638809316,10.960269025,6.7256196288,0.4981940466,-0.996388093,7.2238136754
39017,2010,1158,631,311,143,527,454,NA,NA,NA,NA,NA,NA
39017,2011,4545,3050,-1166,640,1495,-526,12.298126058,8.2528678716,-3.155030799,1.7317493239,4.0452581862,-1.423281476
39017,2012,4470,3016,-1611,553,1454,-1058,12.073233479,8.1460564147,-4.351225757,1.4936237392,3.9271770646,-2.857602018
39017,2013,4703,3039,-1741,663,1664,-1078,12.685970309,8.1974619967,-4.696209719,1.7883900309,4.4885083128,-2.907819688
39017,2014,4419,3095,382,734,1324,1116,11.872569367,8.3153659634,1.0263230365,1.9720447874,3.5572034041,2.998367824
39017,2015,4536,3286,174,810,1250,984,12.11284493,8.7748695853,0.4646461679,2.1630080232,3.3379753444,2.6276541911
39017,2016,4526,3283,284,844,1243,1128,12.013239514,8.7139781978,0.7538135267,2.2402063963,3.2992613158,2.994019923
39017,2017,4531,3347,668,839,1184,1507,11.946681573,8.8248826359,1.7612852109,2.2121531316,3.1217989366,3.9734383425
42019,2010,491,376,106,21,115,127,NA,NA,NA,NA,NA,NA
42019,2011,1761,1869,598,56,-108,654,9.5526112369,10.13846133,3.2438736625,0.3037741222,-0.585850093,3.5476477848
42019,2012,1810,1837,229,70,-27,299,9.7979510914,9.9441083729,1.2396302762,0.3789262853,-0.146157281,1.6185565615
42019,2013,1782,1940,246,93,-158,339,9.6358440421,10.490200585,1.3302006927,0.5028807497,-0.854356542,1.8330814423
42019,2014,1825,1929,702,113,-104,815,9.8458118883,10.406888292,3.7872657236,0.6096310923,-0.561076404,4.3968968159
42019,2015,1805,1946,232,123,-141,355,9.7149561885,10.473853043,1.2486813494,0.6620164051,-0.758896855,1.9106977545
42019,2016,1852,1902,240,128,-50,368,9.9543668603,10.223113266,1.2899827465,0.6879907981,-0.268746406,1.9779735446
42019,2017,1838,1969,913,129,-131,1042,9.8469121251,10.548732304,4.8913116269,0.6911053668,-0.701820179,5.5824169937
06007,2010,622,517,-182,52,105,-130,NA,NA,NA,NA,NA,NA
06007,2011,2440,2182,-312,127,258,-185,11.091917447,9.9190835531,-1.418310756,0.5773252114,1.172833894,-0.840985544
06007,2012,2402,2245,642,186,157,828,10.894115726,10.182052375,2.9117494988,0.8435909763,0.712063351,3.7553404751
06007,2013,2324,2303,556,237,21,793,10.498331967,10.403467521,2.511649128,1.0706130276,0.0948644455,3.5822621556
06007,2014,2503,2167,1246,289,336,1535,11.239411132,9.7306447955,5.595008498,1.2977186645,1.5087663365,6.8927271625
06007,2015,2473,2307,729,316,166,1045,11.029174016,10.288841268,3.2512203226,1.4093081234,0.7403327484,4.6605284459
06007,2016,2454,2386,1324,317,68,1641,10.874213182,10.572890241,5.8669349032,1.4046966498,0.3013229406,7.2716315529
06007,2017,2473,2373,2346,316,100,2662,10.850798234,10.412027581,10.293559505,1.3865152615,0.4387706524,11.680074767
16023,2010,15,0,7,0,15,7,NA,NA,NA,NA,NA,NA
16023,2011,27,27,-84,-1,0,-85,9.3945720251,9.3945720251,-29.22755741,-0.347947112,0,-29.57550452
16023,2012,32,25,-78,-3,7,-81,11.442875022,8.9397461112,-27.89200787,-1.072769533,2.5031289111,-28.9647774
16023,2013,25,30,-89,-2,-5,-91,9.2148912643,11.057869517,-32.8050129,-0.737191301,-1.842978253,-33.5422042
16023,2014,24,33,0,0,-9,0,9.0174713507,12.399023107,0,0,-3.381551757,0
16023,2015,33,24,-105,1,9,-104,12.638835695,9.1918805056,-40.21447721,0.3829950211,3.4469551896,-39.83148219
16023,2016,29,21,1,1,8,2,11.288439081,8.174386921,0.38925652,0.38925652,3.1140521604,0.7785130401
16023,2017,29,15,14,1,14,15,11.207729469,5.7971014493,5.4106280193,0.38647343,5.4106280193,5.7971014493
46019,2010,30,14,16,1,16,17,NA,NA,NA,NA,NA,NA
46019,2011,129,102,138,-3,27,135,12.614903188,9.9745746137,13.495012713,-0.293369842,2.6403285741999998,13.201642871
46019,2012,124,128,-86,-1,-4,-87,12.084003313,12.473809872,-8.380841008,-0.09745164,-0.389806558,-8.478292647
46019,2013,127,102,43,-2,25,41,12.391452825,9.9521904576,4.1955312713,-0.195140989,2.4392623671,4.000390282
46019,2014,141,96,-77,-3,45,-80,13.736665205,9.3526231185,-7.501583126,-0.292269472,4.3840420868,-7.793852599
46019,2015,119,105,-49,-3,14,-52,11.635296993,10.266438524,-4.791004644,-0.293326815,1.3688584698,-5.084331459
46019,2016,116,103,-90,-3,13,-93,11.40890091,10.130317187,-8.851733464,-0.295057782,1.2785837226,-9.146791247
46019,2017,115,101,-30,-3,14,-33,11.367006029,9.9831965998,-2.965305921,-0.296530592,1.3838094297,-3.261836513
13035,2010,72,41,55,2,31,57,NA,NA,NA,NA,NA,NA
13035,2011,282,248,-212,4,34,-208,11.918346646,10.481382866,-8.959891805,0.1690545624,1.4369637801,-8.790837243
13035,2012,281,214,-238,4,67,-234,11.960755102,9.1089024624,-10.13046162,0.1702598591,2.8518526401,-9.960201758
13035,2013,284,279,-212,-1,5,-213,12.184919017,11.970395795,-9.095784619,-0.042904644,0.2145232221,-9.138689263
13035,2014,282,262,98,-1,20,97,12.123817713,11.263972485,4.2132416165,-0.042992261,0.8598452279,4.1702493551
13035,2015,225,245,190,0,-20,190,9.6141520318,10.468743324,8.1186172713,0,-0.854591292,8.1186172713
13035,2016,252,252,219,1,0,220,10.678192335,10.678192335,9.2798576241,0.0423737791,0,9.3222314032
13035,2017,273,264,337,1,9,338,11.430006908,11.053193494,14.109568967,0.0418681572,0.3768134146,14.151437124
37025,2010,571,384,231,41,187,272,NA,NA,NA,NA,NA,NA
37025,2011,2328,1386,1551,187,942,1738,12.941781441,7.7050296721,8.6222951093,1.0395674954,5.2367517685,9.6618626048
37025,2012,2274,1408,1996,122,866,2118,12.444590379,7.7053576315,10.923220051,0.6676517266,4.7392327478,11.590871778
37025,2013,2253,1489,2015,134,764,2149,12.132733069,8.0184818197,10.851068413,0.7216095123,4.1142512494,11.572677925
37025,2014,2392,1415,3277,188,977,3465,12.628622414,7.4705270549,17.301001526,0.992550591,5.1580953588,18.293552117
37025,2015,2340,1550,3604,223,790,3827,12.062570719,7.9901643654,18.578420886,1.1495526797,4.072406354,19.727973565
37025,2016,2501,1549,4076,228,952,4304,12.57137687,7.7861106643,20.488177578,1.1460511501,4.7852662056,21.634228728
37025,2017,2522,1547,4086,229,975,4315,12.349275912,7.575071307,20.007589761,1.1213260047,4.7742046053,21.128915766
54011,2010,300,297,22,20,3,42,NA,NA,NA,NA,NA,NA
54011,2011,1137,1158,102,86,-21,188,11.791242125,12.009022322,1.057789531,0.8918617614,-0.217780198,1.9496512924
54011,2012,1221,1085,102,92,136,194,12.631578947,11.224621751,1.0552178973,0.9517651623,1.4069571964,2.0069830596
54011,2013,1214,1201,18,51,13,69,12.53394179,12.399723303,0.1858409821,0.5265494492,0.134218487,0.7123904313
54011,2014,1143,1207,-367,63,-64,-304,11.819512019,12.481321965,-3.795066414,0.6514691664,-0.661809947,-3.143597247
54011,2015,1128,1286,50,69,-158,119,11.690572921,13.328082249,0.5181991543,0.7151148329,-1.637509328,1.2333139872
54011,2016,1063,1142,-782,69,-79,-713,11.065366859,11.887722439,-8.140279289,0.7182599372,-0.82235558,-7.422019351
54011,2017,1084,1092,-769,69,-8,-700,11.372995431,11.456928976,-8.068112072,0.7239268309,-0.083933546,-7.344185241
49005,2010,639,86,96,66,553,162,NA,NA,NA,NA,NA,NA
49005,2011,2503,502,-797,231,2001,-566,21.938339505,4.3999386463,-6.985559962,2.0246729627,17.538400859,-4.960887
49005,2012,2336,478,-1073,258,1858,-815,20.254218184,4.144484714,-9.303414431,2.2369812891,16.10973347,-7.066433142
49005,2013,2387,517,-907,221,1870,-686,20.497979828,4.4396546172,-7.788717094,1.8978020704,16.058325211,-5.890915024
49005,2014,2350,508,-1249,215,1842,-1034,20.007662509,4.3250606615,-10.63385978,1.8304882721,15.682601848,-8.803371504
49005,2015,2354,520,-172,236,1834,64,19.813563959,4.3768280622,-1.447720051,1.9864065821,15.436735896,0.5386865307
49005,2016,2408,529,470,243,1879,713,19.893428064,4.3702755174,3.8828534842,2.0075178653,15.523152547,5.8903713495
49005,2017,2437,531,-48,242,1906,194,19.750384958,4.3034281546,-0.389010455,1.9612610422,15.446956804,1.5722505876
40015,2010,118,47,35,-1,71,34,NA,NA,NA,NA,NA,NA
40015,2011,471,353,-205,-7,118,-212,15.88184715,11.902955507,-6.912481244,-0.236035945,3.9788916426,-7.148517188
40015,2012,402,363,86,11,39,97,13.546984785,12.232725067,2.8981111729,0.3706886384,1.3142597179,3.2687998113
40015,2013,402,357,-209,20,45,-189,13.549724455,12.032964255,-7.044508485,0.6741156445,1.5167602002,-6.370392841
40015,2014,405,362,-208,24,43,-184,13.716724243,12.260380681,-7.044638624,0.8128429181,1.4563435616,-6.231795705
40015,2015,382,355,-93,28,27,-65,12.97708627,12.05985766,-3.159342993,0.9512000408,0.9172286107,-2.208142952
40015,2016,401,380,73,30,21,103,13.602442334,12.89009498,2.4762550882,1.0176390773,0.7123473541,3.4938941655
40015,2017,373,367,-404,30,6,-374,12.70544154,12.501064464,-13.76138976,1.0218853785,0.2043770757,-12.73950439
22017,2010,981,595,254,56,386,310,NA,NA,NA,NA,NA,NA
22017,2011,3871,2641,25,119,1230,144,15.101803556,10.303245464,0.0975316685,0.4642507422,4.7985580918,0.5617824107
22017,2012,3863,2634,-1084,240,1229,-844,15.020578932,10.241834043,-4.214938535,0.9331967237,4.7787448893,-3.281741812
22017,2013,3799,2873,-3268,188,926,-3080,14.821924275,11.209104618,-12.7502102,0.7334882242,3.6128196575,-12.01672197
22017,2014,3772,2783,-3692,186,989,-3506,14.849107558,10.955743991,-14.53417421,0.7322200439,3.8933635669,-13.80195416
22017,2015,3626,2728,-2314,201,898,-2113,14.378447397,10.81754123,-9.175876249,0.7970402446,3.5609061673,-8.378836004
22017,2016,3486,2773,-3323,182,713,-3141,13.923893897,11.076006247,-13.27283403,0.7269502838,2.8478876502,-12.54588374
22017,2017,3380,2689,-3430,167,691,-3263,13.636565361,10.848734987,-13.8382897,0.6737592944,2.787830374,-13.16453041
06009,2010,74,141,-39,5,-67,-34,NA,NA,NA,NA,NA,NA
06009,2011,334,450,-205,15,-116,-190,7.3703838558,9.9301578895,-4.523738594,0.331005263,-2.559774034,-4.192733331
06009,2012,356,451,-249,9,-95,-240,7.9120781429000004,10.02344731,-5.534009712,0.2000244474,-2.111369167,-5.333985265
06009,2013,323,510,12,24,-187,36,7.2184416658,11.397539472,0.2681773993,0.5363547987,-4.179097807,0.804532198
06009,2014,365,476,95,28,-111,123,8.1706661891,10.655444126,2.1266117479,0.6267908309,-2.484777937,2.7534025788
06009,2015,357,474,364,29,-117,393,7.9659939084,10.576697794,8.1221898673,0.6470975444,-2.610703886,8.7692874117
06009,2016,378,511,467,27,-133,494,8.3749681507,11.321716204,10.346852186,0.5982120108,-2.946748053,10.945064197
06009,2017,387,515,455,27,-128,482,8.5068967412,11.320547343,10.001648623,0.5935044238,-2.813650602,10.595153047
22019,2010,599,498,136,46,101,182,NA,NA,NA,NA,NA,NA
22019,2011,2610,1860,-87,145,750,58,13.493637052,9.6161551406,-0.449787902,0.7496465029,3.8774819115,0.2998586012
22019,2012,2728,1817,-366,164,911,-202,14.050304003,9.3582853273,-1.885048118,0.8446663697,4.6920186754,-1.040381748
22019,2013,2740,1930,60,158,810,218,14.050849717,9.8971313703,0.3076828405,0.8102314801,4.1537183471,1.1179143206
22019,2014,2772,1988,244,144,784,388,14.13755556,10.139054997,1.2444312974,0.7344184706,3.9985005623,1.9788497681
22019,2015,2766,2014,996,162,752,1158,13.998577874,10.192746145,5.0407026618,0.8198733245,3.8058317286,5.8605759863
22019,2016,2915,2010,1014,173,905,1187,14.605159655,10.070796194,5.0804912144,0.8667899212,4.5343634605,5.9472811355
22019,2017,2868,1999,779,170,869,949,14.230531635,9.9187003972,3.8652664379,0.8435112894,4.3118312382,4.7087777273
21033,2010,39,26,9,0,13,9,NA,NA,NA,NA,NA,NA
21033,2011,139,167,45,0,-28,45,10.682036503,12.833813641,3.4582132565,0,-2.151777137,3.4582132565
21033,2012,158,175,-15,0,-17,-15,12.150107659,13.457397724,-1.153491233,0,-1.307290065,-1.153491233
21033,2013,157,169,-93,-1,-12,-94,12.137611133,13.065326633,-7.189795129,-0.077309625,-0.927715501,-7.267104755
21033,2014,160,166,-27,-1,-6,-28,12.437327529,12.903727312,-2.098799021,-0.077733297,-0.466399782,-2.176532318
21033,2015,134,196,-35,-1,-62,-36,10.471204188,15.316089709,-2.735016019,-0.078143315,-4.84488552,-2.813159334
21033,2016,135,153,-108,-1,-18,-109,10.644169361,12.063391942,-8.515335488,-0.078845699,-1.419222581,-8.594181187
21033,2017,128,152,46,-1,-24,45,10.135402645,12.035790641,3.6424103254,-0.079182833,-1.900387996,3.5632274923
29025,2010,23,12,0,0,11,0,NA,NA,NA,NA,NA,NA
29025,2011,91,97,-151,1,-6,-150,9.7248196634,10.366016564,-16.13678867,0.1068661501,-0.641196901,-16.02992252
29025,2012,91,112,-172,0,-21,-172,9.9053009688,12.191139654,-18.72210733,0,-2.285838685,-18.72210733
29025,2013,86,105,-32,2,-19,-30,9.4828536774,11.577902746,-3.528503694,0.2205314809,-2.095049068,-3.307972213
29025,2014,90,111,-23,3,-21,-20,9.972299169,12.299168975,-2.548476454,0.3324099723,-2.326869806,-2.216066482
29025,2015,93,101,12,3,-8,15,10.324156306,11.212255773,1.3321492007,0.3330373002,-0.888099467,1.6651865009
29025,2016,110,90,36,3,20,39,12.167468613,9.9552015928,3.9820806371,0.3318400531,2.2122670206,4.3139206902
29025,2017,109,89,8,3,20,11,11.997798569,9.796367639,0.880572372,0.3302146395,2.2014309301,1.2107870116
37027,2010,174,206,4,2,-32,6,NA,NA,NA,NA,NA,NA
37027,2011,808,899,-492,16,-91,-476,9.7670061346,10.867003113,-5.947236409,0.1934060621,-1.099996978,-5.753830347
37027,2012,823,847,-340,19,-24,-321,10.003524936,10.295243768,-4.132683449,0.2309440751,-0.291718832,-3.901739374
37027,2013,754,949,113,40,-195,153,9.1874470717,11.563510969,1.3768985664,0.4873977226,-2.376063898,1.8642962891
37027,2014,846,919,-334,54,-73,-280,10.334591564,11.226347101,-4.080086977,0.6596547807,-0.891755537,-3.420432196
37027,2015,802,976,-15,59,-174,44,9.8273474739,11.959465255,-0.183803257,0.7229594775,-2.132117781,0.5391562205
37027,2016,810,943,320,65,-133,385,9.9189341432,11.547598638,3.9185912664,0.795963851,-1.628664495,4.7145551174
37027,2017,795,935,278,63,-140,341,9.708856431,11.418592155,3.3950466514,0.7693810757,-1.709735724,4.164427727
48055,2010,115,38,-5,1,77,-4,NA,NA,NA,NA,NA,NA
48055,2011,485,281,89,5,204,94,12.671456564,7.3416067929,2.3252775963,0.1306335728,5.3298497714,2.4559111692
48055,2012,452,299,112,2,153,114,11.724120043,7.7555572848,2.905091692,0.0518766374,3.9685627578,2.9569683293
48055,2013,477,285,327,3,192,330,12.248199361,7.3181065362,8.3965643416,0.0770327004,4.9300928244,8.4735970419
48055,2014,484,346,347,5,138,352,12.269005551,8.7708180182,8.7961672032,0.1267459251,3.4981875333,8.9229131283
48055,2015,530,335,477,11,195,488,13.238416386,8.3676782815,11.914574747,0.2747595854,4.8707381042,12.189334332
48055,2016,553,307,473,12,246,485,13.573050255,7.5351291649,11.609498681,0.2945327361,6.0379210898,11.904031417
48055,2017,561,312,967,12,249,979,13.44582125,7.4778898929,23.176665149,0.2876111497,5.9679313568,23.464276298
22021,2010,38,15,1,0,23,1,NA,NA,NA,NA,NA,NA
22021,2011,141,115,-56,3,26,-53,13.903954245,11.340104526,-5.522137856,0.2958288137,2.563849719,-5.226309043
22021,2012,103,151,-33,1,-48,-32,10.211162883,14.969763061,-3.271537623,0.0991375037,-4.758600178,-3.172400119
22021,2013,102,124,-49,7,-22,-42,10.186248564,12.383282569,-4.893393918,0.699056274,-2.197034004,-4.194337644
22021,2014,134,124,-54,10,10,-44,13.449089175,12.445425804,-5.419782205,1.0036633713,1.0036633713,-4.416118834
22021,2015,143,124,75,13,19,88,14.301430143,12.401240124,7.500750075,1.300130013,1.900190019,8.800880088
22021,2016,119,124,11,14,-5,25,11.827262337,12.324206132,1.0932763504,1.3914426278,-0.496943796,2.4847189783
22021,2017,114,121,-129,14,-7,-115,11.388042555,12.087308326,-12.88646921,1.3985315419,-0.699265771,-11.48793767
50005,2010,63,94,-33,-1,-31,-34,NA,NA,NA,NA,NA,NA
50005,2011,306,296,-79,0,10,-79,9.8299041102,9.5086654138,-2.537785702,0,0.3212386964,-2.537785702
50005,2012,282,307,-52,-3,-25,-55,9.0805171387,9.8855275233,-1.6744216,-0.096601246,-0.805010385,-1.771022846
50005,2013,278,306,57,2,-28,59,8.9597937314,9.8622189993,1.8370800097,0.0644589477,-0.902425268,1.9015389574
50005,2014,311,302,-179,2,9,-177,10.04635537,9.7556248284,-5.782307431,0.0646067869,0.2907305412,-5.717700644
50005,2015,273,328,-189,3,-55,-186,8.8770383859,10.665452713,-6.145641959,0.0975498724,-1.788414327,-6.048092087
50005,2016,280,313,-435,2,-33,-433,9.2103748294,10.295883291,-14.30897518,0.0657883916,-1.085508462,-14.24318679
50005,2017,263,285,20,2,-22,22,8.7185692264,9.4478791997,0.6630090666,0.0663009067,-0.729309973,0.7293099733
01015,2010,317,313,-112,-3,4,-115,NA,NA,NA,NA,NA,NA
01015,2011,1383,1326,-773,27,57,-746,11.707886951,11.225349311,-6.543887645,0.2285704611,0.4825376401,-6.315317184
01015,2012,1358,1356,-603,43,2,-560,11.557250089,11.540229102,-5.131827543,0.3659512179,0.0170209869,-4.765876326
01015,2013,1308,1411,-654,24,-103,-630,11.193790356,12.075258557,-5.596895178,0.2053906487,-0.881468201,-5.391504529
01015,2014,1317,1392,-532,73,-75,-459,11.332785482,11.978160509,-4.577860195,0.6281650267,-0.645375027,-3.949695168
01015,2015,1387,1454,-436,77,-67,-359,11.98551714,12.564485884,-3.7676175,0.6653819898,-0.578968744,-3.102235511
01015,2016,1343,1450,-498,82,-107,-416,11.653686791,12.582163698,-4.321322429,0.7115430505,-0.928476907,-3.609779378
01015,2017,1342,1427,-247,82,-85,-165,11.684399324,12.424469326,-2.150556359,0.7139498842,-0.740070002,-1.436606474
05013,2010,15,4,-16,0,11,-16,NA,NA,NA,NA,NA,NA
05013,2011,41,57,-105,0,-16,-105,7.7322017916,10.749646393,-19.8019802,0,-3.017444602,-19.8019802
05013,2012,48,50,37,0,-2,37,9.124607927,9.504799924,7.0335519437,0,-0.380191997,7.0335519437
05013,2013,50,70,-66,0,-20,-66,9.5501862286,13.37026072,-12.60624582,0,-3.820074491,-12.60624582
05013,2014,46,65,-4,0,-19,-4,8.8794517904,12.547051443,-0.772126243,0,-3.667599653,-0.772126243
05013,2015,43,57,46,0,-14,46,8.2939531295,10.994309962,8.8726010223,0,-2.700356833,8.8726010223
05013,2016,54,58,-35,0,-4,-35,10.42169256,11.193669787,-6.754800733,0,-0.771977227,-6.754800733
05013,2017,45,48,89,0,-3,89,8.6463637237,9.2227879719,17.100586031,0,-0.576424248,17.100586031
12013,2010,39,14,-3,1,25,-2,NA,NA,NA,NA,NA,NA
12013,2011,134,163,93,6,-29,99,9.1280653951,11.103542234,6.3351498638,0.408719346,-1.975476839,6.7438692098
12013,2012,168,156,-69,6,12,-63,11.437519148,10.620553494,-4.697552507,0.4084828267,0.8169656534,-4.28906968
12013,2013,129,150,-69,5,-21,-64,8.8232276598,10.259567046,-4.719400841,0.3419855682,-1.436339386,-4.377415273
12013,2014,151,156,-125,6,-5,-119,10.403031347,10.747502584,-8.611780916,0.413365484,-0.344471237,-8.198415432
12013,2015,132,164,-12,6,-32,-6,9.1457077531,11.362849027,-0.831427978,0.4157139888,-2.217141273,-0.415713989
12013,2016,143,168,-33,6,-25,-27,9.9391833189,11.67680278,-2.2936576890000002,0.4170286707,-1.737619461,-1.876629018
12013,2017,143,158,130,5,-15,135,9.9154070171,10.955484676,9.0140063791,0.346692553,-1.040077659,9.3606989322
13037,2010,12,3,-12,2,9,-10,NA,NA,NA,NA,NA,NA
13037,2011,70,56,-89,5,14,-84,10.511299647,8.4090397177,-13.36436669,0.7508071177,2.1022599294,-12.61355958
13037,2012,58,69,-57,8,-11,-49,8.7938746115,10.461678417,-8.642256084,1.2129482223,-1.667803806,-7.429307861
13037,2013,68,69,26,8,-1,34,10.330421572,10.482339537,3.9498670718,1.2153437144,-0.151917964,5.1652107862
13037,2014,44,75,-60,6,-31,-54,6.7098741899,11.437285551,-9.149828441,0.9149828441,-4.727411361,-8.234845597
13037,2015,54,59,32,10,-5,42,8.2644628099,9.0296908479,4.8974594429,1.5304560759,-0.765228038,6.4279155188
13037,2016,44,48,-165,10,-4,-155,6.7979915025,7.41599073,-25.49246813,1.5449980688,-0.617999228,-23.94747007
13037,2017,50,46,48,10,4,58,7.7833125778,7.1606475716,7.4719800747,1.5566625156,0.6226650062,9.0286425903
17013,2010,12,4,-1,0,8,-1,NA,NA,NA,NA,NA,NA
17013,2011,58,50,-59,2,8,-57,11.43533123,9.858044164,-11.63249211,0.3943217666,1.5772870662,-11.23817035
17013,2012,51,59,-58,2,-8,-56,10.166450713,11.761188079,-11.56184591,0.3986843417,-1.594737367,-11.16316157
17013,2013,39,53,35,2,-14,37,7.806244996,10.608486789,7.0056044836,0.4003202562,-2.802241793,7.4059247398
17013,2014,56,51,-90,2,5,-88,11.275546159,10.268800966,-18.12141347,0.4026980771,1.0067451928,-17.71871539
17013,2015,50,54,-63,2,-4,-61,10.216591745,11.033919085,-12.8729056,0.4086636698,-0.81732734,-12.46424193
17013,2016,42,54,7,3,-12,10,8.641086308,11.10996811,1.4401810513,0.6172204506,-2.468881802,2.0574015019
17013,2017,45,65,-8,3,-20,-5,9.2860090797,13.413124226,-1.650846059,0.619067272,-4.127115147,-1.031778787
19025,2010,28,44,-1,0,-16,-1,NA,NA,NA,NA,NA,NA
19025,2011,90,155,-33,2,-65,-31,8.9011967164,15.329838789,-3.263772129,0.1978043715,-6.428642073,-3.065967758
19025,2012,116,125,-147,0,-9,-147,11.616844424,12.518151319,-14.72134595,0,-0.901306895,-14.72134595
19025,2013,123,150,18,0,-27,18,12.419851568,15.146160448,1.8175392538,0,-2.726308881,1.8175392538
19025,2014,106,146,-18,0,-40,-18,10.741247403,14.79454831,-1.823985408,0,-4.053300907,-1.823985408
19025,2015,119,145,-22,0,-26,-22,12.124917214,14.774058791,-2.241581334,0,-2.649141576,-2.241581334
19025,2016,109,129,30,0,-20,30,11.128694676,13.170657001,3.0629434887,0,-2.041962326,3.0629434887
19025,2017,111,135,-29,0,-24,-29,11.358403684,13.814274751,-2.967510872,0,-2.455871067,-2.967510872
26025,2010,408,451,-202,39,-43,-163,NA,NA,NA,NA,NA,NA
26025,2011,1662,1466,-1263,149,196,-1114,12.26658794,10.819986715,-9.32172116,1.0997121559,1.4466012252,-8.222009004
26025,2012,1619,1451,-846,242,168,-604,12.008425925,10.762338491,-6.274940292,1.7949592796,1.2460874338,-4.479981012
26025,2013,1682,1457,-481,228,225,-253,12.497353043,10.825590597,-3.573856607,1.6940526122,1.6717624463,-1.879803995
26025,2014,1697,1456,-497,299,241,-198,12.6089444,10.818281112,-3.692778649,2.2216112998,1.7906632884,-1.471167349
26025,2015,1670,1449,-989,317,221,-672,12.427629523,10.783015077,-7.359835687,2.359017101,1.6446144458,-5.000818586
26025,2016,1633,1478,-451,321,155,-130,12.171489051,11.016203807,-3.361507386,2.3925584723,1.1552852437,-0.968948914
26025,2017,1620,1397,-590,318,223,-272,12.075764239,10.413483113,-4.397963519,2.3704277951,1.6622811268,-2.027535724
28013,2010,48,20,-18,0,28,-18,NA,NA,NA,NA,NA,NA
28013,2011,176,186,-52,0,-10,-52,11.782032401,12.45146606,-3.481055027,0,-0.669433659,-3.481055027
28013,2012,175,195,-51,-4,-20,-55,11.770244821,13.115415658,-3.430185634,-0.269034167,-1.345170837,-3.699219801
28013,2013,182,192,-110,0,-10,-110,12.322274882,12.999322952,-7.447528775,0,-0.67704807,-7.447528775
28013,2014,173,179,-9,2,-6,-7,11.766706342,12.174800204,-0.612140792,0.1360312872,-0.408093862,-0.476109505
28013,2015,181,204,-48,3,-23,-45,12.346100065,13.914941509,-3.274103885,0.2046314928,-1.568841445,-3.069472392
28013,2016,173,160,-79,3,13,-76,11.853780534,10.96303402,-5.412998047,0.2055568879,0.8907465141,-5.207441159
28013,2017,165,168,-70,3,-3,-67,11.357769747,11.564274652,-4.818447771,0.2065049045,-0.206504904,-4.611942867
45017,2010,40,73,-50,0,-33,-50,NA,NA,NA,NA,NA,NA
45017,2011,145,157,13,0,-12,13,9.6064661455,10.401484033,0.8612693786,0,-0.795017888,0.8612693786
45017,2012,167,155,-240,0,12,-240,11.146337394,10.34540297,-16.01868847,0,0.8009344235,-16.01868847
45017,2013,126,166,152,6,-40,158,8.439383791,11.118553248,10.180843938,0.4018754186,-2.679169457,10.582719357
45017,2014,149,170,-136,7,-21,-129,9.9902779175,11.398303664,-9.118642931,0.4693419156,-1.408025747,-8.649301016
45017,2015,128,181,-35,7,-53,-28,8.6495252897,12.230969355,-2.365104571,0.4730209143,-3.581444065,-1.892083657
45017,2016,137,152,2,8,-15,10,9.2856174597,10.302290904,0.1355564593,0.5422258371,-1.016673444,0.6777822963
45017,2017,138,186,-6,8,-48,2,9.3702257681,12.629434731,-0.40740112,0.5432014938,-3.259208963,0.1358003735
48057,2010,72,73,-77,6,-1,-71,NA,NA,NA,NA,NA,NA
48057,2011,287,204,-56,19,83,-37,13.453019898,9.5624252936,-2.624979492,0.890618042,3.8905946047,-1.73436145
48057,2012,252,186,118,34,66,152,11.739768466,8.6650672009,5.4971931704,1.5839370152,3.0747012648,7.0811301856
48057,2013,285,208,53,32,77,85,13.16093281,9.6051720157,2.4474717155,1.4777187716,3.5557607943,3.9251904872
48057,2014,323,200,-87,36,123,-51,14.836931557,9.1869545246,-3.996325218,1.6536518144,5.6499770326,-2.342673404
48057,2015,316,207,-67,38,109,-29,14.46687726,9.4767202307,-3.067344229,1.7396877718,4.9901570297,-1.327656457
48057,2016,300,184,-97,41,116,-56,13.691440568,8.3974168815,-4.426899117,1.8711635443,5.2940236862,-2.555735573
48057,2017,302,213,-328,41,89,-287,13.82593966,9.7514077737,-15.01625235,1.8770315433,4.0745318866,-13.1392208
54013,2010,23,13,21,0,10,21,NA,NA,NA,NA,NA,NA
54013,2011,88,93,-10,-3,-5,-13,11.506276151,12.160041841,-1.307531381,-0.392259414,-0.65376569,-1.699790795
54013,2012,77,101,-14,-3,-24,-17,10.108966785,13.259813575,-1.837993961,-0.393855849,-3.15084679,-2.23184981
54013,2013,83,97,-32,-1,-14,-33,10.959265861,12.807816729,-4.225259127,-0.132039348,-1.848550868,-4.357298475
54013,2014,69,94,35,-1,-25,34,9.1330244871,12.44209133,4.6326935804,-0.132362674,-3.309066843,4.5003309067
54013,2015,62,90,-65,-1,-28,-66,8.2534611289,11.980830671,-8.652822151,-0.133120341,-3.727369542,-8.785942492
54013,2016,64,85,-77,-1,-21,-78,8.6299892125,11.461704423,-10.38295577,-0.134843581,-2.83171521,-10.51779935
54013,2017,61,82,-37,-1,-21,-38,8.3140248058,11.176230067,-5.042933079,-0.136295489,-2.862205261,-5.179228568
48059,2010,31,60,-3,0,-29,-3,NA,NA,NA,NA,NA,NA
48059,2011,120,158,33,3,-38,36,8.8826381435,11.695473556,2.4427254895,0.2220659536,-2.812835412,2.6647914431
48059,2012,122,142,-6,3,-20,-3,9.0400503872,10.52202586,-0.444592642,0.222296321,-1.481975473,-0.222296321
48059,2013,135,176,51,5,-41,56,10.007783832,13.047184847,3.7807183365,0.3706586604,-3.039401016,4.1513769969
48059,2014,140,178,36,6,-38,42,10.372291165,13.187627338,2.6671605853,0.4445267642,-2.815336173,3.1116873495
48059,2015,153,168,91,6,-15,97,11.300269582,12.408139148,6.7210753721,0.4431478267,-1.107869567,7.1642231988
48059,2016,153,194,232,7,-41,239,11.185437,14.182841686,16.960924078,0.5117520196,-2.997404686,17.472676098
48059,2017,157,181,185,7,-24,192,11.326335534,13.057749883,13.346318941,0.5049958518,-1.731414349,13.851314793
29027,2010,122,129,-21,6,-7,-15,NA,NA,NA,NA,NA,NA
29027,2011,499,347,-223,39,152,-184,11.266397236,7.8345487797,-5.034882933,0.8805400646,3.4318484568,-4.154342869
29027,2012,508,385,-61,45,123,-16,11.460154532,8.685353336,-1.376120918,1.0151711691,2.7748011956,-0.360949749
29027,2013,528,350,-60,20,178,-40,11.879183306,7.874458631,-1.349907194,0.4499690646,4.0047246752,-0.899938129
29027,2014,534,336,-94,24,198,-70,11.979674934,7.5377729919,-2.10878173,0.5384123566,4.4419019416,-1.570369373
29027,2015,516,398,-69,25,118,-44,11.551376763,8.909782852,-1.544660846,0.5596597269,2.6415939109,-0.985001119
29027,2016,468,387,265,27,81,292,10.425368396,8.6209777124,5.9032534723,0.6014635613,1.804390684,6.5047170337
29027,2017,482,393,-160,27,89,-133,10.698154457,8.7227690908,-3.551254592,0.5992742123,1.9753853666,-2.951980379
21035,2010,109,118,132,20,-9,152,NA,NA,NA,NA,NA,NA
21035,2011,402,390,213,82,12,295,10.720285874,10.400277341,5.6801514707,2.1867249793,0.3200085336,7.86687645
21035,2012,398,385,248,104,13,352,10.518526349,10.174956393,6.5542576246,2.748559649,0.3435699561,9.3028172736
21035,2013,358,382,183,143,-24,326,9.3786021167,10.00733522,4.7940899088,3.7462014042,-0.628733103,8.540291313
21035,2014,405,371,-141,211,34,70,10.554295989,9.6682563261,-3.674458604,5.4986579105,0.8860396633,1.8241993068
21035,2015,395,420,30,218,-25,248,10.251086745,10.899889703,0.7785635502,5.6575617985,-0.648802959,6.4361253487
21035,2016,387,394,-81,219,-7,138,9.9981915416,10.179037383,-2.092644741,5.6578913375,-0.180845842,3.5652465962
21035,2017,381,404,-47,218,-23,171,9.8080858787,10.400175052,-1.209921355,5.6119756471,-0.592089174,4.402054292
55015,2010,155,54,-43,1,101,-42,NA,NA,NA,NA,NA,NA
55015,2011,591,279,258,22,312,280,11.982360991,5.6566475746,5.2308784024,0.4460438948,6.3257134168,5.6769222971
55015,2012,599,298,-291,20,301,-271,12.068583402,6.0040698729,-5.863034675,0.4029577096,6.0645135293,-5.460076965
55015,2013,544,305,-261,21,239,-240,10.957027906,6.1431866018,-5.256956404,0.4229735037,4.8138413044,-4.8339829
55015,2014,518,386,-319,25,132,-294,10.450185097,7.7872035668,-6.435538699,0.5043525626,2.6629815306,-5.931186136
55015,2015,538,285,71,27,253,98,10.833341723,5.7388520282,1.4296789263,0.5436807185,5.0944896952,1.9733596448
55015,2016,492,342,-366,30,150,-336,9.8912366056,6.8756156893,-7.358115036,0.6031241833,3.0156209163,-6.754990853
55015,2017,485,344,251,31,141,282,9.7277240134,6.8996640425,5.0343478915,0.6217720503,2.8280599709,5.6561199418
24009,2010,234,90,92,17,144,109,NA,NA,NA,NA,NA,NA
24009,2011,929,649,15,42,280,57,10.420347158,7.2796612546,0.1682510305,0.4711028855,3.1406859034,0.639353916
24009,2012,908,614,-9,120,294,111,10.142758205,6.8586492706,-0.100533947,1.3404526262,3.2841089341,1.2399186792
24009,2013,950,642,366,69,308,435,10.545186123,7.1263257797,4.0626717062,0.7659135184,3.4188603429,4.8285852245
24009,2014,909,633,-245,75,276,-170,10.042978202,6.9936250842,-2.706853311,0.8286285645,3.0493531173,-1.878224746
24009,2015,881,662,-382,88,219,-294,9.731473197,7.3124123229,-4.219549105,0.9720427257,2.4190608742,-3.247506379
24009,2016,955,680,258,74,275,332,10.517968655,7.4892342258,2.8415035739,0.815004901,3.0287344296,3.6565084749
24009,2017,939,720,131,58,219,189,10.284719142,7.8860466263,1.4348223723,0.6352648671,2.3986725155,2.0700872394
16025,2010,7,0,-9,0,7,-9,NA,NA,NA,NA,NA,NA
16025,2011,13,6,-7,0,7,-7,11.653966831,5.378753922,-6.275212909,0,6.275212909,-6.275212909
16025,2012,9,3,-35,-1,6,-36,8.174386921,2.7247956403,-31.78928247,-0.908265213,5.4495912807,-32.69754768
16025,2013,13,11,-45,-1,2,-46,12.195121951,10.318949343,-42.21388368,-0.938086304,1.8761726079,-43.15196998
16025,2014,6,1,7,0,5,7,5.7088487155,0.9514747859,6.6603235014,0,4.7573739296,6.6603235014
16025,2015,9,5,11,0,4,11,8.4586466165,4.6992481203,10.338345865,0,3.7593984962,10.338345865
16025,2016,8,5,9,0,3,9,7.4245939675,4.6403712297,8.3526682135,0,2.7842227378,8.3526682135
16025,2017,10,5,13,0,5,13,9.1491308326,4.5745654163,11.893870082,0,4.5745654163,11.893870082
42021,2010,377,489,-107,11,-112,-96,NA,NA,NA,NA,NA,NA
42021,2011,1372,1876,-408,30,-504,-378,9.5939695049,13.118284833,-2.853017171,0.2097806743,-3.524315328,-2.643236496
42021,2012,1369,1766,-678,39,-397,-639,9.6381640318,12.433161198,-4.773320098,0.27457151,-2.794997166,-4.498748588
42021,2013,1317,1862,-2331,51,-545,-2280,9.3981810202,13.287329582,-16.63413816,0.3639386728,-3.889148562,-16.27019949
42021,2014,1280,1761,-927,42,-481,-885,9.2708276749,12.754630887,-6.71410723,0.3041990331,-3.483803212,-6.409908197
42021,2015,1302,1920,-963,46,-618,-917,9.5300834431,14.053579271,-7.048748353,0.3367003367,-4.523495828,-6.712048016
42021,2016,1331,1784,-1133,46,-453,-1087,9.8531648943,13.20664626,-8.387404827,0.3405301166,-3.353481365,-8.046874711
42021,2017,1276,1745,-834,46,-469,-788,9.5449326207,13.053218984,-6.238615835,0.344096317,-3.508286363,-5.894519518
13039,2010,195,48,-45,47,147,2,NA,NA,NA,NA,NA,NA
13039,2011,788,273,-850,-31,515,-881,15.608905792,5.4076539101,-16.83701767,-0.614055939,10.201251882,-17.45107361
13039,2012,798,319,317,247,479,564,15.699390124,6.2758213653,6.2364745229,4.8593350384,9.4235687586,11.095809561
13039,2013,862,313,-606,108,549,-498,16.776139736,6.0915681409,-11.7938987,2.1018829368,10.684571595,-9.692015764
13039,2014,801,330,-35,79,471,44,15.502375676,6.3867465333,-0.677382208,1.5289484125,9.1156291429,0.8515662044
13039,2015,753,333,-22,135,420,113,14.426945626,6.3800436832,-0.421504387,2.5865041959,8.0469019428,2.1649998084
13039,2016,804,363,-564,74,441,-490,15.332100154,6.9223288011,-10.75535384,1.4111634471,8.4097713534,-9.344190393
13039,2017,777,342,192,1,435,193,14.735444718,6.4858714204,3.6411909729,0.0189645363,8.2495732979,3.6601555092
29029,2010,98,80,44,5,18,49,NA,NA,NA,NA,NA,NA
29029,2011,444,444,-280,13,0,-267,10.106988391,10.106988391,-6.373776463,0.2959253358,0,-6.077851127
29029,2012,399,469,416,26,-70,442,9.0710680671,10.662483517,9.4575546765,0.5910971673,-1.59141545,10.048651844
29029,2013,397,434,123,24,-37,147,8.9759097435,9.8124554879,2.7809493664,0.5426242666,-0.836545744,3.323573633
29029,2014,411,495,328,35,-84,363,9.251026954,11.141747791,7.3828146981,0.7878003489,-1.890720837,8.170615047
29029,2015,419,478,227,40,-59,267,9.3786372997,10.699256872,5.0810278449,0.8953353031,-1.320619572,5.976363148
29029,2016,401,491,276,42,-90,318,8.9319523332,10.936629914,6.1476779151,0.9355162045,-2.004677581,7.0831941196
29029,2017,395,484,668,42,-89,710,8.715702607,10.679493827,14.739466687,0.9267329354,-1.96379122,15.666199623
34007,2010,1646,1125,-1022,324,521,-698,NA,NA,NA,NA,NA,NA
34007,2011,6572,4507,-3835,1410,2065,-2425,12.802356319,8.7797047978,-7.47063854,2.7467015232,4.0226515215,-4.723937017
34007,2012,6466,4381,-3961,1502,2085,-2459,12.604202505,8.5399027492,-7.721194885,2.927855268,4.0642997562,-4.793339617
34007,2013,6321,4691,-4305,1607,1630,-2698,12.338172502,9.1565206783,-8.403074295,3.1367573503,3.1816518238,-5.266316945
34007,2014,6321,4576,-4404,1741,1745,-2663,12.361263348,8.948764607,-8.6124037,3.4046763944,3.4124987411,-5.207727305
34007,2015,6312,4684,-3612,1877,1628,-1735,12.355611409,9.1688345754,-7.070416415,3.6741892609,3.1867768336,-3.396227154
34007,2016,6153,4671,-3496,1942,1482,-1554,12.046400078,9.1449268269,-6.844501003,3.8020654887,2.9014732514,-3.042435515
34007,2017,6153,4676,-3438,1930,1477,-1508,12.047461477,9.1555224874,-6.731541127,3.778904705,2.8919389893,-2.952636422
37029,2010,20,6,14,2,14,16,NA,NA,NA,NA,NA,NA
37029,2011,93,76,-15,11,17,-4,9.28514377,7.5878594249,-1.497603834,1.0982428115,1.697284345,-0.399361022
37029,2012,76,71,-37,11,5,-26,7.5908909309,7.0914902117,-3.695565322,1.0986815821,0.4994007191,-2.59688374
37029,2013,80,79,92,18,1,110,7.9550539452,7.8556157709,9.148312037,1.7898871377,0.0994381743,10.938199175
37029,2014,105,66,108,17,39,125,10.300176574,6.4743967039,10.594467334,1.6676476359,3.8257798705,12.26211497
37029,2015,87,88,-4,18,-1,14,8.4609773888,8.5582300024,-0.389010455,1.750547046,-0.097252614,1.3615365913
37029,2016,97,80,101,17,17,118,9.3665507918,7.7249903438,9.752800309,1.641560448,1.641560448,11.394360757
37029,2017,84,65,124,16,19,140,7.9984764807,6.1892972767,11.807274805,1.5235193297,1.809179204,13.330794134
42023,2010,12,18,-7,0,-6,-7,NA,NA,NA,NA,NA,NA
42023,2011,39,72,-41,0,-33,-41,7.745010426,14.298480786,-8.142190448,0,-6.55347036,-8.142190448
42023,2012,46,67,-17,2,-21,-15,9.2369477912,13.453815261,-3.413654618,0.4016064257,-4.21686747,-3.012048193
42023,2013,49,69,-28,3,-20,-25,9.9220411056,13.971853802,-5.669737775,0.6074719044,-4.049812696,-5.06226587
42023,2014,48,46,-108,5,2,-103,9.8643649815,9.4533497739,-22.19482121,1.0275380189,0.4110152076,-21.16728319
42023,2015,55,55,-57,5,0,-52,11.479858067,11.479858067,-11.89730745,1.0436234607,0,-10.85368399
42023,2016,44,72,-59,6,-28,-53,9.3141405588,15.241320914,-12.48941575,1.2701100762,-5.927180356,-11.21930567
42023,2017,41,67,-72,6,-26,-66,8.8409703504,14.447439353,-15.52560647,1.2938005391,-5.606469003,-14.23180593
48061,2010,1817,596,138,49,1221,187,NA,NA,NA,NA,NA,NA
48061,2011,7814,2321,-649,530,5493,-119,19.046760113,5.6574776327,-1.581948722,1.2918841643,13.38928248,-0.290064558
48061,2012,7362,2365,-2933,365,4997,-2568,17.776447053,5.7105809943,-7.082086282,0.8813370245,12.065866059,-6.200749257
48061,2013,7366,2455,-3812,586,4911,-3226,17.696840107,5.898145868,-9.158342993,1.4078669974,11.798694239,-7.750475996
48061,2014,7359,2604,-3776,730,4755,-3046,17.606674219,6.2301643792,-9.034216857,1.7465514581,11.37650984,-7.287665399
48061,2015,7250,2651,-4855,961,4599,-3894,17.294496653,6.3238221553,-11.58134914,2.2924153494,10.970674497,-9.288933788
48061,2016,7103,2701,-3246,1035,4402,-2211,16.884868871,6.4206716626,-7.716216297,2.4603462313,10.464197208,-5.255870065
48061,2017,7047,2739,-3403,1047,4308,-2356,16.669603816,6.4790754721,-8.049760435,2.4766674039,10.190528344,-5.573093031
22023,2010,20,19,45,0,1,45,NA,NA,NA,NA,NA,NA
22023,2011,77,40,-288,-3,37,-291,11.349399366,5.8957918785,-42.44970153,-0.442184391,5.4536074877,-42.89188592
22023,2012,53,39,-53,-2,14,-55,7.9807257943,5.8726095468,-7.980725794,-0.301159464,2.1081162476,-8.281885258
22023,2013,56,44,70,-2,12,68,8.4065150492,6.6051189672,10.508143811,-0.30023268,1.801396082,10.207911131
22023,2014,70,35,-20,-1,35,-21,10.433745715,5.2168728574,-2.981070204,-0.14905351,5.2168728574,-3.130123714
22023,2015,72,50,78,-1,22,77,10.643015521,7.3909830007,11.529933481,-0.14781966,3.2520325203,11.382113821
22023,2016,73,61,59,-1,12,58,10.656156485,8.9044595285,8.6125100358,-0.145974746,1.7516969564,8.4665352894
22023,2017,71,60,18,-1,11,17,10.291346572,8.696912596,2.6090737788,-0.144948543,1.5944339759,2.4641252355
48063,2010,55,57,-11,8,-2,-3,NA,NA,NA,NA,NA,NA
48063,2011,173,135,-50,25,38,-25,13.949363006,10.885341074,-4.031607805,2.0158039026,3.0640219319,-2.015803903
48063,2012,156,155,5,46,1,51,12.546244169,12.465819527,0.4021232106,3.6995335371,0.0804246421,4.1016567476
48063,2013,204,146,-111,29,58,-82,16.388833099,11.729262904,-8.917453304,2.3297850974,4.6595701948,-6.587668206
48063,2014,214,139,71,40,75,111,17.081055194,11.094704075,5.6670790597,3.192720597,5.9863511194,8.8597996568
48063,2015,202,145,-58,43,57,-15,15.977852482,11.469250544,-4.587700218,3.4012260233,4.5086019379,-1.186474194
48063,2016,170,123,20,45,47,65,13.365830647,9.6705715858,1.5724506644,3.5380139948,3.6952590612,5.1104646592
48063,2017,174,130,-8,46,44,38,13.577838471,10.144362076,-0.624268435,3.5895435037,3.4334763948,2.9652750683
21037,2010,285,194,169,6,91,175,NA,NA,NA,NA,NA,NA
21037,2011,942,716,161,70,226,231,10.370223587,7.8822506247,1.7724055176,0.7706110946,2.4879729626,2.5430166122
21037,2012,974,816,-425,96,158,-329,10.706237977,8.9694971146,-4.671613081,1.0552349547,1.7367408629,-3.616378126
21037,2013,1100,854,-244,123,246,-121,12.095488383,9.3904973445,-2.682999241,1.3524955192,2.7049910383,-1.330503722
21037,2014,1145,784,114,128,361,242,12.54169154,8.5874988362,1.2486924328,1.4020406263,3.9541927039,2.6507330591
21037,2015,1112,848,-79,141,264,62,12.120023107,9.2426075489,-0.861044807,1.536801491,2.8774155577,0.675756684
21037,2016,1099,893,-224,147,206,-77,11.949548766,9.7096879417,-2.435576819,1.5983472872,2.2398608242,-0.837229531
21037,2017,1068,890,134,145,178,279,11.575855454,9.6465462113,1.4524013397,1.5716283153,1.9293092423,3.024029655
46021,2010,3,2,4,0,1,4,NA,NA,NA,NA,NA,NA
46021,2011,13,17,-46,2,-4,-44,8.9779005525,11.740331492,-31.7679558,1.3812154696,-2.762430939,-30.38674033
46021,2012,4,17,-8,2,-13,-6,2.8268551237,12.014134276,-5.653710247,1.4134275618,-9.187279152,-4.240282686
46021,2013,14,18,-33,3,-4,-30,10.08282319,12.963629816,-23.76665466,2.1606049694,-2.880806626,-21.60604969
46021,2014,9,9,33,0,0,33,6.4841498559,6.4841498559,23.775216138,0,0,23.775216138
46021,2015,18,14,7,0,4,7,12.775017743,9.9361249113,4.9680624556,0,2.8388928318,4.9680624556
46021,2016,9,11,-25,0,-2,-25,6.4239828694,7.8515346181,-17.84439686,0,-1.427551749,-17.84439686
46021,2017,9,6,-11,0,3,-11,6.5052403325,4.3368268883,-7.950849295,0,2.1684134442,-7.950849295
47013,2010,104,94,8,0,10,8,NA,NA,NA,NA,NA,NA
47013,2011,403,533,-13,-17,-130,-30,9.9136552606,13.111608571,-0.319795331,-0.418193894,-3.19795331,-0.737989225
47013,2012,431,477,-24,-12,-46,-36,10.636066383,11.771238201,-0.592263557,-0.296131779,-1.135171818,-0.888395336
47013,2013,428,551,-123,-9,-123,-132,10.607844352,13.656360369,-3.048516017,-0.223062148,-3.048516017,-3.271578165
47013,2014,419,577,-150,-10,-158,-160,10.460355502,14.404833233,-3.74475734,-0.249650489,-3.944477731,-3.994407829
47013,2015,417,590,-20,-9,-173,-29,10.479756729,14.827473549,-0.502626222,-0.2261818,-4.34771682,-0.72880802200000006
47013,2016,440,581,138,-10,-141,128,11.088989138,14.642506112,3.4779102296,-0.25202248,-3.553516974,3.2258877492
47013,2017,433,579,134,-10,-146,124,10.917938955,14.59927634,3.378761709,-0.252146396,-3.681337384,3.1266153129
51031,2010,160,153,81,7,7,88,NA,NA,NA,NA,NA,NA
51031,2011,596,497,-223,6,99,-217,10.865701029,9.0608278716,-4.065522365,0.109386252,1.8048731575,-3.956136113
51031,2012,601,485,-100,32,116,-68,10.964552205,8.8482659223,-1.824384726,0.5838031124,2.1162862825,-1.240581614
51031,2013,559,526,182,39,33,221,10.170940948,9.5705097297,3.311469146,0.7096005313,0.6004312188,4.0210696773
51031,2014,546,531,116,47,15,163,9.8966829799,9.6247960848,2.1025919884,0.8519122712,0.2718868951,2.9545042596
51031,2015,554,557,-36,52,-3,16,10.026060518,10.080353265,-0.651512958,0.9410742725,-0.054292746,0.2895613146
51031,2016,511,553,-87,51,-42,-36,9.2540611022,10.014668864,-1.575544649,0.9235951394,-0.760607762,-0.65194951
51031,2017,524,539,-204,52,-15,-152,9.5108449043,9.7831019149,-3.702695344,0.9438243035,-0.272257011,-2.758871041
56005,2010,208,83,-25,-2,125,-27,NA,NA,NA,NA,NA,NA
56005,2011,722,240,-151,-3,482,-154,15.561518649,5.1728039831,-3.254555839,-0.06466005,10.388714666,-3.319215889
56005,2012,767,239,768,-14,528,754,16.246385868,5.0624331452,16.267567596,-0.296544201,11.183952722,15.971023395
56005,2013,732,223,-302,-20,509,-322,15.263991993,4.6500959213,-6.297439319,-0.417048962,10.613896071,-6.714488281
56005,2014,749,249,-361,-4,500,-365,15.564768347,5.1744022942,-7.50184429,-0.083122928,10.390366053,-7.584967218
56005,2015,767,274,601,1,493,602,15.735754219,5.6213776478,12.330102067,0.0205159768,10.114376571,12.350618044
56005,2016,808,216,-1093,5,592,-1088,16.474162275,4.4039839744,-22.28497446,0.1019440735,12.0701783,-22.18303039
56005,2017,747,292,-3032,5,455,-3027,15.719366175,6.1446518381,-63.80337114,0.1052166411,9.5747143368,-63.6981545
40017,2010,394,168,522,14,226,536,NA,NA,NA,NA,NA,NA
40017,2011,1613,861,2188,41,752,2229,13.686890115,7.3058973271,18.565973695,0.3478998727,6.3809927874,18.913873568
40017,2012,1615,840,2261,51,775,2312,13.354999028,6.9462533646,18.69699864,0.4217368114,6.4087456638,19.118735451
40017,2013,1718,920,2534,68,798,2602,13.83069077,7.4064234623,20.399866362,0.5474312994,6.4242673075,20.947297662
40017,2014,1686,885,2467,71,801,2538,13.209801579,6.9339705796,19.328932678,0.5562846454,6.2758309992,19.885217323
40017,2015,1732,941,2882,81,791,2963,13.198955972,7.1710263103,21.962696946,0.6172721904,6.0279296615,22.579969136
40017,2016,1767,992,2322,85,775,2407,13.117017604,7.3639397077,17.236963711,0.6309827371,5.7530778967,17.867946448
40017,2017,1775,998,2753,83,777,2836,12.851655691,7.2258886648,19.932736968,0.6009506605,5.6257670266,20.533687629
13043,2010,38,14,3,0,24,3,NA,NA,NA,NA,NA,NA
13043,2011,149,128,160,5,21,165,13.405308142,11.515969411,14.394961763,0.4498425551,1.8893387314,14.844804318
13043,2012,158,132,-131,5,26,-126,14.158974819,11.829016937,-11.73940317,0.4480688234,2.3299578815,-11.29133435
13043,2013,150,113,-194,13,37,-181,13.586956522,10.235507246,-17.57246377,1.1775362319,3.3514492754,-16.39492754
13043,2014,148,134,-115,17,14,-98,13.543811485,12.262640128,-10.52390757,1.555708076,1.2811713567,-8.968199497
13043,2015,126,143,11,23,-17,34,11.565999633,13.126491647,1.0097301267,2.1112539012,-1.560492014,3.1209840279
13043,2016,132,134,-9,24,-2,15,12.100100834,12.283435695,-0.825006875,2.2000183335,-0.183334861,1.3750114584
13043,2017,136,128,-150,25,8,-125,12.527634488,11.790714812,-13.81724392,2.3028739867,0.7369196758,-11.51436993
47015,2010,36,48,-2,1,-12,-1,NA,NA,NA,NA,NA,NA
47015,2011,148,156,-78,8,-8,-70,10.754250836,11.335561692,-5.667780846,0.581310856,-0.581310856,-5.08646999
47015,2012,144,162,91,7,-18,98,10.462835138,11.77068953,6.6119305384,0.5086100414,-1.307854392,7.1205405798
47015,2013,137,172,-80,16,-35,-64,9.9611008107,12.505907587,-5.816701203,1.1633402407,-2.544806776,-4.653360963
47015,2014,137,182,-55,11,-45,-44,10.030016839,13.324547917,-4.026649096,0.8053298192,-3.294531078,-3.221319277
47015,2015,167,193,153,11,-26,164,12.204033908,14.104063139,11.180941245,0.8038585209,-1.900029231,11.984799766
47015,2016,153,172,161,11,-19,172,11.062506778,12.43628213,11.640938505,0.7953436246,-1.373775352,12.43628213
47015,2017,164,141,275,11,23,286,11.663051595,10.027379725,19.556946272,0.7822778509,1.63567187,20.339224123
16027,2010,813,243,-119,6,570,-113,NA,NA,NA,NA,NA,NA
16027,2011,3151,1252,99,-22,1899,77,16.554543043,6.5776857789,0.5201205209,-0.115582338,9.9768572637,0.4045381829
16027,2012,2989,1256,634,-46,1733,588,15.529894658,6.5257770792,3.294062634,-0.23900139,9.0041175783,3.0550612441
16027,2013,3095,1434,3149,-66,1661,3083,15.789648215,7.3157853118,16.065138038,-0.336709784,8.473862903,15.728428254
16027,2014,3134,1336,2095,-35,1798,2060,15.642508292,6.668280497,10.456622486,-0.174692977,8.9742277947,10.281929509
16027,2015,3187,1410,2543,-10,1777,2533,15.587591553,6.8962987418,12.437792695,-0.04890992,8.6912928115,12.388882775
16027,2016,3238,1462,2728,-14,1776,2714,15.502762537,6.999703159,13.061005621,-0.067028621,8.5030593778,12.993977
16027,2017,3206,1443,3826,-18,1763,3808,14.987961946,6.7459853673,17.886444917,-0.084149506,8.2419765784,17.802295412
29031,2010,229,140,114,18,89,132,NA,NA,NA,NA,NA,NA
29031,2011,900,786,451,109,114,560,11.806298004,10.31083359,5.9162671109,1.4298738694,1.4954644139,7.3461409803
29031,2012,936,711,119,132,225,251,12.187817391,9.2580535951,1.5495195187,1.7187947603,2.9297637959,3.268314279
29031,2013,924,745,152,116,179,268,11.961397309,9.644200211,1.9676757477,1.5016472812,2.3171970977,3.4693230289
29031,2014,895,718,158,106,177,264,11.52140471,9.242869924,2.0339463064,1.3645462562,2.2785347863,3.3984925626
29031,2015,908,792,36,113,116,149,11.637519465,10.150787904,0.4613994502,1.4482816075,1.4867315616,1.9096810576
29031,2016,923,801,6,111,122,117,11.792437764,10.233740681,0.0766572336,1.418158821,1.5586970826,1.4948160546
29031,2017,897,765,-471,109,132,-362,11.459524372,9.7731729596,-6.01720845,1.3925174544,1.6863514126,-4.624690995
34009,2010,236,350,54,33,-114,87,NA,NA,NA,NA,NA,NA
34009,2011,890,1278,-488,215,-388,-273,9.1855322706,13.190011508,-5.036561515,2.2189768968,-4.004479237,-2.817584618
34009,2012,961,1250,-122,254,-289,132,9.9612330783,12.956858843,-1.264589423,2.6328337169,-2.995625764,1.3682442938
34009,2013,890,1382,-335,152,-492,-183,9.2664414262,14.38901354,-3.4879302,1.5825832548,-5.122572114,-1.905346945
34009,2014,927,1288,-325,141,-361,-184,9.7144354205,13.497511134,-3.405816086,1.4776002096,-3.783075714,-1.928215876
34009,2015,923,1302,-512,174,-379,-338,9.7379818217,13.736568074,-5.401784066,1.8357625536,-3.998586252,-3.566021512
34009,2016,869,1293,-226,154,-424,-72,9.2279429333,13.730414514,-2.399902305,1.6353316591,-4.502471581,-0.764570646
34009,2017,872,1282,-95,145,-410,50,9.3026729182,13.676636102,-1.013479274,1.5468894187,-4.373963184,0.5334101444
30009,2010,23,42,4,0,-19,4,NA,NA,NA,NA,NA,NA
30009,2011,96,93,26,-1,3,25,9.5275903136,9.2298531163,2.5803890433,-0.099245732,0.2977371973,2.4811433108
30009,2012,82,100,59,3,-18,62,8.108776267,9.8887515451,5.8343634116,0.2966625464,-1.779975278,6.131025958
30009,2013,66,86,205,2,-20,207,6.4519282467,8.4070580185,20.04008016,0.1955129772,-1.955129772,20.235593137
30009,2014,82,88,99,2,-6,101,7.9047573143,8.483154191,9.5435484648,0.1927989589,-0.578396877,9.7363474237
30009,2015,59,96,2,3,-37,5,5.6698058812,9.2254468576,0.1921968095,0.2882952143,-3.555640976,0.4804920238
30009,2016,72,100,134,2,-28,136,6.8942404366,9.5753339398,12.830947479,0.1915066788,-2.681093503,13.022454158
30009,2017,70,84,213,2,-14,215,6.6056431065,7.9267717278,20.10002831,0.1887326602,-1.321128621,20.28876097
42025,2010,158,147,10,-6,11,4,NA,NA,NA,NA,NA,NA
42025,2011,611,860,106,-8,-249,98,9.3751918002,13.195850979,1.6264653532,-0.122752102,-3.820659179,1.5037132511
42025,2012,565,776,-61,-2,-211,-63,8.6989322638,11.947560065,-0.939176758,-0.030792681,-3.248627801,-0.969969438
42025,2013,623,815,-64,2,-192,-62,9.6321835526,12.600689559,-0.989502002,0.0309219376,-2.968506007,-0.958580065
42025,2014,557,756,-93,13,-199,-80,8.6485982905,11.738492473,-1.444020899,0.2018523838,-3.089894183,-1.242168516
42025,2015,575,853,-233,14,-278,-219,8.9831819212,13.326355093,-3.640141544,0.2187209511,-4.343173172,-3.421420593
42025,2016,607,808,-51,12,-201,-39,9.5385509888,12.697115649,-0.801426854,0.1885710245,-3.15856466,-0.61285583
42025,2017,580,775,522,12,-195,534,9.1074681239,12.169461717,8.1967213115,0.188430375,-3.061993593,8.3851516865
49007,2010,78,79,0,2,-1,2,NA,NA,NA,NA,NA,NA
49007,2011,332,225,-218,12,107,-206,15.546710372,10.536174198,-10.20838211,0.5619292906,5.0105361742,-9.646452821
49007,2012,334,196,-230,11,138,-219,15.704344555,9.2157231522,-10.81436901,0.5172089524,6.488621403,-10.29716005
49007,2013,333,244,-420,1,89,-419,15.805211448,11.580995776,-19.93450093,0.0474630974,4.2242156723,-19.88703783
49007,2014,269,230,-332,3,39,-329,12.954802668,11.076597077,-15.98882708,0.1444773532,1.8782055913,-15.84434973
49007,2015,266,228,-299,3,38,-296,12.979725279,11.12547881,-14.58999195,0.1463878791,1.8542464684,-14.44360407
49007,2016,287,189,-97,4,98,-93,14.090384663,9.2790338022,-4.762255443,0.1963816678,4.8113508604,-4.565873776
49007,2017,279,166,-195,5,113,-190,13.721536419,8.1640682634,-9.590321153,0.2459056706,5.5574681552,-9.344415482
56007,2010,46,17,-70,1,29,-69,NA,NA,NA,NA,NA,NA
56007,2011,200,114,-86,0,86,-86,12.619490804,7.193109758,-5.426381046,0,5.4263810455,-5.426381046
56007,2012,189,125,-190,10,64,-180,11.969601013,7.9164027866,-12.03293224,0.6333122229,4.0531982267,-11.39962001
56007,2013,199,117,48,0,82,48,12.597727345,7.4067040167,3.0386478017,0,5.191023328,3.0386478017
56007,2014,205,160,6,-4,45,2,12.906069,10.073029464,0.3777386049,-0.251825737,2.8330395366,0.1259128683
56007,2015,217,134,-350,0,83,-350,13.755070994,8.4939148073,-22.18559838,0,5.2611561866,-22.18559838
56007,2016,230,127,-20,0,103,-20,14.662756598,8.0963916869,-1.275022313,0,6.5663649114,-1.275022313
56007,2017,217,138,-503,-1,79,-504,13.986464712,8.8946181115,-32.42023848,-0.064453754,5.0918466001,-32.48469223
16029,2010,25,10,-3,0,15,-3,NA,NA,NA,NA,NA,NA
16029,2011,102,61,-183,5,41,-178,14.765489288,8.8303416329,-26.4910249,0.7237984945,5.9351476549,-25.7672264
16029,2012,84,76,-94,4,8,-90,12.351124835,11.174827231,-13.82149684,0.5881488016,1.1762976033,-13.23334804
16029,2013,98,78,20,4,20,24,14.450014745,11.501032144,2.948982601,0.5897965202,2.948982601,3.5387791212
16029,2014,89,49,-39,5,40,-34,13.072855464,7.1974148061,-5.728554642,0.7344300823,5.875440658,-4.994124559
16029,2015,81,67,-79,7,14,-72,11.942499079,9.8783634353,-11.64762256,1.0320678216,2.0641356432,-10.61555474
16029,2016,89,38,95,7,51,102,13.03170071,5.5640969324,13.910242331,1.0249652244,7.4676037777,14.935207555
16029,2017,87,61,96,7,26,103,12.482065997,8.7517934003,13.773314204,1.0043041607,3.7302725968,14.777618364
21039,2010,15,28,-2,0,-13,-2,NA,NA,NA,NA,NA,NA
21039,2011,53,67,-37,2,-14,-35,10.463968411,13.228035538,-7.305034551,0.3948667325,-2.764067127,-6.910167818
21039,2012,73,64,-18,2,9,-16,14.492753623,12.705975779,-3.573555688,0.3970617431,1.786777844,-3.176493945
21039,2013,63,70,-66,2,-7,-64,12.605042017,14.005602241,-13.20528211,0.400160064,-1.400560224,-12.80512205
21039,2014,71,70,-1,3,1,2,14.301540941,14.100110787,-0.201430154,0.6042904623,0.2014301541,0.4028603082
21039,2015,67,64,-114,3,3,-111,13.637288826,13.026663953,-23.20374517,0.6106248728,0.6106248728,-22.59312029
21039,2016,78,62,-63,3,16,-60,16.122364613,12.815212898,-13.02190988,0.6200909467,3.3071517156,-12.40181893
21039,2017,67,59,20,3,8,23,13.868764231,12.212792383,4.1399296212,0.6209894432,1.6559718485,4.7609190644
27017,2010,105,75,3,0,30,3,NA,NA,NA,NA,NA,NA
27017,2011,369,351,0,4,18,4,10.416813697,9.9086764436,0,0.1129193897,0.5081372535,0.1129193897
27017,2012,388,345,-215,5,43,-210,10.976575761,9.7600995813,-6.082380898,0.1414507186,1.2164761797,-5.94093018
27017,2013,362,393,31,3,-31,34,10.265135403,11.14419396,0.8790585566,0.0850701829,-0.879058557,0.9641287395
27017,2014,355,385,120,5,-30,125,10.054093857,10.903735591,3.3985669376,0.1416069557,-0.849641734,3.5401738933
27017,2015,363,395,57,6,-32,63,10.264095459,11.168919301,1.6117174688,0.1696544704,-0.904823842,1.7813719392
27017,2016,357,373,176,6,-16,182,10.067256038,10.518449586,4.9631290273,0.1691975805,-0.451193548,5.1323266077
27017,2017,361,363,-49,6,-2,-43,10.163002168,10.219306889,-1.379465668,0.1689141635,-0.056304721,-1.210551505
24011,2010,100,96,-35,3,4,-32,NA,NA,NA,NA,NA,NA
24011,2011,417,289,-326,37,128,-289,12.645176942,8.7636837795999991,-9.885677897,1.1219941171,3.8814931619,-8.76368378
24011,2012,397,322,-384,48,75,-336,12.114554248,9.8259104988,-11.717856,1.4647319998,2.2886437497,-10.253124
24011,2013,377,326,-94,69,51,-25,11.545116293,9.9833101104,-2.878623161,2.1130318945,1.5618061829,-0.765591266
24011,2014,365,348,-190,64,17,-126,11.19219919,10.67091868,-5.826076291,1.9624678033,0.5212805102,-3.863608488
24011,2015,413,344,-74,70,69,-4,12.672987818,10.555708982,-2.270704839,2.1479640369,2.1172788364,-0.122740802
24011,2016,382,327,138,76,55,214,11.662875723,9.9836658678,4.2132901827,2.3203627093,1.6792098554,6.5336528921
24011,2017,396,340,176,76,56,252,11.985472155,10.290556901,5.3268765133,2.3002421308,1.6949152542,7.6271186441
51033,2010,106,79,51,3,27,54,NA,NA,NA,NA,NA,NA
51033,2011,385,225,-131,9,160,-122,13.433825325,7.8509368785,-4.570989916,0.3140374751,5.5828884469,-4.256952441
51033,2012,399,226,103,5,173,108,13.846714442,7.8430011626,3.5744651316,0.1735177248,6.0037132793,3.7479828564
51033,2013,394,286,185,11,108,196,13.536030233,9.8256463111,6.3557502362,0.3779094735,3.7103839217,6.7336597097
51033,2014,439,238,276,13,201,289,14.877573498,8.0657459968,9.3535541811,0.4405659578,6.8118275015,9.7941201389
51033,2015,402,255,-14,15,147,1,13.478173406,8.5495876081,-0.469389124,0.5029169181,4.9285857976,0.0335277945
51033,2016,367,289,82,14,78,96,12.239657156,9.6383131284,2.7347462856,0.4669079024,2.6013440277,3.201654188
51033,2017,388,277,264,13,111,277,12.819665631,9.1521839688,8.7226590894,0.4295248794,3.6674816626,9.1521839688
05015,2010,73,38,60,4,35,64,NA,NA,NA,NA,NA,NA
05015,2011,315,305,-109,1,10,-108,11.455795178,11.09211914,-3.964068808,0.0363676037,0.3636760374,-3.927701204
05015,2012,305,305,137,10,0,147,11.08224479,11.08224479,4.9779263485,0.3633522882,0,5.3412786367
05015,2013,308,298,124,42,10,166,11.125961782,10.764729256,4.4792833147,1.5171766066,0.3612325254,5.9964599213
05015,2014,313,310,-103,50,3,-53,11.282125221,11.173989835,-3.712648236,1.802256425,0.1081353855,-1.910391811
05015,2015,340,337,-21,58,3,37,12.259762738,12.15158836,-0.75722064,2.0913712905,0.1081743771,1.3341506508
05015,2016,312,280,-113,59,32,-54,11.247499054,10.093909407,-4.073613439,2.1269309108,1.1535896465,-1.946682529
05015,2017,324,296,130,59,28,189,11.639603391,10.63371174,4.6702112372,2.1195574077,1.0058916511,6.7897686449
13045,2010,385,188,-136,27,197,-109,NA,NA,NA,NA,NA,NA
13045,2011,1495,987,-505,91,508,-414,13.503443604,8.9149824997,-4.561363893,0.8219487411,4.5884611042,-3.739415152
13045,2012,1513,859,-38,94,654,56,13.617748976,7.7314252284,-0.342018811,0.8460465326,5.8863237478,0.5040277215
13045,2013,1406,964,258,154,442,412,12.56748543,8.6166827559,2.306124638,1.3765240087,3.9508026744,3.6826486467
13045,2014,1442,987,672,166,455,838,12.766936998,8.7385345469,5.9496405426,1.4697028721,4.0284024507,7.4193434147
13045,2015,1466,1075,330,188,391,518,12.854744023,9.4262277114,2.8936326928,1.6484937765,3.4285163118,4.5421264693
13045,2016,1530,1066,1140,195,464,1335,13.259266321,9.2381554887,9.8794533369,1.6899064918,4.0211108319,11.569359829
13045,2017,1551,1049,822,197,502,1019,13.250577737,8.9618672123,7.0225499032,1.6830198673,4.2887105249,8.7055697706
17015,2010,51,39,-11,0,12,-11,NA,NA,NA,NA,NA,NA
17015,2011,138,181,-132,6,-43,-126,9.0169557973,11.826586952,-8.624914241,0.3920415564,-2.809631154,-8.232872685
17015,2012,144,193,-67,10,-49,-57,9.4946098309,12.725414565,-4.417630963,0.6593479049,-3.230804734,-3.758283058
17015,2013,134,194,-94,6,-60,-88,8.9104631446,12.900222762,-6.2506234,0.3989759617,-3.989759617,-5.851647438
17015,2014,131,193,-127,8,-62,-119,8.8076108515,12.97609843,-8.538676169,0.537869365,-4.168487579,-8.000806804
17015,2015,164,191,-118,8,-27,-110,11.145847492,12.980834579,-8.019573196,0.5436998777,-1.834987087,-7.475873318
17015,2016,147,178,-11,8,-31,-3,10.049220673,12.16844408,-0.751982499,0.5468963631,-2.119223407,-0.205086136
17015,2017,155,188,-67,8,-33,-59,10.642315219,12.908098459,-4.600226578,0.5492807855,-2.26578324,-4.050945793
18015,2010,68,30,1,0,38,1,NA,NA,NA,NA,NA,NA
18015,2011,205,192,-170,3,13,-167,10.188613603,9.5425063989,-8.449094207,0.1491016625,0.6461072041,-8.299992545
18015,2012,205,154,10,8,51,18,10.209671796,7.6697046666,0.4980327706,0.3984262164,2.5399671298,0.896458987
18015,2013,234,177,-54,3,57,-51,11.632242189,8.798747297,-2.684363582,0.1491313101,2.8334948923,-2.535232272
18015,2014,226,176,-220,4,50,-216,11.278852152,8.7835308796,-10.9794136,0.1996257018,2.4953212726,-10.7797879
18015,2015,194,204,-59,4,-10,-55,9.7377337182,10.239678755,-2.961475718,0.2007780148,-0.501945037,-2.760697704
18015,2016,194,166,43,7,28,50,9.7350461662,8.3299879566,2.1577679647,0.3512645524,1.4050582096,2.5090325171
18015,2017,190,188,64,7,2,71,9.4985752137,9.3985902115,3.199520072,0.3499475079,0.0999850022,3.5494675799
19027,2010,54,47,2,1,7,3,NA,NA,NA,NA,NA,NA
19027,2011,263,227,-5,1,36,-4,12.620870024,10.893298462,-0.239940495,0.047988099,1.7275715623,-0.191952396
19027,2012,295,263,-239,1,32,-238,14.215497301,12.673477255,-11.51696222,0.0481881264,1.5420200463,-11.46877409
19027,2013,223,227,-118,6,-4,-112,10.828133725,11.022360339,-5.72968511,0.2913399209,-0.194226614,-5.438345189
19027,2014,272,256,-64,7,16,-57,13.257298825,12.477457718,-3.119364429,0.3411804845,0.7798411074,-2.778183945
19027,2015,275,250,-108,7,25,-101,13.442174211,12.220158373,-5.279108417,0.3421644345,1.2220158373,-4.936943983
19027,2016,253,246,-66,7,7,-59,12.40621782,12.062962781,-3.236404649,0.3432550385,0.3432550385,-2.89314961
19027,2017,262,240,-76,7,22,-69,12.87912304,11.79766996,-3.735928821,0.3440987072,1.0814530797,-3.391830114
21041,2010,39,14,-34,4,25,-30,NA,NA,NA,NA,NA,NA
21041,2011,166,113,100,12,53,112,15.246142542,10.378398237,9.1844232182,1.1021307862,4.8677443057,10.286554004
21041,2012,167,133,-173,1,34,-172,15.315480558,12.197358767,-15.86573734,0.0917094644,3.1181217902,-15.77402788
21041,2013,160,129,-67,-1,31,-68,14.788797486,11.923467973,-6.192808947,-0.092429984,2.8653295129,-6.285238932
21041,2014,143,112,-122,-3,31,-125,13.296759496,10.4142452,-11.34408852,-0.278952996,2.8825142963,-11.62304152
21041,2015,171,154,-71,-1,17,-72,16.009736916,14.418125644,-6.647317667,-0.093624192,1.5916112724,-6.740941859
21041,2016,168,147,-75,0,21,-75,15.809532772,13.833341175,-7.05782713,0,1.9761915965,-7.05782713
21041,2017,166,122,70,0,44,70,15.578078078,11.448948949,6.5690690691,0,4.1291291291,6.5690690691
24013,2010,410,356,12,11,54,23,NA,NA,NA,NA,NA,NA
24013,2011,1546,1397,-361,34,149,-327,9.2514189798,8.3597880432,-2.160260189,0.2034594084,0.8916309366,-1.95680078
24013,2012,1589,1347,-307,79,242,-228,9.5135743559,8.064685121,-1.838053699,0.4729845023,1.4488892348,-1.365069196
24013,2013,1578,1483,36,60,95,96,9.442288648,8.8738365431,0.2154134292,0.3590223821,0.5684521049,0.5744358113
24013,2014,1572,1497,7,50,75,57,9.3979793149,8.9496024392,0.0418485084,0.2989179171,0.4483768757,0.3407664255
24013,2015,1663,1544,-371,63,119,-308,9.9442393076,9.2326551358,-2.2184683,0.3767210321,0.7115841717,-1.841747268
24013,2016,1714,1503,-270,65,211,-205,10.254998863,8.9925690148,-1.61543156,0.3889001903,1.2624298484,-1.226531369
24013,2017,1713,1543,419,65,170,484,10.229277949,9.2141131789,2.5020825807,0.3881512357,1.0151647702,2.8902338163
28015,2010,16,7,-3,0,9,-3,NA,NA,NA,NA,NA,NA
28015,2011,97,96,-174,0,1,-174,9.2231624988,9.1280783493,-16.54464201,0,0.0950841495,-16.54464201
28015,2012,80,111,2,-1,-31,1,7.680122882,10.656170499,0.192003072,-0.096001536,-2.976047617,0.096001536
28015,2013,98,113,-65,0,-15,-65,9.4580900449,10.905756888,-6.273222989,0,-1.447666844,-6.273222989
28015,2014,93,117,-63,-1,-24,-64,9.0488932133,11.384091462,-6.129895403,-0.097299927,-2.335198249,-6.22719533
28015,2015,91,121,1,-1,-30,0,8.906288231,11.842427208,0.0978712992,-0.097871299,-2.936138977,0
28015,2016,87,92,17,-1,-5,16,8.5239798168,9.0138637143,1.6656052516,-0.09797678,-0.489883898,1.5676284721
28015,2017,80,100,-50,-1,-20,-51,7.8624078624,9.828009828,-4.914004914,-0.098280098,-1.965601966,-5.012285012
29033,2010,34,40,-8,3,-6,-5,NA,NA,NA,NA,NA,NA
29033,2011,105,123,-20,5,-18,-15,11.330527679,13.272903852,-2.158195748,0.5395489371,-1.942376174,-1.618646811
29033,2012,116,116,-181,3,0,-178,12.657537236,12.657537236,-19.75012276,0.3273501009,0,-19.42277266
29033,2013,116,142,3,2,-26,5,12.793647292,15.661188927,0.3308701886,0.2205801257,-2.867541634,0.5514503143
29033,2014,113,112,-102,2,1,-100,12.545797713,12.434772954,-11.32452537,0.222049517,0.1110247585,-11.10247585
29033,2015,94,113,-57,2,-19,-55,10.538116592,12.668161435,-6.390134529,0.2242152466,-2.130044843,-6.165919283
29033,2016,92,106,-16,2,-14,-14,10.374379793,11.953089761,-1.804239964,0.2255299955,-1.578709968,-1.578709968
29033,2017,95,116,-38,2,-21,-36,10.764872521,13.144475921,-4.305949008,0.2266288952,-2.379603399,-4.079320113
33003,2010,94,123,36,-3,-29,33,NA,NA,NA,NA,NA,NA
33003,2011,381,513,-38,10,-132,-28,7.9789740422,10.743343002,-0.795803185,0.2094218909,-2.764368959,-0.586381294
33003,2012,371,451,70,6,-80,76,7.7838971938,9.4623655914,1.4686598479,0.1258851298,-1.678468398,1.5945449777
33003,2013,357,498,-52,15,-141,-37,7.5057554637,10.470213504,-1.093275306,0.3153678766,-2.96445804,-0.777907429
33003,2014,343,527,82,12,-184,94,7.2333111905,11.113571421,1.7292464071,0.2530604498,-3.88026023,1.9823068569
33003,2015,377,546,115,13,-169,128,7.9629101585,11.532490574,2.429004425,0.2745831089,-3.569580416,2.7035875339
33003,2016,328,530,266,17,-202,283,6.9257487938,11.190996527,5.6166133511,0.3589564924,-4.265247733,5.9755698434
33003,2017,340,540,843,18,-200,861,7.1231786137,11.313283681,17.661292857,0.377109456,-4.190105067,18.038402313
39019,2010,80,42,-23,-1,38,-24,NA,NA,NA,NA,NA,NA
39019,2011,310,290,-45,0,20,-45,10.751010075,10.057396522,-1.560630495,0,0.6936135532,-1.560630495
39019,2012,243,308,-217,0,-65,-217,8.4726556371,10.739003853,-7.566116351,0,-2.266348216,-7.566116351
39019,2013,278,288,-279,3,-10,-276,9.7894217903,10.141559265,-9.824635538,0.1056412423,-0.352137474,-9.718994295
39019,2014,266,340,-55,4,-74,-51,9.4347988011,12.059517265,-1.950804263,0.1418766737,-2.624718463,-1.80892759
39019,2015,282,357,-345,4,-75,-341,10.099020538,12.784930256,-12.3551847,0.1432485183,-2.685909718,-12.21193618
39019,2016,281,277,-86,3,4,-83,10.153017903,10.008490958,-3.107329323,0.1083952089,0.1445269452,-2.998934114
39019,2017,271,289,-237,3,-18,-234,9.8506052125,10.504888954,-8.614735924,0.1090472902,-0.654283741,-8.505688634
47017,2010,67,110,13,1,-43,14,NA,NA,NA,NA,NA,NA
47017,2011,328,409,161,0,-81,161,11.513215627,14.356418267,5.6513040121,0,-2.84320264,5.6513040121
47017,2012,323,404,198,2,-81,200,11.297261376,14.13032073,6.9252561995,0.0699520828,-2.833059354,6.9952082823
47017,2013,323,398,15,2,-75,17,11.285814116,13.906359189,0.5241090147,0.069881202,-2.620545073,0.5939902166
47017,2014,315,385,-162,3,-70,-159,11.063112422,13.521581849,-5.689600674,0.1053629755,-2.458469427,-5.584237699
47017,2015,291,480,-222,5,-189,-217,10.335458436,17.048178864,-7.884782725,0.1775851965,-6.712720428,-7.707197528
47017,2016,318,397,46,5,-79,51,11.382142921,14.2097822,1.6464735043,0.1789645113,-2.827639279,1.8254380156
47017,2017,307,390,15,5,-83,20,11.006740284,13.982503944,0.5377886132,0.1792628711,-2.97576366,0.7170514843
51035,2010,56,72,19,-1,-16,18,NA,NA,NA,NA,NA,NA
51035,2011,248,333,105,0,-85,105,8.2438586577,11.06937473,3.4903433833,0,-2.825516072,3.4903433833
51035,2012,271,357,-82,-1,-86,-83,9.0318280287,11.898016997,-2.732877854,-0.033327779,-2.866188969,-2.766205632
51035,2013,257,378,107,5,-121,112,8.5917258671,12.636857501,3.5770998746,0.1671541997,-4.045131634,3.7442540744
51035,2014,254,399,-68,9,-145,-59,8.5226319498,13.387913968,-2.281649498,0.3019830218,-4.865282019,-1.979666477
51035,2015,283,365,197,11,-82,208,9.5092488365,12.264578888,6.619512441,0.3696174459,-2.755330052,6.9891298869
51035,2016,261,369,-27,12,-108,-15,8.7700139447,12.398985232,-0.907242822,0.4032190319,-3.628971287,-0.50402379
51035,2017,256,382,125,12,-126,137,8.6185129699,12.860437322,4.2082582861,0.4039927955,-4.241924352,4.6122510815
32510,2010,142,189,-257,-1,-47,-258,NA,NA,NA,NA,NA,NA
32510,2011,583,632,-212,-21,-49,-233,10.629860244,11.523279029,-3.865403725,-0.382893765,-0.893418785,-4.24829749
32510,2012,549,658,-198,-31,-109,-229,10.067391005,12.066199056,-3.63086233,-0.568468345,-1.99880805,-4.199330674
32510,2013,574,698,-453,-4,-124,-457,10.614592291,12.907640102,-8.377021442,-0.073969284,-2.293047812,-8.450990726
32510,2014,548,631,440,4,-83,444,10.153224761,11.691030701,8.1522242603,0.0741111296,-1.53780594,8.2263353899
32510,2015,614,680,26,15,-66,41,11.34117734,12.560261549,0.4802452945,0.277064593,-1.219084209,0.7573098875
32510,2016,551,785,376,18,-234,394,10.165488995,14.482593214,6.9368854122,0.3320849399,-4.317104219,7.2689703522
32510,2017,572,657,526,19,-85,545,10.492717467,12.051949958,9.6488975309,0.3485343215,-1.559232491,9.9974318524
48065,2010,15,19,-20,0,-4,-20,NA,NA,NA,NA,NA,NA
48065,2011,64,67,76,1,-3,77,10.3284112,10.812555475,12.2649883,0.161381425,-0.484144275,12.426369725
48065,2012,58,79,-132,4,-21,-128,9.4155844156,12.824675325,-21.42857143,0.6493506494,-3.409090909,-20.77922078
48065,2013,58,73,-91,1,-15,-90,9.6106048053,12.096106048,-15.07870754,0.1657000829,-2.485501243,-14.91300746
48065,2014,71,58,35,2,13,37,11.81659316,9.6529915952,5.8250811351,0.3328617791,2.1636015645,6.1579429142
48065,2015,56,59,-23,2,-3,-21,9.3023255814,9.8006644518,-3.820598007,0.3322259136,-0.49833887,-3.488372093
48065,2016,59,46,86,2,13,88,9.7407957735,7.5945187386,14.198448077,0.3301964669,2.1462770348,14.528644544
48065,2017,61,53,-86,2,8,-84,10.050251256,8.7321855178,-14.16920669,0.3295164346,1.3180657385,-13.83969025
21043,2010,85,56,-5,2,29,-3,NA,NA,NA,NA,NA,NA
21043,2011,347,310,-153,0,37,-153,12.534995033,11.198410548,-5.526957464,0,1.3365844848,-5.526957464
21043,2012,337,295,-19,-1,42,-20,12.196225323,10.67622098,-0.687621012,-0.03619058,1.5200043429,-0.723811592
21043,2013,361,308,-114,13,53,-101,13.073078873,11.153762584,-4.128340697,0.4707756935,1.9193162888,-3.657565003
21043,2014,394,263,-222,12,131,-210,14.301270417,9.5462794918,-8.058076225,0.4355716878,4.7549909256,-7.622504537
21043,2015,378,343,-121,12,35,-109,13.758712942,12.484758039999999,-4.40424409,0.4367845378,1.273954902,-3.967459552
21043,2016,345,347,-199,12,-2,-187,12.618411909,12.691562123,-7.278446289,0.4389012838,-0.073150214,-6.839545006
21043,2017,333,342,-104,12,-9,-92,12.244897959,12.575841147,-3.824232396,0.4412575841,-0.330943188,-3.382974812
29035,2010,20,23,27,0,-3,27,NA,NA,NA,NA,NA,NA
29035,2011,73,85,51,-2,-12,49,11.568021551,13.469614135,8.0817684811,-0.316932097,-1.901592584,7.7648363838
29035,2012,66,82,-42,-1,-16,-43,10.477021986,13.016906104,-6.667195809,-0.158742757,-2.539884118,-6.825938567
29035,2013,90,55,36,-1,35,35,14.275517488,8.7239273535,5.710206995,-0.158616861,5.551590134,5.551590134
29035,2014,78,69,-66,-1,9,-67,12.360351795,10.934157357,-10.45875921,-0.158466049,1.4261944378,-10.61722526
29035,2015,79,69,-14,-1,10,-15,12.581621277,10.989010989,-2.229654404,-0.159261029,1.5926102883,-2.388915432
29035,2016,76,81,-62,-1,-5,-63,12.176560122,12.977649603,-9.933509573,-0.160217896,-0.801089482,-10.09372747
29035,2017,76,89,-24,-1,-13,-25,12.281835811,14.382676147,-3.878474467,-0.161603103,-2.100840336,-4.040077569
30011,2010,3,0,-4,0,3,-4,NA,NA,NA,NA,NA,NA
30011,2011,10,15,-19,0,-5,-19,8.7108013937,13.066202091,-16.55052265,0,-4.355400697,-16.55052265
30011,2012,10,20,31,0,-10,31,8.7221979939,17.444395988,27.038813781000002,0,-8.722197994,27.038813781000002
30011,2013,11,8,-8,0,3,-8,9.5238095238,6.9264069264,-6.926406926,0,2.5974025974,-6.926406926
30011,2014,16,16,-2,0,0,-2,13.888888889,13.888888889,-1.736111111,0,0,-1.736111111
30011,2015,19,10,-13,0,9,-13,16.536118364,8.7032201915,-11.31418625,0,7.8328981723,-11.31418625
30011,2016,14,10,26,0,4,26,12.048192771,8.6058519793,22.375215146,0,3.4423407917,22.375215146
30011,2017,15,16,45,0,-1,45,12.505210504,13.338891205,37.515631513,0,-0.8336807,37.515631513
40019,2010,155,115,29,9,40,38,NA,NA,NA,NA,NA,NA
40019,2011,626,643,232,19,-17,251,13.064938589,13.41973724,4.8419580711,0.3965396696,-0.354798652,5.2384977408
40019,2012,625,588,-79,13,37,-66,13.017578939,12.246938265,-1.645421978,0.2707656419,0.7706406732,-1.374656336
40019,2013,665,641,408,9,24,417,13.792388261,13.294617858,8.4620968578,0.1866639013,0.4977704034,8.6487607591
40019,2014,689,623,46,8,66,54,14.20838274,12.847347528,0.948600299,0.164973965,1.3610352116,1.1135742641
40019,2015,718,631,-137,10,87,-127,14.796801583,13.003874371,-2.823345149,0.2060835875,1.7929272113,-2.617261561
40019,2016,706,610,-248,12,96,-236,14.577891574,12.595628697,-5.120845765,0.2477828596,1.982262877,-4.873062906
40019,2017,702,662,-221,12,40,-209,14.541838859,13.713244052,-4.577986307,0.248578442,0.8285948068,-4.329407865
47019,2010,129,134,-27,2,-5,-25,NA,NA,NA,NA,NA,NA
47019,2011,585,579,8,9,6,17,10.201145667,10.096518532,0.1395028467,0.1569407026,0.104627135,0.2964435493
47019,2012,518,656,33,15,-138,48,9.0395874598,11.447817324,0.5758810544,0.2617641156,-2.408229864,0.83764517
47019,2013,506,718,-128,7,-212,-121,8.8638971368,12.577624791,-2.242250659,0.1226230829,-3.713727654,-2.119627576
47019,2014,540,677,-516,2,-137,-514,9.5417318243,11.962504528,-9.117654854,0.0353397475,-2.420772704,-9.082315107
47019,2015,531,693,261,3,-162,264,9.428601868,12.305124472,4.6343975283,0.0532689371,-2.876522604,4.6876664654
47019,2016,500,715,306,2,-215,308,8.8633624052,12.674608239,5.424377792,0.0354534496,-3.811245834,5.4598312416
47019,2017,508,732,253,3,-224,256,8.9954491527,12.961946417,4.4800169993,0.0531227312,-3.966497264,4.5331397305
37031,2010,132,177,234,33,-45,267,NA,NA,NA,NA,NA,NA
37031,2011,615,728,770,61,-113,831,9.1704814876,10.855464265,11.481741049,0.9095924727,-1.684982777,12.391333522
37031,2012,645,756,328,140,-111,468,9.5412789752,11.18326652,4.8519992308,2.0709752814,-1.641987545,6.9229745122
37031,2013,617,773,683,77,-156,760,9.0627340962,11.354122296,10.032167565,1.1310057138,-2.291388199,11.163173279
37031,2014,623,734,312,63,-111,375,9.0928993651,10.712982559,4.5537473546,0.9195066774,-1.620083193,5.473254032
37031,2015,590,783,198,89,-193,287,8.5897519891,11.399620013,2.8826625319,1.2957422492,-2.809868024,4.1784047811
37031,2016,584,779,259,64,-195,323,8.4893592278,11.323991162,3.7649726712,0.9303407373,-2.834631934,4.6953134085
37031,2017,563,824,253,40,-261,293,8.1750595342,11.964918395,3.6736946042,0.5808212813,-3.78985886,4.2545158855
27019,2010,314,124,108,17,190,125,NA,NA,NA,NA,NA,NA
27019,2011,1105,425,656,75,680,731,11.997633046,4.6144742485,7.1225767224,0.814318985,7.3831587976,7.9368957075
27019,2012,1097,402,319,50,695,369,11.753802307,4.3072274634,3.4179242807,0.5357248089,7.4465748434,3.9536490895
27019,2013,1129,486,1043,61,643,1104,11.91751685,5.1301268281,11.009716629,0.6439048076,6.7873900216,11.653621437
27019,2014,1166,436,947,55,730,1002,12.085844739,4.5192352542,9.8158618938,0.570087016,7.5666094852,10.38594891
27019,2015,1173,468,494,66,705,560,11.973114081,4.7769969225,5.0423856404,0.6736790532,7.1961171589,5.7160646936
27019,2016,1226,531,972,67,695,1039,12.326377543,5.3387491642,9.7726255888,0.673627484,6.9876283788,10.446253073
27019,2017,1198,504,1037,67,694,1104,11.835254833,4.9791055393,10.244707231,0.661904903,6.8561492941,10.906612134
30013,2010,311,231,40,49,80,89,NA,NA,NA,NA,NA,NA
30013,2011,1197,820,-203,20,377,-183,14.672264272,10.051175191,-2.488278736,0.2451506144,4.6210890816,-2.243128122
30013,2012,1180,790,-694,224,390,-470,14.454584431,9.6772217799,-8.501255589,2.7439211123,4.7773626508,-5.757334477
30013,2013,1184,794,36,105,390,141,14.464160279,9.6997831598,0.4397886571,1.2827169166,4.7643771188,1.7225055737
30013,2014,1152,796,-556,77,356,-479,14.039363841,9.700810432,-6.775942965,0.938394979,4.3385534093,-5.837547986
30013,2015,1200,827,-649,114,373,-535,14.650225858,10.09644732,-7.923330485,1.3917714565,4.5537785374,-6.531559028
30013,2016,1106,880,-623,57,226,-566,13.544211564,10.776587863,-7.629334362,0.6980289866,2.7676237010999998,-6.931305375
30013,2017,1106,812,-121,-2,294,-123,13.558740239,9.9545181498,-1.483370315,-0.024518518,3.6042220887,-1.507888833
21045,2010,44,35,14,0,9,14,NA,NA,NA,NA,NA,NA
21045,2011,180,205,-42,-5,-25,-47,11.29092962,12.859114289,-2.634550245,-0.313636934,-1.568184669,-2.948187179
21045,2012,209,162,79,-7,47,72,13.091956903,10.147832623,4.9486344275,-0.438486595,2.9441242796,4.5101478326
21045,2013,198,195,-13,-5,3,-18,12.364567396,12.177225466,-0.811815031,-0.31223655,0.1873419302,-1.124051581
21045,2014,194,189,-234,-4,5,-238,12.210473313,11.895770393,-14.72809668,-0.251762336,0.3147029204,-14.97985901
21045,2015,195,194,-32,-3,1,-35,12.377415976,12.313942048,-2.031165699,-0.190421784,0.0634739281,-2.221587483
21045,2016,196,204,36,-4,-8,32,12.445234618,12.953203378,2.2858594196,-0.25398438,-0.50796876,2.0318750397
21045,2017,180,209,23,-4,-29,19,11.424581892,13.265208975,1.4598076862,-0.253879598,-1.840627083,1.2059280886
17017,2010,44,31,-23,7,13,-16,NA,NA,NA,NA,NA,NA
17017,2011,182,139,-82,25,43,-57,13.354857646,10.199589081,-6.017023775,1.8344584679,3.1552685647,-4.182565307
17017,2012,187,153,-281,42,34,-239,13.828803845,11.314475874,-20.78018118,3.1059345535,2.5143279719,-17.67424663
17017,2013,161,134,-203,39,27,-164,12.053604851,10.032192858,-15.19802351,2.9198173242,2.0214119937,-12.27820618
17017,2014,155,142,-276,45,13,-231,11.756674757,10.770631068,-20.93446602,3.4132281553,0.9860436893,-17.52123786
17017,2015,184,160,-310,50,24,-260,14.195887822,12.34425028,-23.91698492,3.8575782124,1.851637542,-20.0594067
17017,2016,167,151,-236,56,16,-180,13.084697955,11.831074199,-18.4909504,4.3876831466,1.2536237562,-14.10326726
17017,2017,169,134,-267,54,35,-213,13.420154054,10.640832208,-21.20225522,4.2880965616,2.7793218455,-16.91415866
18017,2010,107,66,-49,21,41,-28,NA,NA,NA,NA,NA,NA
18017,2011,511,340,-311,82,171,-229,13.119047008,8.7289158173,-7.984390645,2.1052091089,4.3901311905,-5.879181536
18017,2012,504,403,-353,95,101,-258,12.974141815,10.374164983,-9.087047739,2.4455227627,2.5999768319,-6.641524977
18017,2013,506,393,-402,89,113,-313,13.084571325,10.162522788,-10.39525232,2.3014364584,2.922048537,-8.093815859
18017,2014,472,395,-259,98,77,-161,12.249081968,10.250820714,-6.721424215,2.543241595,1.9982612532,-4.17818262
18017,2015,503,427,-522,116,76,-406,13.12270907,11.139953823,-13.61839788,3.0263106404,1.9827552471,-10.59208724
18017,2016,495,401,-370,120,94,-250,12.995366299,10.527559365,-9.713708142,3.15039183,2.4678069335,-6.563316312
18017,2017,473,409,-204,121,64,-83,12.446222058,10.762166643,-5.367926638,3.1839172708,1.6840554159,-2.184009368
19029,2010,44,72,2,1,-28,3,NA,NA,NA,NA,NA,NA
19029,2011,149,183,-134,3,-34,-131,10.76084209,13.216336258,-9.677535839,0.2166612501,-2.455494168,-9.460874589
19029,2012,152,203,-13,1,-51,-12,11.069438881,14.783526927,-0.946728325,0.0728252558,-3.714088046,-0.87390307
19029,2013,154,177,-109,1,-23,-108,11.295291184,12.982250257,-7.994719085,0.0733460466,-1.686959073,-7.921373038
19029,2014,138,203,-112,0,-65,-112,10.236249675,15.057671624,-8.307680896,0,-4.821421949,-8.307680896
19029,2015,129,193,21,0,-64,21,9.6473843623,14.433683581,1.5705044311,0,-4.786299218,1.5705044311
19029,2016,140,185,-124,0,-45,-124,10.554487542,13.947001395,-9.348260394,0,-3.392513853,-9.348260394
19029,2017,131,173,8,0,-42,8,9.9525166192,13.14339981,0.6077872745,0,-3.190883191,0.6077872745
26027,2010,106,104,-53,5,2,-48,NA,NA,NA,NA,NA,NA
26027,2011,471,480,-44,8,-9,-36,9.0206555776,9.1930247924,-0.842693939,0.1532170799,-0.172369215,-0.689476859
26027,2012,469,498,-380,6,-29,-374,9.0214861408,9.5793179064,-7.309519688,0.1154134688,-0.557831766,-7.194106219
26027,2013,440,525,-119,-9,-85,-128,8.514426147,10.159258471,-2.302765253,-0.174158717,-1.644832324,-2.47692397
26027,2014,538,507,-47,-11,31,-58,10.436368221,9.8350161492,-0.911727335,-0.213382993,0.6013520722,-1.125110329
26027,2015,513,567,-172,-9,-54,-181,9.9777300178,11.028017388,-3.345359772,-0.175047895,-1.05028737,-3.520407667
26027,2016,466,521,-19,-11,-55,-30,9.0923281043,10.165456958,-0.37071724,-0.214625771,-1.073128854,-0.585343011
26027,2017,481,535,243,-11,-54,232,9.3771322741,10.429866459,4.7373038308,-0.214445852,-1.052734185,4.5228579784
27021,2010,96,52,44,0,44,44,NA,NA,NA,NA,NA,NA
27021,2011,296,283,-300,10,13,-290,10.379591479,9.9237310423,-10.51985623,0.3506618743,0.4558604366,-10.16919435
27021,2012,361,292,-45,6,69,-39,12.714625341,10.284406093,-1.584925597,0.2113234129,2.430219248,-1.373602184
27021,2013,322,319,69,4,3,73,11.321683485,11.216201962,2.4260750325,0.1406420309,0.1054815232,2.5667170634
27021,2014,370,324,12,8,46,20,12.97790249,11.364433532,0.4209049456,0.2806032971,1.6134689583,0.7015082427
27021,2015,360,348,113,9,12,122,12.583012933,12.163579168,3.9496679483,0.3145753233,0.4194337644,4.2642432716
27021,2016,320,313,308,8,7,316,11.096277546,10.853546474,10.680167138,0.2774069386,0.2427310713,10.957574076
27021,2017,322,319,343,8,3,351,11.035900951,10.933081998,11.755633622,0.2741838746,0.102818953,12.029817496
29037,2010,354,236,135,4,118,139,NA,NA,NA,NA,NA,NA
29037,2011,1203,827,-188,29,376,-159,12.046443395,8.2813039799,-1.882569708,0.2903963911,3.7651394153,-1.592173317
29037,2012,1204,867,88,34,337,122,12.016627659,8.6531695852,0.8782917226,0.3393399837,3.363458074,1.2176317063
29037,2013,1202,944,-38,53,258,15,11.954429952,9.3885040553,-0.37792707,0.5271088082,2.5659258965,0.1491817382
29037,2014,1170,903,-127,51,267,-76,11.610367959,8.9608224507,-1.26027071,0.5060929623,2.6495455087,-0.754177748
29037,2015,1154,909,236,59,245,295,11.411337173,8.9886529381,2.3336876715,0.5834219179,2.4226842352,2.9171095894
29037,2016,1191,888,1031,58,303,1089,11.666748298,8.6986334917,10.099426948,0.5681539893,2.9681148063,10.667580937
29037,2017,1173,932,653,58,241,711,11.360554759,9.0264595359,6.3243327006,0.5617324604,2.3340952233,6.886065161
31025,2010,72,94,21,2,-22,23,NA,NA,NA,NA,NA,NA
31025,2011,314,224,-102,7,90,-95,12.441802873,8.8756810302,-4.041604755,0.2773650322,3.5661218425,-3.764239723
31025,2012,259,217,-159,4,42,-155,10.286145475,8.6181218849,-6.314660736,0.1588593896,1.6680235906,-6.155801346
31025,2013,285,219,108,-2,66,106,11.305710375,8.6875458675,4.2842691949,-0.079338318,2.618164508,4.2049308765
31025,2014,295,249,64,-6,46,58,11.640295151,9.8251982796,2.5253521683,-0.236751766,1.8150968709,2.2886004025
31025,2015,299,260,-26,-6,39,-32,11.773739442,10.238034297,-1.02380343,-0.23626233,1.5357051446,-1.26006576
31025,2016,257,227,173,-6,30,167,10.080012551,8.9033573894,6.7853780985,-0.235331032,1.1766551616,6.5500470662
31025,2017,284,233,252,-6,51,246,11.032768098,9.0515315735,9.7896392984,-0.23308665,1.9812365247,9.5565526484
38017,2010,537,255,51,100,282,151,NA,NA,NA,NA,NA,NA
38017,2011,2202,888,779,491,1314,1270,14.533933964,5.8610959853,5.1416596538,3.2407636586,8.6728379783,8.3824233124
38017,2012,2355,830,1790,636,1525,2426,15.213178295,5.3617571059,11.563307494,4.1085271318,9.8514211886,15.671834625
38017,2013,2427,953,3972,609,1474,4581,15.180657328,5.960925601,24.844487395,3.809237871,9.2197317271,28.653725266
38017,2014,2501,1007,1612,715,1494,2327,15.168331484,6.1073609772,9.7766294888,4.336408241,9.0609705064,14.11303773
38017,2015,2548,1069,1839,771,1479,2610,15.08884237,6.3304444635,10.890259465,4.5657368395,8.758397906,15.455996305
38017,2016,2624,1057,1337,791,1567,2128,15.187470337,6.1178186533,7.7384328661,4.5782351511,9.0696516837,12.316668017
38017,2017,2611,1087,847,786,1524,1633,14.817883613,6.1689159279,4.8068737727,4.4606880583,8.6489676855,9.267561831
48067,2010,89,129,34,-1,-40,33,NA,NA,NA,NA,NA,NA
48067,2011,338,383,-132,-4,-45,-136,11.131236621,12.613205994,-4.34711016,-0.131730611,-1.481969373,-4.478840771
48067,2012,348,387,-225,12,-39,-213,11.542671399,12.836246642,-7.462934094,0.3980231517,-1.293575243,-7.064910942
48067,2013,367,407,235,13,-40,248,12.181561696,13.509252344,7.8001825575,0.4314994606,-1.327690648,8.2316820181
48067,2014,368,412,-81,16,-44,-65,12.194919888,13.653008135,-2.68420791,0.5302139082,-1.458088247,-2.153994002
48067,2015,363,373,20,17,-10,37,12.04699323,12.378866322,0.6637461835,0.5641842559,-0.331873092,1.2279304394
48067,2016,362,427,-14,18,-65,4,12.021984956,14.180628663,-0.464938645,0.5977782575,-2.158643708,0.1328396128
48067,2017,353,437,-1,18,-84,17,11.748652067,14.544365307,-0.0332823,0.5990814085,-2.79571324,0.565799108
16031,2010,103,70,77,1,33,78,NA,NA,NA,NA,NA,NA
16031,2011,389,201,-163,0,188,-163,16.850403933,8.7067639861,-7.060709103,0,8.1436399472,-7.060709103
16031,2012,418,175,-129,16,243,-113,18.045242618,7.5548264548,-5.568986358,0.6907269902,10.490416163,-4.878259368
16031,2013,378,204,-124,14,174,-110,16.250026868,8.7698557703,-5.330696645,0.601852847,7.4801710982,-4.728843798
16031,2014,373,174,-37,23,199,-14,15.949713504,7.4403489267,-1.582143163,0.9834943984,8.5093645771,-0.598648764
16031,2015,367,208,-204,27,159,-177,15.637649666,8.8627551238,-8.692317525,1.1504537901,6.7748945417,-7.541863735
16031,2016,362,181,-207,27,181,-180,15.429862325,7.7149311624,-8.823153318,1.150846085,7.7149311624,-7.672307233
16031,2017,365,173,-18,29,192,11,15.490387472,7.3420192675,-0.763909519,1.2307431142,8.1483682044,0.466833595
48069,2010,30,0,25,2,30,27,NA,NA,NA,NA,NA,NA
48069,2011,141,59,-170,34,82,-136,17.417083565,7.2879995059,-20.99932061,4.199864122,10.129084059,-16.79945649
48069,2012,139,49,28,29,90,57,17.0688279,6.0170688279,3.4383250445,3.5611223675,11.051759072,6.999447412
48069,2013,116,76,-235,55,40,-180,14.234875445,9.3262977052,-28.83789422,6.7492943919,4.9085777396,-22.08859983
48069,2014,129,61,-313,65,68,-248,16.135084428,7.6297686054,-39.14946842,8.1300813008,8.5053158224,-31.01938712
48069,2015,121,74,-227,69,47,-158,15.404201146,9.4207511139,-28.89879058,8.7842138765,5.9834500318,-20.1145767
48069,2016,107,42,-118,75,65,-43,13.6968766,5.376344086,-15.10496672,9.6006144393,8.3205325141,-5.504352279
48069,2017,118,36,-140,76,82,-64,15.064470829,4.5959402528,-17.87310098,9.7025405336,10.468530576,-8.170560449
37033,2010,36,31,13,2,5,15,NA,NA,NA,NA,NA,NA
37033,2011,215,270,-244,6,-55,-238,9.1012995809,11.429539009,-10.32891673,0.2539897557,-2.328239428,-10.07492698
37033,2012,212,284,-375,14,-72,-361,9.1125964452,12.207440521,-16.11897956,0.6017752369,-3.0948440760000002,-15.51720432
37033,2013,209,287,111,13,-78,124,9.0580102715,12.438511713,4.8107135892,0.5634169068,-3.380501441,5.374130496
37033,2014,210,250,-245,15,-40,-230,9.1449474166,10.886842163,-10.66910532,0.6532105298,-1.741894746,-10.01589479
37033,2015,205,260,62,17,-55,79,8.9750886564,11.383039271,2.714417057,0.7442756447,-2.407950615,3.4586927017
37033,2016,194,296,-25,19,-102,-6,8.5100783015,12.984449367,-1.096659575,0.833461277,-4.474371066,-0.263198298
37033,2017,197,256,-54,19,-59,-35,8.6807085573,11.280514673,-2.379483564,0.8372256984,-2.599806116,-1.542257866
22025,2010,31,43,-17,1,-12,-16,NA,NA,NA,NA,NA,NA
22025,2011,125,131,-106,17,-6,-89,12.09950634,12.680282644,-10.26038138,1.6455328623,-0.580776304,-8.614848514
22025,2012,111,114,-46,12,-3,-34,10.813443741,11.105698977,-4.481246956,1.169020945,-0.292255236,-3.312226011
22025,2013,141,153,4,18,-12,22,13.755426565,14.926101166,0.3902248671,1.7560119019,-1.170674601,2.1462367689
22025,2014,128,139,-122,18,-11,-104,12.552096102,13.630791861,-11.9637166,1.7651385143,-1.078695759,-10.19857808
22025,2015,117,155,-84,19,-38,-65,11.596788582,15.363266924,-8.325899494,1.8832391714,-3.766478343,-6.442660323
22025,2016,123,117,-155,20,6,-135,12.332063365,11.730499298,-15.54040505,2.0052135552,0.6015640666,-13.5351915
22025,2017,116,116,-54,20,0,-34,11.726055092,11.726055092,-5.458680819,2.0217336366,0,-3.436947182
37035,2010,439,308,-136,32,131,-104,NA,NA,NA,NA,NA,NA
37035,2011,1790,1535,-569,110,255,-459,11.573176093,9.9244834096,-3.678847596,0.7112007655,1.6486926837,-2.967646831
37035,2012,1820,1547,-176,172,273,-4,11.765618535,10.000775755,-1.1377741,1.1119155978,1.7648427803,-0.025858502
37035,2013,1753,1611,-31,225,142,194,11.311319385,10.395057347,-0.200029036,1.4518236518,0.916262038,1.2517946153
37035,2014,1709,1556,-182,256,153,74,11.008689715,10.023125334,-1.172370701,1.6490488982,0.9855643805,0.4766781971
37035,2015,1774,1694,110,296,80,406,11.4029703,10.888743906,0.7070612926,1.90263766,0.5142263946,2.6096989526
37035,2016,1728,1648,461,303,80,764,11.060898954,10.548820299,2.9508532511,1.9394979069,0.5120786553,4.8903511579
37035,2017,1707,1637,960,305,70,1265,10.851151067,10.406171235,6.1025805652,1.9388407004,0.4449798329,8.0414212656
13047,2010,189,85,35,7,104,42,NA,NA,NA,NA,NA,NA
13047,2011,707,497,459,15,210,474,10.975108082,7.7151749886,7.1252823335,0.2328523638,3.2599330938,7.3581346973
13047,2012,777,538,-142,17,239,-125,11.987780795,8.3004196495,-2.190817082,0.2622809183,3.6873611454,-1.928536164
13047,2013,755,528,118,15,227,133,11.60681343,8.1170827696,1.8140450129,0.2305989423,3.4897306604,2.0446439552
13047,2014,743,549,67,13,194,80,11.368504804,8.4001468878,1.0251545382,0.198910582,2.9683579166,1.2240651203
13047,2015,726,634,229,20,92,249,11.05788636,9.6566115042,3.4879558903,0.3046249686,1.4012748555,3.7925808589
13047,2016,717,714,420,24,3,444,10.856398764,10.810974502,6.3593967658,0.3633941009,0.0454242626,6.7227908667
13047,2017,702,665,226,24,37,250,10.570935949,10.013778357,3.4031788099,0.3613995196,0.5571575928,3.7645783296
35003,2010,1,3,21,0,-2,21,NA,NA,NA,NA,NA,NA
35003,2011,16,42,-5,0,-26,-5,4.2849491162,11.24799143,-1.339046599,0,-6.963042314,-1.339046599
35003,2012,29,39,-72,-1,-10,-73,7.8857919782,10.605030591,-19.57851801,-0.271923861,-2.719238613,-19.85044188
35003,2013,18,47,-19,-1,-29,-20,4.9833887043,13.012181617,-5.260243632,-0.276854928,-8.028792913,-5.53709856
35003,2014,22,31,-29,0,-9,-29,6.1659192825,8.6883408072,-8.127802691,0,-2.522421525,-8.127802691
35003,2015,26,41,-54,0,-15,-54,7.3979228909,11.665955328,-15.36491677,0,-4.268032437,-15.36491677
35003,2016,18,28,61,0,-10,61,5.1340559042,7.9863091843,17.398745009,0,-2.85225328,17.398745009
35003,2017,15,22,61,0,-7,61,4.2140750105,6.1806433488,17.137238376,0,-1.966568338,17.137238376
36009,2010,261,258,-120,7,3,-113,NA,NA,NA,NA,NA,NA
36009,2011,934,832,-559,49,102,-510,11.670550603,10.396036511,-6.984837031,0.6122665734,1.2745140915,-6.372570458
36009,2012,928,805,-626,41,123,-585,11.657998543,10.112811236,-7.864124017,0.5150624356,1.5451873069,-7.349061581
36009,2013,910,808,-499,56,102,-443,11.489318721,10.201504974,-6.300186859,0.7070349982,1.2878137468,-5.593151861
36009,2014,933,784,-519,57,149,-462,11.828168282,9.9392110751,-6.579656311,0.7226212134,1.8889572069,-5.857035098
36009,2015,892,844,-830,59,48,-771,11.382487303,10.769976776,-10.59132787,0.7528775234,0.6125105275,-9.838450348
36009,2016,866,853,-319,60,13,-259,11.119171583,10.952255613,-4.095861126,0.770381403,0.1669159706,-3.325479723
36009,2017,846,824,-494,59,22,-435,10.908457923,10.624786441,-6.369714201,0.7607553398,0.2836714826,-5.608958861
38019,2010,9,15,-1,0,-6,-1,NA,NA,NA,NA,NA,NA
38019,2011,45,52,-34,-1,-7,-35,11.350737798,13.116408122,-8.576113003,-0.252238618,-1.765670324,-8.828351621
38019,2012,44,69,2,0,-25,2,11.190233978,17.548321465,0.508646999,0,-6.358087487,0.508646999
38019,2013,35,45,-57,0,-10,-57,9.0043735529,11.577051711,-14.6642655,0,-2.572678158,-14.6642655
38019,2014,47,38,-21,1,9,-20,12.210963887,9.8726942063,-5.455962588,0.2598077423,2.3382696804,-5.196154845
38019,2015,47,50,-26,1,-3,-25,12.27154047,13.054830287,-6.788511749,0.2610966057,-0.783289817,-6.527415144
38019,2016,49,31,-26,1,18,-25,12.850773669,8.1300813008,-6.818777865,0.2622606871,4.7206923682,-6.556517178
38019,2017,53,46,-55,1,7,-54,13.998943476000001,12.150026413,-14.52720549,0.26413100900000003,1.8489170629,-14.26307448
36011,2010,216,204,-135,9,12,-126,NA,NA,NA,NA,NA,NA
36011,2011,819,740,-335,54,79,-281,10.264572811,9.2744613919,-4.198573738,0.6767850205,0.9901114189,-3.521788718
36011,2012,792,737,-292,70,55,-222,9.9494362614,9.2585031877,-3.6682265,0.8793693665,0.6909330737,-2.788857134
36011,2013,795,775,-491,66,20,-425,10.023261531,9.7711040087,-6.190467185,0.8321198253,0.2521575228,-5.35834736
36011,2014,735,720,-397,72,15,-325,9.30880537,9.1188297502,-5.028021404,0.911882975,0.1899756198,-4.116138429
36011,2015,778,795,-541,75,-17,-466,9.9033216861,10.119718175,-6.886500041,0.9546903939,-0.216396489,-5.931809647
36011,2016,694,748,-585,76,-54,-509,8.8931033599,9.5850739383,-7.496347933,0.9738845178,-0.691970578,-6.522463415
36011,2017,698,688,-238,76,10,-162,8.9855818744,8.8568486097,-3.063851699,0.9783728115,0.1287332647,-2.085478888
24015,2010,298,225,-6,11,73,5,NA,NA,NA,NA,NA,NA
24015,2011,1158,838,32,73,320,105,11.422540282,8.2660524667,0.3156487815,0.7200737829,3.1564878155,1.0357225644
24015,2012,1165,807,-242,74,358,-168,11.457964515,7.9369762776,-2.380109367,0.7278020378,3.5209882371,-1.652307329
24015,2013,1101,908,-95,78,193,-17,10.810120865,8.9151587154,-0.93275339,0.7658396253,1.8949621498,-0.166913764
24015,2014,1061,863,43,93,198,136,10.392790675,8.4533254971,0.4211969831,0.9109609168,1.9394651778,1.3321578999
24015,2015,1018,910,8,99,108,107,9.9462142344,8.8910166536,0.0781627838,0.9672644491,1.0551975809,1.0454272329
24015,2016,1200,953,-99,103,247,4,11.698585933,9.2906269955,-0.96513334,1.004128626,2.407958938,0.0389952864
24015,2017,1159,969,-245,103,190,-142,11.28271525,9.4330897993,-2.385043345,1.0026916918,1.8496254508,-1.382351653
19031,2010,35,28,1,0,7,1,NA,NA,NA,NA,NA,NA
19031,2011,199,191,-109,0,8,-109,10.784738782,10.351181444,-5.90721873,0,0.433557338,-5.90721873
19031,2012,179,170,-76,4,9,-72,9.7436176583,9.2537150944,-4.136954983,0.2177344728,0.4899025638,-3.919220511
19031,2013,170,162,-91,12,8,-79,9.2870800328,8.8500409724,-4.971319312,0.6555585905,0.4370390604,-4.315760721
19031,2014,179,175,35,12,4,47,9.7846288401,9.5659779163,1.9131955833,0.6559527714,0.2186509238,2.5691483547
19031,2015,195,200,-22,12,-5,-10,10.650499754,10.923589492,-1.201594844,0.6554153695,-0.273089737,-0.546179475
19031,2016,191,194,97,13,-3,110,10.40673441,10.570190972,5.2850954859,0.7083117661,-0.163456561,5.993407252
19031,2017,190,191,127,13,-1,140,10.284167794,10.338294993,6.8741542625,0.7036535859,-0.054127199,7.5778078484
29039,2010,36,68,20,0,-32,20,NA,NA,NA,NA,NA,NA
29039,2011,142,187,-12,0,-45,-12,10.18651363,13.414634146,-0.860832138,0,-3.228120516,-0.860832138
29039,2012,178,185,6,1,-7,7,12.796549245,13.299784328,0.4313443566,0.0718907261,-0.503235083,0.5032350827
29039,2013,173,196,-109,-1,-23,-110,12.498193903,14.159803497,-7.874584598,-0.072243895,-1.661609594,-7.946828493
29039,2014,176,204,42,-1,-28,41,12.770743388,14.802452563,3.047563763,-0.072561042,-2.031709175,2.975002721
29039,2015,177,211,37,-1,-34,36,12.837249782,15.30316217,2.6834928924,-0.072526835,-2.465912388,2.6109660574
29039,2016,189,213,123,-1,-24,122,13.659030137,15.393510154,8.8892100889,-0.072270001,-1.734480017,8.8169400882
29039,2017,188,209,208,-1,-21,207,13.448263529,14.950463178,14.878929862,-0.071533317,-1.502199649,14.807396545
31027,2010,25,37,-22,0,-12,-22,NA,NA,NA,NA,NA,NA
31027,2011,99,98,-71,0,1,-71,11.270491803,11.156648452,-8.08287796,0,0.1138433515,-8.08287796
31027,2012,108,106,-54,0,2,-54,12.380351923,12.151086147,-6.190175961,0,0.2292657764,-6.190175961
31027,2013,92,92,-73,-3,0,-76,10.622943248,10.622943248,-8.429074534,-0.346400323,0,-8.775474857
31027,2014,104,87,-99,-2,17,-101,12.116975417,10.136315973,-11.53442852,-0.233018758,1.9806594431,-11.76744728
31027,2015,132,121,-38,-2,11,-40,15.478424015,14.188555347,-4.455909944,-0.234521576,1.2898686679,-4.69043152
31027,2016,97,91,77,-2,6,75,11.339061313,10.637676077,9.0011105266,-0.233795079,0.7013852358,8.767315448
31027,2017,108,91,-79,-2,17,-81,12.613138686,10.627737226,-9.226277372,-0.233576642,1.9854014599,-9.459854015
42027,2010,393,216,-64,151,177,87,NA,NA,NA,NA,NA,NA
42027,2011,1237,940,-362,831,297,469,7.9982154346,6.0778678322,-2.340625697,5.3730937964,1.9203476023,3.0324680993
42027,2012,1320,925,-459,937,395,478,8.4901655582,5.9495478344,-2.952262115,6.0267311576000004,2.5406177239,3.0744690431
42027,2013,1282,935,985,1031,347,2016,8.1602255838,5.9514905779,6.2697521061,6.5625527121,2.2087350059,12.832304818
42027,2014,1242,917,-95,1133,325,1038,7.8129177348,5.7684746882,-0.597606429,7.1272429899,2.0444430465,6.5296365609
42027,2015,1309,959,-633,1203,350,570,8.1763952653,5.9901933227,-3.9539023700000002,7.5142883913,2.1862019426,3.5603860208
42027,2016,1294,1010,24,1219,284,1243,8.0214235237,6.2609256252,0.1487744703,7.556503304,1.7604978986,7.7052777743
42027,2017,1265,1043,-853,1202,222,349,7.7907760906,6.4235410771,-5.253384984,7.4027769652,1.3672350135,2.1493919807
19033,2010,124,133,-51,6,-9,-45,NA,NA,NA,NA,NA,NA
19033,2011,479,463,-165,16,16,-149,10.879811023,10.516393536,-3.747742837,0.3634174872,0.3634174872,-3.38432535
19033,2012,484,501,-277,26,-17,-251,11.043672706,11.431570301,-6.320449049,0.5932551453,-0.387897595,-5.727193903
19033,2013,443,465,-192,37,-22,-155,10.1600844,10.664648411,-4.403467731,0.8485849273,-0.504564011,-3.554882804
19033,2014,494,512,-370,40,-18,-330,11.398509426,11.813839729,-8.537345116,0.9229562288,-0.415330303,-7.614388888
19033,2015,485,532,-237,42,-47,-195,11.267409309,12.359302582,-5.50592991,0.9757344144,-1.091893273,-4.530195495
19033,2016,443,508,163,44,-65,207,10.303883145,11.815739589,3.7912707735,1.0234105155,-1.511856443,4.814681289
19033,2017,461,505,-55,44,-44,-11,10.712210991,11.7346346,-1.278029511,1.0224236087,-1.022423609,-0.255605902
08015,2010,30,29,-7,3,1,-4,NA,NA,NA,NA,NA,NA
08015,2011,147,155,207,12,-8,219,8.206788745,8.6534167039,11.556498437,0.6699419384,-0.446627959,12.226440375
08015,2012,150,158,118,11,-8,129,8.2962307458,8.7386963856,6.5263681867,0.6083902547,-0.44246564,7.1347584414
08015,2013,111,177,273,-4,-66,269,6.0840253227,9.701553893,14.963413632,-0.219244156,-3.61752857,14.744169476
08015,2014,141,171,120,-3,-30,117,7.665959876,9.2970151688,6.5242211711,-0.163105529,-1.631055293,6.3611156418
08015,2015,138,203,204,-2,-65,202,7.4552281138,10.966748602,11.020771994,-0.108046784,-3.511520488,10.91272521
08015,2016,132,172,543,-2,-40,541,7.0093457944,9.1333899745,28.833899745,-0.106202209,-2.12404418,28.727697536
08015,2017,136,159,577,-2,-23,575,7.0247933884,8.2128099174,29.803719008,-0.103305785,-1.188016529,29.700413223
01017,2010,81,80,-54,8,1,-46,NA,NA,NA,NA,NA,NA
01017,2011,401,441,-76,27,-40,-49,11.767640456,12.941469928,-2.230275997,0.7923348935,-1.173829472,-1.437941103
01017,2012,394,475,124,18,-81,142,11.567312068,13.945363534,3.6404738488,0.5284558813,-2.378051466,4.16892973
01017,2013,406,452,58,21,-46,79,11.90371478,13.252411528,1.7005306829,0.6157093852,-1.348696748,2.316240068
01017,2014,425,454,-157,14,-29,-143,12.487145585,13.339209637,-4.612898487,0.4113412663,-0.852064052,-4.201557221
01017,2015,421,446,31,17,-25,48,12.397667707,13.133871253,0.9128923965,0.500618411,-0.736203546,1.4135108075
01017,2016,388,446,-208,17,-58,-191,11.464874049,13.178695427,-6.146118047,0.5023269558,-1.713821378,-5.643791091
01017,2017,384,468,65,17,-84,82,11.389589204,13.881061842,1.9279252558,0.5042266054,-2.491472638,2.4321518612
48071,2010,120,83,284,2,37,286,NA,NA,NA,NA,NA,NA
48071,2011,475,238,-13,16,237,3,13.356202902,6.6921606119,-0.365538185,0.4498931504,6.66404229,0.0843549657
48071,2012,454,269,595,17,185,612,12.581056365,7.4544144544,16.488388849,0.4710968243,5.126641911,16.959485673
48071,2013,478,261,565,74,217,639,12.947087582,7.0694348515,15.303565866,2.0043608391,5.8776527309,17.307926705
48071,2014,448,258,638,98,190,736,11.846680682,6.8224187855,16.870942578,2.5914613991,5.0242618963,19.462403977
48071,2015,496,296,461,114,200,575,12.826148794,7.6543146027,11.92107781,2.9479454889,5.171834191,14.869023299
48071,2016,541,256,820,120,285,940,13.637165688,6.4530765547,20.670010839,3.024879635,7.1840891331,23.694890474
48071,2017,538,259,761,120,279,881,13.166266947,6.3384073222,18.623660124,2.9367138172,6.8278596251,21.560373942
17019,2010,603,282,-239,380,321,141,NA,NA,NA,NA,NA,NA
17019,2011,2334,1245,-1555,1740,1089,185,11.543711793,6.157635468,-7.69086197,8.6058519793,5.386076325,0.9149900093
17019,2012,2422,1146,-1650,1619,1276,-31,11.903650223,5.6323629876,-8.10942315,7.9570642905,6.2712872358,-0.152358859
17019,2013,2351,1261,-1219,1651,1090,432,11.475905967,6.1553030303,-5.950288972,8.0590049984,5.3206029366,2.1087160262
17019,2014,2447,1233,-1608,1835,1214,227,11.85820552,5.9751399288,-7.792396598,8.8924426353,5.8830655909,1.1000460372
17019,2015,2428,1280,-1840,1952,1148,112,11.688952544,6.162215509,-8.858184794,9.3973786513,5.5267370347,0.539193857
17019,2016,2364,1323,-2122,1986,1041,-136,11.321269764,6.3358882815,-10.16232421,9.511015969,4.9853814823,-0.651308244
17019,2017,2360,1338,-2884,1971,1022,-913,11.273903302,6.3917299231,-13.777092,9.4156200886,4.8821733793,-4.361471913
39021,2010,95,66,-50,3,29,-47,NA,NA,NA,NA,NA,NA
39021,2011,421,404,-303,21,17,-282,10.540415357,10.114792885,-7.586094663,0.52576893709999994,0.4256224729,-7.060325726
39021,2012,392,374,-289,19,18,-270,9.8775386786,9.4239782291,-7.282164995,0.4787582523,0.4535604495,-6.803406743
39021,2013,417,374,-164,5,43,-159,10.555893074,9.4673957068,-4.151478331,0.1265694613,1.0884973674,-4.02490887
39021,2014,384,371,-408,4,13,-404,9.7824425536,9.451266113,-10.39384521,0.1019004433,0.3311764406,-10.29194477
39021,2015,393,432,-81,4,-39,-77,10.076664701,11.076639061,-2.076869824,0.1025614728,-0.99997436,-1.974308351
39021,2016,405,403,-211,5,2,-206,10.427662916,10.376168284,-5.432683643,0.1287365792,0.0514946317,-5.303947064
39021,2017,396,396,101,5,0,106,10.209211493,10.209211493,2.6038645475,0.1289041855,0,2.732768733
29041,2010,18,11,13,0,7,13,NA,NA,NA,NA,NA,NA
29041,2011,80,93,-85,2,-13,-83,10.258383022,11.925370264,-10.89953196,0.2564595756,-1.666987241,-10.64307239
29041,2012,78,97,-50,2,-19,-48,10.106245141,12.568022804,-6.47836227,0.2591344908,-2.461777663,-6.219227779
29041,2013,91,75,-57,2,16,-55,11.87137173,9.7840975801,-7.435914161,0.2609092688,2.0872741504,-7.175004892
29041,2014,102,96,30,1,6,31,13.307240705,12.52446184,3.9138943249000002,0.1304631442,0.782778865,4.044357469
29041,2015,74,121,-47,1,-47,-46,9.6890343699,15.842880524,-6.153846154,0.1309328969,-6.153846154,-6.022913257
29041,2016,96,81,-78,1,15,-77,12.698412698,10.714285714,-10.31746032,0.1322751323,1.9841269841,-10.18518519
29041,2017,84,101,-32,1,-17,-31,11.19328403,13.458591512,-4.264108202,0.1332533813,-2.265307482,-4.13085482
51036,2010,25,36,14,0,-11,14,NA,NA,NA,NA,NA,NA
51036,2011,48,85,-17,0,-37,-17,6.6376270483,11.754131231,-2.350826246,0,-5.116504183,-2.350826246
51036,2012,57,72,-63,-1,-15,-64,7.9553384508,10.048848569,-8.792742498,-0.139567341,-2.093510119,-8.932309839
51036,2013,50,79,-26,0,-29,-26,7.0437416356,11.129111784,-3.66274565,0,-4.085370149,-3.66274565
51036,2014,59,66,-89,0,-7,-89,8.4009682472,9.3976932935,-12.67264702,0,-0.996725046,-12.67264702
51036,2015,72,57,48,0,15,48,10.276172126,8.135302933,6.8507814173,0,2.1408691929,6.8507814173
51036,2016,50,79,15,0,-29,15,7.1118697105,11.236754143,2.1335609132,0,-4.124884432,2.1335609132
51036,2017,51,100,32,0,-49,32,7.2716903115,14.258216297,4.5626292151,0,-6.986525986,4.5626292151
24017,2010,441,188,258,74,253,332,NA,NA,NA,NA,NA,NA
24017,2011,1843,947,968,197,896,1165,12.437911673,6.3910484829,6.5327718389,1.329500054,6.0468631897,7.8622718929
24017,2012,1914,890,243,227,1024,470,12.764425001,5.9353909355,1.6205617948,1.5138581375,6.8290340651,3.1344199322
24017,2013,1840,990,987,201,850,1188,12.128762636,6.5258016354,6.5060264789,1.3249354836,5.6029610001,7.8309619625
24017,2014,1809,935,698,190,874,888,11.777957185,6.0875566436,4.5445075264,1.237043596,5.6904005417,5.7815511225
24017,2015,1901,959,182,222,942,404,12.254435867,6.1820115711,1.1732284734,1.4310808851,6.0724242961,2.6043093584
24017,2016,1832,1094,701,202,738,903,11.697736118,6.9854384895,4.4760442241,1.289815882,4.7122976282,5.7658601061
24017,2017,1851,1112,1359,181,739,1540,11.673446221,7.0128969192,8.5706177277,1.141487718,4.6605493015,9.7121054457
46023,2010,35,11,0,0,24,0,NA,NA,NA,NA,NA,NA
46023,2011,148,110,-3,1,38,-2,16.136945974,11.993676062,-0.327100256,0.1090334187,4.1432699122,-0.218066837
46023,2012,168,93,-72,2,75,-70,18.276762402,10.117493473,-7.832898172,0.2175805048,8.1592689295,-7.615317668
46023,2013,156,80,-84,-1,76,-85,16.97404929,8.7046406616,-9.139872695,-0.108808008,8.2694086285,-9.248680703
46023,2014,147,93,-1,0,54,-1,15.957446809,10.095527573,-0.10855406,0,5.8619192358,-0.10855406
46023,2015,183,113,54,0,70,54,19.678477337,12.151190924,5.8067638045,0,7.5272864132,5.8067638045
46023,2016,153,106,-27,0,47,-27,16.326095075,11.310889399,-2.881075602,0,5.0152056768,-2.881075602
46023,2017,161,109,-4,0,52,-4,17.118553961,11.589580011,-0.425305688,0,5.52897395,-0.425305688
45019,2010,1110,756,361,92,354,453,NA,NA,NA,NA,NA,NA
45019,2011,4784,2886,4245,200,1898,4445,13.50430125,8.1466165148,11.982809115,0.564561089,5.357684735,12.547370204
45019,2012,4760,2817,4951,378,1943,5329,13.178057427,7.7988629773,13.706840824,1.0464927957,5.3791944497,14.753333619
45019,2013,4621,2873,4910,284,1748,5194,12.541609728,7.797456124,13.32596922,0.7707892583,4.7441536042,14.096758478
45019,2014,4917,2958,5502,292,1959,5794,13.07890166,7.8680884907,14.634963785,0.7767010951,5.2108131688,15.41166488
45019,2015,5079,3122,6890,429,1957,7319,13.205224371,8.1170920427,17.913761747,1.1153851654,5.0881323278,19.029146912
45019,2016,4961,3383,5270,375,1578,5645,12.62503197,8.6092487712,13.411392558,0.9543211023,4.0157831986,14.36571366
45019,2017,5038,3463,2975,299,1575,3274,12.626439835,8.6791109864,7.4560656034,0.7493659211,3.9473288488,8.2054315245
26029,2010,54,43,-35,4,11,-31,NA,NA,NA,NA,NA,NA
26029,2011,247,285,149,45,-38,194,9.4979908096,10.959220165,5.7295572091,1.7304031839,-1.461229355,7.459960393
26029,2012,242,235,18,59,7,77,9.2640444062,8.9960761795,0.6890611542,2.2585893387,0.2679682266,2.9476504929
26029,2013,255,289,76,15,-34,91,9.7367265507,11.034956757,2.9019263445,0.5727486206,-1.298230207,3.4746749652
26029,2014,211,299,25,18,-88,43,8.0558949297,11.41569945,0.9544899206,0.6872327428,-3.35980452,1.6417226634
26029,2015,239,289,20,22,-50,42,9.1357364015,11.046978327,0.76449677,0.840946447,-1.911241925,1.605443217
26029,2016,223,274,-7,26,-51,19,8.5314765576,10.482621421,-0.267804197,0.9947013027,-1.951144863,0.7268971058
26029,2017,221,274,44,26,-53,70,8.4575496068,10.485830734,1.6838560303,0.9950058361,-2.028281127,2.6788618664
12015,2010,260,581,208,43,-321,251,NA,NA,NA,NA,NA,NA
12015,2011,995,2273,1066,220,-1278,1286,6.223612197,14.21735731,6.6677091478,1.3760750586,-7.993745113,8.0437842064
12015,2012,997,2191,3782,271,-1194,4053,6.1788456652,13.578586612,23.438710437,1.6795056923,-7.399740947,25.118216129
12015,2013,1022,2346,2989,288,-1324,3277,6.2381166015,14.319590555,18.244354718,1.7579036998,-8.081473953,20.002258418
12015,2014,1036,2429,4413,368,-1393,4781,6.2191219992,14.581319823,26.491298632,2.2091089727,-8.362197823,28.700407605
12015,2015,1000,2503,5502,399,-1503,5901,5.8623519756,14.673466995,32.25466057,2.3390784383,-8.811115019,34.593739008
12015,2016,1051,2610,6470,417,-1559,6887,5.9889281756,14.872599941,36.868092575,2.3761970021,-8.883671766,39.244289577
12015,2017,1047,2665,5047,418,-1618,5465,5.8135983786,14.797745634,28.024098393,2.3209972515,-8.984147256,30.345095644
51037,2010,25,49,-2,0,-24,-2,NA,NA,NA,NA,NA,NA
51037,2011,130,150,-54,3,-20,-51,10.378412901,11.975091809,-4.311033051,0.2395018362,-1.596678908,-4.071531215
51037,2012,139,157,-77,2,-18,-75,11.171388387,12.618042998,-6.188466948,0.1607394012,-1.446654611,-6.027727547
51037,2013,154,166,-106,-1,-12,-107,12.483787289,13.456549935,-8.592736706,-0.081063554,-0.972762646,-8.673800259
51037,2014,131,157,-72,0,-26,-72,10.713993621,12.840435103,-5.888607181,0,-2.126441482,-5.888607181
51037,2015,147,131,-18,1,16,-17,12.072434608,10.75842812,-1.478257299,0.0821254055,1.3140064879,-1.396131893
51037,2016,140,147,-39,1,-7,-38,11.519789352,12.09577882,-3.209084177,0.0822842097,-0.575989468,-3.126799967
51037,2017,144,150,-6,1,-6,-5,11.876778424,12.371644192,-0.494865768,0.0824776279,-0.494865768,-0.41238814
51540,2010,123,51,-104,93,72,-11,NA,NA,NA,NA,NA,NA
51540,2011,485,256,-279,399,229,120,11.10805735,5.8632220237,-6.389995877,9.138381201,5.2448353259,2.7483853236
51540,2012,542,249,93,375,293,468,12.257451716,5.6311909177,2.1032158849,8.4807092134,6.6262607988,10.583925098
51540,2013,508,259,-173,409,249,236,11.328917732,5.7759639616,-3.858076314,9.121116835,5.55295377,5.263040521
51540,2014,534,296,-156,419,238,263,11.780797741,6.5301800212,-3.441581363,9.243734557,5.2506177197,5.8021531945
51540,2015,541,290,199,449,251,648,11.754353565,6.3008549608,4.3236901283,9.7554616463,5.453498604,14.079151775
51540,2016,600,272,26,454,328,480,12.79836181,5.8019240204,0.5545956784,9.6840937693,6.9964377893,10.238689448
51540,2017,592,292,-20,452,300,432,12.423272651,6.1276952941,-0.419705157,9.4853365511,6.2955773569,9.0656313939
13049,2010,38,5,566,-3,33,563,NA,NA,NA,NA,NA,NA
13049,2011,131,92,560,-14,39,546,9.956298689,6.9922097663,42.561276838,-1.064031921,2.9640889227,41.497244917
13049,2012,148,122,-125,-5,26,-130,11.034894125,9.0963316433,-9.32001193,-0.372800477,1.9385624814,-9.692812407
13049,2013,132,118,-267,7,14,-260,9.9682827367,8.9110406283,-20.16311735,0.5286210542,1.0572421084,-19.6344963
13049,2014,108,114,-134,55,-6,-79,8.2568807339,8.7155963303,-10.24464832,4.2048929664,-0.458715596,-6.039755352
13049,2015,111,104,81,64,7,145,8.4642366936,7.9304560012,6.1766051548,4.8802806161,0.5337806924,11.056885771
13049,2016,116,80,-544,67,36,-477,8.9433714969,6.1678424116,-41.9413284,5.1655680197,2.7755290852,-36.77576038
13049,2017,115,70,-150,67,45,-83,9.0316500432,5.4975261132,-11.7804131,5.2619178513,3.5341239299,-6.518495249
20017,2010,8,18,3,0,-10,3,NA,NA,NA,NA,NA,NA
20017,2011,18,41,9,0,-23,9,6.4853179607,14.772113133,3.2426589804,0,-8.286795172,3.2426589804
20017,2012,26,35,-17,0,-9,-17,9.4373865699,12.704174229,-6.170598911,0,-3.266787659,-6.170598911
20017,2013,26,31,-49,0,-5,-49,9.5746639661,11.415945498,-18.04455901,0,-1.841281532,-18.04455901
20017,2014,27,36,-26,0,-9,-26,10.108573568,13.478098091,-9.734181954,0,-3.369524523,-9.734181954
20017,2015,30,33,4,0,-3,4,11.305822499,12.436404748,1.5074429998,0,-1.13058225,1.5074429998
20017,2016,23,20,-11,0,3,-11,8.6825217063,7.550018875,-4.152510381,0,1.1325028313,-4.152510381
20017,2017,24,11,25,0,13,25,9.0107002065,4.1299042613,9.3861460484,0,4.8807959452,9.3861460484
31029,2010,13,20,8,0,-7,8,NA,NA,NA,NA,NA,NA
31029,2011,51,55,23,0,-4,23,12.826961771,13.832997988,5.7847082495,0,-1.006036217,5.7847082495
31029,2012,42,42,33,1,0,34,10.492130902,10.492130902,8.2438171371,0.2498126405,0,8.4936297777
31029,2013,46,45,-55,11,1,-44,11.502875719,11.252813203,-13.75343836,2.7506876719,0.2500625156,-11.00275069
31029,2014,37,54,18,16,-17,34,9.283653243,13.549115544,4.5163718479,4.0145527537,-4.265462301,8.5309246017
31029,2015,49,61,-15,20,-12,5,12.280701754,15.288220551,-3.759398496,5.0125313283,-3.007518797,1.2531328321
31029,2016,54,45,-64,23,9,-41,13.600302229,11.333585191,-16.11887672,5.7927213197,2.2667170382,-10.3261554
31029,2017,51,50,-8,24,1,16,12.870662461,12.61829653,-2.018927445,6.0567823344,0.2523659306,4.0378548896
13051,2010,868,501,172,173,367,345,NA,NA,NA,NA,NA,NA
13051,2011,3812,2252,3755,594,1560,4349,14.178488273,8.3761688326,13.966480447,2.2093447098,5.80231944,16.175825157
13051,2012,4008,2139,1797,923,1869,2720,14.617787528,7.8012593618,6.5539331805,3.3663218284,6.816528166,9.9202550089
13051,2013,3951,2278,-953,757,1673,-196,14.25155014,8.2169150137,-3.437541707,2.7305551648,6.0346351264,-0.706986542
13051,2014,3906,2321,2418,837,1585,3255,13.929578243,8.27715082,8.6230722459,2.9849096236,5.6524274234,11.607981869
13051,2015,4079,2397,1275,994,1682,2269,14.320395593,8.4152949829,4.4762207356,3.4896967931,5.9051006096,7.9659175287
13051,2016,4019,2463,116,901,1556,1017,13.949799465,8.5489813592,0.402631684,3.1273374765,5.4008181059,3.5299691605
13051,2017,4005,2516,-1164,810,1489,-354,13.812940708,8.6774928392,-4.014547562,2.7936284578,5.1354478687,-1.220919104
37037,2010,159,112,287,23,47,310,NA,NA,NA,NA,NA,NA
37037,2011,670,598,197,47,72,244,10.468095744,9.3431660521,3.0779326292,0.7343291044,1.1249296919,3.8122617336
37037,2012,609,628,428,24,-19,452,9.4602676526,9.755415576,6.6485953289,0.3728184297,-0.295147923,7.0214137586
37037,2013,590,630,744,16,-40,760,9.083630989,9.6994703781,11.454612637,0.2463357556,-0.615839389,11.700948393
37037,2014,625,645,1439,22,-20,1461,9.4621702434,9.7649596912,21.785700768,0.3330683926,-0.302789448,22.118769161
37037,2015,647,653,1576,37,-6,1613,9.5703688364,9.6591203248,23.312057629,0.5473008454,-0.088751488,23.859358475
37037,2016,643,651,1375,40,-8,1415,9.3025274519,9.4182665181,19.892652016,0.5786953314,-0.115739066,20.471347347
37037,2017,662,742,1685,38,-80,1723,9.3703997282,10.502774318,23.850639792,0.53787793,-1.13237459,24.388517722
13053,2010,53,1,-219,70,52,-149,NA,NA,NA,NA,NA,NA
13053,2011,224,38,-194,83,186,-111,19.954567725,3.385149882,-17.28208098,7.3938800053,16.569417843,-9.888200971
13053,2012,308,32,234,502,276,736,26.169335996,2.7188920515,19.881898127,42.652619058,23.450443944,62.534517184
13053,2013,268,34,-504,234,234,-270,21.857923497,2.7730201452,-41.10594568,19.084903352,19.084903352,-22.02104233
13053,2014,217,34,-914,188,183,-726,18.113522538,2.8380634391,-76.29382304,15.692821369,15.275459098,-60.60100167
13053,2015,235,37,-1133,275,198,-858,20.623985256,3.2471806573,-99.43393743,24.134450832,17.376804599,-75.29948659
13053,2016,202,25,-1307,154,177,-1153,19.079102715,2.3612750885,-123.4474616,14.545454545,16.717827627,-108.9020071
13053,2017,195,29,3,74,166,77,19.077434819,2.837156973,0.2934989972,7.2396419312,16.240277846,7.5331409284
13055,2010,49,96,-18,3,-47,-15,NA,NA,NA,NA,NA,NA
13055,2011,303,266,-325,7,37,-318,11.738044047,10.304685533,-12.59031127,0.2711759351,1.433358514,-12.31913534
13055,2012,291,315,-32,2,-24,-30,11.345913911,12.281659389,-1.247660636,0.0779787898,-0.935745477,-1.169681847
13055,2013,248,331,-510,4,-83,-506,9.7901821842,13.066735093,-20.13303594,0.1579061643,-3.276552908,-19.97512978
13055,2014,296,324,-163,5,-28,-158,11.863014248,12.985191271,-6.532673386,0.2003887542,-1.122177023,-6.332284632
13055,2015,299,332,66,7,-33,73,12.018892574,13.345392423,2.6529996985,0.2813787559,-1.326499849,2.9343784544
13055,2016,297,295,-73,7,2,-66,11.944740493,11.864304531,-2.935912647,0.2815258702,0.0804359629,-2.654386776
13055,2017,299,290,-78,7,9,-71,12.055722436,11.692841159,-3.14497107,0.2822409935,0.3628812773,-2.862730077
20019,2010,4,23,0,0,-19,0,NA,NA,NA,NA,NA,NA
20019,2011,34,57,-17,1,-23,-16,9.3689721686,15.706806283,-4.684486084,0.275558005,-6.337834114,-4.408928079
20019,2012,32,61,-23,3,-29,-20,8.9260808926,17.015341702,-6.415620642,0.8368200837,-8.089260809,-5.578800558
20019,2013,42,47,-26,0,-5,-26,11.844331641,13.254371122,-7.332205302,0,-1.410039481,-7.332205302
20019,2014,36,60,-49,0,-24,-49,10.300429185,17.167381974,-14.02002861,0,-6.86695279,-14.02002861
20019,2015,38,53,-56,0,-15,-56,11.098130841,15.478971963,-16.35514019,0,-4.380841121,-16.35514019
20019,2016,37,42,1,0,-5,1,10.924121642,12.400354296,0.2952465309,0,-1.476232654,0.2952465309
20019,2017,41,43,-20,0,-2,-20,12.151748666,12.744516894,-5.927682276,0,-0.592768228,-5.927682276
36013,2010,311,392,-112,28,-81,-84,NA,NA,NA,NA,NA,NA
36013,2011,1387,1498,-587,191,-111,-396,10.314299843,11.139741287,-4.36517232,1.4203541962,-0.825441444,-2.944818124
36013,2012,1411,1411,-1090,192,0,-898,10.547442937,10.547442937,-8.147918356,1.4352296554,0,-6.712688701
36013,2013,1393,1406,-612,189,-13,-423,10.464675148,10.562335433,-4.597545722,1.4198302965,-0.097660285,-3.177715425
36013,2014,1432,1378,-1306,229,54,-1077,10.81620013,10.408326661,-9.86449537,1.7296856353,0.4078734686,-8.134809735
36013,2015,1414,1509,-1279,230,-95,-1049,10.767262648,11.490664311,-9.739270811,1.7513935,-0.723401663,-7.987877311
36013,2016,1438,1390,-1395,229,48,-1166,11.04480134,10.67612925,-10.71453259,1.7588730923,0.3686720892,-8.955659501
36013,2017,1368,1362,-826,229,6,-597,10.576610846,10.530222202,-6.386169999,1.770499915,0.0463886441,-4.615670084
35005,2010,232,179,26,10,53,36,NA,NA,NA,NA,NA,NA
35005,2011,955,662,-361,6,293,-355,14.536211148,10.076410241,-5.494840026,0.091326981,4.4598009072,-5.403513045
35005,2012,918,650,-215,-25,268,-240,13.977389517,9.8968444292,-3.273571619,-0.380647863,4.0805450877,-3.654219482
35005,2013,945,641,-140,-10,304,-150,14.370000912,9.7472704601,-2.128889024,-0.152063502,4.6227304522,-2.280952526
35005,2014,949,657,-499,12,292,-487,14.435875203,9.9940674485,-7.590623526,0.1825400447,4.4418077549,-7.408083482
35005,2015,916,638,-389,27,278,-362,13.963840361,9.7259062776,-5.930058843,0.4115979146,4.2379340834,-5.518460929
35005,2016,931,647,-499,32,284,-467,14.221882757,9.8835210999,-7.622684743,0.4888294825,4.3383616574,-7.133855261
35005,2017,915,633,-821,31,282,-790,14.051306464,9.7207398819,-12.60778427,0.4760551917,4.3305665825,-12.13172908
47021,2010,104,58,-28,3,46,-25,NA,NA,NA,NA,NA,NA
47021,2011,414,369,-202,1,45,-201,10.602742883,9.4502708309,-5.173318991,0.0256104901,1.1524720526,-5.147708501
47021,2012,448,351,156,0,97,156,11.459119336,8.9780153726,3.9902290545,0,2.4811039634,3.9902290545
47021,2013,415,397,98,1,18,99,10.56598009,10.107696616,2.4950989128,0.025460193,0.4582834738,2.5205591058
47021,2014,455,336,157,2,119,159,11.52803466,8.5130102105,3.9778053662,0.0506726798,3.0150244496,4.0284780461
47021,2015,462,385,-110,4,77,-106,11.670350489,9.7252920745,-2.778654878,0.1010419956,1.9450584149,-2.677612883
47021,2016,469,439,124,2,30,126,11.828648533,11.072018563,3.1274038765,0.050441998,0.7566299701,3.1778458745
47021,2017,467,387,521,2,80,523,11.666541757,9.6679907067,13.015563716,0.0499637763,1.9985510505,13.065527493
26031,2010,49,96,-34,0,-47,-34,NA,NA,NA,NA,NA,NA
26031,2011,169,289,-66,6,-120,-60,6.5061307771,11.125868607,-2.540855806,0.2309868915,-4.61973783,-2.309868915
26031,2012,200,306,-37,7,-106,-30,7.7478838592,11.854262305,-1.433358514,0.2711759351,-4.106378445,-1.162182579
26031,2013,194,304,-56,1,-110,-55,7.5606999493,11.847694766,-2.182470088,0.0389726802,-4.286994817,-2.143497408
26031,2014,217,300,145,1,-83,146,8.4745762712,11.716004062,5.6627352964,0.0390533469,-3.24142779,5.7017886433
26031,2015,211,326,-128,1,-115,-127,8.2698073644,12.777048345,-5.016755178,0.0391933998,-4.507240981,-4.977561779
26031,2016,207,345,149,1,-138,150,8.150248051,13.583746752,5.8666036696,0.039373179,-5.433498701,5.9059768486
26031,2017,209,355,111,1,-146,112,8.2327221161,13.983810293,4.372402655,0.0393910149,-5.751088177,4.4117936699
53007,2010,267,112,136,9,155,145,NA,NA,NA,NA,NA,NA
53007,2011,943,644,147,36,299,183,12.918250625,8.822219939,2.0137675948,0.4931675742,4.096030686,2.506935169
53007,2012,939,670,-4,37,269,33,12.796315097,9.1304910705,-0.054510394,0.5042211487,3.6658240268,0.4497107542
53007,2013,924,659,-45,63,265,18,12.543610768,8.9461466408,-0.610890135,0.8552461887,3.5974641272,0.2443560539
53007,2014,902,713,188,58,189,246,12.187624562,9.6338983509,2.5402144319,0.7836831758,2.5537262108,3.3238976077
53007,2015,984,731,614,80,253,694,13.173660711,9.7865304674,8.220150078,1.0710293261,3.3871302439,9.2911794041
53007,2016,915,732,536,82,183,618,12.108299809,9.6866398476,7.0929493966,1.0851153928,2.4216599619,8.1780647893
53007,2017,955,683,215,81,272,296,12.524508036,8.9573183127,2.8196536416,1.0622881161,3.5671897233,3.8819417578
36015,2010,254,197,73,18,57,91,NA,NA,NA,NA,NA,NA
36015,2011,1024,970,-107,61,54,-46,11.507686775,10.900836105,-1.202463364,0.6855164973,0.6068506698,-0.516946867
36015,2012,1049,916,21,74,133,95,11.774609945,10.281737569,0.235716691,0.8306207206,1.4928723762,1.0663374116
36015,2013,1023,928,-998,66,95,-932,11.522151703,10.452157165,-11.24057419,0.743364626,1.0699945374,-10.49720957
36015,2014,918,881,-1086,70,37,-1016,10.444398935,10.023437322,-12.3557922,0.7964138622,0.4209616129,-11.55937834
36015,2015,1024,1017,-458,73,7,-385,11.7401573,11.659902318,-5.250968792,0.8369448075,0.0802549815,-4.414023985
36015,2016,937,981,-1024,78,-44,-946,10.827988675,11.336453458,-11.83336222,0.9013693881,-0.508464783,-10.93199284
36015,2017,937,932,-569,81,5,-488,10.920936846,10.862660769,-6.631817573,0.9440724488,0.0582760771,-5.687745124
36017,2010,107,165,-48,1,-58,-47,NA,NA,NA,NA,NA,NA
36017,2011,535,527,-231,5,8,-226,10.638192104,10.479116334,-4.593312852,0.0994223561,0.1590757698,-4.493890496
36017,2012,505,545,-267,11,-40,-256,10.092733232,10.892157646,-5.336157966,0.219841714,-0.799424414,-5.116316252
36017,2013,535,545,-405,17,-10,-388,10.766753874,10.96800161,-8.150533307,0.3421211511,-0.201247736,-7.808412155
36017,2014,539,538,-167,16,1,-151,10.907398413,10.887162053,-3.379472236,0.3237817711,0.0202363607,-3.055690465
36017,2015,528,602,-487,17,-74,-470,10.760248219,12.268313311,-9.924698642,0.3464473859,-1.508065091,-9.578251256
36017,2016,474,564,-404,17,-90,-387,9.7609192562,11.614258355,-8.31943329,0.3500751632,-1.853339099,-7.969358127
36017,2017,478,547,-408,17,-69,-391,9.9390763729,11.373796602,-8.483563097,0.3534817957,-1.43472023,-8.130081301
01019,2010,55,110,41,1,-55,42,NA,NA,NA,NA,NA,NA
01019,2011,221,310,115,-2,-89,113,8.5055613286,11.930877882,4.4259708271,-0.076973406,-3.425316553,4.3489974214
01019,2012,245,334,53,3,-89,56,9.431964736,12.858270293,2.0403842082,0.1154934457,-3.426305557,2.1558776539
01019,2013,233,341,162,4,-108,166,8.966366505,13.12245055,6.2341260679,0.1539290387,-4.156084045,6.3880551066
01019,2014,251,347,-20,5,-96,-15,9.670397411,13.369035465,-0.770549594,0.1926373986,-3.698638054,-0.577912196
01019,2015,231,338,-52,6,-107,-46,8.9468995701,13.091134436,-2.014020682,0.2323870018,-4.144234866,-1.781633681
01019,2016,234,356,141,7,-122,148,9.086143631,13.823363815,5.4749839828,0.2718077155,-4.737220184,5.7467916982
01019,2017,244,338,178,7,-94,185,9.4531507274,13.094938303,6.8961509405,0.2711969471,-3.641787575,7.1673478876
13057,2010,664,261,368,49,403,417,NA,NA,NA,NA,NA,NA
13057,2011,2851,1212,817,200,1639,1017,13.168317518,5.5980360685,3.7735936205,0.9237683281,7.5702814491,4.6973619486
13057,2012,2785,1227,1287,114,1558,1401,12.69970109,5.5951645375,5.8687667154,0.519844138,7.1045365521,6.3886108533
13057,2013,2735,1265,2121,112,1470,2233,12.284957104,5.6820733953,9.5270179221,0.503076854,6.6028837084,10.030094776
13057,2014,2866,1277,4087,145,1589,4232,12.601042466000001,5.6146305753,17.969455882,0.6375265728,6.9864118905,18.606982455
13057,2015,2807,1460,3463,187,1347,3650,12.051865527,6.2685157357,14.868404105,0.8028852346,5.7833497918,15.671289339
13057,2016,2839,1489,4624,194,1350,4818,11.90296505,6.242872476,19.386865231,0.8133762662,5.660092574,20.200241497
13057,2017,2791,1489,4452,198,1302,4650,11.41109587,6.0878257794,18.202149342,0.8095295529,5.3232700905,19.011678895
19035,2010,17,22,45,1,-5,46,NA,NA,NA,NA,NA,NA
19035,2011,111,156,-42,0,-45,-42,9.1952118627,12.923000456,-3.479269353,0,-3.727788593,-3.479269353
19035,2012,137,171,-35,-1,-34,-36,11.423806546,14.25891182,-2.918490723,-0.083385449,-2.835105274,-3.001876173
19035,2013,140,162,-59,2,-22,-57,11.74743025,13.593455003,-4.950702748,0.1678204321,-1.846024754,-4.782882316
19035,2014,144,161,-67,6,-17,-61,12.162162162,13.597972973,-5.658783784,0.5067567568,-1.435810811,-5.152027027
19035,2015,129,164,-291,6,-35,-285,11.079142869,14.085111865,-24.99248508,0.5153089707,-3.005968996,-24.47717611
19035,2016,125,161,-51,6,-36,-45,10.922277076,14.067892874,-4.456289047,0.5242692997,-3.145615798,-3.932019747
19035,2017,131,169,-55,6,-38,-49,11.531690141,14.876760563,-4.841549296,0.5281690141,-3.345070423,-4.313380282
20021,2010,48,94,-32,-1,-46,-33,NA,NA,NA,NA,NA,NA
20021,2011,244,274,-133,-9,-30,-142,11.382189672,12.781639222,-6.204226338,-0.419834865,-1.39944955,-6.624061203
20021,2012,265,274,-153,-5,-9,-158,12.459448023,12.882599088,-7.193568104,-0.235083925,-0.423151065,-7.428652029
20021,2013,204,261,-233,-7,-57,-240,9.6960479099,12.405237767,-11.07440766,-0.332707526,-2.709189857,-11.40711519
20021,2014,240,255,-114,-6,-15,-120,11.524056468,12.244309997,-5.473926822,-0.288101412,-0.720253529,-5.762028234
20021,2015,237,268,-206,-6,-31,-212,11.483670898,12.985754434,-9.981587363,-0.290725846,-1.502083535,-10.27231321
20021,2016,245,242,-294,-6,3,-300,12.028377151,11.8810909,-14.43405258,-0.294572502,0.1472862508,-14.72862508
20021,2017,231,257,-71,-6,-26,-77,11.454072146,12.743275071,-3.520515681,-0.297508367,-1.2892029250000001,-3.818024049
37039,2010,56,97,28,3,-41,31,NA,NA,NA,NA,NA,NA
37039,2011,232,348,-141,8,-116,-133,8.4972347361,12.745852104,-5.164267663,0.2930080943,-4.248617368,-4.871259569
37039,2012,207,354,6,1,-147,7,7.6371082293,13.060561899,0.2213654559,0.0368942427,-5.42345367,0.2582596986
37039,2013,220,372,239,1,-152,240,8.1249769177,13.738597334,8.8266794697,0.0369317133,-5.613620416,8.8636111829
37039,2014,223,381,126,3,-158,129,8.2265055796,14.055150789,4.6481601033,0.1106704786,-5.828645209,4.7588305819
37039,2015,192,363,207,4,-171,211,7.081604426,13.388658368,7.6348547718,0.1475334255,-6.307053942,7.7823881973
37039,2016,249,343,841,3,-94,844,9.0520767064,12.469326547,30.57347996,0.1090611651,-3.417249841,30.682541125
37039,2017,241,330,291,3,-89,294,8.611756298,11.792031445,10.398427729,0.1072002859,-3.180275147,10.505628015
40021,2010,152,120,89,1,32,90,NA,NA,NA,NA,NA,NA
40021,2011,635,463,387,5,172,392,13.399451361,9.7699936696,8.1662798059,0.105507491,3.6294576915,8.2717872969
40021,2012,649,451,85,9,198,94,13.572153037,9.4314961783,1.7775547121,0.1882116754,4.1406568587,1.9657663875
40021,2013,595,538,-181,18,57,-163,12.419119182,11.229388437,-3.777916928,0.3757044458,1.1897307451,-3.402212482
40021,2014,614,495,215,30,119,245,12.782213155,10.304878683,4.4758563979,0.624538102,2.4773344714,5.1003944999
40021,2015,529,542,84,32,-13,116,10.960663856,11.230018544,1.7404456784,0.6630269251,-0.269354688,2.4034726035
40021,2016,654,477,230,31,177,261,13.475783769,9.8286679785,4.7391900106,0.6387603927,3.6471157908,5.3779504033
40021,2017,624,496,-19,31,128,12,12.781777773,10.15987464,-0.389188746,0.634992165,2.621903133,0.2458034187
45021,2010,186,167,37,-2,19,35,NA,NA,NA,NA,NA,NA
45021,2011,691,579,74,-10,112,64,12.428169318,10.413762714,1.3309472207,-0.179857733,2.0144066044,1.1510894882
45021,2012,697,553,6,-14,144,-8,12.503027096,9.9199052855,0.1076300754,-0.251136843,2.5831218103,-0.143506767
45021,2013,669,615,194,-7,54,187,11.961594164,10.996084321,3.4686835094,-0.125158683,0.9655098428,3.3435248261
45021,2014,659,608,260,-2,51,258,11.725874325,10.818409089,4.6262933604,-0.035586872,0.9074652361,4.5907064884
45021,2015,674,634,132,-1,40,131,11.943154836,11.234362264,2.3390154871,-0.017719814,0.7087925719,2.3212956728
45021,2016,683,640,169,-1,43,168,12.062768785,11.303326534,2.9847846628,-0.017661448,0.7594422515,2.9671232151
45021,2017,663,589,308,-1,74,307,11.648950189,10.348765703,5.4115786699,-0.017570061,1.3001844856,5.3940086093
48073,2010,203,78,-14,1,125,-13,NA,NA,NA,NA,NA,NA
48073,2011,770,532,-98,2,238,-96,15.095819242,10.429838749,-1.921286085,0.0392099201,4.6659804931,-1.882076165
48073,2012,709,478,-41,2,231,-39,13.856181049,9.3416848256,-0.801274221,0.0390865474,4.5144962233,-0.762187674
48073,2013,728,545,-366,11,183,-355,14.225835133,10.649835367,-7.151999531,0.2149508056,3.5759997655,-6.937048725
48073,2014,785,503,-211,22,282,-189,15.352721441,9.8374762864,-4.126655062,0.4302673525,5.5152451546,-3.69638771
48073,2015,776,531,123,39,245,162,15.105063895,10.336068206,2.3942304885,0.7591462524,4.7689956884,3.1533767409
48073,2016,778,550,52,43,228,95,15.038320656,10.631203549,1.0051319719,0.8311668229,4.4071171075,1.8362987948
48073,2017,777,523,51,43,254,94,14.92279327,10.044557118,0.9794883614,0.8258431282,4.8782361527,1.8053314896
31031,2010,7,24,-2,0,-17,-2,NA,NA,NA,NA,NA,NA
31031,2011,72,56,23,-2,16,21,12.605042017,9.8039215686,4.0266106443,-0.350140056,2.8011204482,3.6764705882
31031,2012,65,62,0,-2,3,-2,11.342814763,10.819300236,0,-0.349009685,0.5235145275,-0.349009685
31031,2013,70,57,13,-2,13,11,12.189812799,9.9259904223,2.263822377,-0.348280366,2.263822377,1.9155420113
31031,2014,67,54,-26,-1,13,-27,11.658256482,9.3962067165,-4.52409953,-0.174003828,2.2620497651,-4.698103358
31031,2015,89,75,63,-1,14,62,15.401920914,12.979146837,10.902483343,-0.173055291,2.4227740763,10.729428052
31031,2016,74,52,-10,-1,22,-11,12.708226,8.930104757,-1.717327838,-0.171732784,3.7781212433,-1.889060622
31031,2017,77,55,-32,-1,22,-33,13.222289001,9.4444921439,-5.494977247,-0.171718039,3.7777968576,-5.666695286
51550,2010,724,414,786,89,310,875,NA,NA,NA,NA,NA,NA
51550,2011,2767,1559,451,186,1208,637,12.326814274,6.9452488083,2.0091771729,0.8286185236,5.3815654653,2.8377956965
51550,2012,2768,1548,993,521,1220,1514,12.207788198,6.8271879086,4.3794558096,2.2977809434,5.3806002898,6.677236753
51550,2013,2805,1687,797,423,1118,1220,12.235283854,7.3586181326,3.4764781575,1.8451069769,4.8766657216,5.3215851345
51550,2014,2883,1621,1314,469,1262,1783,12.431010693,6.9894791307,5.6657468092,2.0222490514,5.4415315626,7.6879958606
51550,2015,2988,1744,-43,581,1244,538,12.752282223,7.4430991289,-0.183516779,2.4796104323,5.3091830943,2.2960936533
51550,2016,3041,1830,752,471,1211,1223,12.863436496,7.7409039092,3.1809616064,1.9923310061,5.1225325869,5.1732926125
51550,2017,2991,1848,1276,375,1143,1651,12.514173106,7.7319264128,5.3387110946,1.568978574,4.7822466936,6.9076896686
33005,2010,186,150,-98,-4,36,-102,NA,NA,NA,NA,NA,NA
33005,2011,741,697,-205,-11,44,-216,9.6281281671,9.0564174528,-2.663652192,-0.142927679,0.5717107144,-2.806579871
33005,2012,712,718,-61,0,-6,-61,9.2662484708,9.3443348343,-0.793878029,0,-0.078086364,-0.793878029
33005,2013,699,700,-230,18,-1,-212,9.1139042453,9.126942735,-2.998852613,0.2346928132,-0.01303849,-2.7641598
33005,2014,626,668,-309,30,-42,-279,8.1908762013,8.7404238059,-4.043100234,0.3925340033,-0.549547605,-3.65056623
33005,2015,642,686,-207,33,-44,-174,8.4307841811,9.008594935,-2.718336956,0.4333580654,-0.577810754,-2.28497889
33005,2016,684,714,-342,34,-30,-308,9.0158370295,9.4112684782,-4.507918515,0.4481556418,-0.395431449,-4.059762873
33005,2017,668,681,249,32,-13,281,8.809352684,8.9807921824,3.2837257759,0.422004919,-0.171439498,3.7057306949
42029,2010,1422,908,60,228,514,288,NA,NA,NA,NA,NA,NA
42029,2011,5552,3630,560,1071,1922,1631,11.067212585,7.2359477098,1.1162894539,2.1349035805,3.8312648756,3.2511930344
42029,2012,5563,3621,-111,1104,1942,993,11.019256463,7.1725198007,-0.219870118,2.1868163104,3.846736662,1.9669461922
42029,2013,5384,3755,412,1126,1629,1538,10.601858279,7.3941266414,0.8112863319,2.2172534216,3.2077316375,3.0285397535
42029,2014,5494,3739,454,1352,1755,1806,10.748817317,7.315221687,0.8882349949,2.6451403372,3.43359563,3.5333753321
42029,2015,5671,3899,-892,1515,1772,623,11.032108084,7.5849390618,-1.735256641,2.9472127927,3.4471690222,1.2119561517
42029,2016,5365,4000,-1661,1561,1365,-100,10.400158959,7.7540793727,-3.21988146,3.0260294752,2.6460795859,-0.193851984
42029,2017,5438,4072,-105,1566,1366,1461,10.500279016,7.8626583586,-0.202745365,3.0238023059,2.6376206576,2.8210569406
45023,2010,98,49,-39,-2,49,-41,NA,NA,NA,NA,NA,NA
45023,2011,379,383,-273,-7,-4,-280,11.483456551,11.604653981,-8.271724639,-0.212095504,-0.121197431,-8.483820143
45023,2012,456,354,-274,-8,102,-282,13.913467993,10.801244889,-8.360285592,-0.24409593,3.1122231037,-8.604381522
45023,2013,413,368,0,-4,45,-4,12.628424658,11.252446184,0,-0.122309198,1.3759784736,-0.122309198
45023,2014,370,426,-238,-4,-56,-242,11.358926735,13.078115646,-7.306552873,-0.12279920800000001,-1.719188911,-7.429352081
45023,2015,381,410,3,-4,-29,-1,11.756537838,12.651392425,0.0925711641,-0.123428219,-0.894854586,-0.030857055
45023,2016,367,417,-55,-4,-50,-59,11.349930416,12.896242462,-1.70094325,-0.123704964,-1.546312046,-1.824648214
45023,2017,361,405,70,-4,-44,66,11.179758753,12.542388628,2.1678202567,-0.123875443,-1.362629876,2.0439448135
47023,2010,45,19,27,0,26,27,NA,NA,NA,NA,NA,NA
47023,2011,182,189,-66,7,-7,-59,10.606369649,11.014306944,-3.846265917,0.4079372942,-0.407937294,-3.438328623
47023,2012,180,166,-88,-3,14,-91,10.533091462,9.7138510153,-5.149511382,-0.175551524,0.8192404471,-5.325062906
47023,2013,206,178,0,1,28,1,12.071137675,10.430400516,0,0.0585977557,1.6407371598,0.0585977557
47023,2014,202,199,14,7,3,21,11.819777648,11.644236396,0.8191925102,0.4095962551,0.1755412522,1.2287887654
47023,2015,196,205,-16,7,-9,-9,11.467353148,11.993915282,-0.936110461,0.4095483267,-0.526562134,-0.526562134
47023,2016,162,157,7,7,5,14,9.4778411584,9.1853151967,0.4095363464,0.4095363464,0.2925259617,0.8190726927
47023,2017,170,157,-3,7,13,4,9.9354197715,9.1756523772,-0.175330937,0.40910552,0.7597673943,0.2337745829
45025,2010,115,137,-86,4,-22,-82,NA,NA,NA,NA,NA,NA
45025,2011,520,477,-169,19,43,-150,11.164308564,10.241106125,-3.628400283,0.4079266591,0.923202439,-3.220473624
45025,2012,501,470,-472,20,31,-452,10.817463402,10.148119359,-10.19130285,0.4318348663,0.6693440428,-9.759467979
45025,2013,512,490,-5,36,22,31,11.09942877,10.62250019,-0.108392859,0.7804285854,0.4769285799,0.6720357263
45025,2014,532,493,-34,28,39,-6,11.523881729,10.679085888,-0.736488682,0.606520091,0.844795841,-0.129968591
45025,2015,542,530,-32,30,12,-2,11.736301333,11.476457023,-0.69291816,0.6496107749,0.25984431,-0.043307385
45025,2016,486,534,1,32,-48,33,10.524606139,11.564073412,0.0216555682,0.692978182,-1.039467273,0.7146337502
45025,2017,497,551,-200,32,-54,-168,10.790507827,11.962917128,-4.342256671,0.6947610673,-1.172409301,-3.647495603
51041,2010,1039,513,330,163,526,493,NA,NA,NA,NA,NA,NA
51041,2011,3724,1945,899,565,1779,1464,11.6804622,6.1005636356,2.8197463797,1.7721431641,5.5798985644,4.5918895437
51041,2012,3681,2059,1276,709,1622,1985,11.424439175,6.390361386,3.9602239575,2.2004692679,5.0340777892,6.1606932254
51041,2013,3729,2163,1711,653,1566,2364,11.441019229,6.6363434147,5.249553205,2.0034823161,4.8046758148,7.2530355212
51041,2014,3768,2132,2283,661,1636,2944,11.412924956,6.4576316363,6.9149967288,2.0021081199,4.9552933194,8.9171048487
51041,2015,3796,2383,668,772,1413,1440,11.370784632,7.1381927761,2.0009705306,2.3124988767,4.2325918559,4.3134694073
51041,2016,3869,2415,1381,738,1454,2119,11.479588052,7.1654704435,4.0975216077,2.1896965579,4.3141176087,6.2872181656
51041,2017,3797,2407,2700,714,1390,3414,11.128142154,7.0543687556,7.9130850188,2.0925713716,4.0737733986,10.00565639
08017,2010,4,2,-4,0,2,-4,NA,NA,NA,NA,NA,NA
08017,2011,21,21,13,9,0,22,11.397557666,11.397557666,7.0556309362,4.8846675712,0,11.940298507
08017,2012,38,27,-2,1,11,-1,20.457604307,14.535666218,-1.076716016,0.5383580081,5.9219380888,-0.538358008
08017,2013,27,18,-4,2,9,-2,14.473331547,9.6488876977,-2.144197266,1.0720986331,4.8244438488,-1.072098633
08017,2014,26,14,-50,2,12,-48,14.042668107,7.561436673,-27.00513097,1.080205239,6.481231434,-25.92492574
08017,2015,28,20,-35,3,8,-32,15.36351166,10.9739369,-19.20438957,1.646090535,4.3895747599,-17.55829904
08017,2016,25,17,12,3,8,15,13.717421125,9.3278463649,6.5843621399,1.646090535,4.3895747599,8.2304526749
08017,2017,25,13,-3,3,12,0,13.590649633,7.0671378092,-1.630877956,1.630877956,6.5235118239,0
20023,2010,5,15,-2,0,-10,-2,NA,NA,NA,NA,NA,NA
20023,2011,29,39,-12,1,-10,-11,10.726835584,14.425744405,-4.438690586,0.3698908822,-3.698908822,-4.068799704
20023,2012,31,45,-15,4,-14,-11,11.567164179,16.791044776,-5.597014925,1.4925373134,-5.223880597,-4.104477612
20023,2013,23,41,16,5,-18,21,8.6174597227,15.361558636,5.9947545897,1.8733608093,-6.744098913,7.868115399
20023,2014,28,21,5,3,7,8,10.455563854,7.8416728902,1.8670649739,1.1202389843,2.6138909634,2.9873039582
20023,2015,42,40,-18,3,2,-15,15.677491601,14.930944382,-6.718924972,1.1198208287,0.7465472191,-5.599104143
20023,2016,33,33,-5,4,0,-1,12.350299401,12.350299401,-1.871257485,1.497005988,0,-0.374251497
20023,2017,39,40,10,4,-1,14,14.568546881,14.942099365,3.7355248412,1.4942099365,-0.373552484,5.2297347777
31033,2010,32,37,-28,2,-5,-26,NA,NA,NA,NA,NA,NA
31033,2011,132,87,-27,1,45,-26,13.229104029,8.7191822008,-2.705953097,0.1002204851,4.509921828,-2.605732612
31033,2012,122,91,58,-2,31,56,12.162903145,9.0723293953,5.7823637904,-0.199391855,3.0905737501,5.5829719356
31033,2013,127,90,-37,-6,37,-43,12.612344208,8.937881722,-3.674462486,-0.595858781,3.6744624857,-4.270321267
31033,2014,135,107,25,-5,28,20,13.378920767,10.604033497,2.4775779198,-0.495515584,2.7748872702,1.9820623359
31033,2015,117,90,0,-5,27,-5,11.553843875,8.8875722115,0,-0.493754012,2.6662716635,-0.493754012
31033,2016,138,86,-117,-6,52,-123,13.660661255,8.5131657098,-11.58186498,-0.593941794,5.1474955454,-12.17580677
31033,2017,125,92,-419,-6,33,-425,12.663357309,9.3202309796,-42.4475737,-0.607841151,3.3431263297,-43.05541485
19037,2010,46,54,-24,-1,-8,-25,NA,NA,NA,NA,NA,NA
19037,2011,136,135,-5,0,1,-5,10.964647075,10.88402467,-0.403112025,0,0.080622405,-0.403112025
19037,2012,148,124,-144,0,24,-144,11.992545175,10.047808119,-11.66842233,0,1.9447370553,-11.66842233
19037,2013,138,151,0,0,-13,0,11.242362525,12.301425662,0,0,-1.059063136,0
19037,2014,141,128,-42,1,13,-41,11.506916391,10.445995022,-3.427592117,0.0816093361,1.0609213694,-3.34598278
19037,2015,125,138,-103,1,-13,-102,10.261883261,11.32911912,-8.455791807,0.0820950661,-1.067235859,-8.373696741
19037,2016,134,125,-70,1,9,-69,11.08079054,10.33655834,-5.78847267,0.0826924667,0.7442322004,-5.705780203
19037,2017,133,114,-79,1,19,-78,11.052019279,9.4731593818,-6.564733256,0.0830978893,1.578859897,-6.481635366
28017,2010,84,23,-13,0,61,-13,NA,NA,NA,NA,NA,NA
28017,2011,250,191,-11,7,59,-4,14.312703956,10.934905822,-0.629758974,0.4007557108,3.3777981336,-0.229003263
28017,2012,241,153,-98,13,88,-85,13.774577046,8.7448559671,-5.601280293,0.7430269776,5.0297210791,-4.858253315
28017,2013,246,170,-212,13,76,-199,14.108335962,9.7496630631,-12.15840335,0.7455624695,4.3586728988,-11.41284088
28017,2014,233,187,-56,19,46,-37,13.406214039,10.759493671,-3.222094361,1.0932105869,2.6467203682,-2.128883774
28017,2015,281,193,-106,20,88,-86,16.164289001,11.102162908,-6.097560976,1.1504832029,5.062126093,-4.947077773
28017,2016,233,190,-215,21,43,-194,13.461205153,10.976948408,-12.42128373,1.2132416662,2.484256745,-11.20804206
28017,2017,236,208,-137,21,28,-116,13.728912158,12.100058173,-7.969749855,1.2216404887,1.6288539849,-6.748109366
05017,2010,34,19,-17,1,15,-16,NA,NA,NA,NA,NA,NA
05017,2011,169,180,-101,6,-11,-95,14.387876724,15.324365742,-8.598671888,0.5108121914,-0.936489018,-8.087859697
05017,2012,170,159,-234,13,11,-221,14.66844989,13.719314897,-20.19068985,1.1217049916,0.9491349929,-19.06898486
05017,2013,130,161,-118,9,-31,-109,11.387027548,14.102395655,-10.33591731,0.7883326764,-2.715368108,-9.547584636
05017,2014,143,157,-164,17,-14,-147,12.691932191,13.934498979,-14.55578237,1.5088310997,-1.242566788,-13.04695127
05017,2015,103,159,-193,18,-56,-175,9.3027456647,14.360549133,-17.43135838,1.6257225434,-5.057803468,-15.80563584
05017,2016,132,142,-54,19,-10,-35,12.071882574,12.986419132,-4.938497416,1.7376194613,-0.914536559,-3.200877955
05017,2017,124,165,-255,19,-41,-236,11.509188788,15.314646371,-23.66808985,1.7635047336,-3.805457583,-21.90458511
48075,2010,15,5,18,0,10,18,NA,NA,NA,NA,NA,NA
48075,2011,102,63,-78,-2,39,-80,14.467059074,8.9355364868,-11.06304517,-0.283667825,5.5315225871000004,-11.346713
48075,2012,70,73,71,-2,-3,69,9.9093997735,10.334088335,10.050962627,-0.283125708,-0.424688562,9.7678369196
48075,2013,71,78,-36,0,-7,-36,10.033208507,11.022398078,-5.087260651,0,-0.989189571,-5.087260651
48075,2014,73,72,2,4,1,6,10.342140681,10.200467521,0.28334632,0.5666926401,0.14167316,0.8500389601
48075,2015,67,80,-14,6,-13,-8,9.5021982697,11.345908382,-1.985533967,0.8509431286,-1.843710112,-1.134590838
48075,2016,84,67,29,9,17,38,11.885390874,9.4800141493,4.1032897064,1.2734347365,2.4053767244,5.3767244429
48075,2017,75,68,-44,9,7,-35,10.591724333,9.603163395,-6.213811609,1.2710069199,0.9885609377,-4.942804689
01021,2010,123,142,47,6,-19,53,NA,NA,NA,NA,NA,NA
01021,2011,564,474,-85,24,90,-61,12.913713952,10.853014917,-1.946215755,0.5495197426,2.0606990349,-1.396696013
01021,2012,564,495,-168,15,69,-153,12.922590475,11.341635258,-3.849282269,0.3436859169,1.5809552177,-3.505596352
01021,2013,536,499,4,6,37,10,12.287096257,11.438919836,0.0916947482,0.1375421223,0.8481764207,0.2292368705
01021,2014,600,485,13,15,115,28,13.726207906,11.095351391,0.2974011713,0.3431551977,2.6308565154,0.640556369
01021,2015,533,504,-120,22,29,-98,12.184945991,11.521975196,-2.743327428,0.5029433617,0.662970795,-2.240384066
01021,2016,519,465,47,23,54,70,11.857978432,10.624200329,1.0738439042,0.5254980808,1.2337781027,1.599341985
01021,2017,523,476,167,24,47,191,11.900292388,10.830858846,3.7999021582,0.5460937233,1.0694335415,4.3459958815
26033,2010,87,97,-60,6,-10,-54,NA,NA,NA,NA,NA,NA
26033,2011,378,363,198,33,15,231,9.7578604987,9.3706438123,5.1112602612,0.8518767102,0.3872166865,5.9631369714
26033,2012,348,367,60,55,-19,115,8.943831198,9.4321438209,1.5420398617,1.4135365399,-0.488312623,2.9555764016
26033,2013,346,344,-489,49,2,-440,8.930645536,8.8790233074,-12.62163488,1.264744599,0.0516222285,-11.35689028
26033,2014,354,372,-350,48,-18,-302,9.2258375575,9.6949479418,-9.121590805,1.2509610247,-0.469110384,-7.870629781
26033,2015,375,372,-299,50,3,-249,9.8454914213,9.7667274899,-7.850138493,1.3127321895,0.0787639314,-6.537406304
26033,2016,338,347,-308,47,-9,-261,8.9345898151,9.1724930942,-8.141578885,1.2423837909,-0.237903279,-6.899195094
26033,2017,333,353,-10,46,-20,36,8.8320712931,9.3625260254,-0.265227366,1.2200458843,-0.530454732,0.9548185182
27023,2010,38,46,8,3,-8,11,NA,NA,NA,NA,NA,NA
27023,2011,157,135,-174,15,22,-159,12.685331071,10.907768755,-14.05890195,1.2119743061,1.7775623157,-12.84692765
27023,2012,154,154,-219,24,0,-195,12.60899824,12.60899824,-17.93097802,1.9650386867,0,-15.96593933
27023,2013,152,160,-61,21,-8,-40,12.568735271,13.230247654,-5.044031918,1.7364700045,-0.661512383,-3.307561913
27023,2014,173,144,-74,24,29,-50,14.34613152,11.941288664,-6.136495563,1.9902147773,2.404842856,-4.146280786
27023,2015,164,155,-16,25,9,9,13.602620993,12.856135694,-1.327084975,2.0735702733,0.7464852984,0.7464852984
27023,2016,182,145,-92,26,37,-66,15.103107755,12.032695739,-7.634537986,2.1575868221,3.0704120161,-5.476951164
27023,2017,172,134,-120,26,38,-94,14.323784144,11.159227182,-9.993337775,2.1652231845,3.164556962,-7.82811459
55017,2010,169,87,54,5,82,59,NA,NA,NA,NA,NA,NA
55017,2011,763,509,58,2,254,60,12.151132699,8.1060636222,0.9236771907,0.0318509376,4.0450690767,0.9555281284
55017,2012,769,499,-161,3,270,-158,12.206639841,7.9208235117,-2.555616404,0.0476201814,4.285816329,-2.507996222
55017,2013,697,571,-90,9,126,-81,11.051300549,9.0535044673,-1.426997201,0.1426997201,1.9977960821,-1.284297481
55017,2014,702,589,134,12,113,146,11.1054863,9.3178510409,2.1198506613,0.1898373727,1.7876352591,2.3096880339
55017,2015,729,630,-21,16,99,-5,11.50205112,9.940044178,-0.331334806,0.2524455664,1.5620069423,-0.07888924
55017,2016,690,594,32,18,96,50,10.866997401,9.3550673281,0.5039766911,0.2834868887,1.5119300732,0.7874635798
55017,2017,697,567,103,18,130,121,10.943633223,8.9024964673,1.617208353,0.2826189355,2.0411367562,1.8998272884
27025,2010,137,68,-62,5,69,-57,NA,NA,NA,NA,NA,NA
27025,2011,550,362,-369,17,188,-352,10.218679747,6.725749215,-6.855805139,0.3158501013,3.4929305316,-6.5399550380000004
27025,2012,572,349,-533,14,223,-519,10.67124361,6.5109510839,-9.943658819,0.2611842842,4.1602925264,-9.682474535
27025,2013,542,383,32,10,159,42,10.120153483,7.1513261696,0.5974998366,0.1867186989,2.9688273132,0.7842185356
27025,2014,522,404,12,16,118,28,9.7159661989,7.519636675,0.2233555448,0.2978073931,2.1963295239,0.5211629379
27025,2015,563,438,190,18,125,208,10.433654559,8.1171237954,3.5211267606,0.3335804299,2.3165307635,3.8547071905
27025,2016,586,388,263,18,198,281,10.779687831,7.1374042291,4.8379827635,0.331116691,3.6422836014,5.1690994546
27025,2017,603,376,467,19,227,486,10.972813626,6.8420861084,8.4980165229,0.3457437129,4.1307275176,8.8437602358
50007,2010,416,231,-2,49,185,47,NA,NA,NA,NA,NA,NA
50007,2011,1525,964,-17,344,561,327,9.7019435697,6.1329007221,-0.108152814,2.1885039921,3.5690428476,2.0803511785
50007,2012,1577,1025,-47,397,552,350,9.9775079007,6.4850637909,-0.297363901,2.5117759268,3.4924441098,2.2144120262
50007,2013,1578,1032,2,547,546,549,9.9226249053,6.4893212308,0.0125762039,3.4395917764,3.4333036745,3.4521679804
50007,2014,1613,1071,-262,636,542,374,10.080525462,6.6932689213,-1.637382313,3.9747143174,3.3872565409,2.3373320043
50007,2015,1557,1134,-546,692,423,146,9.6869021511,7.0552004106,-3.396948346,4.3052898449,2.6317017405,0.9083414991
50007,2016,1585,1069,-693,688,516,-5,9.8284821351,6.628799623,-4.297248025,4.2662433495,3.1996825121,-0.031004676
50007,2017,1561,1081,-314,684,480,370,9.6389559547,6.6750233101,-1.938905938,4.2236040186,2.9639326446,2.2846980802
01023,2010,29,21,-19,1,8,-18,NA,NA,NA,NA,NA,NA
01023,2011,114,160,-199,-2,-46,-201,8.3041958042,11.655011655,-14.49592075,-0.145687646,-3.350815851,-14.64160839
01023,2012,110,145,-6,-2,-35,-8,8.097762073,10.674322733,-0.441696113,-0.147232038,-2.57656066,-0.588928151
01023,2013,138,194,-107,-2,-56,-109,10.238528026,14.393293022,-7.938568832,-0.148384464,-4.154764996,-8.086953296
01023,2014,142,177,-39,-2,-35,-41,10.631129745,13.251478625,-2.919817324,-0.149734222,-2.620348881,-3.069551546
01023,2015,159,184,-58,-2,-25,-60,11.977852273,13.861162379,-4.369279446,-0.150664808,-1.883310106,-4.519944254
01023,2016,134,167,-147,-2,-33,-149,10.19748107,12.708801035,-11.18678893,-0.15220121,-2.511319965,-11.33899014
01023,2017,143,174,-71,-2,-31,-73,11.002115791,13.387189844,-5.462588959,-0.153875745,-2.385074053,-5.616464705
28019,2010,29,11,2,1,18,3,NA,NA,NA,NA,NA,NA
28019,2011,95,85,-135,-1,10,-136,11.169243431,9.9935335959,-15.87208277,-0.117570983,1.1757098348,-15.98965375
28019,2012,80,74,-29,1,6,-28,9.4871034687,8.7755707086,-3.439075007,0.1185887934,0.7115327602,-3.320486214
28019,2013,96,85,20,2,11,22,11.37642946,10.072880251,2.3700894709,0.2370089471,1.303549209,2.607098418
28019,2014,90,100,-63,3,-10,-60,10.690105713,11.877895237,-7.483073999,0.3563368571,-1.187789524,-7.126737142
28019,2015,97,91,-24,3,6,-21,11.582089552,10.865671642,-2.865671642,0.3582089552,0.7164179104,-2.507462687
28019,2016,84,86,-51,3,-2,-48,10.070131271,10.309896302,-6.114008272,0.3596475454,-0.23976503,-5.754360726
28019,2017,82,105,-19,3,-23,-16,9.8830902736,12.65517657,-2.289984332,0.3615764734,-2.772086296,-1.928407858
40023,2010,52,33,17,0,19,17,NA,NA,NA,NA,NA,NA
40023,2011,197,179,23,-4,18,19,12.912105919,11.732319591,1.5075047519,-0.262174739,1.1797863276,1.2453300125
40023,2012,181,214,-79,1,-33,-78,11.893419194,14.061832638,-5.191050366,0.0657094983,-2.168413444,-5.125340868
40023,2013,207,224,-113,1,-17,-112,13.710425222,14.836402172,-7.484435025,0.0662339383,-1.125976951,-7.418201086
40023,2014,168,231,126,2,-63,128,11.150565825,15.332028009,8.3629243686,0.1327448312,-4.181462184,8.4956691999
40023,2015,212,234,-96,2,-22,-94,14.094338995,15.55695908,-6.382342187,0.1329654622,-1.462620084,-6.249376724
40023,2016,214,213,-70,3,1,-67,14.315338819,14.248444712,-4.682587464,0.2006823199,0.0668941066,-4.481905144
40023,2017,213,215,-53,3,-2,-50,14.305863389,14.440190745,-3.559674928,0.2014910336,-0.134327356,-3.358183894
30015,2010,17,24,2,0,-7,2,NA,NA,NA,NA,NA,NA
30015,2011,45,41,-12,7,4,-5,7.7479338843,7.0592286501,-2.066115702,1.2052341598,0.6887052342,-0.860881543
30015,2012,35,55,135,6,-20,141,5.9635372295,9.3712727892,23.002215028,1.0223206679,-3.40773556,24.024535696
30015,2013,50,65,-74,1,-15,-73,8.4940117217,11.042215238,-12.57113735,0.1698802344,-2.548203517,-12.40125711
30015,2014,42,70,71,4,-28,75,7.1599045346,11.933174224,12.103648142,0.68189567,-4.77326969,12.785543812
30015,2015,55,67,-116,5,-12,-111,9.4371997255,11.49622512,-19.90391215,0.8579272478,-2.059025395,-19.0459849
30015,2016,65,45,1,5,20,6,11.244702015,7.784793703,0.1729954156,0.8649770781,3.4599083124,1.0379724937
30015,2017,61,59,-35,5,2,-30,10.554546241,10.208495545,-6.055887187,0.8651267411,0.3460506964,-5.190760446
37041,2010,39,62,-34,1,-23,-33,NA,NA,NA,NA,NA,NA
37041,2011,140,198,114,26,-58,140,9.4729007375,13.397388186,7.7136477434,1.7592529941,-3.924487448,9.4729007375
37041,2012,158,156,-132,21,2,-111,10.699895033,10.564453323,-8.939152812,1.4221379474,0.1354417093,-7.517014865
37041,2013,168,184,-9,5,-16,-4,11.428182715,12.516581069,-0.612224074,0.3401244856,-1.088398354,-0.272099588
37041,2014,130,176,-113,3,-46,-110,8.8971015981,12.045306779,-7.733634466,0.2053177292,-3.148205181,-7.528316737
37041,2015,160,181,-237,5,-21,-232,11.104171004,12.561593449,-16.4480533,0.3470053439,-1.457422444,-16.10104796
37041,2016,132,184,2,6,-52,8,9.2553639041,12.901416351,0.1402327864,0.4206983593,-3.646052447,0.5609311457
37041,2017,137,187,-92,6,-50,-86,9.6666078673,13.194566943,-6.491444699,0.4233550891,-3.527959076,-6.06808961
17021,2010,90,108,-10,3,-18,-7,NA,NA,NA,NA,NA,NA
17021,2011,351,416,-16,16,-65,0,10.104499525,11.975703141,-0.460603967,0.460603967,-1.871203616,0
17021,2012,378,414,-163,12,-36,-151,10.921698931,11.961860734,-4.709621497,0.346720601,-1.040161803,-4.362900896
17021,2013,362,415,-314,-1,-53,-315,10.543484593,12.087143939,-9.145453486,-0.029125648,-1.543659346,-9.174579134
17021,2014,323,397,-262,0,-74,-262,9.5046125326,11.682139862,-7.709623788,0,-2.177527329,-7.709623788
17021,2015,341,424,-264,0,-83,-264,10.135838064,12.602918884,-7.847100437,0,-2.467080819,-7.847100437
17021,2016,359,406,-152,0,-47,-152,10.758004825,12.166434426,-4.554921263,0,-1.408429601,-4.554921263
17021,2017,350,376,-141,0,-26,-141,10.546457144,11.329908246,-4.248715592,0,-0.783451102,-4.248715592
21047,2010,371,97,-189,94,274,-95,NA,NA,NA,NA,NA,NA
21047,2011,1484,585,-1650,60,899,-1590,20.109899789,7.9274200652,-22.35938993,0.8130687246,12.182479724,-21.5463212
21047,2012,1475,612,-289,874,863,585,19.881251643,8.2490345799,-3.895377441,11.780484024,11.632217063,7.8851065837
21047,2013,1600,643,-2609,312,957,-2297,21.544033986,8.658008658,-35.13024042,4.2010866272,12.886025328,-30.92915379
21047,2014,1484,569,-1452,241,915,-1211,20.197895826,7.7443414588,-19.76236168,3.2801165054,12.453554367,-16.48224518
21047,2015,1669,584,-1700,375,1085,-1325,22.797120651,7.9769433555000004,-23.22055429,5.122181093,14.820177296,-18.0983732
21047,2016,1504,585,-2450,173,919,-2277,20.769177657,8.078436788,-33.83276945,2.3890078023,12.690740869,-31.44376165
21047,2017,1459,615,-2178,16,844,-2162,20.527467271,8.6527706453,-30.64347068,0.2251127322,11.874696625,-30.41835794
29043,2010,258,110,257,0,148,257,NA,NA,NA,NA,NA,NA
29043,2011,1068,519,249,3,549,252,13.65074293,6.6336475475,3.1826170315,0.0383447835,7.0170953826,3.220961815
29043,2012,949,537,620,-12,412,608,11.990801577,6.7851005762,7.8338218943,-0.151622359,5.2057010007,7.682199535
29043,2013,991,579,564,-6,412,558,12.366014051,7.2249466552,7.0377718714,-0.074869914,5.1410673954,6.9629019578
29043,2014,969,599,830,10,370,840,11.928796533,7.3739413039,10.217648217,0.1231041954,4.5548552295,10.340752413
29043,2015,1068,667,834,11,401,845,12.951341519,8.0885250872,10.11368804,0.133393967,4.8628164317,10.247082007
29043,2016,1018,612,662,6,406,668,12.173829853,7.3186482026,7.9165769774,0.071751453,4.8551816508,7.9883284303
29043,2017,1030,607,843,7,423,850,12.146871001,7.1583987358,9.9415652953,0.0825515505,4.9884722656,10.024116846
32001,2010,71,38,-123,29,33,-94,NA,NA,NA,NA,NA,NA
32001,2011,308,278,-263,27,30,-236,12.459546926,11.245954693,-10.63915858,1.0922330097,1.213592233,-9.546925566
32001,2012,320,265,-512,107,55,-405,13.089005236,10.839332461,-20.94240838,4.3766361257,2.2496727749,-16.56577225
32001,2013,318,278,-432,64,40,-368,13.1851729,11.526660585,-17.911933,2.6536197031,1.6585123145,-15.25831329
32001,2014,339,248,-225,60,91,-165,14.171944566,10.367676261,-9.406157898,2.5083087728,3.8042683054,-6.897849125
32001,2015,319,265,11,80,54,91,13.317469263,11.063101426,0.459223078,3.339804204,2.2543678377,3.799027282
32001,2016,309,279,-104,66,30,-38,12.864279767,11.615320566,-4.329725229,2.7477102415,1.2489592007,-1.582014988
32001,2017,299,261,135,42,38,177,12.394809932,10.819549807,5.5963188658,1.7410769805,1.5752601252,7.3373958463
35006,2010,104,31,24,4,73,28,NA,NA,NA,NA,NA,NA
35006,2011,425,262,-15,7,163,-8,15.514346206999999,9.5641381324,-0.54756516,0.2555304081,5.9502080748,-0.292034752
35006,2012,372,227,-259,18,145,-241,13.564513482,8.277270324,-9.444110193,0.6563474266,5.2872431585,-8.787762767
35006,2013,423,271,-203,15,152,-188,15.460526316,9.9049707602,-7.419590643,0.548245614,5.5555555556,-6.871345029
35006,2014,415,269,-430,15,146,-415,15.251465427,9.8858896382,-15.80272321,0.5512577865,5.3655757888,-15.25146543
35006,2015,345,257,-213,21,88,-192,12.764540477,9.5086576883,-7.880716294,0.776972029,3.2558827882,-7.103744265
35006,2016,334,276,-58,22,58,-36,12.376787964,10.227525384,-2.149262581,0.8152375306,2.1492625806,-1.33402505
35006,2017,334,282,-219,22,52,-197,12.40505859,10.473732103,-8.133855782,0.8170996676,1.931326487,-7.316756114
40025,2010,5,0,-13,0,5,-13,NA,NA,NA,NA,NA,NA
40025,2011,25,29,0,1,-4,1,10.133765707,11.755168221,0,0.4053506283,-1.621402513,0.4053506283
40025,2012,20,26,-77,0,-6,-77,8.2491235306,10.72386059,-31.75912559,0,-2.474737059,-31.75912559
40025,2013,29,44,-62,0,-15,-62,12.36673774,18.763326226,-26.43923241,0,-6.396588486,-26.43923241
40025,2014,24,29,-31,0,-5,-31,10.484927916,12.669287899,-13.54303189,0,-2.184359983,-13.54303189
40025,2015,35,34,-72,0,1,-72,15.649452269,15.202325061,-32.19315895,0,0.4471272077,-32.19315895
40025,2016,19,26,-26,1,-7,-25,8.6916742909,11.893870082,-11.89387008,0.4574565416,-3.202195791,-11.43641354
40025,2017,23,18,-22,1,5,-21,10.638297872,8.3256244218,-10.17576318,0.4625346901,2.3126734505,-9.713228492
12017,2010,244,597,284,15,-353,299,NA,NA,NA,NA,NA,NA
12017,2011,1061,2277,-228,58,-1216,-170,7.5531335538,16.209693781,-1.623105043,0.4128951424,-8.656560228,-1.2102099
12017,2012,1065,2309,629,66,-1244,695,7.6354211849,16.554166682,4.5095586153,0.4731810312,-8.918745497,4.9827396465
12017,2013,1007,2437,1031,65,-1430,1096,7.2429629257,17.528401837,7.4155856766,0.4675199505,-10.28543891,7.8831056271
12017,2014,1035,2431,1352,91,-1396,1443,7.451806253,17.502744929,9.7341469122,0.6551829652,-10.05093868,10.389329877
12017,2015,1024,2575,2939,95,-1551,3034,7.3309636566,18.434796304,21.040724792,0.6801186986,-11.10383265,21.72084349
12017,2016,1035,2530,3952,92,-1495,4044,7.3033133051,17.852543635,27.886661045,0.6491834049,-10.54923033,28.53584445
12017,2017,1061,2542,4034,93,-1481,4127,7.3517948149,17.613819434,27.952064358,0.6444080281,-10.26202462,28.596472386
41005,2010,1014,720,424,80,294,504,NA,NA,NA,NA,NA,NA
41005,2011,3810,3073,1430,271,737,1701,10.080538475000001,8.1305760459,3.7835091915,0.717014679,1.9499624295,4.5005238705
41005,2012,3880,2948,2498,202,932,2700,10.184796304,7.7383452331000004,6.5571188576,0.5302393952,2.446451071,7.0873582528
41005,2013,4033,3210,3503,173,823,3676,10.474712517,8.3371751002,9.0981695875,0.4493243901,2.1375374166,9.5474939776
41005,2014,3963,3117,4903,270,846,5173,10.153285663,7.9858166567,12.561584558,0.6917454274,2.167469006,13.253329986
41005,2015,4121,3415,5420,309,706,5729,10.391083991,8.6109079906,13.666506972,0.7791421871,1.7801760004,14.445649159
41005,2016,4343,3446,5661,304,897,5965,10.769927031,8.545514287,14.038350661,0.7538700938,2.2244127439,14.792220755
41005,2017,4290,3506,4915,298,784,5213,10.471689823,8.5579824056,11.99728566,0.7274040949,1.9137074176,12.724689755
28021,2010,35,9,-46,1,26,-45,NA,NA,NA,NA,NA,NA
28021,2011,120,89,157,6,31,163,12.394133444,9.1923156373,16.215657922,0.6197066722,3.2018178062,16.835364594
28021,2012,107,89,-462,2,18,-460,11.1836948,9.3023255814,-48.28847661,0.2090410243,1.8813692187,-48.07943559
28021,2013,110,99,-235,10,11,-225,11.892534732,10.703281258,-25.40677874,1.0811395211,1.1892534732,-24.32563922
28021,2014,134,112,-13,10,22,-3,14.637609919,12.23442023,-1.420066634,1.0923589492,2.4031896881,-0.327707685
28021,2015,111,111,-31,11,0,-20,12.126508986,12.126508986,-3.38668269,1.2017261157,0,-2.184956574
28021,2016,120,90,-58,13,30,-45,13.134851138,9.8511383538,-6.348511384,1.4229422067,3.2837127846,-4.925569177
28021,2017,112,101,-204,13,11,-191,12.390065822,11.173184358,-22.56761989,1.4381326401,1.2168814647,-21.12948725
47025,2010,81,115,40,0,-34,40,NA,NA,NA,NA,NA,NA
47025,2011,318,386,-63,8,-68,-55,9.890673841,12.0056607,-1.959473119,0.2488219834,-2.114986859,-1.710651136
47025,2012,315,438,-226,7,-123,-219,9.869503235,13.72330926,-7.080976924,0.2193222941,-3.853806025,-6.86165463
47025,2013,288,424,2,4,-136,6,9.0910525734,13.384049622,0.0631323095,0.1262646191,-4.292997049,0.1893969286
47025,2014,313,430,43,-2,-117,41,9.9141617307,13.62009439,1.362009439,-0.063349276,-3.70593266,1.2986601628
47025,2015,326,431,95,-1,-105,94,10.341655299,13.672556546,3.0136725565,-0.031722869,-3.330901247,2.9819496875
47025,2016,285,465,225,0,-180,225,9.0364310853,14.743650718,7.134024541,0,-5.707219633,7.134024541
47025,2017,319,438,167,0,-119,167,10.099730885,13.867342093,5.2873199303,0,-3.767611208,5.2873199303
22027,2010,41,18,-46,2,23,-44,NA,NA,NA,NA,NA,NA
22027,2011,163,202,-223,22,-39,-201,9.5570343877,11.843686787,-13.07496116,1.2899064818,-2.2866524,-11.78505467
22027,2012,179,191,-58,7,-12,-51,10.589209655,11.299100805,-3.431140558,0.4141031708,-0.70989115,-3.017037388
22027,2013,160,200,-171,7,-40,-164,9.5399934413,11.924991802,-10.19586799,0.4173747131,-2.38499836,-9.778493277
22027,2014,184,190,-257,-1,-6,-258,11.12387401,11.486609032,-15.53715011,-0.060455837,-0.362735022,-15.59760595
22027,2015,158,178,-124,-1,-20,-125,9.6704103804,10.89451296,-7.589435995,-0.061205129,-1.22410258,-7.650641124
22027,2016,162,182,-81,-1,-20,-82,9.9907493062,11.224175146,-4.995374653,-0.061671292,-1.23342584,-5.057045945
22027,2017,151,192,-153,-1,-41,-154,9.3984377431,11.950331435,-9.522920362,-0.06224131,-2.551893692,-9.585161672
53009,2010,167,198,121,8,-31,129,NA,NA,NA,NA,NA,NA
53009,2011,685,919,456,23,-234,479,9.5635663027,12.830536397,6.3664032614,0.3211124452,-3.266970095,6.6875157066
53009,2012,657,942,265,43,-285,308,9.1559011664,13.127639115,3.6930194964,0.599244673,-3.971737949,4.2922641693
53009,2013,659,930,507,52,-271,559,9.1644879568,12.933192413,7.0506758636,0.7231462424,-3.768704456,7.773822106
53009,2014,696,926,567,49,-230,616,9.6338846979,12.81749602,7.8482939996,0.6782476296,-3.183611323,8.5265416292
53009,2015,663,996,958,61,-333,1019,9.1089571412,13.684044212,13.161962204,0.838079013,-4.575087071,14.000041217
53009,2016,661,992,1248,48,-331,1296,8.9790872846,13.475422975,16.952951484,0.6520365956,-4.49633569,17.60498808
53009,2017,661,989,1654,45,-328,1699,8.8385526703,13.224400289,22.116438906,0.6017168989,-4.385847619,22.718155805
26035,2010,92,74,60,0,18,60,NA,NA,NA,NA,NA,NA
26035,2011,324,405,74,2,-81,76,10.451107204,13.063884006,2.3869812751,0.0645130074,-2.612776801,2.4514942825
26035,2012,316,406,-111,1,-90,-110,10.228357798,13.141497678,-3.592872518,0.0323682209,-2.913139879,-3.560504297
26035,2013,330,394,-135,3,-64,-132,10.751987489,12.837221426,-4.398540336,0.0977453408,-2.085233937,-4.300794995
26035,2014,316,366,179,3,-50,182,10.307260748,11.938156436,5.8386065627,0.0978537413,-1.630895688,5.936460304
26035,2015,342,443,-17,3,-101,-14,11.152416357,14.445966217,-0.554359877,0.0978282137,-3.29354986,-0.456531664
26035,2016,321,393,-132,3,-72,-129,10.522175238,12.882289311,-4.326875799,0.0983380863,-2.360114072,-4.228537713
26035,2017,307,376,313,3,-69,316,10.055847623,12.315956698,10.252378847,0.0982656119,-2.260109075,10.350644459
45027,2010,80,64,-14,4,16,-10,NA,NA,NA,NA,NA,NA
45027,2011,363,384,-241,-5,-21,-246,10.420404472,11.023237789,-6.918229967,-0.143531742,-0.602833317,-7.061761709
45027,2012,341,358,-342,-8,-17,-350,9.8773299347,10.369748143,-9.906295712,-0.231726215,-0.492418208,-10.13802193
45027,2013,350,370,-28,1,-20,-27,10.199026721,10.781828248,-0.815922138,0.0291400763,-0.582801527,-0.786782061
45027,2014,370,406,-47,1,-36,-46,10.80418151,11.855399171,-1.372423057,0.0292004906,-1.05121766,-1.343222566
45027,2015,343,385,-170,2,-42,-168,10.059683545,11.29148153,-4.985848987,0.0586570469,-1.231797985,-4.927191941
45027,2016,313,385,318,2,-72,320,9.1747153054,11.285192947,9.3212762527,0.0586243789,-2.110477642,9.3799006317
45027,2017,317,372,-128,2,-55,-126,9.2831205341,10.893756589,-3.748389364,0.0585685838,-1.610636055,-3.68982078
42031,2010,94,110,-48,3,-16,-45,NA,NA,NA,NA,NA,NA
42031,2011,410,421,-43,19,-11,-24,10.273500633,10.549131137,-1.077464701,0.4760890537,-0.275630505,-0.601375647
42031,2012,375,427,-428,24,-52,-404,9.4535829079,10.764479738,-10.78968929,0.6050293061,-1.31089683,-10.18465999
42031,2013,399,425,-415,26,-26,-389,10.167936597,10.830508907,-10.5756734,0.6625723096,-0.66257231,-9.913101093
42031,2014,401,433,-171,30,-32,-141,10.295514647,11.117101851,-4.39035662,0.7702380035,-0.821587204,-3.620118617
42031,2015,393,414,-49,33,-21,-16,10.118174094,10.658839886,-1.261553513,0.849617672,-0.540665791,-0.411935841
42031,2016,410,410,-298,34,0,-264,10.597190452,10.597190452,-7.702348182,0.8787914034,0,-6.823556779
42031,2017,410,428,-114,33,-18,-81,10.647138257,11.114573595,-2.960423808,0.8569647865,-0.467435338,-2.103459022
05019,2010,67,94,-47,5,-27,-42,NA,NA,NA,NA,NA,NA
05019,2011,241,269,18,5,-28,23,10.513687425,11.735194678,0.7852546624,0.2181262951,-1.221507253,1.0033809576
05019,2012,251,247,-186,5,4,-181,10.993583426,10.818386878,-8.146639511,0.2189956858,0.1751965486,-7.927643825
05019,2013,222,249,-158,13,-27,-145,9.797215296,10.988768508,-6.972792868,0.5737108056,-1.191553212,-6.399082063
05019,2014,244,233,-42,13,11,-29,10.814404432,10.326869806,-1.861495845,0.5761772853,0.487534626,-1.28531856
05019,2015,250,271,-34,14,-21,-20,11.097054842,12.029207448,-1.509199458,0.6214350711,-0.932152607,-0.887764387
05019,2016,227,234,36,15,-7,51,10.076349432,10.387073864,1.5980113636,0.6658380682,-0.310724432,2.2638494318
05019,2017,225,255,-242,15,-30,-227,10.035011039,11.37301251,-10.79321187,0.6690007359,-1.338001472,-10.12421114
16033,2010,3,4,-2,1,-1,-1,NA,NA,NA,NA,NA,NA
16033,2011,8,4,-37,6,4,-31,8.2730093071,4.1365046536,-38.26266805,6.2047569804,4.1365046536,-32.05791107
16033,2012,13,12,-90,7,1,-83,14.215418261,13.121924549,-98.41443412,7.6544559869,1.0934937124,-90.75997813
16033,2013,7,7,-11,3,0,-8,8.03673938,8.03673938,-12.62916188,3.4443168772,0,-9.184845006
16033,2014,13,8,4,2,5,6,14.908256881,9.1743119266,4.5871559633,2.2935779817,5.7339449541,6.880733945
16033,2015,7,7,-5,2,0,-3,7.9954311822,7.9954311822,-5.711022273,2.2844089092,0,-3.426613364
16033,2016,8,8,-24,2,0,-22,9.2592592593,9.2592592593,-27.77777778,2.3148148148,0,-25.46296296
16033,2017,8,2,11,2,6,13,9.2646207296,2.3161551824,12.738853503,2.3161551824,6.9484655472,15.055008686
17023,2010,53,69,-27,0,-16,-27,NA,NA,NA,NA,NA,NA
17023,2011,199,207,-83,-1,-8,-84,12.249546028,12.74199009,-5.109107137,-0.061555508,-0.492444061,-5.170662645
17023,2012,202,199,63,-6,3,57,12.446854396,12.262000123,3.8819397375,-0.369708546,0.1848542732,3.5122311911
17023,2013,182,207,-136,-3,-25,-139,11.250888635,12.79634037,-8.407257441,-0.185454208,-1.545451736,-8.59271165
17023,2014,203,211,-39,-1,-8,-40,12.632233976,13.130056005,-2.42688239,-0.062227754,-0.497822029,-2.489110143
17023,2015,177,200,-157,-1,-23,-158,11.093701034,12.535255406,-9.840175494,-0.062676277,-1.441554372,-9.902851771
17023,2016,191,220,15,-2,-29,13,12.045533377,13.874436351,0.9459842967,-0.12613124,-1.828902974,0.8198530571
17023,2017,176,206,-48,-2,-30,-50,11.133955401,13.031788708,-3.036533291,-0.12652222,-1.897833307,-3.163055512
18019,2010,342,247,212,22,95,234,NA,NA,NA,NA,NA,NA
18019,2011,1441,1016,423,110,425,533,12.977013306,9.1496499088,3.809352275,0.9906117027,3.8273633969,4.7999639778
18019,2012,1466,1087,-86,77,379,-9,13.125204242,9.7319897756,-0.769964232,0.6893865802,3.3932144664,-0.080577652
18019,2013,1458,1153,483,40,305,523,12.98498889,10.268650336,4.3016115458,0.3562411218,2.7163385538,4.6578526676
18019,2014,1482,1121,939,55,361,994,13.070915449,9.8869745064,8.2817743635,0.4850879553,3.1839409427,8.7668623188
18019,2015,1471,1182,515,64,289,579,12.847554292,10.323459669,4.4979540859,0.5589690515,2.524094623,5.0569231374
18019,2016,1477,1210,530,75,267,605,12.803009617,10.488586078,4.5941740672,0.6501189718,2.3144235395,5.244293039
18019,2017,1463,1143,776,76,320,852,12.570186405,9.8207266307,6.6674399522,0.6529966964,2.7494597741,7.3204366486
20025,2010,8,12,-12,0,-4,-12,NA,NA,NA,NA,NA,NA
20025,2011,25,37,-69,1,-12,-68,11.576753878,17.13359574,-31.9518407,0.4630701551,-5.556841862,-31.48877055
20025,2012,24,37,57,0,-13,57,11.201866978,17.269544924,26.604434072,0,-6.067677946,26.604434072
20025,2013,29,24,10,-1,5,9,13.35174954,11.049723757,4.6040515654,-0.460405157,2.3020257827,4.1436464088
20025,2014,18,34,-50,0,-16,-50,8.3857442348,15.83973911,-23.29373399,0,-7.453994875,-23.29373399
20025,2015,21,40,-13,0,-19,-13,10.011918951,19.070321812,-6.197854589,0,-9.058402861,-6.197854589
20025,2016,21,25,-12,0,-4,-12,10.13024602,12.059816691,-5.788712012,0,-1.929570671,-5.788712012
20025,2017,21,22,-61,0,-1,-61,10.321946424,10.813467682,-29.98279676,0,-0.491521258,-29.98279676
21049,2010,103,115,12,0,-12,12,NA,NA,NA,NA,NA,NA
21049,2011,413,375,-204,-2,38,-206,11.626761257,10.556986614,-5.743000718,-0.056303929,1.0697746435,-5.799304646
21049,2012,444,386,206,-4,58,202,12.483657374,10.852909339,5.7919671601,-0.112465382,1.6307480354,5.6795017784
21049,2013,424,418,-152,3,6,-149,11.90208848,11.733662699,-4.266786436,0.0842128902,0.1684257804,-4.182573546
21049,2014,380,404,103,3,-24,106,10.67655653,11.350865363,2.8939087435,0.0842886042,-0.674308833,2.9781973477
21049,2015,451,428,14,4,23,18,12.651303701,12.006115264,0.3927233965,0.1122066847,0.6451884371,0.5049300812
21049,2016,467,397,152,1,70,153,13.052896373,11.096359444,4.2484801901000004,0.0279505276,1.9565369296,4.2764307176
21049,2017,467,360,51,1,107,52,12.983943838,10.009035935,1.4179467575,0.0278028776,2.974907903,1.4457496351
29045,2010,16,12,3,0,4,3,NA,NA,NA,NA,NA,NA
29045,2011,74,81,-106,1,-7,-105,10.451239319,11.439870066,-14.97069416,0.1412329638,-0.988630746,-14.8294612
29045,2012,85,86,-62,1,-1,-61,12.150668287,12.293617325,-8.862840397,0.1429490387,-0.142949039,-8.719891359
29045,2013,85,102,-50,0,-17,-50,12.261973456,14.714368148,-7.212925563,0,-2.452394691,-7.212925563
29045,2014,73,84,-1,0,-11,-1,10.59352779,12.189812799,-0.145116819,0,-1.596285009,-0.145116819
29045,2015,86,96,-75,0,-10,-75,12.568505663,14.02995981,-10.9609061,0,-1.461454147,-10.9609061
29045,2016,74,79,-65,0,-5,-65,10.937038132,11.676027195,-9.606857819,0,-0.738989063,-9.606857819
29045,2017,80,72,-16,0,8,-16,11.892374015,10.703136614,-2.378474803,0,1.1892374015,-2.378474803
32003,2010,6582,3279,-2735,1140,3303,-1595,NA,NA,NA,NA,NA,NA
32003,2011,26877,13600,-5021,5561,13277,540,13.714759836,6.9397899234,-2.562109206,2.8376596885,6.7749699127,0.2755504823
32003,2012,26100,13791,11777,5561,12309,17338,13.172467726,6.96021082,5.9437606285,2.8065936024,6.2122569055,8.7503542309
32003,2013,26311,14431,12059,5819,11880,17878,13.082415088,7.1754145466,5.9960033274,2.8933363763,5.9070005415,8.8893397037
32003,2014,26322,14268,20239,6357,12054,26596,12.868099535,6.9752315239,9.8942886748,3.1077619006,5.8928680115,13.002050575
32003,2015,27105,15299,25921,7355,11806,33276,12.983432891,7.3282988302,12.416290867,3.5230824169,5.6551340604,15.939373284
32003,2016,27337,16468,28088,7397,10869,35485,12.813055565,7.7186742891,13.16505486,3.4670290088,5.0943812757,16.632083869
32003,2017,27449,16867,29414,7221,10582,36635,12.58896584,7.7357312403,13.490176007,3.3117753771,4.8532345992,16.801951384
39023,2010,435,381,-140,13,54,-127,NA,NA,NA,NA,NA,NA
39023,2011,1622,1602,-578,47,20,-531,11.752814118,11.607896558,-4.188117485,0.3405562661,0.14491756,-3.847561219
39023,2012,1595,1707,-546,26,-112,-520,11.605528452,12.420462111,-3.972801589,0.1891810281,-0.814933659,-3.783620561
39023,2013,1600,1748,-397,8,-148,-389,11.692402131,12.773949328,-2.901177279,0.0584620107,-1.081547197,-2.842715268
39023,2014,1556,1618,-270,16,-62,-254,11.407624633,11.862170088,-1.979472141,0.1173020528,-0.454545455,-1.862170088
39023,2015,1629,1789,-458,18,-160,-440,11.984241715,13.161331141,-3.369418481,0.1324225604,-1.177089426,-3.236995921
39023,2016,1575,1742,-853,19,-167,-834,11.656089844,12.892005403,-6.312790246,0.1406131473,-1.235915558,-6.172177099
39023,2017,1561,1680,44,19,-119,63,11.598273262,12.48244656,0.3269212194,0.1411705266,-0.884173298,0.468091746
46025,2010,15,8,0,0,7,0,NA,NA,NA,NA,NA,NA
46025,2011,45,64,-101,9,-19,-92,12.352456766,17.567938512,-27.72440296,2.4704913533,-5.215481746,-25.25391161
46025,2012,35,51,-3,10,-16,7,9.766987582,14.231896191,-0.837170364,2.7905678806,-4.464908609,1.9533975164
46025,2013,49,44,24,10,5,34,13.614893026,12.225618227,6.6685190331,2.7785495971,1.3892747986,9.4470686302
46025,2014,60,53,10,5,7,15,16.52892562,14.600550964,2.7548209366,1.3774104683,1.9283746556,4.132231405
46025,2015,67,35,-33,5,32,-28,18.393960192,9.608785175,-9.059711736,1.3726835964,8.7851750172,-7.68702814
46025,2016,65,40,-34,5,25,-29,17.847336628,10.982976387,-9.335529929,1.3728720483,6.8643602416,-7.96265788
46025,2017,60,40,4,5,20,9,16.420361248,10.946907499,1.0946907499,1.3683634373,5.4734537493,2.4630541872
53011,2010,1342,719,563,96,623,659,NA,NA,NA,NA,NA,NA
53011,2011,5486,2975,2674,384,2511,3058,12.775282181,6.9279009275,6.2269603631,0.8942231785,5.8473812534,7.1211835416
53011,2012,5341,3021,1738,192,2320,1930,12.297837459,6.9559571176,4.0018051872,0.442086649,5.3418803419,4.4438918361
53011,2013,5461,3096,2580,237,2365,2817,12.440159779,7.0526890085,5.8772408404,0.5398860772,5.3874707704,6.4171269176
53011,2014,5342,3141,4310,318,2201,4628,12.004737174,7.0585697239,9.6855891467,0.7146211946,4.9461674506,10.400210341
53011,2015,5637,3383,6059,410,2254,6469,12.448971254,7.4711495036,13.380932558,0.9054600344,4.9778217503,14.286392592
53011,2016,5592,3550,5931,379,2042,6310,12.120384549,7.694450134,12.855150351,0.8214638312,4.4259344151,13.676614182
53011,2017,5652,3584,6633,372,2068,7005,12.023088926,7.6239827865,14.109898946,0.7913285705,4.3991061391,14.901227517
55019,2010,154,119,-46,2,35,-44,NA,NA,NA,NA,NA,NA
55019,2011,582,320,-272,16,262,-256,16.778136531,9.2250922509,-7.841328413,0.4612546125,7.5530442804,-7.380073801
55019,2012,556,315,-505,15,241,-490,16.081913632,9.1111561045,-14.60677407,0.4338645764,6.9707575276,-14.1729095
55019,2013,591,334,-169,11,257,-158,17.128448875,9.6800370971,-4.897982843,0.318803617,7.4484117783,-4.579179226
55019,2014,558,362,-388,18,196,-370,16.188224372,10.502038034,-11.25632806,0.5222007862,5.6861863386,-10.73412727
55019,2015,538,344,-210,22,194,-188,15.645447407,10.003780498,-6.106959025,0.6397766598,5.641666909,-5.467182365
55019,2016,597,322,-127,22,275,-105,17.317398619,9.3403724546,-3.68393572,0.6381620932,7.9770261646,-3.045773627
55019,2017,574,319,-156,22,255,-134,16.580729957,9.2147262302,-4.506261103,0.6354983607,7.3660037263,-3.870762742
01025,2010,49,46,-78,1,3,-77,NA,NA,NA,NA,NA,NA
01025,2011,259,299,-146,2,-40,-144,10.088223265,11.646250024,-5.686797671,0.077901338,-1.558026759,-5.608896333
01025,2012,292,286,-446,1,6,-445,11.511018252,11.27449048,-17.58189774,0.0394212954,0.2365277723,-17.54247645
01025,2013,269,291,-10,1,-22,-9,10.702208076,11.577481599,-0.397851601,0.0397851601,-0.875273523,-0.358066441
01025,2014,267,296,-228,2,-29,-226,10.683632435,11.844026969,-9.123101855,0.0800272093,-1.160394534,-9.043074645
01025,2015,312,295,-178,3,17,-175,12.587497226,11.901640006,-7.181328546,0.1210336272,0.6858572207,-7.060294919
01025,2016,261,277,-345,4,-16,-341,10.640466387,11.292755514,-14.0649843,0.1630722818,-0.652289127,-13.90191202
01025,2017,270,321,-221,4,-51,-217,11.149422914,13.25542502,-9.126009126,0.1651766358,-2.106002106,-8.96083249
13059,2010,364,198,409,88,166,497,NA,NA,NA,NA,NA,NA
13059,2011,1454,635,-225,367,819,142,12.326525768,5.3833176497,-1.907474758,3.1113032715,6.9432081182,1.2038285138
13059,2012,1434,629,552,327,805,879,12.021729654,5.2731296737,4.6276114148,2.741356762,6.7485999799,7.3689681768
13059,2013,1397,685,-150,408,712,258,11.582355355,5.6792508363,-1.24363157,3.3826778704,5.9031045189,2.1390463004
13059,2014,1372,739,-1467,436,633,-1031,11.34751773,6.1121104977,-12.13324235,3.6060624858,5.2354072328,-8.527179869
13059,2015,1352,747,2020,482,605,2502,11.054964104,6.1080312025,16.517032167,3.9411928241,4.9469329016,20.458224991
13059,2016,1349,732,32,493,617,525,10.839999518,5.8820456984,0.2571386098,3.9615417067,4.9579538195,4.2186803164
13059,2017,1369,767,944,490,602,1434,10.861545053,6.085321443,7.4896263914,3.8876238684,4.7762236098,11.37725026
19039,2010,34,11,11,-1,23,10,NA,NA,NA,NA,NA,NA
19039,2011,116,111,-8,2,5,-6,12.449691441,11.91306681,-0.85859941,0.2146498524,0.5366246311,-0.643949557
19039,2012,129,128,26,-1,1,25,13.827848644,13.720656019,2.7870082538,-0.107192625,0.1071926251,2.6798156287
19039,2013,128,107,-127,10,21,-117,13.773808243,11.514042828,-13.66620037,1.076078769,2.2597654148,-12.5901216
19039,2014,121,116,-59,12,5,-47,13.118664281,12.576570716,-6.396704071,1.3010245568,0.5420935653,-5.095679514
19039,2015,128,105,-11,13,23,2,13.891149818,11.395083835,-1.193770688,1.4108199034,2.496065983,0.2170492159
19039,2016,116,98,27,14,18,41,12.531734457,10.587154972,2.916869227,1.5124507103,1.9445794847,4.4293199373
19039,2017,123,98,51,13,25,64,13.183279743,10.50375134,5.4662379421,1.3933547696,2.679528403,6.8595927117
28023,2010,46,21,-26,0,25,-26,NA,NA,NA,NA,NA,NA
28023,2011,185,209,-12,1,-24,-11,11.068896401,12.50486134,-0.717982469,0.0598318724,-1.435964939,-0.658150597
28023,2012,196,200,-162,2,-4,-160,11.797279403,12.038040207,-9.750812568,0.1203804021,-0.240760804,-9.630432166
28023,2013,177,198,-90,0,-21,-90,10.742572755,12.017115285,-5.46232513,0,-1.27454253,-5.46232513
28023,2014,184,212,-118,2,-28,-116,11.254510979,12.967153954,-7.217566824,0.1223316411,-1.712642975,-7.095235183
28023,2015,188,221,-224,2,-33,-222,11.640866873,13.684210526,-13.86996904,0.1238390093,-2.043343653,-13.74613003
28023,2016,187,237,-78,2,-50,-76,11.717159059,14.850089289,-4.887371158,0.1253172092,-3.13293023,-4.762053949
28023,2017,193,203,-60,2,-10,-58,12.167444206,12.79788173,-3.782625142,0.1260875047,-0.630437524,-3.656537637
51043,2010,26,59,18,0,-33,18,NA,NA,NA,NA,NA,NA
51043,2011,129,150,193,1,-21,194,9.149585077,10.639052415,13.688914107,0.0709270161,-1.489467338,13.759841123
51043,2012,115,150,89,2,-35,91,8.0903302965,10.552604735,6.2612121425,0.1407013965,-2.462274438,6.401913539
51043,2013,125,142,26,2,-17,28,8.774392812,9.9677102345,1.8250737049,0.140390285,-1.193317422,1.9654639899
51043,2014,143,141,64,6,2,70,10.010500525,9.8704935247,4.4802240112,0.4200210011,0.1400070004,4.9002450123
51043,2015,115,136,-52,6,-21,-46,8.0489938758,9.5188101487,-3.639545057,0.4199475066,-1.469816273,-3.21959755
51043,2016,144,158,76,6,-14,82,10.078034783,11.05784372,5.3189628023,0.419918116,-0.979808937,5.7388809182
51043,2017,131,146,195,6,-15,201,9.0877558099,10.128338536,13.527575442,0.4162330905,-1.040582726,13.943808533
41007,2010,118,74,8,7,44,15,NA,NA,NA,NA,NA,NA
41007,2011,418,359,29,18,59,47,11.255621079,9.6669090126,0.7808923715,0.4846918168,1.5887120661,1.2655841883
41007,2012,429,365,79,45,64,124,11.506584771,9.7899847115,2.1189281978,1.2069844165,1.716600059,3.3259126143
41007,2013,415,428,-290,10,-13,-280,11.146774822,11.4959509,-7.789312526,0.2685969837,-0.349176079,-7.520715542
41007,2014,416,383,294,8,33,302,11.167035769,10.281189182,7.8920877793,0.2147506879,0.8858465875,8.1068384672
41007,2015,427,419,336,17,8,353,11.355778948,11.143024307,8.9356949098,0.4521036115,0.2127546407,9.3877985214
41007,2016,410,389,828,4,21,832,10.730175347,10.180581,21.669719969,0.1046846375,0.549594347,21.774404606
41007,2017,427,391,506,0,36,506,10.974183683,10.048959766,13.004536167,0,0.925223917,13.004536167
01027,2010,27,39,-21,1,-12,-20,NA,NA,NA,NA,NA,NA
01027,2011,152,211,-157,1,-59,-156,11.019283747,15.296505727,-11.38176019,0.0724952878,-4.277221981,-11.3092649
01027,2012,147,183,-220,-1,-36,-221,10.839908561,13.494580046,-16.2229924,-0.073740875,-2.654671484,-16.29673328
01027,2013,120,172,26,0,-52,26,8.9418777943,12.816691505,1.9374068554,0,-3.874813711,1.9374068554
01027,2014,148,171,61,-2,-23,59,11.025851151,12.739328019,4.5444386501,-0.148997989,-1.713476868,4.3954406616
01027,2015,153,201,24,0,-48,24,11.394950473,14.969836896,1.7874432114,0,-3.574886423,1.7874432114
01027,2016,131,159,23,0,-28,23,9.7673725022,11.855055174,1.714882195,0,-2.087682672,1.714882195
01027,2017,134,184,8,0,-50,8,10.008589461,13.743137767,0.597527729,0,-3.734548306,0.597527729
05021,2010,37,85,16,0,-48,16,NA,NA,NA,NA,NA,NA
05021,2011,177,238,-118,-1,-61,-119,11.089878137,14.91181354,-7.393252091,-0.062654679,-3.821935403,-7.45590677
05021,2012,167,256,-73,-3,-89,-76,10.576983976,16.213819748,-4.623472037,-0.1900057,-5.636835772,-4.813477738
05021,2013,148,241,-129,-4,-93,-133,9.4911341264,15.455157598,-8.272677718,-0.256517139,-5.964023471,-8.529194857
05021,2014,175,254,-105,-2,-79,-107,11.37249805,16.506368599,-6.82349883,-0.129971406,-5.133870548,-6.953470237
05021,2015,178,214,-60,-2,-36,-62,11.675193493,14.036468582,-3.935458481,-0.131181949,-2.361275089,-4.06664043
05021,2016,171,225,-83,-2,-54,-85,11.304290342,14.874066239,-5.486877768,-0.132213922,-3.569775897,-5.61909169
05021,2017,166,200,-99,-2,-34,-101,11.075157621,13.343563399,-6.605063882,-0.133435634,-2.268405778,-6.738499516
12019,2010,517,337,291,111,180,402,NA,NA,NA,NA,NA,NA
12019,2011,2107,1484,-197,433,623,236,10.981880158,7.734746158,-1.02678234,2.2568363116,3.2471340003,1.2300539712
12019,2012,2086,1486,575,447,600,1022,10.80319642,7.6958532505,2.9778705377,2.3149706615,3.1073431698,5.2928411992
12019,2013,2064,1529,1025,304,535,1329,10.594748311,7.8485320576,5.2614423538,1.5604668054,2.746216253,6.8219091593
12019,2014,2106,1558,2081,352,548,2433,10.67805118,7.899526941,10.551293687,1.7847454963,2.7785242386,12.336039183
12019,2015,2188,1703,2896,417,485,3313,10.905973363,8.4885158306,14.434962916,2.0785150331,2.4174575325,16.513477949
12019,2016,2190,1751,3894,381,439,4275,10.68894914,8.546278513,19.005830114,1.8595843024,2.1426706266,20.865414416
12019,2017,2246,1778,4175,342,468,4517,10.70875152,8.477364293,19.906071948,1.6306291272,2.2313872267,21.536701075
13061,2010,5,3,-11,0,2,-11,NA,NA,NA,NA,NA,NA
13061,2011,33,42,-3,-3,-9,-6,10.421601137,13.263855992,-0.947418285,-0.947418285,-2.842254856,-1.89483657
13061,2012,43,38,-59,-3,5,-62,13.733631428,12.136697541,-18.84381987,-0.958160332,1.5969338869,-19.8019802
13061,2013,40,48,-80,-4,-8,-84,13.08258381,15.699100572,-26.16516762,-1.308258381,-2.616516762,-27.473426
13061,2014,29,39,71,-5,-10,66,9.5363367313,12.824728708,23.347583032,-1.644195988,-3.288391976,21.703387044
13061,2015,42,37,2,-5,5,-3,13.676326929,12.048192771,0.6512536633,-1.628134158,1.6281341583,-0.976880495
13061,2016,26,23,-62,-5,3,-67,8.5554458704,7.5682790392,-20.40144784,-1.645278052,0.9871668312,-22.0467259
13061,2017,31,40,-31,-5,-9,-36,10.388739946,13.404825737,-10.38873995,-1.675603217,-3.016085791,-12.06434316
17025,2010,41,30,-1,3,11,2,NA,NA,NA,NA,NA,NA
17025,2011,145,182,-82,13,-37,-69,10.527844333000001,13.214259784,-5.953677485,0.9438756988,-2.686415451,-5.009801786
17025,2012,177,149,-39,1,28,-38,12.905577834,10.864017499,-2.843601896,0.0729128691,2.0415603354,-2.770689027
17025,2013,168,195,-130,-3,-27,-133,12.325299879,14.306151645,-9.53743443,-0.220094641,-1.980851766,-9.757529071
17025,2014,143,158,-92,-2,-15,-94,10.595732069,11.707172496,-6.816834618,-0.148192057,-1.111440427,-6.965026675
17025,2015,165,164,-45,-1,1,-46,12.296914592,12.222387837,-3.35370398,-0.074526755,0.0745267551,-3.428230735
17025,2016,164,187,-60,0,-23,-60,12.281884221,14.004343593,-4.493372276,0,-1.722459372,-4.493372276
17025,2017,156,174,-23,0,-18,-23,11.738148984,13.09255079,-1.73062453,0,-1.354401806,-1.73062453
18021,2010,69,79,-23,1,-10,-22,NA,NA,NA,NA,NA,NA
18021,2011,326,293,-52,-2,33,-54,12.144919437,10.915525752,-1.937226413,-0.074508708,1.2293936854,-2.011735122
18021,2012,319,292,-73,-1,27,-74,11.899211071,10.892067814,-2.723016954,-0.037301602,1.0071432568,-2.760318556
18021,2013,299,285,-140,-1,14,-141,11.189282239,10.665369359,-5.239128808,-0.037422349,0.5239128808,-5.276551156
18021,2014,317,290,-262,-2,27,-264,11.943560085,10.926285251,-9.871333572,-0.075353691,1.0172748338,-9.946687263
18021,2015,322,342,-10,-2,-20,-12,12.193967394,12.951356674,-0.37869464,-0.075738928,-0.757389279,-0.454433567
18021,2016,339,298,-225,-2,41,-227,12.891694554,11.332522057,-8.556434439,-0.076057195,1.5591724977,-8.632491634
18021,2017,326,288,-40,-2,38,-42,12.442510639,10.992156638,-1.526688422,-0.076334421,1.4503540009,-1.603022843
19041,2010,55,60,-27,-1,-5,-28,NA,NA,NA,NA,NA,NA
19041,2011,198,194,-38,-2,4,-40,11.917659805,11.676899001,-2.287227639,-0.120380402,0.2407608041,-2.407608041
19041,2012,179,193,-37,-2,-14,-39,10.804285499,11.649313415,-2.233288064,-0.120718274,-0.845027916,-2.354006338
19041,2013,225,191,-140,6,34,-134,13.643805712,11.582075071,-8.48947911,0.363834819,2.061730641,-8.125644291
19041,2014,192,200,49,11,-8,60,11.660037045,12.145871922,2.9757386208,0.6680229557,-0.485834877,3.6437615765
19041,2015,212,206,2,13,6,15,12.848874208,12.485226825,0.1212157944,0.7879026637,0.3636473833,0.9091184581
19041,2016,174,175,-194,12,-1,-182,10.599092377,10.660006701,-11.81737886,0.730971888,-0.060914324,-11.08640697
19041,2017,176,159,-184,12,17,-172,10.832435759000001,9.7861209417,-11.3248192,0.7385751654,1.0463148177,-10.58624404
20027,2010,21,32,17,0,-11,17,NA,NA,NA,NA,NA,NA
20027,2011,98,111,-5,-1,-13,-6,11.480787254000001,13.003748828,-0.585754452,-0.11715089,-1.522961575,-0.702905342
20027,2012,105,103,-24,-1,2,-25,12.33335291,12.098431902,-2.819052094,-0.117460504,0.2349210078,-2.936512598
20027,2013,117,98,-133,-3,19,-136,13.856812933,11.60656126,-15.75176171,-0.355302896,2.2502516729,-16.10706461
20027,2014,106,114,-81,1,-8,-80,12.705261896,13.664149586,-9.708737864,0.1198609613,-0.95888769,-9.588876903
20027,2015,108,103,-11,1,5,-10,13.016753043,12.414125588,-1.325780403,0.1205254911,0.6026274557,-1.205254911
20027,2016,74,107,-184,1,-33,-183,9.0392719721,13.070298662,-22.47602761,0.1221523239,-4.03102669,-22.35387528
20027,2017,78,109,-90,1,-31,-89,9.7275051444,13.593564881,-11.2240444,0.1247116044,-3.866059737,-11.09933279
21051,2010,79,91,-62,1,-12,-61,NA,NA,NA,NA,NA,NA
21051,2011,298,289,-74,-1,9,-75,13.778116837,13.361999214,-3.421411563,-0.046235291,0.4161176226,-3.467646855
21051,2012,303,268,-105,0,35,-105,14.053477424,12.430138448,-4.870016929,0,1.6233389764,-4.870016929
21051,2013,272,243,-369,4,29,-365,12.734082397,11.376404494,-17.2752809,0.1872659176,1.3576779026,-17.08801498
21051,2014,297,240,-169,9,57,-160,14.045541605,11.34993261,-7.992244213,0.4256224729,2.6956089948,-7.56662174
21051,2015,280,234,-161,9,46,-152,13.306087535,11.12008744,-7.651000333,0.4276956708,2.186000095,-7.223304662
21051,2016,275,278,-315,9,-3,-306,13.197993905,13.34197202,-15.11770211,0.431934346,-0.143978115,-14.68576776
21051,2017,267,241,-354,9,26,-345,13.00884309,11.742064362,-17.2476796,0.4385003289,1.2667787279,-16.80917927
27027,2010,200,118,47,15,82,62,NA,NA,NA,NA,NA,NA
27027,2011,792,460,369,51,332,420,13.306339832,7.7284297007,6.1995446947,0.8568476407,5.5779101318,7.0563923354
27027,2012,790,424,-130,48,366,-82,13.158113893,7.0620763171,-2.165259248,0.7994803378,6.0960375756,-1.36577891
27027,2013,779,502,-8,74,277,66,12.908036454,8.3181441591,-0.132560066,1.2261806131,4.5898922949,1.0936205468
27027,2014,844,442,179,94,402,273,13.8691469,7.2632262199,2.9414422927,1.5446680196,6.6059206797,4.4861103123
27027,2015,872,466,376,100,406,476,14.149871807,7.56174342,6.1013208711,1.622691721,6.5881283874,7.7240125921
27027,2016,874,464,289,98,410,387,13.992731464,7.4286354685,4.6268871776,1.5689790429,6.5640959959,6.1958662205
27027,2017,896,449,172,97,447,269,14.174187476,7.1029131436,2.7209377744,1.5344823495,7.0712743322,4.2554201239
28025,2010,49,79,-60,1,-30,-59,NA,NA,NA,NA,NA,NA
28025,2011,259,199,-132,3,60,-129,12.625831769,9.7009286567,-6.434786848,0.1462451556,2.9249031126,-6.288541692
28025,2012,232,230,-96,0,2,-96,11.35501554,11.257127475,-4.69862712,0,0.097888065,-4.69862712
28025,2013,228,226,-39,0,2,-39,11.196228639,11.098016107,-1.915144372,0,0.0982125319,-1.915144372
28025,2014,204,255,-158,0,-51,-158,10.079051383,12.598814229,-7.806324111,0,-2.519762846,-7.806324111
28025,2015,229,237,-136,0,-8,-136,11.414614694,11.813378527,-6.778985146,0,-0.398763832,-6.778985146
28025,2016,224,229,-145,0,-5,-145,11.248085566,11.499158904,-7.281126817,0,-0.251073339,-7.281126817
28025,2017,227,232,-197,0,-5,-197,11.499493414,11.752786221,-9.979736575,0,-0.253292806,-9.979736575
29047,2010,784,385,252,78,399,330,NA,NA,NA,NA,NA,NA
29047,2011,3073,1560,755,231,1513,986,13.723375513,6.9666338431,3.3716721484,1.0315977037,6.7567416696,4.4032698521
29047,2012,2993,1576,754,242,1417,996,13.221862679,6.9621301644,3.3308668426,1.0690580582,6.2597325146,4.3999249009
29047,2013,3132,1640,1137,171,1492,1308,13.679125794,7.1627606328,4.9658895363,0.7468488221,6.516365161,5.7127383583
29047,2014,3040,1629,1148,189,1411,1337,13.118998813,7.0298845614,4.9541482361,0.8156219657,6.0891142518,5.7697702017
29047,2015,3108,1806,666,211,1302,877,13.272210562,7.7122304616,2.8440451204,0.9010413219,5.5599801002,3.7450864423
29047,2016,3002,1708,2003,210,1294,2213,12.666265835,7.2065230003,8.4512093499,0.8860479099,5.4597428351,9.3372572598
29047,2017,3021,1711,2583,213,1310,2796,12.544743333,7.1049506266,10.725942413,0.884485379,5.4397927065,11.610427792
31035,2010,20,25,3,0,-5,3,NA,NA,NA,NA,NA,NA
31035,2011,77,83,-79,1,-6,-78,11.855273287,12.779060816,-12.16320246,0.1539645881,-0.923787529,-12.00923788
31035,2012,67,69,-70,1,-2,-69,10.436949918,10.748500662,-10.90427603,0.1557753719,-0.311550744,-10.74850066
31035,2013,76,67,-32,-1,9,-33,11.927181419,10.51475204,-5.021971124,-0.156936598,1.4124293785,-5.178907721
31035,2014,73,66,-52,-1,7,-53,11.520555512,10.415844709,-8.206423104,-0.157815829,1.1047108025,-8.364238933
31035,2015,95,80,-36,0,15,-36,15.073383578,12.693375645,-5.71201904,0,2.3800079334,-5.71201904
31035,2016,84,58,-169,0,26,-169,13.504823151,9.3247588424,-27.17041801,0,4.1800643087,-27.17041801
31035,2017,84,67,39,0,17,39,13.598834386,10.846689331,6.3137445362,0,2.7521450542,6.3137445362
37043,2010,22,17,11,2,5,13,NA,NA,NA,NA,NA,NA
37043,2011,78,118,117,4,-40,121,7.3246314208,11.080852662,10.986947131,0.3756221241,-3.756221241,11.362569255
37043,2012,86,142,29,2,-56,31,8.05545148,13.300861746,2.7163731735,0.1873360809,-5.245410266,2.9037092544
37043,2013,82,148,12,4,-66,16,7.7089404907,13.913697471,1.1281376328,0.3760458776,-6.20475698,1.5041835104
37043,2014,82,154,46,8,-72,54,7.7340249941,14.524876208,4.3385993869,0.7545390238,-6.790851214,5.0931384108
37043,2015,68,132,129,9,-64,138,6.3966887729,12.417101736,12.134894878,0.8466205729,-6.020412963,12.981515451
37043,2016,102,140,180,11,-38,191,9.4941127193,13.031135105,16.754316564,1.0238749011,-3.537022386,17.778191465
37043,2017,90,153,304,11,-63,315,8.2218060567,13.977070296,27.771433792,1.0048874069,-5.75526424,28.776321199
46027,2010,28,37,-28,-1,-9,-29,NA,NA,NA,NA,NA,NA
46027,2011,156,90,78,11,66,89,11.216162778,6.4708631412,5.6080813891,0.7908832728,4.7452996369,6.3989646619
46027,2012,143,99,-7,25,44,18,10.201897696,7.0628522508,-0.499393593,1.7835485482,3.1390454448,1.2841549547
46027,2013,160,111,-217,28,49,-189,11.444511999,7.9396301992,-15.5216194,2.0027895998,3.5048817996,-13.5188298
46027,2014,165,81,-118,19,84,-99,11.864102103,5.8241955779,-8.484630595,1.3661693331,6.0399065253,-7.118461262
46027,2015,128,111,-150,22,17,-128,9.2448810083,8.0170452494,-10.83384493,1.5889639233,1.2278357589,-9.244881008
46027,2016,153,93,64,23,60,87,11.035776111,6.7080207732,4.6162723601,1.6589728794,4.3277553376,6.2752452395
46027,2017,144,89,-24,21,55,-3,10.312231452,6.3735319393,-1.718705242,1.5038670868,3.938699513,-0.214838155
47027,2010,18,39,12,0,-21,12,NA,NA,NA,NA,NA,NA
47027,2011,76,109,-51,1,-33,-50,9.7323600973,13.958253297,-6.530925855,0.1280573697,-4.2258932,-6.402868485
47027,2012,81,124,2,2,-43,4,10.455660256,16.006195947,0.2581644508,0.2581644508,-5.550535691,0.5163289015
47027,2013,98,107,-12,1,-9,-11,12.698412698,13.864593456,-1.554907677,0.1295756398,-1.166180758,-1.425332038
47027,2014,62,109,-25,3,-47,-22,8.079755001,14.204730566,-3.257965726,0.3909558871,-6.124975565,-2.867009839
47027,2015,84,107,62,5,-23,67,10.964626028,13.966845059,8.0929382587,0.6526563112,-3.002219031,8.7455945699
47027,2016,72,123,50,6,-51,56,9.3682909375,16.004163685,6.5057575955,0.7806909115,-6.635872747,7.2864485069
47027,2017,75,111,45,6,-36,51,9.7459554285,14.424014034,5.8475732571,0.7796764343,-4.678058606,6.6272496914
48077,2010,19,22,-16,0,-3,-16,NA,NA,NA,NA,NA,NA
48077,2011,92,102,-66,4,-10,-62,8.5977290781,9.5322648474,-6.167936078,0.3738143077,-0.934535769,-5.79412177
48077,2012,74,118,-108,6,-44,-102,6.9850858977,11.138380215,-10.19444969,0.566358316,-4.153294318,-9.628091372
48077,2013,111,114,-71,5,-3,-66,10.584028605,10.870083433,-6.769964243,0.4767580453,-0.286054827,-6.293206198
48077,2014,74,125,-36,8,-51,-28,7.1061602727,12.003649109,-3.457050943,0.768233543,-4.897488837,-2.6888174
48077,2015,87,128,13,8,-41,21,8.3948473006,12.351039707,1.2544024702,0.7719399817,-3.956192406,2.0263424519
48077,2016,91,116,-92,7,-25,-85,8.8370963826,11.264870114,-8.934207332,0.6797766448,-2.427773731,-8.254430687
48077,2017,87,123,208,7,-36,215,8.4208488603,11.905338044,20.132604172,0.6775395635,-3.484489184,20.810143735
54015,2010,39,32,-19,0,7,-19,NA,NA,NA,NA,NA,NA
54015,2011,120,101,-58,-2,19,-60,12.828050671,10.796942648,-6.200224491,-0.213800845,2.0311080229,-6.414025335
54015,2012,111,108,-129,-2,3,-131,11.972818466,11.649228778,-13.9143566,-0.215726459,0.3235896883,-14.13008305
54015,2013,111,107,-72,-1,4,-73,12.09941138,11.663396555,-7.848266841,-0.109003706,0.4360148245,-7.957270547
54015,2014,95,109,-249,0,-14,-249,10.54267007,12.096326712,-27.63289313,0,-1.553656642,-27.63289313
54015,2015,113,117,-2,0,-4,-2,12.726658407,13.17715959,-0.225250591,0,-0.450501183,-0.225250591
54015,2016,103,103,-32,0,0,-32,11.625938258,11.625938258,-3.611941983,0,0,-3.611941983
54015,2017,113,111,-80,0,2,-80,12.835803942,12.608621571,-9.087294826,0,0.2271823706,-9.087294826
13063,2010,1083,388,-565,136,695,-429,NA,NA,NA,NA,NA,NA
13063,2011,4373,1431,-1146,708,2942,-438,16.747827053,5.4804803367,-4.38898006,2.7115164769,11.267346716,-1.677463583
13063,2012,4177,1395,-52,720,2782,668,15.81786544,5.2827202033,-0.196918603,2.7265652662,10.535145237,2.5296466636
13063,2013,4145,1521,-4718,702,2624,-4016,15.633014512999999,5.7365054461,-17.79410434,2.6476178982,9.8965090668,-15.14648644
13063,2014,4125,1512,-494,808,2613,314,15.509967739,5.685108175,-1.857436137,3.0380736808,9.8248595643,1.1806375443
13063,2015,4401,1643,2571,928,2758,3499,16.26746507,6.073039107,9.5032157906,3.4301766837,10.194425963,12.933392474
13063,2016,4289,1732,2804,968,2557,3772,15.492675385,6.2563100413,10.128575841,3.4965982217,9.2363653439,13.625174062
13063,2017,4127,1733,1784,965,2394,2749,14.604739551,6.1327874103,6.3132675937,3.4149681771,8.4719521409,9.7282357708
19043,2010,47,61,-34,0,-14,-34,NA,NA,NA,NA,NA,NA
19043,2011,179,207,-36,3,-28,-33,9.9171722208,11.46846173,-1.994515084,0.1662095903,-1.551289509,-1.828305493
19043,2012,190,167,-97,3,23,-94,10.565534116,9.2865484068,-5.393983206,0.1668242229,1.2789857087,-5.227158983
19043,2013,200,213,-143,2,-13,-141,11.191941802,11.919418019,-8.002238388,0.111919418,-0.727476217,-7.89031897
19043,2014,206,184,-56,4,22,-52,11.587681058,10.350161721,-3.15004922,0.2250035157,1.2375193362,-2.925045704
19043,2015,191,198,-44,4,-7,-40,10.767236034,11.161846778,-2.480410395,0.2254918541,-0.394610745,-2.254918541
19043,2016,181,186,-66,5,-5,-61,10.236977547,10.519766982,-3.732820542,0.282789435,-0.282789435,-3.450031107
19043,2017,177,190,-1,5,-13,4,10.032876091,10.769753996,-0.056682916,0.2834145788,-0.736877905,0.2267316631
08019,2010,14,32,22,3,-18,25,NA,NA,NA,NA,NA,NA
08019,2011,67,55,-113,18,12,-95,7.4094553497,6.0823887199,-12.4965441,1.9905999447,1.3270666298,-10.50594415
08019,2012,68,42,-39,18,26,-21,7.5526184262,4.6648525573,-4.331648803,1.9992225246,2.8877658688,-2.332426279
08019,2013,67,57,-26,19,10,-7,7.4390717815,6.3287625604,-2.886803975,2.1095875201,1.1103092211,-0.777216455
08019,2014,79,61,59,24,18,83,8.7206093388,6.7336350591,6.5128601391,2.6492990396,1.9869742797,9.1621591787
08019,2015,59,60,95,26,-1,121,6.4329717058,6.5420051246,10.358174781,2.8348688873,-0.109033419,13.193043668
08019,2016,75,47,74,25,28,99,8.0671184253,5.0553942132,7.9595568463,2.6890394751,3.0117242121,10.648596321
08019,2017,65,57,177,26,8,203,6.8655928175,6.0205967785,18.695537365,2.746237127,0.8449960391,21.441774492
42033,2010,199,276,5,4,-77,9,NA,NA,NA,NA,NA,NA
42033,2011,729,912,14,29,-183,43,8.9514302028,11.198497044,0.1719067529,0.3560925595,-2.247066841,0.5279993124
42033,2012,700,894,130,62,-194,192,8.6041066172,10.988673308,1.5979055146,0.7620780147,-2.384566691,2.3599835293
42033,2013,797,942,133,47,-145,180,9.7955471434,11.577673035,1.6346396111,0.5776545994,-1.782125892,2.2122942105
42033,2014,720,916,-286,59,-196,-227,8.8710919452,11.286000308,-3.523794856,0.7269367011,-2.414908363,-2.796858155
42033,2015,782,922,-214,63,-140,-151,9.6783376032,11.411032315,-2.648547631,0.7797126202,-1.732694712,-1.86883501
42033,2016,712,937,-454,64,-225,-390,8.8620041572,11.662497044,-5.650772314,0.7965846433,-2.800492887,-4.85418767
42033,2017,710,946,-175,63,-236,-112,8.8905584773,11.845730028,-2.191334836,0.7888805409,-2.95517155,-1.402454295
16035,2010,17,40,-11,1,-23,-10,NA,NA,NA,NA,NA,NA
16035,2011,52,122,-50,0,-70,-50,5.9997692396,14.076381678,-5.769008884,0,-8.076612438,-5.769008884
16035,2012,72,94,-9,3,-22,-6,8.380375953,10.941046383,-1.047546994,0.3491823314,-2.56067043,-0.698364663
16035,2013,60,107,40,1,-47,41,6.9974925652,12.478861741,4.6649950434,0.1166248761,-5.481369176,4.7816199195
16035,2014,73,98,-39,0,-25,-39,8.5480093677,11.475409836,-4.566744731,0,-2.927400468,-4.566744731
16035,2015,55,108,31,0,-53,31,6.4728727786,12.710368365,3.6483464752,0,-6.237495587,3.6483464752
16035,2016,68,120,121,0,-52,121,7.9807523033,14.083680535,14.20104454,0,-6.102928232,14.20104454
16035,2017,62,99,28,0,-37,28,7.251037951,11.578270277,3.2746623005,0,-4.327232326,3.2746623005
27029,2010,23,12,0,0,11,0,NA,NA,NA,NA,NA,NA
27029,2011,119,97,-9,2,22,-7,13.659320478,11.134067952,-1.033057851,0.2295684114,2.5252525253,-0.80348944
27029,2012,94,94,-43,0,0,-43,10.807703363,10.807703363,-4.943949411,0,0,-4.943949411
27029,2013,112,105,92,7,7,99,12.830058995,12.028180308,10.538977032,0.8018786872,0.8018786872,11.340855719
27029,2014,98,104,8,10,-6,18,11.150935882,11.833646242,0.9102804802,1.1378506002,-0.68271036,2.0481310804
27029,2015,115,118,5,10,-3,15,13.069667008,13.410614843,0.5682463916,1.1364927833,-0.340947835,1.7047391749
27029,2016,108,82,20,10,26,30,12.227568639,9.283894707,2.2643645627,1.1321822813,2.9436739315,3.396546844
27029,2017,108,80,-21,10,28,-11,12.176560122,9.0196741643,-2.367664468,1.1274592705,3.1568859575,-1.240205198
01029,2010,42,22,13,0,20,13,NA,NA,NA,NA,NA,NA
01029,2011,184,174,-88,0,10,-88,12.294534278,11.626353067,-5.879994655,0,0.6681812107,-5.879994655
01029,2012,183,159,-63,-1,24,-64,12.274876748,10.665056847,-4.225777241,-0.067075829,1.6098199014,-4.29285307
01029,2013,176,187,103,-4,-11,99,11.786372007,12.523020258,6.8977063452,-0.267872091,-0.73664825,6.6298342541
01029,2014,198,190,50,-5,8,45,13.199120059,12.665822279,3.3331111259,-0.333311113,0.5332977801,2.9998000133
01029,2015,149,209,-37,-5,-60,-42,9.9505810071,13.957526379,-2.4709496460000002,-0.333912114,-4.006945372,-2.80486176
01029,2016,163,196,-12,-5,-33,-17,10.941433126,13.156569894,-0.805504279,-0.335626783,-2.215136768,-1.141131062
01029,2017,154,190,68,-5,-36,63,10.344943405,12.763241863,4.567897088,-0.335874786,-2.418298458,4.2320223021
05023,2010,71,104,55,-1,-33,54,NA,NA,NA,NA,NA,NA
05023,2011,264,361,-2,-11,-97,-13,10.174782726,13.913244561,-0.077081687,-0.42394928,-3.738461835,-0.501030968
05023,2012,231,359,20,-7,-128,13,8.9425701179,13.897760486,0.7742484951,-0.270986973,-4.955190368,0.5032615218
05023,2013,263,368,-17,-9,-105,-26,10.231273463,14.316002412,-0.661337068,-0.350119624,-4.084728949,-1.011456692
05023,2014,210,358,123,-4,-148,119,8.1965613474,13.973185535,4.8008430749,-0.156124978,-5.776624188,4.6447180968
05023,2015,258,367,-133,-3,-109,-136,10.125390004,14.403171052,-5.219677793,-0.117737093,-4.277781048,-5.337414886
05023,2016,213,376,-32,-2,-163,-34,8.4328047984,14.886077954,-1.266900251,-0.079181266,-6.453273156,-1.346081517
05023,2017,227,382,47,-1,-155,46,9.0425637859,15.217001613,1.8722488896,-0.039835083,-6.174437827,1.8324138068
39025,2010,618,414,26,28,204,54,NA,NA,NA,NA,NA,NA
39025,2011,2443,1553,298,66,890,364,12.325684648,7.8353615467,1.503501443,0.3329902525,4.4903231015,1.8364916954
39025,2012,2379,1530,-289,79,849,-210,11.947029313,7.6834614747,-1.451320501,0.3967277493,4.2635678379,-1.054592751
39025,2013,2324,1648,202,69,676,271,11.625929224,8.2442045443,1.0105153628,0.3451760398,3.3817246796,1.3556914026
39025,2014,2261,1603,314,81,658,395,11.256232373,7.9804248095,1.5632273176,0.4032529068,3.2758075637,1.9664802244
39025,2015,2352,1726,-196,89,626,-107,11.665393657,8.5605737469,-0.972116138,0.4414200831,3.1048199105,-0.53069605500000006
39025,2016,2296,1744,502,97,552,599,11.341548052,8.614834409,2.4797287118,0.479150767,2.7267136432,2.9588794788
39025,2017,2307,1706,515,94,601,609,11.330206517,8.3785575719,2.5292832061,0.4616555755,2.9516489453,2.9909387815
05025,2010,21,41,7,0,-20,7,NA,NA,NA,NA,NA,NA
05025,2011,85,91,0,0,-6,0,9.7982708934,10.489913545,0,0,-0.691642651,0
05025,2012,98,84,-79,0,14,-79,11.343249031,9.7227848834,-9.144047688,0,1.6204641472,-9.144047688
05025,2013,87,108,-73,0,-21,-73,10.16236421,12.615348674,-8.527041234,0,-2.452984464,-8.527041234
05025,2014,76,87,-108,0,-11,-108,8.9877010407,10.288552507,-12.77199622,0,-1.300851466,-12.77199622
05025,2015,87,105,-97,2,-18,-95,10.431029315,12.589173311,-11.6299982,0.2397937774,-2.158143996,-11.39020442
05025,2016,65,94,4,2,-29,6,7.8578336557,11.363636364,0.4835589942,0.2417794971,-3.505802708,0.7253384913
05025,2017,68,80,-48,2,-12,-46,8.2614506135,9.719353663,-5.831612198,0.2429838416,-1.457903049,-5.588628356
37045,2010,253,301,-65,6,-48,-59,NA,NA,NA,NA,NA,NA
37045,2011,1111,1065,-561,31,46,-530,11.374339654,10.903394897,-5.743478439,0.3173758139,0.4709447561,-5.426102625
37045,2012,1082,1117,-125,50,-35,-75,11.1117387,11.471175718,-1.283703639,0.5134814556,-0.359437019,-0.770222183
37045,2013,1080,1128,-428,41,-48,-387,11.123241395,11.617607679,-4.408099368,0.4222712011,-0.494366284,-3.985828167
37045,2014,1060,1150,186,60,-90,246,10.934260339,11.862640933,1.9186532292,0.6189203965,-0.928380595,2.5375736257
37045,2015,1041,1228,-15,69,-187,54,10.738601197,12.667629462,-0.154734888,0.7117804828,-1.929028265,0.5570455952
37045,2016,1086,1252,331,72,-166,403,11.197607878,12.909212765,3.4128989019,0.7423828427,-1.711604887,4.1552817446
37045,2017,1057,1211,320,73,-154,393,10.872472176,12.45654097,3.2915715197,0.7508897529,-1.584068794,4.0424612726
40027,2010,790,438,575,126,352,701,NA,NA,NA,NA,NA,NA
40027,2011,3092,1833,3028,409,1259,3437,11.916622185,7.0644141219,11.669965063,1.5762931674,4.852208063,13.246258231
40027,2012,3061,1772,2224,636,1289,2860,11.597772137,6.7139014133,8.4264767173,2.4097298526,4.8838707233,10.83620657
40027,2013,3125,1903,1845,585,1222,2430,11.667064902,7.104775843,6.8882351184,2.1840745497,4.5622890595,9.0723096682
40027,2014,2978,1862,-1874,647,1116,-1227,11.04478553,6.9057725509,-6.950278067,2.3995890657,4.1390129789,-4.550689001
40027,2015,2924,1918,2247,712,1006,2959,10.767298932,7.062817836,8.2743230853,2.6218593844,3.7044810965,10.89618247
40027,2016,2943,2039,2511,704,904,3215,10.678151515,7.3981484673,9.1107164303,2.5543386567,3.2800030478,11.665055087
40027,2017,2919,2035,428,671,884,1099,10.475300147,7.30292422,1.5359467156,2.4079912293,3.1723759265,3.9439379449
13065,2010,17,29,-16,1,-12,-15,NA,NA,NA,NA,NA,NA
13065,2011,109,84,-77,13,25,-64,16.143364929,12.440758294,-11.40402844,1.9253554502,3.7026066351,-9.478672986
13065,2012,97,63,-71,11,34,-60,14.432376135,9.3736051183,-10.56390418,1.6366612111,5.0587710162,-8.92724297
13065,2013,97,65,20,14,32,34,14.38742213,9.6410560664,2.9664787897,2.0765351528,4.7463660635,5.0430139425
13065,2014,104,73,-23,16,31,-7,15.32228361,10.755064457,-3.388581952,2.3572744015,4.5672191529,-1.031307551
13065,2015,97,72,10,17,25,27,14.212454212,10.549450549,1.4652014652,2.4908424908,3.663003663,3.956043956
13065,2016,103,75,-106,18,28,-88,15.103746609,10.997873744,-15.54366156,2.6394896987,4.1058728646,-12.90417186
13065,2017,94,66,-110,18,28,-92,13.909440663,9.7662030186,-16.27700503,2.6635099142,4.1432376443,-13.61349512
17027,2010,101,61,40,1,40,41,NA,NA,NA,NA,NA,NA
17027,2011,399,292,79,0,107,79,10.519239135,7.6982902941,2.0827566207,0,2.8209488406,2.0827566207
17027,2012,433,337,-206,0,96,-206,11.404941263,8.8763630617,-5.425907391,0,2.5285782015,-5.425907391
17027,2013,414,348,-250,1,66,-249,10.946878553,9.2017240012,-6.610433909,0.0264417356,1.7451545519,-6.583992173
17027,2014,395,334,-148,0,61,-148,10.482041212,8.8632956068,-3.927448353,0,1.6187456048,-3.927448353
17027,2015,451,390,-44,0,61,-44,11.979706218,10.359391187,-1.168751826,0,1.6203150317,-1.168751826
17027,2016,447,363,-170,-2,84,-172,11.885294939,9.6518166952,-4.52013454,-0.053178053,2.2334782435,-4.573312594
17027,2017,447,380,-17,-1,67,-18,11.89161867,10.109206028,-0.452253954,-0.026603174,1.7824126418,-0.478857128
18023,2010,112,64,-57,10,48,-47,NA,NA,NA,NA,NA,NA
18023,2011,431,340,-312,40,91,-272,13.006020188,10.259969522,-9.415030855,1.2070552379,2.7460506661,-8.207975617
18023,2012,418,368,-227,32,50,-195,12.674155941,11.158108579,-6.88285502,0.9702703112,1.5160473613,-5.912584709
18023,2013,467,381,-221,13,86,-208,14.21678311,11.598703137,-6.727856675,0.395756275,2.6180799732,-6.3321004
18023,2014,423,347,-384,5,76,-379,12.959360304,10.630964599,-11.76452567,0.1531839279,2.3283957047,-11.61134174
18023,2015,490,388,-188,6,102,-182,15.099223469,11.956119808,-5.793171453,0.1848884506,3.1431036608,-5.608283003
18023,2016,456,356,-250,7,100,-243,14.100621541,11.008379975,-7.730603915,0.2164569096,3.0922415659,-7.514147005
18023,2017,456,319,-93,7,137,-86,14.121144556,9.8786077047,-2.879970271,0.2167719559,4.2425368512,-2.663198315
19045,2010,168,165,-24,4,3,-20,NA,NA,NA,NA,NA,NA
19045,2011,596,541,-66,12,55,-54,12.141212899,11.020798957,-1.34449673,0.244453951,1.120413942,-1.100042779
19045,2012,571,530,-458,24,41,-434,11.678563394,10.839997546,-9.367394105,0.4908678134,0.8385658479,-8.876526292
19045,2013,561,545,-489,30,16,-459,11.571304814,11.241285426,-10.08621757,0.6187863537,0.3300193886,-9.467431212
19045,2014,537,527,-427,33,10,-394,11.170511514,10.96249454,-8.882324798,0.6864560148,0.2080169742,-8.195868783
19045,2015,591,565,-405,38,26,-367,12.386431513,11.84151236,-8.488163727,0.7964203003,0.5449191529,-7.691743427
19045,2016,587,576,-360,41,11,-319,12.386448761,12.15433473,-7.596459206,0.8651522985,0.2321140313,-6.731306908
19045,2017,580,520,-328,41,60,-287,12.308214672,11.034951085,-6.960507608,0.870063451,1.2732635868,-6.090444157
21053,2010,26,48,1,0,-22,1,NA,NA,NA,NA,NA,NA
21053,2011,116,126,-90,13,-10,-77,11.371991569,12.35233567,-8.823096907,1.274447331,-0.980344101,-7.548649576
21053,2012,119,122,100,13,-3,113,11.651816313,11.945559581,9.7914422794,1.2728874963,-0.293743268,11.064329776
21053,2013,122,131,-100,10,-9,-90,11.937377691,12.818003914,-9.784735812,0.9784735812,-0.880626223,-8.806262231
21053,2014,104,125,40,10,-21,50,10.211596053,12.273552948,3.9275369434,0.9818842358,-2.061956895,4.9094211792
21053,2015,137,170,0,13,-33,13,13.447852761,16.687116564,0,1.2760736196,-3.239263804,1.2760736196
21053,2016,130,117,17,14,13,31,12.746972594,11.472275335,1.6669118008,1.3727508947,1.2746972594,3.0396626955
21053,2017,120,101,24,14,19,38,11.709601874,9.8555815769,2.3419203747,1.3661202186,1.8540202966,3.7080405933
26037,2010,197,152,-23,17,45,-6,NA,NA,NA,NA,NA,NA
26037,2011,803,566,171,64,237,235,10.61481315,7.4819230922,2.2604396621,0.8460125051,3.132890058,3.1064521672
26037,2012,754,539,-53,84,215,31,9.9205304984,7.0917320141,-0.697331719,1.1052049892,2.8287984843,0.4078732698
26037,2013,800,568,331,76,232,407,10.46545093,7.4304701604,4.3300803223,0.9942178384,3.0349807697,5.3242981607
26037,2014,815,667,-71,81,148,10,10.607628382,8.6813351295,-0.924100141,1.0542550907,1.9262932521,0.1301549495
26037,2015,807,608,-224,88,199,-136,10.48916964,7.9026209926,-2.911491945,1.1438004068,2.5865486473,-1.767691538
26037,2016,769,587,294,88,182,382,9.9548858554,7.5988530522,3.8058991437,1.1391806961,2.3560328032,4.9450798397
26037,2017,802,575,601,88,227,689,10.283831176,7.3730709802,7.7064620159,1.1284004283,2.9107601957,8.8348624441
29049,2010,42,31,-12,0,11,-12,NA,NA,NA,NA,NA,NA
29049,2011,243,257,-45,-6,-14,-51,11.734595325,12.410662546,-2.173073208,-0.289743094,-0.67606722,-2.462816303
29049,2012,223,258,-79,-6,-35,-85,10.816316632,12.513944803,-3.8317893,-0.291021972,-1.697628171,-4.122811272
29049,2013,231,218,-3,-7,13,-10,11.235681802,10.603370705,-0.145917945,-0.340475206,0.6323110971,-0.486393152
29049,2014,211,281,-227,-7,-70,-234,10.338069574,13.767760902,-11.12199902,-0.342969133,-3.429691328,-11.46496815
29049,2015,237,261,342,-7,-24,335,11.608826627,12.784404007,16.751977664,-0.342876736,-1.17557738,16.409100928
29049,2016,231,247,-21,-7,-16,-28,11.240328938,12.01887986,-1.021848085,-0.340616028,-0.778550922,-1.362464114
29049,2017,238,241,36,-7,-3,29,11.586018888,11.732061143,1.7525070587,-0.340765261,-0.146042255,1.4117417973
36019,2010,218,160,-119,26,58,-93,NA,NA,NA,NA,NA,NA
36019,2011,793,703,-589,122,90,-467,9.6809439226,8.5822239313,-7.190511942,1.4893759881,1.0987199912,-5.701135954
36019,2012,787,692,-191,120,95,-71,9.6283835449,8.466126319,-2.336748738,1.4681143906,1.1622572259,-0.868634348
36019,2013,738,737,-285,123,1,-162,9.0369744503,9.0247292275,-3.489888507,1.5061624084,0.0122452228,-1.983726099
36019,2014,765,672,-254,132,93,-122,9.3787928942,8.2386259149,-3.114004438,1.618301519,1.1401669793,-1.495702919
36019,2015,780,697,-745,138,83,-607,9.5952171533,8.5741876357,-9.164662537,1.6976153425,1.0210295176,-7.467047195
36019,2016,760,700,-261,140,60,-121,9.3824264683,8.6417085892,-3.222122774,1.7283417178,0.7407178791,-1.493781056
36019,2017,767,718,-178,138,49,-40,9.4718838181,8.8667699888,-2.198168604,1.7041981316,0.6051138293,-0.493970473
39027,2010,131,112,-157,4,19,-153,NA,NA,NA,NA,NA,NA
39027,2011,484,415,-100,10,69,-90,11.550210004,9.9035891562,-2.386407026,0.2386407026,1.6466208477,-2.147766323
39027,2012,512,458,-150,9,54,-141,12.234461994,10.944108581,-3.584315037,0.2150589022,1.2903534135,-3.369256135
39027,2013,520,435,-52,9,85,-43,12.43320143,10.400851196,-1.243320143,0.2151900247,2.0323502337,-1.028130118
39027,2014,505,429,-142,14,76,-128,12.076717046,10.259230916,-3.395829348,0.3348000765,1.8174861297,-3.061029271
39027,2015,524,443,-55,15,81,-40,12.534385839,10.596818562,-1.315632101,0.3588087549,1.9375672766,-0.956823346
39027,2016,496,404,-51,17,92,-34,11.85142707,9.6531785002,-1.218594316,0.4061981052,2.1982485693,-0.81239621
39027,2017,492,425,46,17,67,63,11.729645965,10.132316128,1.0966742162,0.4052926451,1.5973298367,1.5019668614
42035,2010,124,115,-1,1,9,0,NA,NA,NA,NA,NA,NA
42035,2011,385,361,189,15,24,204,9.7821253891,9.1723305596,4.8021342819,0.3811217684,0.6097948294,5.1832560503
42035,2012,441,410,185,7,31,192,11.141005722,10.357851125,4.6736645319,0.1768413607,0.7831545972,4.8505058926
42035,2013,442,387,34,18,55,52,11.120336126,9.7365838931,0.8554104712,0.4528643671,1.3837522329,1.3082748384
42035,2014,425,421,-376,25,4,-351,10.725010725,10.624069448,-9.488480077,0.6308829838,0.1009412774,-8.857597093
42035,2015,434,395,-151,26,39,-125,11.01201426,10.022455375,-3.831369017,0.6597059234,0.9895588851,-3.171663093
42035,2016,407,400,-414,26,7,-388,10.389013682,10.210332857,-10.56769451,0.6636716357,0.178680825,-9.904022871
42035,2017,416,392,-35,26,24,-9,10.66899196,10.053473193,-0.897631535,0.6668119975,0.6155187669,-0.230819538
20029,2010,24,47,8,1,-23,9,NA,NA,NA,NA,NA,NA
20029,2011,129,131,-119,18,-2,-101,13.624841572,13.836079425,-12.5686523,1.9011406844,-0.211237854,-10.66751162
20029,2012,118,131,-10,17,-13,7,12.533857348,13.914706039,-1.062191301,1.8057252111,-1.380848691,0.7435339105
20029,2013,125,124,-71,9,1,-62,13.324805458,13.218207014,-7.5684895,0.959385993,0.1065984437,-6.609103507
20029,2014,94,121,-7,13,-27,6,10.065856401,12.957113027,-0.749585051,1.3920865235,-2.891256626,0.6425014724
20029,2015,111,161,-107,13,-50,-94,11.992221262,17.394122731,-11.56006914,1.404494382,-5.401901469,-10.15557476
20029,2016,131,130,-97,13,1,-84,14.328684714,14.219305442,-10.60978944,1.4219305442,0.1093792726,-9.187858901
20029,2017,124,136,-111,13,-12,-98,13.708473827,15.035100326,-12.27129512,1.4371787076,-1.326626499,-10.83411641
28027,2010,117,95,-67,3,22,-64,NA,NA,NA,NA,NA,NA
28027,2011,455,306,-417,2,149,-415,17.516168771,11.780104712,-16.05327995,0.0769941484,5.7360640591,-15.9762858
28027,2012,428,283,-382,-1,145,-383,16.634602305,10.999047786,-14.84677122,-0.038865893,5.6355545191,-14.88563711
28027,2013,439,318,-562,0,121,-562,17.285506162,12.521163917,-22.12859787,0,4.7643422451,-22.12859787
28027,2014,431,305,-471,-1,126,-472,17.232073246,12.19439058,-18.83133758,-0.039981608,5.037682666,-18.87131919
28027,2015,419,298,-487,-1,121,-488,16.990045212,12.083612108,-19.74737952,-0.040549034,4.9064331042,-19.78792855
28027,2016,404,302,-764,0,102,-764,16.728432124,12.504917082,-31.6349558,0,4.2235150411,-31.6349558
28027,2017,377,283,-762,0,94,-762,16.051432707,12.049218717,-32.44347937,0,4.0022139907,-32.44347937
40029,2010,13,33,-12,0,-20,-12,NA,NA,NA,NA,NA,NA
40029,2011,69,93,39,0,-24,39,11.691942726,15.758705414,6.6084893671,0,-4.066762687,6.6084893671
40029,2012,60,70,-17,0,-10,-17,10.178117048,11.87446989,-2.88379983,0,-1.696352841,-2.88379983
40029,2013,69,64,-146,0,5,-146,11.871988988,11.011699931,-25.12044047,0,0.8602890571,-25.12044047
40029,2014,62,81,-13,0,-19,-13,10.827803004,14.146000699,-2.270345791,0,-3.318197695,-2.270345791
40029,2015,72,89,-102,0,-17,-102,12.7422352,15.750818512,-18.05149987,0,-3.008583311,-18.05149987
40029,2016,80,89,59,0,-9,59,14.242478191,15.844756988,10.503827666,0,-1.602278797,10.503827666
40029,2017,80,76,-4,0,4,-4,14.179369018,13.470400567,-0.708968451,0,0.7089684509,-0.708968451
13067,2010,2322,934,-350,523,1388,173,NA,NA,NA,NA,NA,NA
13067,2011,9481,3741,-47,2238,5740,2191,13.670956895,5.3942674553,-0.067770802,3.2270437223,8.2766894396,3.1592729202
13067,2012,9488,3659,2078,2286,5829,4364,13.506222856,5.2086076548,2.9580450141,3.2541342167,8.2976152008,6.2121792308
13067,2013,9232,3841,1831,2506,5391,4337,12.959466573,5.3918231269,2.5702754869,3.5178101421,7.5676434462,6.0880856291
13067,2014,9307,3979,4581,2806,5328,7387,12.86292287,5.4992554099,6.3312613805,3.8780876301,7.3636674602,10.209349011
13067,2015,9748,4152,3425,3144,5596,6569,13.24522208,5.6415841275,4.6537634,4.2719509867,7.6036379522,8.9257143867
13067,2016,9432,4328,121,3228,5104,3349,12.63919598,5.7996649916,0.1621440536,4.3256281407,6.8395309883,4.4877721943
13067,2017,9514,4498,-2963,3227,5016,264,12.632856448,5.9725234708,-3.934323487,4.2848673278,6.6603329768,0.3505438409
04003,2010,397,266,198,98,131,296,NA,NA,NA,NA,NA,NA
04003,2011,1775,1215,436,166,560,602,13.409686704,9.1790249836,3.2938723398,1.2540890101,4.2306617208,4.5479613499
04003,2012,1688,1216,-2063,435,472,-1628,12.750304028,9.1850531389,-15.58286565,3.2857714765,3.5652508894,-12.29709417
04003,2013,1628,1269,-3188,265,359,-2923,12.467548381,9.7182548496,-24.41433921,2.0294228015,2.7492935311,-22.38491641
04003,2014,1681,1248,-3052,269,433,-2783,13.113040494,9.7353209614,-23.80785222,2.0983985085,3.3777195323,-21.70945371
04003,2015,1604,1250,-1690,352,354,-1338,12.67292939,9.8760359962,-13.35240067,2.7810917365,2.7968933941,-10.57130893
04003,2016,1543,1354,-1183,270,189,-913,12.273354571,10.770007835,-9.409836978,2.1476381946,1.5033467362,-7.262198784
04003,2017,1498,1292,-1039,231,206,-808,11.978681465,10.331412853,-8.30831111,1.8471798521,1.6472686127,-6.461131258
48079,2010,11,1,8,1,10,9,NA,NA,NA,NA,NA,NA
48079,2011,56,31,-106,9,25,-97,18.006430868,9.9678456592,-34.08360129,2.8938906752,8.038585209,-31.18971061
48079,2012,43,30,-75,7,13,-68,14.107611549,9.842519685,-24.60629921,2.2965879265,4.2650918635,-22.30971129
48079,2013,51,27,-48,4,24,-44,16.935082185,8.965631745,-15.93890088,1.32824174,7.96945044,-14.61065914
48079,2014,47,37,-90,10,10,-80,15.835579515,12.466307278,-30.32345013,3.3692722372,3.3692722372,-26.9541779
48079,2015,40,33,7,11,7,18,13.570822731,11.195928753,2.3748939779,3.7319762511,2.3748939779,6.106870229
48079,2016,37,18,-82,13,19,-69,12.602179837,6.1307901907,-27.92915531,4.4277929155,6.4713896458,-23.5013624
48079,2017,37,9,-101,13,28,-88,12.84276293,3.1239153072,-35.05727178,4.5123221104,9.7188476224,-30.54494967
47029,2010,97,106,3,11,-9,14,NA,NA,NA,NA,NA,NA
47029,2011,359,427,-168,-2,-68,-170,10.106697447,12.021057966,-4.729596577,-0.056304721,-1.914360519,-4.785901298
47029,2012,400,462,122,-2,-62,120,11.290504686,13.040532912,3.4436039291,-0.056452523,-1.750028226,3.3871514057
47029,2013,405,505,-20,-4,-100,-24,11.443910709,14.269567674,-0.565131393,-0.113026279,-2.825656965,-0.678157672
47029,2014,373,528,40,-3,-155,37,10.577659303,14.973201373,1.1343334373,-0.085075008,-4.39554207,1.0492584295
47029,2015,414,521,-18,-3,-107,-21,11.783289929,14.828729596,-0.512316953,-0.085386159,-3.045439668,-0.597703112
47029,2016,368,498,226,-2,-130,224,10.480150367,14.182377399,6.4361793017,-0.056957339,-3.702227032,6.3792219627
47029,2017,380,482,499,-2,-102,497,10.747214209,13.63199276,14.112789185,-0.056564285,-2.884778551,14.0562249
04005,2010,430,165,-101,25,265,-76,NA,NA,NA,NA,NA,NA
04005,2011,1801,719,-1599,61,1082,-1538,13.400646594,5.3498416997,-11.89763126,0.4538808674,8.0508048945,-11.4437504
04005,2012,1726,729,688,104,997,792,12.77652554,5.396342479,5.0928444795,0.7698485841,7.3801830611,5.8626930636
04005,2013,1682,741,-624,140,941,-484,12.347219673,5.439530189,-4.580657001,1.0277115067,6.9076894843,-3.552945495
04005,2014,1664,710,-359,184,954,-175,12.161209105,5.1889774426,-2.623722397,1.3447490837,6.9722316623,-1.278973313
04005,2015,1677,786,369,211,891,580,12.156975037,5.6979024325,2.6749694626,1.5295895843,6.4590726048,4.2045590469
04005,2016,1587,896,488,215,691,703,11.386097768,6.428445873,3.5012071273,1.5425400253,4.9576518954,5.0437471526
04005,2017,1615,888,-241,212,727,-29,11.500596393,6.3235477382,-1.716188069,1.5096758114,5.177048655,-0.206512257
46029,2010,93,71,-37,5,22,-32,NA,NA,NA,NA,NA,NA
46029,2011,371,243,69,13,128,82,13.580540659,8.8950711057,2.5257609312,0.4758680015,4.6854695536,3.0016289328
46029,2012,381,260,43,15,121,58,13.849005852,9.4507651485,1.5630111592,0.5452364509,4.3982407037,2.10824761
46029,2013,368,209,82,13,159,95,13.273458493,7.5384587639,2.9576728165,0.468899349,5.7349997295,3.4265721654
46029,2014,422,262,-69,9,160,-60,15.126532368,9.3913542189,-2.473295577,0.3226037709,5.735178149,-2.150691806
46029,2015,366,237,-197,10,129,-187,13.110526033,8.489602923,-7.056758548,0.3582110938,4.62092311,-6.698547454
46029,2016,371,233,-4,11,138,7,13.268955651,8.3333333333,-0.143061516,0.3934191702,4.9356223176,0.2503576538
46029,2017,367,228,-82,11,139,-71,13.076320103,8.1237084016,-2.921684601,0.3919333001,4.952611701,-2.529751301
01031,2010,168,77,117,42,91,159,NA,NA,NA,NA,NA,NA
01031,2011,679,508,-17,80,171,63,13.494042946,10.095690452,-0.337847909,1.5898725121,3.3983524946,1.2520246033
01031,2012,623,492,356,188,131,544,12.270180311,9.6900942421,7.0115316061,3.702718938,2.5800860685,10.714250544
01031,2013,616,519,-672,97,97,-575,12.106918239,10.200471698,-13.20754717,1.9064465409,1.9064465409,-11.30110063
01031,2014,617,467,-230,84,150,-146,12.181758951,9.2202292224,-4.541012251,1.6584566481,2.9615297288,-2.882555603
01031,2015,619,533,134,108,86,242,12.181921949,10.489441678,2.6371204219,2.1254403401,1.6924802708,4.762560762
01031,2016,654,480,-5,75,174,70,12.799561605,9.3941736552,-0.097855976,1.4678396336,3.40538795,1.3699836581
01031,2017,643,517,483,50,126,533,12.474415807,10.029973519,9.3703621073,0.9700167813,2.4444422889,10.340378889
13069,2010,123,40,254,6,83,260,NA,NA,NA,NA,NA,NA
13069,2011,594,396,42,51,198,93,13.850996852,9.2339979014,0.9793634138,1.1892270024,4.6169989507,2.1685904162
13069,2012,588,364,-137,58,224,-79,13.64110892,8.4444959981,-3.178285582,1.3455515601,5.1966129219,-1.832734022
13069,2013,577,388,-271,40,189,-231,13.369634478,8.990326131,-6.279325726,0.9268377455,4.3793083473,-5.35248798
13069,2014,639,360,-478,34,279,-444,14.840792438,8.3610098242,-11.10156304,0.7896509278,6.4797826137,-10.31191212
13069,2015,572,397,-88,40,175,-48,13.290580417,9.2244063386,-2.04470468,0.929411218,4.0661740787,-1.115293462
13069,2016,581,460,-247,43,121,-204,13.493740855,10.683512553,-5.73658174,0.9986761734,2.810228302,-4.737905567
13069,2017,560,408,-198,44,152,-154,13.018865731,9.4851736042,-4.603098955,1.0229108789,3.5336921271,-3.580188076
47031,2010,159,169,-17,3,-10,-14,NA,NA,NA,NA,NA,NA
47031,2011,637,636,137,6,1,143,12.05537524,12.036450004,2.5927573122,0.1135514151,0.0189252359,2.7063087274
47031,2012,632,653,251,10,-21,261,11.918569017,12.314597418,4.7334823154,0.1885849528,-0.396028401,4.9220672683
47031,2013,653,650,170,-17,3,153,12.26993865,12.213568335,3.1943178722,-0.319431787,0.0563703154,2.874886085
47031,2014,652,636,236,-19,16,217,12.207908928,11.90832834,4.4188136609,-0.355751947,0.2995805872,4.0630617136
47031,2015,727,655,517,-16,72,501,13.511127631,12.173024207,9.6083259769,-0.297356316,1.3381034242,9.3109696604
47031,2016,688,678,341,-15,10,326,12.6794567,12.495162271,6.2844400214,-0.276441643,0.1842944288,6.0079983782
47031,2017,692,645,574,-15,47,559,12.64365716,11.784911659,10.487657817,-0.274067713,0.8587455007,10.213590104
20031,2010,24,45,9,0,-21,9,NA,NA,NA,NA,NA,NA
20031,2011,90,105,-83,-2,-15,-85,10.544197762,12.301564056,-9.724093492,-0.234315506,-1.757366294,-9.958408998
20031,2012,87,96,-9,1,-9,-8,10.263064763,11.324761118,-1.061696355,0.1179662616,-1.061696355,-0.943730093
20031,2013,91,116,-67,2,-25,-65,10.803751632,13.771815268,-7.954410543,0.2374450908,-2.968063635,-7.716965452
20031,2014,92,84,11,1,8,12,10.968049595,10.014306152,1.3113972341,0.1192179304,0.953743443,1.4306151645
20031,2015,77,101,-82,1,-24,-81,9.2265292673,12.102330597,-9.825654544,0.1198250554,-2.87580133,-9.705829489
20031,2016,72,84,67,1,-12,68,8.6533261222,10.095547143,8.0524006971,0.120185085,-1.44222102,8.1725857821
20031,2017,78,81,-121,1,-3,-120,9.4134685011,9.7755249819,-14.60294473,0.1206854936,-0.362056481,-14.48225923
48081,2010,4,7,6,0,-3,6,NA,NA,NA,NA,NA,NA
48081,2011,29,56,-27,0,-27,-27,8.807896735,17.008352316,-8.200455581,0,-8.200455581,-8.200455581
48081,2012,29,55,-39,0,-26,-39,8.9686098655,17.009432503,-12.06123396,0,-8.040822638,-12.06123396
48081,2013,27,56,6,0,-29,6,8.4639498433,17.554858934,1.8808777429,0,-9.090909091,1.8808777429
48081,2014,28,44,52,0,-16,52,8.7582108226,13.762902721,16.265248671,0,-5.004691899,16.265248671
48081,2015,35,50,25,0,-15,25,10.869565217,15.527950311,7.7639751553,0,-4.658385093,7.7639751553
48081,2016,41,48,47,0,-7,47,12.638717633,14.796547472,14.488286067,0,-2.1578298400000002,14.488286067
48081,2017,43,49,49,0,-6,49,13.091794794,14.918556858,14.918556858,0,-1.826762064,14.918556858
01033,2010,162,129,59,7,33,66,NA,NA,NA,NA,NA,NA
01033,2011,604,671,55,29,-67,84,11.076573231,12.305265957,1.0086283571,0.5318222247,-1.228692726,1.5404505818
01033,2012,622,668,79,10,-46,89,11.402069604,12.245309478,1.4481728275,0.1833130161,-0.843239874,1.6314858437
01033,2013,590,723,96,3,-133,99,10.81606277,13.25425997,1.7599017388,0.0549969293,-2.438197201,1.8148986682
01033,2014,594,715,64,2,-121,66,10.900182587,13.120590151,1.1744304471,0.0367009515,-2.220407564,1.2111313986
01033,2015,604,743,43,2,-139,45,11.101002582,13.655703508,0.790303164,0.0367582867,-2.554700925,0.8270614507
01033,2016,648,736,54,3,-88,57,11.924368588,13.543727285,0.9936973823,0.0552054101,-1.619358697,1.0489027925
01033,2017,618,684,238,3,-66,241,11.357475626,12.570409917,4.3739145616,0.0551333768,-1.21293429,4.4290479385
29051,2010,233,119,49,17,114,66,NA,NA,NA,NA,NA,NA
29051,2011,941,614,-47,47,327,0,12.33063396,8.0457058993,-0.61587651,0.6158765102,4.2849280604,0
29051,2012,891,589,-395,94,302,-301,11.651018647,7.7019640662,-5.16515417,1.2291759291,3.9490545806,-3.935978241
29051,2013,971,655,-113,63,316,-50,12.67574377,8.550578959,-1.475138049,0.8224220984,4.1251648108,-0.652715951
29051,2014,916,637,-427,92,279,-335,11.942166538,8.3047599181,-5.566926978,1.1994315737,3.6374066203,-4.367495404
29051,2015,953,640,-222,97,313,-125,12.414350103,8.3370242034,-2.891905271,1.2635802308,4.0773258995,-1.62832504
29051,2016,898,662,-418,100,236,-318,11.69027286,8.6179962508,-5.441574672,1.3018121225,3.072276609,-4.139762549
29051,2017,896,671,-390,97,225,-293,11.67556016,8.7436393607,-5.081996052,1.2639836334,2.931920799,-3.818012418
48083,2010,18,46,8,0,-28,8,NA,NA,NA,NA,NA,NA
48083,2011,99,111,-118,-1,-12,-119,11.23786821,12.600034054,-13.3946308,-0.11351382,-1.362165844,-13.50814462
48083,2012,94,140,-36,6,-46,-30,10.796531327,16.079940275,-4.134841785,0.6891402975,-5.283408947,-3.445701487
48083,2013,96,104,-139,6,-8,-133,11.166686053,12.097243224,-16.16843085,0.6979178783,-0.930557171,-15.47051297
48083,2014,86,157,-46,7,-71,-39,10.152284264,18.533821273,-5.430291583,0.8263487192,-8.381537009,-4.603942864
48083,2015,78,149,-36,7,-71,-29,9.324009324,17.81124858,-4.303388919,0.8367700675,-8.487239256,-3.466618851
48083,2016,71,102,131,6,-31,137,8.4847036329,12.189292543,15.654875717,0.7170172084,-3.70458891,16.371892925
48083,2017,73,115,45,6,-42,51,8.664174233,13.6490416,5.3409293217,0.7121239096,-4.984867367,6.0530532313
17029,2010,114,146,23,7,-32,30,NA,NA,NA,NA,NA,NA
17029,2011,502,512,-273,19,-10,-254,9.3422289218,9.5283290996,-5.080534852,0.3535903377,-0.186100178,-4.726944514
17029,2012,510,486,-353,22,24,-331,9.5413599244,9.0923547515,-6.604117752,0.4115880752,0.4490051729,-6.192529676
17029,2013,499,525,-298,50,-26,-248,9.386050711,9.8751034535,-5.605296817,0.9404860432,-0.489052742,-4.664810774
17029,2014,492,483,-387,58,9,-329,9.3057565183,9.1355292649,-7.319771895,1.0970200774,0.1702272534,-6.222751818
17029,2015,531,541,-193,62,-10,-131,10.087194392,10.277160388,-3.666343724,1.1777891757,-0.189965996,-2.488554549
17029,2016,536,488,-266,60,48,-206,10.211274314,9.2968318378,-5.067535387,1.1430530948,0.9144424759,-3.924482292
17029,2017,515,484,-526,59,31,-467,9.8667509651,9.2728300332,-10.0774971,1.1303656445,0.5939209319,-8.947131458
31037,2010,41,7,-10,2,34,-8,NA,NA,NA,NA,NA,NA
31037,2011,182,80,-88,23,102,-65,17.236480727,7.576475045,-8.334122549,2.1782365754,9.6600056824,-6.155885974
31037,2012,166,86,-127,34,80,-93,15.700368864,8.133926038,-12.01172799,3.2157382011,7.5664428261,-8.795989785
31037,2013,163,100,-248,72,63,-176,15.502401446,9.5106757335,-23.58647582,6.8476865281,5.9917257121,-16.73878929
31037,2014,184,86,6,102,98,108,17.418469257,8.1412410659,0.5679935627,9.6558905666,9.2772281914,10.223884129
31037,2015,191,82,-178,108,109,-70,17.873017358,7.6732325832,-16.65652927,10.106208768,10.199784775,-6.550320498
31037,2016,202,68,-298,116,134,-182,18.908546288,6.365253206,-27.89478611,10.858373116,12.543293082,-17.03641299
31037,2017,195,72,-314,117,123,-197,18.358124647,6.778384485,-29.56128789,11.014874788,11.579740162,-18.5464131
35007,2010,30,24,-24,2,6,-22,NA,NA,NA,NA,NA,NA
35007,2011,135,130,-145,16,5,-129,9.8741954359,9.5084844939,-10.60561732,1.1702750146,0.3657109421,-9.435342305
35007,2012,139,168,-357,8,-29,-349,10.353817505,12.51396648,-26.59217877,0.5959031657,-2.160148976,-25.99627561
35007,2013,127,151,-172,11,-24,-161,9.6599984787,11.485510002,-13.08283259,0.8366927816,-1.825511524,-12.2461398
35007,2014,138,166,-349,5,-28,-344,10.719279167,12.894205375,-27.10890166,0.38837968,-2.174926208,-26.72052198
35007,2015,133,138,-274,8,-5,-266,10.590015129,10.988135998,-21.81702365,0.6369933912,-0.398120869,-21.18003026
35007,2016,114,153,-132,8,-39,-124,9.2356300887,12.395187751,-10.69388747,0.6481143922,-3.159557662,-10.04577308
35007,2017,117,148,-62,8,-31,-54,9.5760353577,12.113275495,-5.074480275,0.6547716484,-2.537240138,-4.419708627
45029,2010,112,95,-10,-1,17,-11,NA,NA,NA,NA,NA,NA
45029,2011,471,464,-443,-8,7,-451,12.178409825,11.99741435,-11.45442793,-0.206851972,0.1809954751,-11.6612799
45029,2012,441,445,-327,-6,-4,-333,11.517969076,11.622440451,-8.540534893,-0.156707062,-0.104471375,-8.697241956
45029,2013,449,499,-383,-9,-50,-392,11.84649684,13.165705843,-10.10514096,-0.23745762,-1.319209002,-10.34259858
45029,2014,438,523,-31,-13,-85,-44,11.644290841,13.904027649,-0.824139306,-0.345606806,-2.259736807,-1.169746112
45029,2015,457,528,-1,-5,-71,-6,12.184229821,14.077184563,-0.026661334,-0.133306672,-1.892954742,-0.159968006
45029,2016,479,531,189,-4,-52,185,12.762102683,14.147550156,5.0355686995,-0.106572883,-1.385447473,4.928995817
45029,2017,464,580,132,-4,-116,128,12.338784736,15.42348092,3.5101715197,-0.106368834,-3.084696184,3.4038026858
12021,2010,785,749,572,499,36,1071,NA,NA,NA,NA,NA,NA
12021,2011,3284,2856,2717,1909,428,4626,10.100450891,8.7840705678,8.3565545283,5.87142532,1.3163803232,14.227979848
12021,2012,3192,2968,2752,1916,224,4668,9.6694601672,8.990901559,8.3365771868,5.8040995239,0.6785586082,14.140676711
12021,2013,3139,2930,4644,2031,209,6675,9.3417197514,8.7197320394,13.820626481,6.0442920723,0.621987712,19.864918554
12021,2014,3242,2977,6065,2271,265,8336,9.4285435925,8.6578575801,17.638530811,6.6046337133,0.7706860123,24.243164524
12021,2015,3253,3132,6220,2569,121,8789,9.2230050609,8.8799421613,17.635134177,7.2837073475,0.3430628996,24.918841525
12021,2016,3298,3327,6271,2658,-29,8929,9.1194529434,9.1996421901,17.340233295,7.3497592249,-0.080189247,24.68999252
12021,2017,3304,3583,4395,2665,-279,7060,8.9421157685,9.697215738,11.894854359,7.2126932576,-0.75509997,19.107547617
48085,2010,2621,744,3471,660,1877,4131,NA,NA,NA,NA,NA,NA
48085,2011,10564,3265,14718,3230,7299,17948,13.184991775,4.0750660872,18.369624095,4.0313823772,9.1099256878,22.401006473
48085,2012,10348,3307,12155,3404,7041,15559,12.537141646,4.0066029592,14.72641638,4.1241235177,8.5305386864,18.850539898
48085,2013,10436,3532,10340,4011,6904,14351,12.314598097,4.1677999692,12.201317011,4.7330253897,8.1467981278,16.9343424
48085,2014,10772,3702,15557,4645,7070,20202,12.355038761,4.2460409854,17.843235983,5.3276230084,8.108997776,23.170858992
48085,2015,10796,3922,16802,5103,6874,21905,11.994156237,4.3572694297,18.666711106,5.6693385772,7.6368868077,24.336049683
48085,2016,11219,4291,15741,5199,6928,20940,12.082727752,4.6213552709,16.952867238,5.5992603247,7.4613724811,22.552127563
48085,2017,11158,4529,15342,5163,6629,20505,11.671206283,4.7373089491,16.04764714,5.4004694423,6.9338973336,21.448116582
48087,2010,14,15,-3,1,-1,-2,NA,NA,NA,NA,NA,NA
48087,2011,52,48,18,4,4,22,16.95191524,15.64792176,5.8679706601,1.30399348,1.30399348,7.1719641402
48087,2012,54,40,-79,3,14,-76,17.704918033,13.114754098,-25.90163934,0.9836065574,4.5901639344,-24.91803279
48087,2013,44,42,67,5,2,72,14.393195944,13.738959764,21.916912005,1.6355904482,0.6542361793,23.552502453
48087,2014,27,31,-87,5,-4,-82,8.8452088452,10.155610156,-28.5012285,1.638001638,-1.31040131,-26.86322686
48087,2015,32,40,3,6,-8,9,10.631229236,13.289036545,0.9966777409,1.9933554817,-2.657807309,2.9900332226
48087,2016,33,26,3,7,7,10,10.930771779,8.6121232196,0.9937065253,2.3186485591,2.3186485591,3.3123550845
48087,2017,30,28,-50,8,2,-42,9.9750623441,9.3100581879,-16.62510391,2.6600166251,0.6650041563,-13.96508728
51570,2010,40,61,-56,3,-21,-53,NA,NA,NA,NA,NA,NA
51570,2011,174,219,-59,51,-45,-8,10.050251256,12.649454167,-3.407843817,2.9457632993,-2.599202911,-0.462080518
51570,2012,187,220,77,51,-33,128,10.788669013,12.69255178,4.4423931229,2.9423642762,-1.903882767,7.3847573992
51570,2013,216,202,56,41,14,97,12.389583572,11.586555007,3.2121142595,2.3517265114,0.8030285649,5.5638407709
51570,2014,227,234,-75,48,-7,-27,12.993703492,13.394390384,-4.293073841,2.7475672582,-0.400686892,-1.545506583
51570,2015,231,258,10,61,-27,71,13.219640609,14.764793407,0.5722788142,3.4909007669,-1.545152798,4.0631795811
51570,2016,314,223,6,51,91,57,17.872388867,12.692811202,0.3415106153,2.90284023,5.1795776652,3.2443508452
51570,2017,300,190,29,51,110,80,16.914749662,10.712674786,1.6350924673,2.8755074425,6.202074876,4.5105999098
48089,2010,67,83,10,6,-16,16,NA,NA,NA,NA,NA,NA
48089,2011,255,247,-140,45,8,-95,12.24342816,11.85932061,-6.721882127,2.1606049694,0.3841075501,-4.561277158
48089,2012,229,280,-67,34,-51,-33,11.040667261,13.499505822,-3.230238893,1.6392257069,-2.45883856,-1.591013186
48089,2013,254,297,17,39,-43,56,12.268753321,14.345746993,0.8211370333,1.8837849587,-2.076993672,2.704921992
48089,2014,264,260,-80,55,4,-25,12.755163667,12.561903612,-3.865201111,2.657325764,0.1932600556,-1.207875347
48089,2015,250,252,168,59,-2,227,12.020097603,12.116258384,8.0775055893,2.8367430344,-0.096160781,10.914248624
48089,2016,270,252,40,60,18,100,12.876457543,12.018027041,1.9076233398,2.8614350097,0.8584305029,4.7690583494
48089,2017,262,265,149,60,-3,209,12.399725502,12.541707092,7.0517522895,2.8396317944,-0.14198159,9.8913840839
13071,2010,188,72,23,18,116,41,NA,NA,NA,NA,NA,NA
13071,2011,764,446,-190,74,318,-116,16.699271046,9.7485273385,-4.152960077,1.6174686615,6.9507437077,-2.535491415
13071,2012,726,458,-40,51,268,11,15.78621207,9.9587949423,-0.86976375,1.1089487818,5.8274171278,0.2391850314
13071,2013,692,499,-111,49,193,-62,14.981759924,10.803321101,-2.403143572,1.0608471622,4.1784388227000004,-1.342296409
13071,2014,623,464,-443,58,159,-385,13.50223773,10.056241263,-9.601109654,1.2570301579,3.4459964673,-8.344079496
13071,2015,658,457,-644,74,201,-570,14.352084106,9.9679368334,-14.04672061,1.61406417,4.3841472724,-12.43265644
13071,2016,644,494,-227,82,150,-145,14.10177805,10.817202417,-4.970657791,1.7955680126,3.2845756328,-3.175089778
13071,2017,622,444,-95,82,178,-13,13.594736957,9.7042816864,-2.076366577,1.7922322034,3.8904552707,-0.284134374
05027,2010,72,117,181,7,-45,188,NA,NA,NA,NA,NA,NA
05027,2011,287,310,-40,24,-23,-16,11.61849243,12.549591126,-1.619302081,0.9715812485,-0.931098696,-0.647720832
05027,2012,298,317,-333,38,-19,-295,12.149627969,12.924268678,-13.5765977,1.5492814188,-0.774640709,-12.02731628
05027,2013,286,313,-128,31,-27,-97,11.764705882,12.875359934,-5.265322912,1.2751953928,-1.110654052,-3.99012752
05027,2014,306,285,-293,38,21,-255,12.681046808,11.81077889,-12.14230953,1.5747705186,0.8702679182,-10.56753901
05027,2015,312,279,7,39,33,46,12.972163898,11.600108101,0.2910421387,1.6215204873,1.3720557969,1.912562626
05027,2016,281,320,-107,41,-39,-66,11.690797138,13.313363288,-4.45165585,1.7057746713,-1.622566151,-2.745881178
05027,2017,282,289,-392,41,-7,-351,11.846250788,12.140306658,-16.46712875,1.7223272422,-0.294055871,-14.74480151
12023,2010,194,210,45,4,-16,49,NA,NA,NA,NA,NA,NA
12023,2011,769,745,-295,30,24,-265,11.403996589,11.048085122,-4.374745115,0.4448893338,0.355911467,-3.929855782
12023,2012,783,729,494,20,54,514,11.583268612,10.784422501,7.3079625726,0.2958689301,0.7988461112,7.6038315026
12023,2013,779,768,-488,21,11,-467,11.513875032,11.351291431,-7.212799764,0.3103868751,0.1625836012,-6.902412888
12023,2014,830,801,361,39,29,400,12.270845653,11.842105263,5.3370786517,0.5765819042,0.4287403903,5.9136605559
12023,2015,853,749,262,40,104,302,12.534348229,11.006127577,3.8499404876,0.5877771737,1.5282206516,4.4377176612
12023,2016,807,796,967,42,11,1009,11.735706651,11.575740389,14.062488639,0.6107802718,0.1599662617,14.673268911
12023,2017,807,809,302,42,-2,344,11.621041718,11.649842317,4.3488904569,0.6048125801,-0.028800599,4.953703037
13073,2010,406,136,555,86,270,641,NA,NA,NA,NA,NA,NA
13073,2011,1611,771,2814,200,840,3014,12.689135863,6.0728266606,22.164635827,1.5753117148,6.6163092022,23.739947542
13073,2012,1718,776,2456,321,942,2777,13.134857833,5.9328577873,18.777189079,2.454184729,7.2020000459,21.231373808
13073,2013,1500,854,2726,197,646,2923,11.153535857,6.3500797478,20.269692497,1.4648310425,4.803456109,21.73452354
13073,2014,1723,818,1869,199,905,2068,12.504626639,5.9366132275,13.564217753,1.4442372033,6.5680134118,15.008454956
13073,2015,1721,885,3568,277,836,3845,12.150007766,6.2479702921,25.189557065,1.9555794022,5.9020374737,27.145136467
13073,2016,1899,914,2239,221,985,2460,13.031037062,6.2719156791,15.364134798,1.5165135285,6.7591213828,16.880648327
13073,2017,1826,954,3100,154,872,3254,12.212821456,6.3806307059,20.733705648,1.0299969903,5.8321907501,21.763702639
36021,2010,153,139,-49,14,14,-35,NA,NA,NA,NA,NA,NA
36021,2011,573,700,-433,57,-127,-376,9.1258749612,11.148538347,-6.896167292,0.9078095511,-2.022663386,-5.988357741
36021,2012,534,644,0,54,-110,54,8.5432481942,10.303093328,0,0.8639239747,-1.759845134,0.8639239747
36021,2013,563,668,-235,93,-105,-142,9.0298160355,10.713884746,-3.76910616,1.4916037146,-1.68406871,-2.277502446
36021,2014,513,673,-137,101,-160,-36,8.2580105117,10.833608332,-2.205355634,1.6258461241,-2.57559782,-0.57950951
36021,2015,501,702,-375,109,-201,-266,8.1089611304,11.362256913,-6.069581684,1.7642250763,-3.253295783,-4.305356608
36021,2016,505,655,-500,111,-150,-389,8.2409288588,10.68872951,-8.159335504,1.8113724818,-2.447800651,-6.347963022
36021,2017,505,653,-367,111,-148,-256,8.3049648889,10.738895193,-6.035489335,1.8254477280999999,-2.433930304,-4.210041607
41009,2010,126,74,-59,5,52,-54,NA,NA,NA,NA,NA,NA
41009,2011,498,390,-97,9,108,-88,10.088630033,7.9007343631,-1.965054444,0.1823246391,2.1878956698,-1.782729805
41009,2012,444,424,-216,2,20,-214,9.0102887757,8.6044199119,-4.383383729,0.0405868864,0.4058688638,-4.342796842
41009,2013,478,364,-61,3,114,-58,9.7134728714,7.3968705548,-1.23958545,0.0609632189,2.3166023166,-1.178622231
41009,2014,509,440,161,16,69,177,10.312306897,8.9143713849,3.2618495295,0.3241589594,1.3979355126,3.5860084889
41009,2015,537,458,74,20,79,94,10.834585935,9.2406710583,1.4930341885,0.4035227536,1.5939148769,1.8965569421
41009,2016,506,464,1180,17,42,1197,10.066246245,9.2307080192,23.474645394,0.3381940438,0.8355382259,23.812839437
41009,2017,552,472,797,17,80,814,10.753107103,9.1946857833,15.525772393,0.3311645303,1.5584213192,15.856936923
42037,2010,181,145,15,12,36,27,NA,NA,NA,NA,NA,NA
42037,2011,614,680,-264,39,-66,-225,9.1365648599,10.11867118,-3.928425282,0.580335553,-0.98210632,-3.348089729
42037,2012,626,677,10,29,-51,39,9.3370820873,10.097770884,0.1491546659,0.4325485312,-0.760688796,0.5817031971
42037,2013,606,647,178,26,-41,204,9.0295471816,9.6404571395,2.6522432316,0.3874063147,-0.610909958,3.0396495463
42037,2014,625,691,-34,28,-66,-6,9.3074511731,10.290318017,-0.506325344,0.4169738126,-0.982866844,-0.089351531
42037,2015,594,722,-318,30,-128,-288,8.8791892134,10.792549852,-4.753505336,0.4484438997,-1.913360639,-4.305061437
42037,2016,572,716,-425,33,-144,-392,8.6118638964,10.779885577,-6.398675098,0.4968383017,-2.16802168,-5.901836796
42037,2017,564,702,-113,33,-138,-80,8.5400199873,10.629599346,-1.711032373,0.4996820205,-2.089579359,-1.211350353
53013,2010,6,22,29,1,-16,30,NA,NA,NA,NA,NA,NA
53013,2011,41,63,-71,1,-22,-70,10.125957026,15.559397382,-17.53519388,0.2469745616,-5.433440356,-17.28821931
53013,2012,26,46,-8,1,-20,-7,6.5154742513,11.527377522,-2.004761308,0.2505951635,-5.01190327,-1.754166145
53013,2013,34,44,26,9,-10,35,8.5223712245,11.028950996,6.5171074069,2.2559217947,-2.506579772,8.7730292017
53013,2014,39,51,-25,19,-12,-6,9.7683155917,12.773951158,-6.261740764,4.7589229806,-3.005635567,-1.502817783
53013,2015,35,72,0,20,-37,20,8.806139137,18.115486225,0,5.0320795069,-9.309347088,5.0320795069
53013,2016,36,36,13,20,0,33,9.0418184101,9.0418184101,3.2651010926,5.0232324501,0,8.2883335426
53013,2017,35,45,39,20,-10,59,8.7021382397,11.188463451,9.6966683242,4.9726504227,-2.486325211,14.669318747
55021,2010,138,152,20,0,-14,20,NA,NA,NA,NA,NA,NA
55021,2011,627,512,-265,9,115,-256,11.048068791,9.021708486,-4.669438963,0.1585847195,2.0263603045,-4.510854243
55021,2012,580,514,-312,10,66,-302,10.254053003,9.0872124887,-5.515973339,0.1767940173,1.1668405141,-5.339179322
55021,2013,626,510,-32,22,116,-10,11.080136289,9.026948095,-0.566396743,0.389397761,2.0531881942,-0.176998982
55021,2014,613,552,-8,23,61,15,10.833834082,9.7557527129,-0.14138772,0.4064896964,1.0780813686,0.2651019759
55021,2015,568,562,6,27,6,33,10.029930868,9.9239808937,0.105949974,0.4767748828,0.105949974,0.5827248567
55021,2016,622,524,121,27,98,148,10.956587604,9.2303085283,2.131426206,0.4756075005,1.7262790759,2.6070337065
55021,2017,615,515,229,27,100,256,10.776145294,9.023926547,4.0125809306,0.4730990617,1.752218747,4.4856799923
39029,2010,287,242,-7,8,45,1,NA,NA,NA,NA,NA,NA
39029,2011,1109,1174,-414,-7,-65,-421,10.303722905,10.907638134,-3.846475458,-0.065037025,-0.603915229,-3.911512482
39029,2012,1106,1157,-754,-1,-51,-755,10.337849522,10.814549635,-7.047684032,-0.009347061,-0.476700114,-7.057031093
39029,2013,1079,1223,-516,-14,-144,-530,10.155628656,11.51096742,-4.856630571,-0.131769047,-1.355338764,-4.988399618
39029,2014,1105,1230,-205,-9,-125,-214,10.450902041,11.633130778,-1.93885513,-0.085120469,-1.182228738,-2.023975599
39029,2015,1066,1338,-646,-7,-272,-653,10.143252026,12.731398884,-6.146848788,-0.066606721,-2.588146858,-6.213455509
39029,2016,1095,1244,-732,-7,-149,-739,10.509847583,11.939954697,-7.025761124,-0.06718624,-1.430107114,-7.092947364
39029,2017,1057,1187,-528,-7,-130,-535,10.221399181,11.478524908,-5.105864492,-0.067691385,-1.257125727,-5.173555877
37047,2010,143,158,-122,2,-15,-120,NA,NA,NA,NA,NA,NA
37047,2011,650,674,-270,15,-24,-255,11.239355034,11.654346604,-4.668655168,0.2593697316,-0.41499157,-4.409285436
37047,2012,654,589,-239,18,65,-221,11.351506157,10.223298359,-4.14833329,0.312426775,1.1282077985,-3.835906515
37047,2013,633,744,-351,15,-111,-336,11.045000087,12.98180105,-6.124478721,0.2617298599,-1.936800963,-5.862748861
37047,2014,617,731,-87,19,-114,-68,10.82551101,12.825686464,-1.526449689,0.3333625757,-2.000175454,-1.193087113
37047,2015,605,680,-155,21,-75,-134,10.652533718,11.97309575,-2.729161531,0.3697573687,-1.320562031,-2.359404162
37047,2016,608,682,-297,22,-74,-275,10.759062475,12.068553632,-5.255660452,0.3893081817,-1.309491157,-4.866352271
37047,2017,591,724,-286,22,-133,-264,10.528097193,12.897364413,-5.094815224,0.3919088634,-2.369267219,-4.702906361
06011,2010,70,13,-30,6,57,-24,NA,NA,NA,NA,NA,NA
06011,2011,336,177,-256,6,159,-250,15.693967631,8.2673579486,-11.95730867,0.280249422,7.4266096826,-11.67705925
06011,2012,301,144,-166,-8,157,-174,14.093079876,6.7422043262,-7.772263321,-0.374566907,7.3508755501,-8.146830228
06011,2013,314,124,-210,4,190,-206,14.712083587,5.8098674038,-9.839291571,0.1874150775,8.9022161833,-9.651876493
06011,2014,308,142,-240,2,166,-238,14.458736269,6.6660407473,-11.26654774,0.0938878978,7.7926955215,-11.17265984
06011,2015,275,140,-68,7,135,-61,12.908071065,6.571381633,-3.191813936,0.3285690816,6.3366894318,-2.863244854
06011,2016,307,130,115,13,177,128,14.283720281,6.0484809008,5.3505792584,0.6048480901,8.2352393803,5.9554273484
06011,2017,301,115,-41,16,186,-25,13.855005754,5.2934407365,-1.887226697,0.7364787112,8.5615650173,-1.150747986
48091,2010,313,186,588,20,127,608,NA,NA,NA,NA,NA,NA
48091,2011,1255,990,2414,59,265,2473,11.342582132,8.9475349089,21.817524515,0.5332369289,2.3950472231,22.350761444
48091,2012,1280,1022,2388,73,258,2461,11.285139323,9.0104784282,21.053838049,0.643605602,2.2746608948000002,21.697443651
48091,2013,1349,1059,3313,102,290,3415,11.560346896,9.0751722483,28.390977959,0.8740959106,2.4851746478,29.26507387
48091,2014,1380,1019,3975,108,361,4083,11.419303588,8.4320799682,32.892559248,0.8936846286,2.9872236198,33.786243877
48091,2015,1524,1026,4826,125,498,4951,12.106143232,8.1501987902,38.336120235,0.9929579423,3.955944442,39.329078178
48091,2016,1585,1155,4927,126,430,5053,12.062634373,8.7901215777,37.496908236,0.9589223539,3.2725127951,38.45583059
48091,2017,1627,1120,6203,127,507,6330,11.826233595,8.1409844049,45.087969878,0.9231294816,3.6852491904,46.01109936
20033,2010,5,15,4,0,-10,4,NA,NA,NA,NA,NA,NA
20033,2011,27,34,4,0,-7,4,14.350252458,18.070688281,2.1259633271,0,-3.720435822,2.1259633271
20033,2012,27,31,34,0,-4,34,14.248021108,16.35883905,17.941952507,0,-2.110817942,17.941952507
20033,2013,21,31,23,0,-10,23,10.957474563,16.175319593,12.001043569,0,-5.21784503,12.001043569
20033,2014,22,30,32,0,-8,32,11.369509044,15.503875969,16.5374677,0,-4.134366925,16.5374677
20033,2015,21,38,-107,0,-17,-107,11.134676564,20.148462354,-56.73382821,0,-9.01378579,-56.73382821
20033,2016,23,25,27,0,-2,27,12.513601741,13.601741023,14.689880305,0,-1.088139282,14.689880305
20033,2017,22,16,-66,0,6,-66,12.084592145,8.7887942873,-36.25377644,0,3.2957978577000002,-36.25377644
40031,2010,501,187,759,161,314,920,NA,NA,NA,NA,NA,NA
40031,2011,2192,950,-925,252,1242,-673,17.439593925,7.55821817,-7.359317692,2.0049168198,9.8813757548,-5.354400872
40031,2012,1993,963,-1585,852,1030,-733,15.800531177,7.6346771316,-12.56590161,6.754667618,8.1658540453,-5.811233995
40031,2013,1994,994,-3299,403,1000,-2896,15.903652895,7.9278991865,-26.31201149,3.2142287446,7.9757537087,-23.09778274
40031,2014,1864,995,-1195,312,869,-883,14.976759508,7.9945685143,-9.601516959,2.5068395743,6.9821909939,-7.094677385
40031,2015,1909,1014,-2358,468,895,-1890,15.398948935,8.1794312311,-19.02080754,3.7751221066,7.219517704,-15.24568543
40031,2016,1752,1100,-3024,279,652,-2745,14.308757172,8.9838087265,-24.6973069,2.278620577,5.3249484452,-22.41868632
40031,2017,1699,1064,-683,180,635,-503,13.987913915,8.7599413808,-5.62315786,1.4819449704,5.2279725346,-4.14121289
48093,2010,29,39,-2,2,-10,0,NA,NA,NA,NA,NA,NA
48093,2011,184,161,-133,10,23,-123,13.235505683,11.581067472,-9.566968781,0.719320961,1.6544382103,-8.84764782
48093,2012,160,140,-164,-4,20,-168,11.61018794,10.158914447,-11.90044264,-0.290254698,1.4512734925,-12.19069734
48093,2013,154,174,-155,8,-20,-147,11.303167089,12.771110866,-11.37656428,0.5871775111,-1.467943778,-10.78938677
48093,2014,137,206,-22,10,-69,-12,10.149275845,15.260954921,-1.62981072,0.7408230544,-5.111679075,-0.888987665
48093,2015,140,167,-74,13,-27,-61,10.438024231,12.451071761,-5.517241379,0.9692451072,-2.01304753,-4.547996272
48093,2016,177,174,137,13,3,150,13.165234854,12.942095281,10.190040537,0.9669381531,0.2231395738,11.15697869
48093,2017,166,174,49,14,-8,63,12.253635491,12.844172141,3.6170369824,1.0334391378,-0.59053665,4.6504761202
48095,2010,6,2,10,0,4,10,NA,NA,NA,NA,NA,NA
48095,2011,32,34,3,15,-2,18,7.7877829156,8.2745193478,0.7301046483,3.6505232417,-0.486736432,4.38062789
48095,2012,31,29,-93,29,2,-64,7.5868820362,7.0974057758,-22.76064611,7.0974057758,0.4894762604,-15.66324033
48095,2013,16,37,33,24,-21,57,3.9268621917,9.0808688183,8.0991532703,5.8902932875,-5.154006627,13.989446558
48095,2014,24,34,-52,33,-10,-19,5.8830739061,8.3343547003,-12.74666013,8.0892266209,-2.451280794,-4.657433509
48095,2015,32,33,30,45,-1,75,7.8001218769,8.0438756856,7.3126142596,10.968921389,-0.243753809,18.281535649
48095,2016,24,22,84,47,2,131,5.7054558421,5.2300011886,19.969095448,11.173184358,0.4754546535,31.142279805
48095,2017,28,26,-1624,47,2,-1577,8.0114449213,7.4391988555,-464.6638054,13.447782546,0.5722460658,-451.2160229
22029,2010,69,32,-19,0,37,-19,NA,NA,NA,NA,NA,NA
22029,2011,247,243,-1,-6,4,-7,11.853913711,11.661947497,-0.047991553,-0.287949321,0.1919662139,-0.335940874
22029,2012,299,211,-433,-3,88,-436,14.468908783,10.210500847,-20.95330269,-0.145172998,4.2584079361,-21.09847568
22029,2013,257,254,5,-4,3,1,12.539337903,12.392964309,0.2439559903,-0.195164792,0.1463735942,0.0487911981
22029,2014,252,270,0,-1,-18,-1,12.301684159,13.180375885,0,-0.048816207,-0.878691726,-0.048816207
22029,2015,267,252,-264,-1,15,-265,13.12007076,12.382988133,-12.97265423,-0.049138842,0.737082627,-13.02179308
22029,2016,272,245,-260,0,27,-260,13.525272867,12.182690634,-12.92856965,0,1.3425822332,-12.92856965
22029,2017,255,244,-140,0,11,-140,12.794781736,12.242849975,-7.024586051,0,0.5519317612,-7.024586051
01035,2010,34,13,-20,0,21,-20,NA,NA,NA,NA,NA,NA
01035,2011,158,189,-10,0,-31,-10,11.962447002,14.309509388,-0.757116899,0,-2.347062386,-0.757116899
01035,2012,145,170,-126,1,-25,-125,11.056885771,12.963245387,-9.608052463,0.0762543846,-1.906359616,-9.531798078
01035,2013,151,192,-94,2,-41,-92,11.638213419,14.798258122,-7.244980539,0.1541485221,-3.160044703,-7.090832017
01035,2014,131,171,-195,1,-40,-194,10.24037522,13.367207348,-15.24330662,0.0781708032,-3.126832128,-15.16513582
01035,2015,154,171,19,2,-17,21,12.147505423,13.488463814,1.4987182015,0.1577598107,-1.340958391,1.6564780122
01035,2016,134,149,-150,2,-15,-148,10.6378756,11.828682571,-11.9080697,0.1587742627,-1.19080697,-11.74929544
01035,2017,148,166,-28,2,-18,-26,11.847582453,13.288504643,-2.241434518,0.1601024656,-1.44092219,-2.081332053
08021,2010,41,5,19,1,36,20,NA,NA,NA,NA,NA,NA
08021,2011,104,87,-53,3,17,-50,12.536917606,10.487613766,-6.389006088,0.361641854,2.0493038394,-6.027364234
08021,2012,124,82,-86,4,42,-82,15.013924204,9.92856278,-10.41288292,0.4843201356,5.0853614239,-9.92856278
08021,2013,107,101,-57,3,6,-54,13.024161646,12.293834824,-6.938104802,0.3651634106,0.7303268213,-6.572941391
08021,2014,126,72,-25,4,54,-21,15.350877193,8.7719298246,-3.045808967,0.4873294347,6.5789473684,-2.558479532
08021,2015,115,93,-192,4,22,-188,14.123426466,11.421553577,-23.57998158,0.4912496162,2.7018728892,-23.08873196
08021,2016,99,64,-29,4,35,-25,12.272980847,7.9340482241,-3.595115602,0.495878014,4.3389326226,-3.099237588
08021,2017,105,68,72,4,37,76,12.918307087,8.3661417323,8.8582677165,0.4921259843,4.5521653543,9.3503937008
06013,2010,3011,1736,1566,757,1275,2323,NA,NA,NA,NA,NA,NA
06013,2011,12334,7271,4724,3673,5063,8397,11.641444638,6.8627326059,4.4587469166,3.4667606741,4.7787120319,7.9255075907
06013,2012,11941,6989,4599,3462,4952,8061,11.132372307,6.5157147685,4.2875622007,3.2275582385,4.6166575381,7.5151204391
06013,2013,12242,7258,7447,3788,4984,11235,11.260102198,6.6758553957,6.8496962155,3.4841747367,4.5842468025,10.333870952
06013,2014,12246,7266,6479,4273,4980,10752,11.101033821,6.5866496607,5.8732319229,3.8734866502,4.5143841605,9.746718573
06013,2015,12575,7637,5427,4775,4938,10202,11.242745859,6.8279006061,4.8520383121,4.2691142326,4.4148452524,9.1211525446
06013,2016,12667,8314,3456,4826,4353,8282,11.186608922,7.3423436153,3.0520976106,4.2619858417,3.8442653064,7.3140834523
06013,2017,12626,8345,-214,4776,4281,4562,11.045963315,7.3006941127,-0.187219717,4.1783241561,3.7452692027,3.9911044389
56009,2010,57,39,-29,-2,18,-31,NA,NA,NA,NA,NA,NA
56009,2011,165,99,-150,-2,66,-152,11.97517872,7.1851072323,-10.88652611,-0.145153681,4.7900714882,-11.03167979
56009,2012,194,132,217,4,62,221,13.976441771,9.5097438853,15.633442599,0.2881740571,4.4666978855,15.921616656
56009,2013,177,127,275,11,50,286,12.469179288,8.9468122578,19.373018669,0.7749207467,3.5223670306,20.147939415
56009,2014,199,118,-242,11,81,-231,13.923873496,8.2563671984,-16.93254968,0.769661349,5.6675062972,-16.16288833
56009,2015,218,132,-5,13,86,8,15.281623497,9.2530931268,-0.350495952,0.9112894746,6.0285303705,0.5607935228
56009,2016,181,118,-264,14,63,-250,12.72899891,8.2984633778,-18.56605366,0.9845634516,4.4305355322,-17.58149021
56009,2017,191,119,-407,14,72,-393,13.674112257,8.5194730813,-29.13802978,1.0022909507,5.1546391753,-28.13573883
05029,2010,56,76,-28,0,-20,-28,NA,NA,NA,NA,NA,NA
05029,2011,271,254,-121,2,17,-119,12.803552868,12.000377965,-5.716715487,0.0944911651,0.8031749031,-5.622224322
05029,2012,268,256,3,1,12,4,12.688793144,12.120638227,0.1420387292,0.0473462431,0.5681549169,0.1893849723
05029,2013,270,258,-62,-2,12,-64,12.796815015,12.228067681,-2.938527892,-0.094791222,0.568747334,-3.033319115
05029,2014,255,266,-79,-3,-11,-82,12.128995434,12.652207002,-3.75761035,-0.142694064,-0.523211568,-3.900304414
05029,2015,251,264,-50,-1,-13,-51,11.984053093,12.604741101,-2.387261572,-0.047745231,-0.620688009,-2.435006804
05029,2016,235,215,-35,-1,20,-36,11.242136484,10.285358911,-1.674360753,-0.047838879,0.9567775731,-1.722199632
05029,2017,235,208,-5,-1,27,-6,11.241060965,9.9495348114,-0.23917151,-0.047834302,1.2915261534,-0.287005812
13075,2010,55,77,0,2,-22,2,NA,NA,NA,NA,NA,NA
13075,2011,237,178,-217,13,59,-204,13.845884209,10.39901852,-12.67745516,0.7594788806,3.4468656891,-11.91797628
13075,2012,208,158,-186,5,50,-181,12.248262867,9.3039689083,-10.95277352,0.2944293958,2.9442939583,-10.65834413
13075,2013,228,186,104,2,42,106,13.416499941,10.945039426,6.1198069907,0.117688596,2.4714605155,6.2374955867
13075,2014,234,185,196,3,49,199,13.609398627,10.759567291,11.399325346,0.1744794696,2.8498313365,11.573804816
13075,2015,222,198,-252,4,24,-248,12.90097629,11.506276151,-14.64435146,0.2324500232,1.3947001395,-14.41190144
13075,2016,204,188,72,4,16,76,11.90059503,10.967215027,4.2002100105,0.2333450006,0.9333800023,4.4335550111
13075,2017,210,177,53,4,33,57,12.186629526,10.271587744,3.0756731662,0.2321262767,1.9150417827,3.3077994429
17031,2010,18571,9364,-7925,3246,9207,-4679,NA,NA,NA,NA,NA,NA
17031,2011,71851,39051,-31665,16509,32800,-15156,13.795578295,7.4978932516,-6.079762101,3.1697708046,6.2976850439,-2.909991297
17031,2012,70558,38857,-27145,15893,31701,-11252,13.498468514,7.4337423259,-5.193116696,3.0404937794,6.0647261877,-2.152622916
17031,2013,69283,39865,-32077,16227,29418,-15850,13.212274373,7.6022591096,-6.117086804,3.0944903693,5.6100152636,-3.022596435
17031,2014,69242,39019,-45425,18404,30223,-27021,13.183611135,7.4291805967,-8.648876922,3.5041041468,5.7544305383,-5.144772775
17031,2015,69508,40737,-57353,20405,28771,-36948,13.240139826,7.7597337876,-10.92481066,3.8868195482,5.4804060388,-7.037991113
17031,2016,67932,41137,-61942,20621,26795,-41321,12.96760285,7.8526803044,-11.82416616,3.9363619262,5.1149225455,-7.887804236
17031,2017,66843,41675,-65871,20511,25168,-45360,12.801960887,7.9817141658,-12.61580069,3.9283248771,4.8202467216,-8.687475814
27031,2010,6,16,-4,0,-10,-4,NA,NA,NA,NA,NA,NA
27031,2011,45,41,39,4,4,43,8.6797183914,7.9081878677,7.5224226058,0.7715305237,0.7715305237,8.2939531295
27031,2012,50,39,-46,8,11,-38,9.6264921063,7.5086638429,-8.856372738,1.540238737,2.1178282634,-7.316134001
27031,2013,41,53,7,12,-12,19,7.909713514,10.224751616,1.3504388926,2.3150381017,-2.315038102,3.6654769943
27031,2014,36,50,45,15,-14,60,6.908462867,9.5950873153,8.6355785838,2.8785261946,-2.686624448,11.514104778
27031,2015,51,43,-41,16,8,-25,9.7570308016,8.2265161661,-7.843887507,3.0610292711,1.5305146355,-4.782858236
27031,2016,58,36,54,17,22,71,11.016144349,6.8376068376,10.256410256,3.2288698955,4.1785375119,13.485280152
27031,2017,55,40,56,16,15,72,10.271734055,7.4703520403,10.458492856,2.9881408161,2.8013820151,13.446633673
48097,2010,138,71,-35,4,67,-31,NA,NA,NA,NA,NA,NA
48097,2011,477,380,-221,44,97,-177,12.414277721,9.8897809934,-5.75168842,1.1451325361,2.5244967273,-4.606555884
48097,2012,521,414,173,9,107,182,13.522106438,10.745013561,4.4900660533,0.2335872513,2.7770928769,4.7236533046
48097,2013,570,427,-423,30,143,-393,14.78522515,11.075949367,-10.9721934,0.7781697448,3.7092757834,-10.19402366
48097,2014,528,417,122,31,111,153,13.692946058,10.814315353,3.1639004149,0.8039419087,2.8786307054,3.9678423237
48097,2015,550,398,182,42,152,224,14.147182139,10.237415438,4.6814311804,1.0803302724,3.9097667001,5.7617614528
48097,2016,581,416,-28,44,165,16,14.839030993,10.624848353,-0.715134024,1.1237820374,4.2141826401,0.4086480136
48097,2017,569,407,444,46,162,490,14.379762191,10.285699845,11.220763467,1.1625115303,4.094062346,12.383274997
29053,2010,45,29,-20,1,16,-19,NA,NA,NA,NA,NA,NA
29053,2011,199,186,-67,4,13,-63,11.323546148,10.583817002,-3.812450211,0.2276089678,0.7397291453,-3.584841243
29053,2012,195,202,-8,2,-7,-6,11.11712893,11.516205353,-0.456087341,0.1140218352,-0.399076423,-0.342065506
29053,2013,189,176,61,2,13,63,10.756972112,10.017074559,3.4718269778,0.1138303927,0.7398975526,3.5856573705
29053,2014,211,191,-75,10,20,-65,11.999203844,10.861838551,-4.26511985,0.5686826466,1.1373652933,-3.696437203
29053,2015,195,201,42,10,-6,52,11.090257635,11.431496332,2.3886708753,0.5687311608,-0.341238696,2.9574020361
29053,2016,172,205,101,11,-33,112,9.7483563818,11.618680571,5.7243255498,0.6234413965,-1.87032419,6.3477669463
29053,2017,184,188,-47,11,-4,-36,10.416961531,10.643417216,-2.660854304,0.622753135,-0.226455685,-2.038101169
33007,2010,82,93,-71,3,-11,-68,NA,NA,NA,NA,NA,NA
33007,2011,254,434,-306,8,-180,-298,7.7586865216,13.256968309,-9.347079038,0.2443680794,-5.498281787,-9.102710958
33007,2012,224,389,-377,7,-165,-370,6.9485373949,12.066879672,-11.6946366,0.2171417936,-5.118342278,-11.4774948
33007,2013,262,403,114,3,-141,117,8.1978754361,12.609709163,3.5670145027,0.0938688027,-4.411833727,3.6608833054
33007,2014,261,462,986,2,-201,988,8.0660114964,14.277767476,30.471598986,0.0618085172,-6.21175598,30.533407504
33007,2015,258,444,-265,2,-186,-263,7.9272414429,13.64222946,-8.142321637,0.0614514841,-5.714988017,-8.080870153
33007,2016,248,449,-200,2,-201,-198,7.7204451708,13.977741458,-6.22616546,0.0622616546,-6.257296288,-6.163903806
33007,2017,242,409,-122,2,-167,-120,7.6152115424,12.870336863,-3.839073587,0.0629356326,-5.255125321,-3.776137955
41011,2010,169,237,34,-2,-68,32,NA,NA,NA,NA,NA,NA
41011,2011,609,833,-47,10,-224,-37,9.6874254355,13.2506164,-0.747633818,0.1590710252,-3.563190965,-0.588562793
41011,2012,587,882,148,52,-295,200,9.3647299065,14.071025175,2.3611244057,0.8295842507,-4.706295268,3.1907086564
41011,2013,648,832,-132,40,-184,-92,10.369493207,13.313917204,-2.112304172,0.6400921733,-2.944423997,-1.472211999
41011,2014,638,864,184,36,-226,220,10.234117468,13.85936911,2.9515323105,0.5774737129,-3.625251642,3.5290060234
41011,2015,606,903,580,46,-297,626,9.6963878555,14.448577943,9.2803712148,0.7360294412,-4.752190088,10.016400656
41011,2016,618,883,938,42,-265,980,9.8066440807,14.011758452,14.884518038,0.6664709569,-4.205114371,15.550988995
41011,2017,629,882,724,41,-253,765,9.8850412139,13.861059381,11.378012462,0.6443349599,-3.976018167,12.022347422
01037,2010,21,11,16,-1,10,15,NA,NA,NA,NA,NA,NA
01037,2011,95,164,-234,0,-69,-234,8.1664231067,14.097825153,-20.11518955,0,-5.931402046,-20.11518955
01037,2012,107,140,-102,-1,-33,-103,9.3732206211,12.264026981,-8.935219657,-0.087600193,-2.89080636,-9.02281985
01037,2013,86,133,-47,1,-47,-46,7.610619469,11.769911504,-4.159292035,0.0884955752,-4.159292035,-4.07079646
01037,2014,103,122,-206,3,-19,-203,9.2430564903,10.948086328,-18.48611298,0.2692152376,-1.705029838,-18.21689774
01037,2015,97,137,-73,3,-40,-70,8.835451109,12.478936102,-6.649360113,0.2732613745,-3.643484993,-6.376098738
01037,2016,82,136,-64,3,-54,-61,7.5464752439,12.516105283,-5.889931898,0.2760905577,-4.969630039,-5.61384134
01037,2017,86,114,-28,3,-28,-25,7.9766266289,10.573667857,-2.597041228,0.2782544173,-2.597041228,-2.318786811
28029,2010,88,43,-61,2,45,-59,NA,NA,NA,NA,NA,NA
28029,2011,421,316,-263,1,105,-262,14.339237057,10.762942779,-8.957765668,0.0340599455,3.5762942779,-8.923705722
28029,2012,377,313,-340,8,64,-332,12.931773745,10.73645937,-11.66260762,0.274414297,2.1953143759,-11.38819332
28029,2013,372,343,-188,20,29,-168,12.849075177,11.847399962,-6.493618638,0.6908104934,1.0016752154,-5.802808145
28029,2014,366,313,-29,27,53,-2,12.662388209,10.828763687,-1.003303984,0.9341106056,1.8336245221,-0.069193378
28029,2015,338,333,-148,28,5,-120,11.707655005,11.534464842,-5.126428819,0.9698649117,0.1731901628,-4.156563907
28029,2016,365,348,-255,31,17,-224,12.714004563,12.121845446,-8.88238675,1.0798195656,0.5921591166,-7.802567184
28029,2017,350,329,-140,31,21,-109,12.254687418,11.519406173,-4.901874967,1.0854151713,0.7352812451,-3.816459796
46031,2010,23,18,18,0,5,18,NA,NA,NA,NA,NA,NA
46031,2011,78,50,-61,0,28,-61,19.235511714,12.330456227,-15.0431566,0,6.9050554871,-15.0431566
46031,2012,82,41,-9,2,41,-7,20.219455061,10.109727531,-2.219208482,0.4931574405,10.109727531,-1.726051042
46031,2013,87,48,94,1,39,95,21.011955078,11.592802802,22.702572153,0.241516725,9.4191522763,22.944088878
46031,2014,94,52,-82,2,42,-80,22.426339019,12.406059883,-19.56340212,0.4771561493,10.020279136,-19.08624597
46031,2015,91,35,-57,2,56,-55,21.796407186,8.3832335329,-13.65269461,0.4790419162,13.413173653,-13.17365269
46031,2016,90,43,-99,3,47,-96,21.684134442,10.360197567,-23.85254789,0.7228044814,11.323936875,-23.1297434
46031,2017,92,50,31,3,42,34,22.09414025,12.007684918,7.4447646494,0.7204610951,10.086455331,8.1652257445
36023,2010,121,82,-54,8,39,-46,NA,NA,NA,NA,NA,NA
36023,2011,476,430,36,19,46,55,9.6502787633,8.7176887988,0.7298530157,0.3852002027,0.9325899645,1.1150532184
36023,2012,454,448,-370,11,6,-359,9.2279236156,9.1059686779,-7.520554488,0.2235840524,0.1219549377,-7.296970436
36023,2013,464,504,-90,21,-40,-69,9.4755758863,10.292435876,-1.837934978,0.4288514949,-0.81685999,-1.409083483
36023,2014,488,401,-281,25,87,-256,9.9944702726,8.2126692199,-5.755012595,0.5120117968,1.7818010527,-5.243000799
36023,2015,462,431,-510,26,31,-484,9.522239169,8.8833010429,-10.51156272,0.5358835896,0.6389381261,-9.975679129
36023,2016,467,433,-422,26,34,-396,9.7061146444,8.9994596167,-8.770835931,0.5403832564,0.7066550276,-8.230452675
36023,2017,453,415,-211,26,38,-185,9.4651065608,8.671124112,-4.408692018,0.5432511492,0.7939824488,-3.865440869
48099,2010,249,91,-115,148,158,33,NA,NA,NA,NA,NA,NA
48099,2011,1068,413,176,157,655,333,14.024858668,5.4234706272,2.3112126644,2.0617067518,8.6013880408,4.3729194162
48099,2012,950,408,505,756,542,1261,12.247871127,5.2601383365,6.510710441,9.7467269176,6.9877327901,16.257437359
48099,2013,1008,394,-2790,407,614,-2383,12.984085479,5.0751286494,-35.93809374,5.2425821327,7.9089568292,-30.6955116
48099,2014,1070,429,-1580,363,641,-1217,13.986562443,5.6076965308,-20.65305482,4.7449739876,8.378865912,-15.90808083
48099,2015,1065,485,-1097,519,580,-578,13.971244162,6.3624914729,-14.39103741,6.808521803,7.6087526893,-7.582515611
48099,2016,973,471,-2093,302,502,-1791,12.87258391,6.231230238,-27.68994668,3.9953960337,6.6413536719,-23.69455065
48099,2017,962,443,-706,157,519,-549,12.838992099,5.9123425155,-9.422378817,2.0953448644,6.9266495836,-7.327033953
39031,2010,116,69,-7,1,47,-6,NA,NA,NA,NA,NA,NA
39031,2011,429,386,-52,1,43,-51,11.616414617,10.452065366,-1.408050257,0.0270778895,1.1643492506,-1.380972367
39031,2012,441,400,-150,7,41,-143,11.96013289,10.848193098,-4.068072412,0.1898433792,1.1119397925,-3.878229032
39031,2013,477,437,-152,10,40,-142,12.972884767,11.885011831,-4.133917158,0.2719682341,1.0878729364,-3.861948924
39031,2014,426,449,-182,12,-23,-170,11.632352138,12.26038993,-4.96969035,0.3276718912,-0.628037791,-4.642018459
39031,2015,462,364,-53,12,98,-41,12.639354353,9.9582791875,-1.449969222,0.3282949183,2.6810751659,-1.121674304
39031,2016,487,383,-51,12,104,-39,13.301831392,10.461193887,-1.39300493,0.3277658659,2.8406375046,-1.065239064
39031,2017,467,374,-205,12,93,-193,12.761654916,10.220254687,-5.602011259,0.3279226103,2.5414002295,-5.274088648
08023,2010,7,11,8,1,-4,9,NA,NA,NA,NA,NA,NA
08023,2011,36,33,89,10,3,99,10.048848569,9.211444522,24.842986741,2.7913468248,0.8374040475,27.634333566
08023,2012,30,40,-35,7,-10,-28,8.2953131481,11.060417531,-9.677865339,1.9355730679,-2.765104383,-7.742292272
08023,2013,28,44,-55,7,-16,-48,7.8519349411,12.338754907,-15.42344363,1.9629837353,-4.486819966,-13.4604599
08023,2014,25,43,30,8,-18,38,7.0531809846,12.131471294,8.4638171815,2.2570179151,-5.078290309,10.720835097
08023,2015,30,34,12,8,-4,20,8.4234170995,9.5465393795,3.3693668398,2.2462445599,-1.12312228,5.6156113997
08023,2016,28,32,131,9,-4,140,7.6986527358,8.7984602695,36.018696728,2.4745669508,-1.099807534,38.493263679
08023,2017,26,22,56,9,4,65,6.9509423874,5.8815666355,14.971260527,2.4060954418,1.0693757519,17.377355968
48101,2010,9,2,0,0,7,0,NA,NA,NA,NA,NA,NA
48101,2011,15,21,1,0,-6,1,9.9436526351,13.921113689,0.6629101757,0,-3.977461054,0.6629101757
48101,2012,15,18,-18,0,-3,-18,10.033444816,12.040133779,-12.04013378,0,-2.006688963,-12.04013378
48101,2013,10,37,-18,0,-27,-18,6.8376068376,25.299145299,-12.30769231,0,-18.46153846,-12.30769231
48101,2014,18,28,-3,0,-10,-3,12.547926107,19.518996166,-2.091321018,0,-6.971070059,-2.091321018
48101,2015,16,28,22,0,-12,22,11.165387299,19.539427774,15.352407537,0,-8.374040475,15.352407537
48101,2016,8,20,-22,0,-12,-22,5.6298381422,14.074595355,-15.48205489,0,-8.444757213,-15.48205489
48101,2017,13,17,-12,0,-4,-12,9.3156574704,12.182013615,-8.599068434,0,-2.866356145,-8.599068434
40033,2010,9,30,3,0,-21,3,NA,NA,NA,NA,NA,NA
40033,2011,57,66,3,0,-9,3,9.2360042129,10.694320668,0.4861054849,0,-1.458316455,0.4861054849
40033,2012,79,86,-17,5,-7,-12,12.826757591,13.963305731,-2.760188342,0.8118201007,-1.136548141,-1.948368242
40033,2013,71,66,-1,0,5,-1,11.542838563,10.729962608,-0.162575191,0,0.8128759551,-0.162575191
40033,2014,73,80,-24,-1,-7,-25,11.89603194,13.036747332,-3.911024199,-0.162959342,-1.140715392,-4.073983541
40033,2015,65,90,-102,-1,-25,-103,10.732271114,14.860067696,-16.84141006,-0.165111863,-4.127796582,-17.00652192
40033,2016,47,78,-48,-1,-31,-49,7.8951789014,13.102637326,-8.063161431,-0.16798253,-5.207458424,-8.231143961
40033,2017,50,85,-53,-1,-35,-54,8.5207907294,14.48534424,-9.032038173,-0.170415815,-5.964553511,-9.202453988
27033,2010,32,23,19,3,9,22,NA,NA,NA,NA,NA,NA
27033,2011,160,138,-37,12,22,-25,13.658286739,11.780272312,-3.158478808,1.0243715054,1.8780144266,-2.134107303
27033,2012,158,142,-157,0,16,-157,13.569220199,12.195121951,-13.48333906,0,1.374098248,-13.48333906
27033,2013,148,129,-43,5,19,-38,12.79667978,11.153862782,-3.717954261,0.4323202629,1.6428169988,-3.2856339979999998
27033,2014,158,135,-83,10,23,-73,13.701599965,11.707063262,-7.197675931,0.8671898712,1.9945367038,-6.33048606
27033,2015,151,142,-97,11,9,-86,13.166499542,12.381741291,-8.457950037,0.9591489733,0.7847582509,-7.498801064
27033,2016,152,124,-73,11,28,-62,13.318145974,10.864803294,-6.396214843,0.9638131955,2.4533426794,-5.432401647
27033,2017,139,134,-118,11,5,-107,12.251553479,11.810850117,-10.40059936,0.9695473976,0.4407033626,-9.431051959
51580,2010,15,27,2,0,-12,2,NA,NA,NA,NA,NA,NA
51580,2011,58,69,-19,4,-11,-15,9.7807757167,11.635750422,-3.204047218,0.6745362563,-1.854974705,-2.529510961
51580,2012,70,59,-80,-3,11,-83,11.90273763,10.032307431,-13.60312872,-0.510117327,1.8704301989,-14.11324605
51580,2013,62,87,10,3,-25,13,10.619165882,14.901087608,1.7127686906,0.5138306072,-4.281921726,2.2265992978
51580,2014,62,71,-53,2,-9,-51,10.685049548,12.236105127,-9.133993968,0.3446790177,-1.551055579,-8.78931495
51580,2015,30,128,-21,2,-98,-19,5.2502625131,22.401120056,-3.675183759,0.3500175009,-17.15085754,-3.325166258
51580,2016,1,63,-11,1,-62,-10,0.1779834475,11.212957195,-1.957817923,0.1779834475,-11.03497375,-1.779834475
51580,2017,0,54,3,1,-54,4,0,9.7183478809,0.5399082156,0.1799694052,-9.718347881,0.7198776208
01039,2010,100,92,43,0,8,43,NA,NA,NA,NA,NA,NA
01039,2011,463,489,231,3,-26,234,12.211847866,12.897610381,6.0927361924,0.0791264441,-0.685762515,6.1718626365
01039,2012,413,479,-140,-4,-66,-144,10.89422316,12.635188605,-3.692957003,-0.105513057,-1.740965444,-3.798470061
01039,2013,476,518,56,-1,-42,55,12.590261063,13.701166451,1.4812071839,-0.026450128,-1.110905388,1.4547570556
01039,2014,426,492,19,-2,-66,17,11.274911997,13.021729349,0.5028716619,-0.052933859,-1.746817352,0.4499378027
01039,2015,465,593,-69,-2,-128,-71,12.349777571,15.749286236,-1.83254764,-0.053117323,-3.399508665,-1.8856649619999999
01039,2016,449,490,-119,-3,-41,-122,11.983559304,13.077826412,-3.176043557,-0.080068325,-1.094267108,-3.256111882
01039,2017,443,511,-222,-3,-68,-225,11.896130401,13.722172991,-5.961491984,-0.080560702,-1.82604259,-6.042052687
28031,2010,72,85,19,0,-13,19,NA,NA,NA,NA,NA,NA
28031,2011,256,241,-107,-3,15,-110,13.109381401,12.341253585,-5.479311757,-0.153625563,0.7681278165,-5.632937321
28031,2012,286,263,-69,8,23,-61,14.695681217,13.513860699,-3.545461552,0.4110680061,1.1818205174,-3.134393546
28031,2013,275,286,-231,6,-11,-225,14.230639861,14.799865456,-11.95373748,0.3104866879,-0.569225594,-11.6432508
28031,2014,257,256,-67,8,1,-59,13.401121105,13.348976665,-3.493677487,0.4171555208,0.0521444401,-3.076521966
28031,2015,264,264,87,8,0,95,13.754298218,13.754298218,4.5326664583,0.4167969157,0,4.949463374
28031,2016,255,262,-54,9,-7,-45,13.271572811,13.635890497,-2.810450713,0.4684084522,-0.364317685,-2.342042261
28031,2017,257,237,-139,9,20,-130,13.431938746,12.386651684,-7.264745081,0.4703791779,1.045287062,-6.794365903
13077,2010,398,171,311,20,227,331,NA,NA,NA,NA,NA,NA
13077,2011,1632,875,665,60,757,725,12.685186625,6.8011876817,5.1689026381,0.4663671553,5.8839989429,5.6352697934
13077,2012,1586,812,405,91,774,496,12.198264093,6.2452650969,3.1149413353,0.6999003988,5.9529989963,3.8148417341
13077,2013,1669,936,1477,127,733,1604,12.661204673,7.100591716,11.204673039,0.9634349871,5.5606129571,12.168108026
13077,2014,1679,958,1368,159,721,1527,12.517613378,7.1422713616,10.198984575,1.1854082949,5.3753420164,11.38439287
13077,2015,1639,959,2076,183,680,2259,11.985681535,7.0129765661,15.181375757,1.3382426607,4.9727049687,16.519618418
13077,2016,1639,1049,1464,190,590,1654,11.761793189,7.527834689,10.505958041,1.363478161,4.2339585,11.869436202
13077,2017,1622,1044,1874,186,578,2060,11.43921068,7.3628458387,13.216449331,1.311771385,4.0763648417,14.528220716
20035,2010,117,69,-59,12,48,-47,NA,NA,NA,NA,NA,NA
20035,2011,479,453,-137,39,26,-98,13.205960603,12.48914437,-3.777070151,1.0752243497,0.7168162331,-2.701845802
20035,2012,453,438,-28,31,15,3,12.498965317,12.085092294,-0.772562978,0.8553375824,0.4138730238,0.0827746048
20035,2013,439,430,-152,34,9,-118,12.128244444,11.879601619,-4.199301037,0.9393173373,0.2486428246,-3.2599837
20035,2014,479,419,-411,48,60,-363,13.30814325,11.641152446,-11.41888701,1.333592643,1.6669908038,-10.08529436
20035,2015,458,450,-212,52,8,-160,12.805099673,12.58142981,-5.927251377,1.4538541113,0.2236698633,-4.473397266
20035,2016,431,450,-108,58,-19,-50,12.087896678,12.620773794,-3.02898571,1.6266775112,-0.532877116,-1.402308199
20035,2017,429,407,-343,59,22,-284,12.087571497,11.467696036,-9.664421966,1.6623932828,0.6198754614,-8.002028683
53015,2010,295,296,-39,-2,-1,-41,NA,NA,NA,NA,NA,NA
53015,2011,1251,941,-391,14,310,-377,12.226109732,9.1964582397,-3.821270108,0.1368229706,3.0296514923,-3.684447137
53015,2012,1208,1046,-837,32,162,-805,11.846621555,10.257918996,-8.208296558,0.3138177895,1.5887025596,-7.894478768
53015,2013,1143,1055,-297,48,88,-249,11.253876828,10.387436617,-2.924235711,0.4726037513,0.8664402107,-2.45163196
53015,2014,1139,1123,258,47,16,305,11.207044991,11.049615035,2.53855804,0.4624504957,0.157429956,3.0010085357
53015,2015,1239,1155,1085,62,84,1147,12.099373059,11.279076581,10.595496182,0.6054569247,0.8202964786,11.200953106
53015,2016,1242,1139,1573,62,103,1635,11.955182504,10.963730171,15.141306022,0.5967965501,0.9914523333,15.738102572
53015,2017,1278,1129,1938,62,149,2000,12.075628585,10.667750135,18.311868699,0.5858286168,1.40787845,18.897697316
40035,2010,45,39,27,2,6,29,NA,NA,NA,NA,NA,NA
40035,2011,167,220,-26,2,-53,-24,11.12035958,14.649575495,-1.731313468,0.133177959,-3.529215915,-1.598135509
40035,2012,161,213,-177,3,-52,-174,10.828989406,14.326551202,-11.90516227,0.2017824113,-3.497561796,-11.70337986
40035,2013,164,206,-25,4,-42,-21,11.137899419,13.990288295,-1.697850521,0.2716560834,-2.852388876,-1.426194438
40035,2014,179,178,-67,5,1,-62,12.20926267,12.141054498,-4.56994748,0.3410408567,0.0682081713,-4.228906623
40035,2015,161,206,119,5,-45,124,10.975526621,14.043220397,8.1123457632,0.340854864,-3.067693776,8.4532006272
40035,2016,159,227,-186,6,-68,-180,10.902358749,15.565002743,-12.75370269,0.4114097641,-4.662643993,-12.34229292
40035,2017,152,227,-63,6,-75,-57,10.560322368,15.771007747,-4.376975718,0.4168548303,-5.210685379,-3.960120888
51045,2010,9,3,16,0,6,16,NA,NA,NA,NA,NA,NA
51045,2011,28,52,-5,-1,-24,-6,5.4017555706,10.031831774,-0.964599209,-0.192919842,-4.630076203,-1.157519051
51045,2012,38,48,-20,0,-10,-20,7.3736295721,9.3140584069,-3.88085767,0,-1.940428835,-3.88085767
51045,2013,49,63,13,0,-14,13,9.5367847411,12.261580381,2.5301673803,0,-2.72479564,2.5301673803
51045,2014,45,42,39,0,3,39,8.7243117487,8.1426909655,7.5610701822,0,0.5816207832,7.5610701822
51045,2015,34,48,-24,0,-14,-24,6.5910632936,9.3050305321,-4.652515266,0,-2.713967239,-4.652515266
51045,2016,50,53,3,0,-3,3,9.7285728184,10.312287187,0.5837143691,0,-0.583714369,0.5837143691
51045,2017,41,68,-50,0,-27,-50,8.0376396785,13.330719467,-9.801999608,0,-5.293079788,-9.801999608
05031,2010,336,175,118,16,161,134,NA,NA,NA,NA,NA,NA
05031,2011,1363,859,967,82,504,1049,13.976118577,8.8081334243,9.915558814,0.8408229811,5.1679851523,10.756381795
05031,2012,1406,881,899,108,525,1007,14.190266648,8.8916251186,9.0732928282,1.0900062574,5.2986415292,10.163299086
05031,2013,1423,847,959,115,576,1074,14.133398223,8.4125005587,9.5248973268,1.1421931101,5.7208976645,10.667090437
05031,2014,1426,916,370,143,510,513,13.977719946,8.9786756453,3.6267576297,1.4016928136,4.9990443004,5.0284504433
05031,2015,1556,910,967,155,646,1122,15.046682429,8.7997949938,9.3509909439,1.4988661803,6.2468874351,10.849857124
05031,2016,1591,912,636,167,679,803,15.146755015,8.6824893611,6.0548938966,1.5898856615,6.4642656537,7.6447795581
05031,2017,1569,982,585,167,587,752,14.739591162,9.2251615812,5.4956410642,1.5688411243,5.5144295806,7.0644821885
48103,2010,16,3,-6,0,13,-6,NA,NA,NA,NA,NA,NA
48103,2011,66,47,-47,2,19,-45,15.102974828,10.755148741,-10.75514874,0.4576659039,4.347826087,-10.29748284
48103,2012,70,31,122,6,39,128,15.756893641,6.9780528981,27.462014631,1.3505908835,8.7788407428,28.812605515
48103,2013,80,55,158,11,25,169,17.299167478,11.893177641,34.165855768,2.3786355282,5.4059898367,36.544491296
48103,2014,81,37,122,14,44,136,16.825924387,7.6859160781,25.342750312,2.908184462,9.1400083091,28.250934774
48103,2015,67,39,59,14,28,73,13.517603147,7.8684555634,11.903560981,2.824573792,5.649147584,14.728134773
48103,2016,85,24,-274,14,61,-260,17.322192786,4.8909720807,-55.83859792,2.8530670471,12.431220705,-52.98553087
48103,2017,72,15,-140,14,57,-126,15.083272232,3.1423483817,-29.3285849,2.9328584896,11.94092385,-26.39572641
37049,2010,411,196,286,128,215,414,NA,NA,NA,NA,NA,NA
37049,2011,1745,1011,-219,202,734,-17,16.695209575,9.6726973527,-2.09527272,1.9326259795,7.0225122224,-0.162646741
37049,2012,1629,956,-885,680,673,-205,15.49922932,9.0959258625,-8.42039162,6.4699054252,6.4033034576,-1.950486194
37049,2013,1532,1010,-1986,414,522,-1572,14.61546167,9.6355197695,-18.94667551,3.9496090936,4.9799419007,-14.99706641
37049,2014,1497,978,-1025,312,519,-713,14.365155143,9.3848508548,-9.83586107,2.99394015,4.980304288,-6.84192092
37049,2015,1485,1077,-1984,464,408,-1520,14.33909794,10.399466991,-19.15742109,4.4803646090000004,3.9396309493,-14.67705648
37049,2016,1443,1124,-774,301,319,-473,14.018419212,10.919406233,-7.519235253,2.9241470428,3.0990129789,-4.59508821
37049,2017,1422,1059,-789,150,363,-639,13.843794874,10.30983036,-7.681261713,1.460315915,3.5339645143,-6.220945798
05033,2010,185,162,6,-5,23,1,NA,NA,NA,NA,NA,NA
05033,2011,707,572,-279,-25,135,-304,11.424600866,9.2430999935,-4.508435137,-0.403981643,2.1815008726,-4.91241678
05033,2012,776,589,-91,13,187,-78,12.546483428,9.523039612,-1.471301536,0.2101859337,3.0234438157,-1.261115602
05033,2013,769,619,-436,48,150,-388,12.446890301,10.01901833,-7.057014527,0.7769190305,2.4278719702,-6.280095496
05033,2014,814,588,-152,64,226,-88,13.186350345,9.5252751881,-2.462316035,1.0367646463,3.6610751573,-1.425551389
05033,2015,801,669,-121,75,132,-46,12.953409771,10.818765464,-1.956757281,1.2128660834,2.1346443068,-0.743891198
05033,2016,770,632,166,80,138,246,12.405748534,10.182380615,2.6744860476,1.2889089386,2.2233679191,3.9633949861
05033,2017,771,624,514,79,147,593,12.310885793,9.9636741048,8.2072571953,1.2614266896,2.3472116882,9.4686838849
13079,2010,53,38,-29,0,15,-29,NA,NA,NA,NA,NA,NA
13079,2011,138,98,-48,5,40,-43,10.938924339,7.7682216321,-3.804843248,0.3963378384,3.170702707,-3.40850541
13079,2012,145,116,-39,6,29,-33,11.495619772,9.196495818,-3.091925318,0.4756808182,2.2991239545,-2.6162445
13079,2013,123,106,-132,13,17,-119,9.7918242248,8.4384826653,-10.50829917,1.0349082514,1.3533415595,-9.473390917
13079,2014,129,135,-86,15,-6,-71,10.342339453,10.823378498,-6.894892969,1.2025976108,-0.481039044,-5.692295358
13079,2015,142,115,-86,17,27,-69,11.438698244,9.2637344933,-6.927662317,1.3694216208,2.1749637506,-5.558240696
13079,2016,106,123,-100,17,-17,-83,8.5885593907,9.965969859,-8.10241452,1.3774104683,-1.377410468,-6.725004051
13079,2017,92,144,38,17,-52,55,7.4839339461,11.713983568,3.0911901082,1.3829008379,-4.230049622,4.4740909461
17033,2010,54,74,6,1,-20,7,NA,NA,NA,NA,NA,NA
17033,2011,215,235,-16,7,-20,-9,10.866543681,11.877384954,-0.808673018,0.3537944454,-1.010841273,-0.454878573
17033,2012,209,196,-208,3,13,-205,10.622077658,9.9613742631,-10.57125432,0.1524700142,0.660703395,-10.41878431
17033,2013,212,245,-123,4,-33,-119,10.868729333,12.560559842,-6.305913717,0.2050703648,-1.691830509,-6.100843352
17033,2014,199,227,-126,6,-28,-120,10.281580987,11.728235598,-6.50994575,0.3099974167,-1.446654611,-6.199948334
17033,2015,217,258,13,6,-41,19,11.261611916,13.389381909,0.6746587783,0.3113809746,-2.127769993,0.986039753
17033,2016,213,234,-99,4,-21,-95,11.094038907,12.187817391,-5.156384281,0.2083387588,-1.093778484,-4.948045522
17033,2017,205,242,-147,4,-37,-143,10.760307587,12.702411884,-7.71592788,0.2099572212,-1.942104296,-7.505970658
18025,2010,29,46,14,0,-17,14,NA,NA,NA,NA,NA,NA
18025,2011,100,110,-79,0,-10,-79,9.3755859741,10.313144572,-7.40671292,0,-0.937558597,-7.40671292
18025,2012,122,99,27,0,23,27,11.459703175,9.2992673305,2.5361638174,0,2.1604358444,2.5361638174
18025,2013,101,130,-20,0,-29,-20,9.4880225458,12.212306247,-1.878816346,0,-2.724283701,-1.878816346
18025,2014,126,109,34,-1,17,33,11.837098971,10.240030062,3.1941378177,-0.09394523,1.5970689088,3.1001925877
18025,2015,135,109,-140,-1,26,-141,12.721447418,10.271390878,-13.19261214,-0.094232944,2.4500565398,-13.28684508
18025,2016,109,113,31,-1,-4,30,10.314155942,10.692657078,2.9333838002,-0.094625284,-0.378501136,2.8387585163
18025,2017,113,115,-12,-1,-2,-13,10.687095096,10.876247222,-1.134912754,-0.094576063,-0.189152126,-1.229488816
19047,2010,90,49,13,10,41,23,NA,NA,NA,NA,NA,NA
19047,2011,231,183,-22,41,48,19,13.437263684,10.645104997,-1.2797393990000001,2.3849688791,2.7921586877,1.1052294805
19047,2012,261,139,-53,31,122,-22,15.109850349,8.0470084233,-3.068283787,1.7946565548,7.0628419255,-1.273627232
19047,2013,205,154,-22,15,51,-7,11.819649446,8.8791512915,-1.268450185,0.8648523985,2.940498155,-0.403597786
19047,2014,251,166,-316,28,85,-288,14.53724082,9.6142708213,-18.30186494,1.6216842349,4.9229699988,-16.6801807
19047,2015,212,165,-219,35,47,-184,12.398385871,9.6496871162,-12.80776654,2.0469033277,2.7486987543,-10.76086321
19047,2016,242,145,-133,40,97,-93,14.207297385,8.5126368627,-7.808142777,2.3483136173,5.6946605219,-5.45982916
19047,2017,236,146,-109,40,90,-69,13.844890297,8.5650592514,-6.394462044,2.3465915757,5.2798310454,-4.047870468
20037,2010,120,79,-15,20,41,5,NA,NA,NA,NA,NA,NA
20037,2011,484,446,-114,87,38,-27,12.35324145,11.383358857,-2.909647779,2.2205206738,0.9698825932,-0.689127106
20037,2012,501,433,-14,82,68,68,12.764819038,11.032268749,-0.35670153,2.0892518185,1.7325502885,1.7325502885
20037,2013,456,379,-258,93,77,-165,11.611917494,9.6511331805,-6.569900688,2.3682200153,1.9607843137,-4.201680672
20037,2014,528,410,-245,108,118,-137,13.463377319,10.454516479,-6.247211066,2.7538726334,3.0088608402,-3.493338433
20037,2015,517,441,-368,115,76,-253,13.215746421,11.273006135,-9.406952965,2.9396728016,1.9427402863,-6.467280164
20037,2016,499,385,-278,124,114,-154,12.790936122,9.8687583308,-7.126012509,3.1785091767,2.9221777914,-3.947503332
20037,2017,475,352,-203,123,123,-80,12.175428703,9.0226334811,-5.203393741,3.1527952221,3.1527952221,-2.050598518
26039,2010,36,47,-14,1,-11,-13,NA,NA,NA,NA,NA,NA
26039,2011,133,175,27,-4,-42,23,9.470573575,12.46128102,1.922597643,-0.28482928,-2.990707445,1.6377683626
26039,2012,110,153,-48,7,-43,-41,7.8630401372,10.936774009,-3.431144787,0.5003752815,-3.073733872,-2.930769506
26039,2013,101,161,-19,8,-60,-11,7.2612243431,11.574822963,-1.365972896,0.5751464826,-4.31359862,-0.790826414
26039,2014,126,173,-96,8,-47,-88,9.1274584375,12.532145315,-6.954254048,0.5795211706,-3.404686877,-6.374732877
26039,2015,136,172,142,8,-36,150,9.8600739506,12.470093526,10.295077213,0.58000435,-2.610019575,10.875081563
26039,2016,105,179,-45,8,-74,-37,7.6117293124,12.976186161,-3.262169705,0.5799412809,-5.364456849,-2.682228424
26039,2017,118,167,208,8,-49,216,8.5364971424,12.081313752,15.047384793,0.578745569,-3.54481661,15.626130362
29055,2010,68,101,-55,1,-33,-54,NA,NA,NA,NA,NA,NA
29055,2011,287,266,161,-1,21,160,11.620138875,10.769884811,6.5186144908,-0.040488289,0.850254064,6.478126202
29055,2012,257,296,12,0,-39,12,10.374197715,11.94849231,0.4843983369,0,-1.574294595,0.4843983369
29055,2013,298,277,-270,-4,21,-274,12.098083793,11.245534264,-10.96135109,-0.162390386,0.8525495291,-11.12374147
29055,2014,317,283,78,-4,34,74,12.907954476,11.5235051,3.1760897449,-0.162876397,1.384449376,3.0132133477
29055,2015,299,288,-132,-4,11,-136,12.180466443,11.732355637,-5.377329667,-0.162949384,0.4481108056,-5.540279051
29055,2016,272,303,-217,-4,-31,-221,11.166533243,12.439189605,-8.908594536,-0.164213724,-1.272656362,-9.07280826
29055,2017,263,304,-85,-4,-41,-89,10.882608516,12.579136839,-3.517192866,-0.165514958,-1.696528324,-3.682707825
39033,2010,115,96,-48,1,19,-47,NA,NA,NA,NA,NA,NA
39033,2011,509,493,-473,-1,16,-474,11.692413714,11.324872222,-10.86544536,-0.022971343,0.367541492,-10.8884167
39033,2012,455,545,-449,5,-90,-444,10.570824524,12.661756848,-10.43142904,0.1161629069,-2.090932323,-10.31526613
39033,2013,458,521,-5,5,-63,0,10.715079486,12.188987799,-0.11697685,0.1169768503,-1.473908314,0
39033,2014,475,555,-246,6,-80,-240,11.163993184,13.044244668,-5.781773312,0.1410188613,-1.880251484,-5.640754451
39033,2015,510,579,-46,9,-69,-37,12.047765848,13.677757698,-1.086661233,0.2126076326,-1.62999185,-0.874053601
39033,2016,468,540,-174,8,-72,-166,11.101359205,12.809260621,-4.127428422,0.189766824,-1.707901416,-3.937661598
39033,2017,474,498,-275,8,-24,-267,11.314944559,11.887853144,-6.56457754,0.1909695284,-0.572908585,-6.373608011
42039,2010,266,283,-112,2,-17,-110,NA,NA,NA,NA,NA,NA
42039,2011,916,1021,-333,-5,-105,-338,10.360877508,11.54853268,-3.766563548,-0.056555008,-1.187655173,-3.823118556
42039,2012,928,900,-466,6,28,-460,10.548930898,10.23064419,-5.297200214,0.0682042946,0.3182867081,-5.228995919
42039,2013,978,998,-167,23,-20,-144,11.155914745,11.384052061,-1.904946587,0.2623579132,-0.228137316,-1.642588674
42039,2014,897,937,-268,30,-40,-238,10.258932248,10.716409717,-3.065099044,0.3431081019,-0.457477469,-2.721990942
42039,2015,1023,1086,-559,33,-63,-526,11.759026173,12.483189075,-6.425508926,0.3793234249,-0.724162902,-6.046185501
42039,2016,921,952,-196,32,-31,-164,10.634735517,10.992690784,-2.263201044,0.3695022112,-0.357955267,-1.893698833
42039,2017,916,942,-350,32,-26,-318,10.610202474,10.911365426,-4.054116666,0.3706620952,-0.301162952,-3.683454571
55023,2010,51,45,-17,0,6,-17,NA,NA,NA,NA,NA,NA
55023,2011,147,180,78,2,-33,80,8.825913362,10.807240851,4.6831377023,0.1200804539,-1.981327489,4.8032181562
55023,2012,174,196,-141,1,-22,-140,10.483822378,11.809363138,-8.495511237,0.0602518527,-1.32554076,-8.435259384
55023,2013,160,172,-118,5,-12,-113,9.7243747531,10.45370286,-7.17172638,0.303886711,-0.729328106,-6.867839669
55023,2014,178,168,-58,8,10,-50,10.873217067,10.262362176,-3.54295837,0.4886839131,0.6108548914,-3.054274457
55023,2015,145,166,-7,8,-21,1,8.8744721219,10.159740498,-0.428422792,0.4896260481,-1.285268376,0.061203256
55023,2016,178,166,-68,9,12,-59,10.917566241,10.18155054,-4.170755643,0.5520117763,0.7360157017,-3.618743867
55023,2017,153,161,-66,8,-8,-58,9.4171231612,9.9095217579,-4.062288422,0.4923985967,-0.492398597,-3.569889826
40037,2010,225,184,185,1,41,186,NA,NA,NA,NA,NA,NA
40037,2011,906,802,278,12,104,290,12.870323676,11.392935528,3.9491721654,0.1704678633,1.4773881482,4.1196400287
40037,2012,850,791,51,26,59,77,12.031224566,11.196116038,0.721873474,0.3680139279,0.8351085287,1.0898874019
40037,2013,858,838,-236,37,20,-199,12.14944669,11.866242805,-3.34180585,0.5239271883,0.2832038856,-2.817878661
40037,2014,867,829,-100,46,38,-54,12.29473326,11.755863751,-1.418077654,0.6523157208,0.5388695085,-0.765761933
40037,2015,877,888,181,51,-11,232,12.420073218,12.575855208,2.5633218385,0.7222619545,-0.15578199,3.285583793
40037,2016,853,910,324,56,-57,380,12.034848859,12.839053296,4.5712673274,0.7900955875,-0.804204437,5.3613629149
40037,2017,846,909,676,56,-63,732,11.853553964,12.73626543,9.4716341371,0.7846324137,-0.882711465,10.256266551
01041,2010,37,24,-47,7,13,-40,NA,NA,NA,NA,NA,NA
01041,2011,166,164,10,13,2,23,11.954056098,11.810031325,0.7201238613,0.9361610197,0.1440247723,1.656284881
01041,2012,148,167,29,11,-19,40,10.642122672,12.008341123,2.0852807938,0.790968577,-1.366218451,2.8762493708
01041,2013,145,162,-52,0,-17,-52,10.445557036,11.670208551,-3.745992868,0,-1.224651515,-3.745992868
01041,2014,155,179,32,-1,-24,31,11.191739774,12.92465432,2.3105527275,-0.072204773,-1.732914546,2.2383479548
01041,2015,158,215,56,0,-57,56,11.406706855,15.521784644,4.0428834422,0,-4.115077789,4.0428834422
01041,2016,152,167,71,0,-15,71,10.95179768,12.032567188,5.1156423373,0,-1.080769508,5.1156423373
01041,2017,163,183,-16,0,-20,-16,11.735906113,13.175894593,-1.151990784,0,-1.43998848,-1.151990784
13081,2010,80,29,-55,0,51,-55,NA,NA,NA,NA,NA,NA
13081,2011,338,252,216,10,86,226,14.322337338,10.678192335,9.1527362868,0.4237377911,3.6441450031,9.5764740778
13081,2012,293,227,-240,9,66,-231,12.373572077,9.5863510632,-10.13534914,0.3800755928,2.787221014,-9.755273549
13081,2013,294,267,-334,18,27,-316,12.533572068,11.382529735,-14.23881997,0.7673615552,1.1510423328,-13.47145841
13081,2014,272,253,-283,15,19,-268,11.726159683,10.90705294,-12.20037938,0.6466632178,0.8191067425,-11.55371616
13081,2015,314,239,-205,16,75,-189,13.640905339,10.382727312,-8.905686607,0.6950779791,3.2581780268,-8.210608628
13081,2016,303,207,-138,17,96,-121,13.203477351,9.0201973985,-6.013464932,0.7407891583,4.1832799529,-5.272675774
13081,2017,301,268,-248,17,33,-231,13.181230978,11.736112632,-10.86028333,0.7444549057,1.4451183464,-10.11582843
05035,2010,198,79,-66,2,119,-64,NA,NA,NA,NA,NA,NA
05035,2011,793,508,-744,-6,285,-750,15.63115982,10.013403769,-14.66530001,-0.118268548,5.6177560514,-14.78356856
05035,2012,789,481,-768,-1,308,-769,15.691343907,9.5659523691,-15.27370357,-0.019887635,6.1253915378,-15.29359121
05035,2013,796,490,-630,-14,306,-644,15.95318262,9.8204264871,-12.62626263,-0.280583614,6.1327561328,-12.90684624
05035,2014,770,465,-487,-4,305,-491,15.511527885,9.3673512555,-9.810537767,-0.080579366,6.14417663,-9.891117132
05035,2015,825,448,-896,-3,377,-899,16.73597728,9.0881428137,-18.17628563,-0.060858099,7.647834466,-18.23714373
05035,2016,843,513,-49,-1,330,-50,17.141114274,10.43106954,-0.996339976,-0.020333469,6.7100447336,-1.016673444
05035,2017,828,522,-876,-1,306,-877,16.885897828,10.645457326,-17.86479046,-0.020393596,6.2404405017,-17.88518405
21055,2010,25,47,5,1,-22,6,NA,NA,NA,NA,NA,NA
21055,2011,82,109,-23,1,-27,-22,8.8433540038,11.755190078,-2.480452952,0.1078457805,-2.911836074,-2.372607172
21055,2012,110,130,-3,-1,-20,-4,11.910562503,14.076119322,-0.324833523,-0.108277841,-2.165556819,-0.433111364
21055,2013,103,138,-7,0,-35,-7,11.194435387,14.998369742,-0.760786871,0,-3.803934355,-0.760786871
21055,2014,116,120,2,0,-4,2,12.640296393,13.076168683,0.2179361447,0,-0.435872289,0.2179361447
21055,2015,114,138,21,0,-24,21,12.42845462,15.044971382,2.2894521668,0,-2.616516762,2.2894521668
21055,2016,94,94,-6,0,0,-6,10.254731904,10.254731904,-0.654557356,0,0,-0.654557356
21055,2017,102,104,-77,0,-2,-77,11.179919987,11.399134104,-8.439743519,0,-0.21921411699999999,-8.439743519
47033,2010,47,25,-10,0,22,-10,NA,NA,NA,NA,NA,NA
47033,2011,176,176,-36,7,0,-29,12.077128937,12.077128937,-2.470321828,0.4803403555,0,-1.989981473
47033,2012,173,190,66,5,-17,71,11.862314866,13.027975864,4.5255074054,0.3428414701,-1.165660998,4.8683488755
47033,2013,182,163,-26,4,19,-22,12.45807379,11.157505647,-1.779724827,0.2738038196,1.3005681429,-1.505921008
47033,2014,180,183,38,6,-3,44,12.30643011,12.511537278,2.5980241343,0.410214337,-0.205107168,3.0082384713
47033,2015,164,182,-54,6,-18,-48,11.224035862,12.455942237,-3.695719125,0.4106354584,-1.231906375,-3.285083667
47033,2016,164,159,-121,6,5,-115,11.292821484,10.948528146,-8.331898778,0.4131520055,0.3442933379,-7.918746772
47033,2017,156,177,22,6,-21,28,10.780926054,12.232204561,1.5203870076,0.4146510021,-1.451278507,1.9350380097
48105,2010,17,19,-16,1,-2,-15,NA,NA,NA,NA,NA,NA
48105,2011,56,45,-61,3,11,-58,15.223596575,12.233247248,-16.58284627,0.8155498165,2.9903493272,-15.76729645
48105,2012,60,37,18,7,23,25,16.306563392,10.055714092,4.8919690175,1.9024323957,6.2508493002,6.7944014132
48105,2013,47,30,33,7,17,40,12.593783494,8.038585209,8.8424437299,1.8756698821,4.5551982851,10.718113612
48105,2014,60,32,-10,8,28,-2,15.900357758,8.4801908043,-2.650059626,2.1200477011,7.4201669538,-0.530011925
48105,2015,49,27,-87,9,22,-78,13.03538175,7.1827613727,-23.14445331,2.3942537909,5.8526203778,-20.75019952
48105,2016,55,31,-112,8,24,-104,14.895057549,8.3953960731,-30.33175355,2.1665538253,6.499661476,-28.16519973
48105,2017,45,28,-114,8,17,-106,12.470555633,7.759456838,-31.59207427,2.216987668,4.7110987945,-29.3750866
41013,2010,56,39,-118,0,17,-118,NA,NA,NA,NA,NA,NA
41013,2011,155,241,-170,-2,-86,-172,7.4680799807,11.611659841,-8.190797398,-0.096362322,-4.14357986,-8.287159721
41013,2012,164,208,21,-1,-44,20,7.9565301766,10.091209004,1.018823986,-0.048515428,-2.134678828,0.9703085581
41013,2013,191,238,137,3,-47,140,9.251410719,11.52793587,6.6358286309,0.145310116,-2.276525151,6.7811387469
41013,2014,192,231,297,2,-39,299,9.2194665194,11.092170656,14.261362272,0.0960361096,-1.872704137,14.357398382
41013,2015,226,276,551,2,-50,553,10.653593231,13.010582884,25.974025974,0.0942795861,-2.356989653,26.06830556
41013,2016,235,248,884,3,-13,887,10.727409673,11.320840846,40.353319791,0.1369456554,-0.593431173,40.490265446
41013,2017,240,248,782,3,-8,785,10.557107353,10.909010931,34.398574791,0.1319638419,-0.351903578,34.530538632
56011,2010,35,20,21,1,15,22,NA,NA,NA,NA,NA,NA
56011,2011,82,64,-20,6,18,-14,11.515236624,8.9875017554,-2.808594299,0.8425782896,2.5277348687,-1.966016009
56011,2012,101,54,-32,5,47,-27,14.161525519,7.5715086932,-4.486819966,0.7010656197,6.5900168256,-3.785754347
56011,2013,87,76,3,-3,11,0,12.172939695,10.633832377,0.4197565412,-0.419756541,1.5391073178,0
56011,2014,98,56,41,9,42,50,13.613001806,7.7788581747,5.6952354494,1.2501736352,5.8341436311,6.9454090846
56011,2015,114,62,125,9,52,134,15.534509777,8.4485930367,17.033453703,1.2264086666,7.0859167405,18.25986237
56011,2016,110,50,-5,10,60,5,14.73641905,6.6983722955,-0.66983723,1.3396744591,8.0380467546,0.6698372296
56011,2017,119,65,-151,10,54,-141,15.96565372,8.7207352251,-20.25893875,1.3416515731,7.2449184947,-18.91728718
48107,2010,20,40,-10,0,-20,-10,NA,NA,NA,NA,NA,NA
48107,2011,89,72,-3,3,17,0,14.752196254,11.934361014,-0.497265042,0.4972650423,2.8178352395,0
48107,2012,72,67,-18,1,5,-17,11.930405965,11.101905551,-2.982601491,0.1657000829,0.8285004143,-2.816901408
48107,2013,64,60,-120,2,4,-118,10.712193489,10.042681396,-20.08536279,0.3347560465,0.6695120931,-19.75060675
48107,2014,73,61,-110,3,12,-107,12.432938772,10.389168015,-18.73456527,0.5109426893,2.043770757,-18.22362258
48107,2015,103,86,73,3,17,76,17.546848382,14.65076661,12.436115843,0.5110732538,2.8960817717,12.947189097
48107,2016,73,54,-22,3,19,-19,12.338375729,9.1270176625,-3.718414603,0.5070565368,3.2113580664,-3.211358066
48107,2017,82,59,-43,3,23,-40,13.879485443,9.9864590386,-7.278266757,0.5077860528,3.8930264049,-6.770480704
05037,2010,49,23,-44,0,26,-44,NA,NA,NA,NA,NA,NA
05037,2011,220,215,-59,0,5,-59,12.343600965,12.063064579,-3.31032935,0,0.2805363856,-3.31032935
05037,2012,242,239,-110,0,3,-110,13.638797306,13.469721306,-6.199453321,0,0.1690759997,-6.199453321
05037,2013,233,246,-168,0,-13,-168,13.237884211,13.976478609,-9.544912221,0,-0.738594398,-9.544912221
05037,2014,219,211,-355,0,8,-355,12.629029468,12.167695058,-20.47171443,0,0.4613344098,-20.47171443
05037,2015,206,235,98,0,-29,98,11.972915637,13.658423179,5.6958530702,0,-1.685507541,5.6958530702
05037,2016,227,188,-241,0,39,-241,13.245033113,10.969454736,-14.0619074,0,2.2755783762,-14.0619074
05037,2017,217,205,-186,0,12,-186,12.802359882,12.09439528,-10.97345133,0,0.7079646018,-10.97345133
27035,2010,207,159,46,6,48,52,NA,NA,NA,NA,NA,NA
27035,2011,750,602,-101,17,148,-84,11.976526009,9.6131582099,-1.612838836,0.2714679229,2.3633677991,-1.341370913
27035,2012,730,643,23,39,87,62,11.639030612000001,10.251913265,0.3667091837,0.6218112245,1.3871173469,0.9885204082
27035,2013,722,678,130,25,44,155,11.481366632,10.781671159,2.0672820806,0.3975542463,0.6996954734,2.4648363269
27035,2014,699,622,19,39,77,58,11.088022081,9.8665947558,0.3013911581,0.6186450088,1.2214273251,0.9200361669
27035,2015,703,652,64,43,51,107,11.127643409,10.320374826,1.0130429277,0.680638217,0.807268583,1.6936811447
27035,2016,725,653,408,42,72,450,11.415435243,10.281764433,6.4241345919,0.6613079727,1.1336708103,7.0854425646
27035,2017,709,671,576,42,38,618,11.061273841,10.468427006,8.9863099185,0.6552517649,0.5928468349,9.6415616834
08025,2010,12,3,25,2,9,27,NA,NA,NA,NA,NA,NA
08025,2011,32,35,-8,10,-3,2,5.4612168274,5.9732059049,-1.365304207,1.7066302586,-0.511989078,0.3413260517
08025,2012,42,47,-446,11,-5,-435,7.4375774748,8.3230033646,-78.97998937,1.9479369577,-0.88542589,-77.03205242
08025,2013,38,38,-118,0,0,-118,7.0658237263,7.0658237263,-21.9412421,0,0,-21.9412421
08025,2014,30,46,270,0,-16,270,5.5010543688,8.4349500321,49.509489319,0,-2.933895663,49.509489319
08025,2015,42,38,7,0,4,7,7.511401234,6.7960296879,1.2519002057,0,0.7153715461,1.2519002057
08025,2016,31,37,-340,0,-6,-340,5.7137591005,6.8196479587,-62.6670353,0,-1.105888858,-62.6670353
08025,2017,37,36,549,0,1,549,6.6883586406,6.5075921909,99.240780911,0,0.1807664497,99.240780911
48109,2010,6,1,-1,1,5,0,NA,NA,NA,NA,NA,NA
48109,2011,27,14,-30,5,13,-25,11.259382819,5.8381984987,-12.51042535,2.0850708924,5.4211843203,-10.42535446
48109,2012,32,15,-97,1,17,-96,13.596770767,6.373486297,-41.21521139,0.4248990865,7.2232844699,-40.7903123
48109,2013,30,19,-22,0,11,-22,12.987012987,8.2251082251,-9.523809524,0,4.7619047619,-9.523809524
48109,2014,26,17,-34,0,9,-34,11.341330425,7.4154852781,-14.83097056,0,3.9258451472,-14.83097056
48109,2015,32,9,-52,0,23,-52,14.124917237,3.9726329729,-22.95299051,0,10.152284264,-22.95299051
48109,2016,31,20,-43,0,11,-43,13.870246085,8.9485458613,-19.2393736,0,4.9217002237,-19.2393736
48109,2017,29,15,-3,0,14,-3,13.033707865,6.7415730337,-1.348314607,0,6.2921348315,-1.348314607
01043,2010,249,228,41,5,21,46,NA,NA,NA,NA,NA,NA
01043,2011,997,910,-152,20,87,-132,12.394562305,11.31299067,-1.889642398,0.2486371576,1.0815716355,-1.64100524
01043,2012,925,965,-93,11,-40,-82,11.513137423,12.011002825,-1.15753706,0.1369129856,-0.497865402,-1.020624074
01043,2013,951,961,390,23,-10,413,11.817407999,11.941670964,4.8462556462,0.2858048202,-0.124262965,5.1320604664
01043,2014,1011,946,285,28,65,313,12.503478342,11.699594966,3.5247194138,0.3462882231,0.8038833751,3.8710076369
01043,2015,1013,967,609,28,46,637,12.44762291,11.882380408,7.4833192023,0.344060653,0.5652425013,7.8273798552
01043,2016,988,1012,598,29,-24,627,12.045622184,12.338228391,7.2907713222,0.3535658333,-0.292606207,7.6443371555
01043,2017,991,1014,427,30,-23,457,12.00651817,12.285176009,5.1733433489,0.3634667458,-0.278657838,5.5368100947
51047,2010,177,108,72,5,69,77,NA,NA,NA,NA,NA,NA
51047,2011,598,373,253,25,225,278,12.699491383,7.9212546588,5.3728617391,0.5309151916,4.7782367245,5.9037769307
51047,2012,624,345,209,19,279,228,13.11186056,7.2493459829,4.3916327839,0.399239344,5.8625145775,4.7908721278
51047,2013,638,390,470,53,248,523,13.228829725,8.0865887037,9.74537613,1.09894667,5.1422410218,10.8443228
51047,2014,633,421,343,61,212,404,12.938831826,8.6054473913,7.0110889672,1.2468700496,4.3333844346,8.2579590168
51047,2015,635,391,-20,65,244,45,12.861671207,7.9195487275,-0.405092007,1.3165490212,4.9421224796,0.9114570147
51047,2016,696,397,453,69,299,522,13.941469864,7.9522464595,9.0739739198,1.3821284779,5.989223404,10.456102398
51047,2017,679,414,613,69,265,682,13.364168676,8.1484032869,12.065147862,1.3580672145,5.215765389,13.423215077
17035,2010,31,19,-5,4,12,-1,NA,NA,NA,NA,NA,NA
17035,2011,119,125,19,10,-6,29,10.752688172,11.294840517,1.7168157586,0.9035872413,-0.542152345,2.6204029999
17035,2012,117,111,-154,12,6,-142,10.625255415,10.080370522,-13.98537892,1.0897697861,0.5448848931,-12.89560914
17035,2013,124,120,-58,7,4,-51,11.353751774,10.987501717,-5.31062583,0.6409376001,0.3662500572,-4.66968823
17035,2014,132,96,-19,11,36,-8,12.096774194,8.7976539589,-1.741202346,1.0080645161,3.2991202346,-0.73313783
17035,2015,115,123,-56,11,-8,-45,10.551426736,11.285439031,-5.138086063,1.0092669052,-0.734012295,-4.128819158
17035,2016,128,113,-6,11,15,5,11.76254365,10.384120566,-0.551369234,1.0108435949,1.378423084,0.4594743613
17035,2017,122,99,-18,11,23,-7,11.19266055,9.0825688073,-1.651376147,1.0091743119,2.1100917431,-0.642201835
21057,2010,21,11,4,0,10,4,NA,NA,NA,NA,NA,NA
21057,2011,80,95,17,5,-15,22,11.639749745,13.822202823,2.4734468209,0.7274843591,-2.182453077,3.20093118
21057,2012,82,93,-6,6,-11,0,11.935953421,13.537117904,-0.873362445,0.8733624454,-1.601164483,0
21057,2013,79,105,-45,6,-26,-39,11.56323185,15.368852459,-6.586651054,0.8782201405,-3.805620609,-5.708430913
21057,2014,79,97,-52,2,-18,-50,11.676890104,14.337447343,-7.686054246,0.295617471,-2.660557239,-7.390436775
21057,2015,79,119,56,2,-40,58,11.721937829,17.657096224,8.3092217524,0.2967579197,-5.935158395,8.6059796721
21057,2016,81,106,11,2,-25,13,12.014239098,15.722337585,1.6315633343,0.296647879,-3.708098487,1.9282112133
21057,2017,80,114,1,2,-34,3,11.902990626,16.961761643,0.1487873828,0.2975747657,-5.058771016,0.4463621485
23005,2010,742,578,-547,136,164,-411,NA,NA,NA,NA,NA,NA
23005,2011,2715,2454,374,564,261,938,9.6270792186,8.7016030948,1.3261611889,1.9998794399,0.9254761238,3.3260406288
23005,2012,2695,2413,413,588,282,1001,9.5156381303,8.5199387045,1.4582406485,2.0761392284,0.9956994259,3.534379877
23005,2013,2890,2589,792,722,301,1514,10.149948811,9.0928088139,2.7815776673,2.5357311563,1.0571399973,5.3173088236
23005,2014,2826,2532,840,749,294,1589,9.8621359935,8.8361388307,2.9314204652,2.6138499148,1.0259971628,5.5452703799
23005,2015,2769,2634,945,828,135,1773,9.6006157708,9.1325467462,3.2764831721,2.8708233508,0.4680690246,6.1473065228
23005,2016,2766,2658,597,842,108,1439,9.5335587472,9.1613156725,2.0576769964,2.9021173048,0.3722430747,4.9597943012
23005,2017,2765,2641,643,836,124,1479,9.4788354574,9.0537448256,2.2043006145,2.8659336139,0.4250906317,5.0702342284
34011,2010,564,377,-182,90,187,-92,NA,NA,NA,NA,NA,NA
34011,2011,2246,1436,-881,457,810,-424,14.31361865,9.1515389052,-5.614558339,2.912432646,5.1620797446,-2.702125693
34011,2012,2150,1408,-1017,436,742,-581,13.677888897,8.9574267756,-6.469959539,2.7737486322,4.7204621218,-3.696210907
34011,2013,2031,1459,-1702,408,572,-1294,12.942942082,9.2977609539,-10.84632566,2.6000592661,3.6451811279,-8.246266398
34011,2014,2013,1533,-1023,446,480,-577,12.860729733,9.7940877698,-6.535780684,2.8494214908,3.0666419632,-3.686359193
34011,2015,2030,1560,-2223,515,470,-1708,13.023840686,10.008468704,-14.2620679,3.3040778094,3.0153719814,-10.95799009
34011,2016,1980,1413,-2450,531,567,-1919,12.8082801,9.1404544352,-15.84862942,3.4349478451,3.6678256651,-12.41368157
34011,2017,1912,1418,-2416,535,494,-1881,12.478300027,9.2543040998,-15.76755903,3.491574537,3.2239959276,-12.27598449
37051,2010,1375,514,5610,431,861,6041,NA,NA,NA,NA,NA,NA
37051,2011,5970,2271,-640,653,3699,13,18.143387465,6.9017810607,-1.945019762,1.9845279756,11.241606404,0.0395082139
37051,2012,5653,2290,-7077,2915,3363,-4162,17.101774162,6.9278370476,-21.40973921,8.818622268,10.173937114,-12.59111694
37051,2013,5550,2388,-1838,1762,3162,-76,16.729540601,7.1982239558,-5.540341554,5.3112523493,9.531316645,-0.229089205
37051,2014,5915,2387,-5673,1515,3528,-4158,17.762922789,7.1682327468,-17.03618952,4.5495905369,10.594690042,-12.48659898
37051,2015,5470,2428,-5987,1925,3042,-4062,16.464175369,7.3080471291,-18.02029578,5.7940653721,9.15612824,-12.22623041
37051,2016,5423,2541,-2372,1278,2882,-1094,16.302665003,7.6387740685,-7.130724947,3.8419335929,8.6638909348,-3.2887913539999998
37051,2017,5359,2587,-4530,758,2772,-3772,16.09106359,7.7677890476,-13.60188805,2.2759892146,8.3232745419,-11.32589884
42041,2010,625,518,260,140,107,400,NA,NA,NA,NA,NA,NA
42041,2011,2524,2164,346,465,360,811,10.673974364,9.1515374498,1.463231034,1.9664810139,1.522436914,3.429712048
42041,2012,2504,2232,1368,611,272,1979,10.514447918,9.3723034157,5.7443149967,2.5656260694,1.1421445023,8.3099410662
42041,2013,2560,2321,1104,604,239,1708,10.656276797,9.6614134552,4.5955193686,2.5142153067,0.9948633416,7.1097346754
42041,2014,2676,2122,1204,669,554,1873,11.039695047,8.7541976419,4.9670376818,2.7599237617,2.2854974051,7.7269614436
42041,2015,2611,2298,1624,725,313,2349,10.660623877,9.382655561,6.630736567,2.9601502531,1.2779683162,9.5908868202
42041,2016,2657,2295,607,696,362,1303,10.753928503,9.2887715144,2.4567687622,2.8169869168,1.4651569883,5.273755679
42041,2017,2638,2274,1117,694,364,1811,10.595079594,9.1331353282,4.4862410561,2.7873332972,1.4619442654,7.2735743533
47035,2010,139,178,168,0,-39,168,NA,NA,NA,NA,NA,NA
47035,2011,581,706,427,16,-125,443,10.308821051,12.526725752,7.5763624589,0.2838918017,-2.217904701,7.8602542606
47035,2012,556,747,531,26,-191,557,9.8046131057,13.172744586,9.3637581999,0.4584891021,-3.368131481,9.822247302
47035,2013,580,808,625,23,-228,648,10.156195279,14.148630665,10.944175947,0.4027456749,-3.992435386,11.346921622
47035,2014,526,787,733,28,-261,761,9.1352750135,13.668177634,12.730335713,0.4862884038,-4.532902621,13.216624116
47035,2015,573,834,516,31,-261,547,9.8828886321,14.384518533,8.8997740561,0.5346763483,-4.5016299,9.4344504045
47035,2016,541,791,627,36,-250,663,9.2752927461,13.561472388,10.749738543,0.6172098685,-4.286179642,11.366948412
47035,2017,545,804,767,36,-259,803,9.2679193946,13.672306777,13.043108579,0.6121928407,-4.404387382,13.65530142
51049,2010,30,35,-4,0,-5,-4,NA,NA,NA,NA,NA,NA
51049,2011,107,84,-69,-2,23,-71,10.694652674,8.395802099,-6.896551724,-0.19990005,2.2988505747,-7.096451774
51049,2012,116,82,-178,-2,34,-180,11.70475758,8.2740527723,-17.9607487,-0.201806165,3.430704808,-18.16255487
51049,2013,105,106,10,-1,-1,9,10.6685633,10.770168665,1.0160536476,-0.101605365,-0.101605365,0.9144482829
51049,2014,109,102,-11,-1,7,-12,11.074984759,10.363747206,-1.117659012,-0.101605365,0.7112375533,-1.219264377
51049,2015,97,71,-119,-1,26,-120,9.905539954,7.2504467705,-12.15215726,-0.102118969,2.6550931836,-12.25427623
51049,2016,82,82,-4,-1,0,-5,8.4154351396,8.4154351396,-0.410509031,-0.102627258,0,-0.513136289
51049,2017,86,106,91,-1,-20,90,8.7966041017,10.842325986,9.3080345727,-0.102286094,-2.045721884,9.2057484785
31039,2010,31,13,-2,3,18,1,NA,NA,NA,NA,NA,NA
31039,2011,102,111,-33,7,-9,-26,11.16034794,12.145084523,-3.610700804,0.7659062312,-0.984736583,-2.844794573
31039,2012,113,96,-67,16,17,-51,12.410763317,10.543657331,-7.358594179,1.7572762219,1.8671059857,-5.601317957
31039,2013,107,116,-83,14,-9,-69,11.821898133,12.816263396,-9.17025743,1.5467904099,-0.994365264,-7.62346702
31039,2014,113,98,-13,17,15,4,12.524244943,10.861734553,-1.440842339,1.8841784428,1.6625103907,0.4433361042
31039,2015,129,96,27,19,33,46,14.221928229,10.583760542,2.9766826526,2.0947026074,3.6381676865,5.0713852599
31039,2016,104,86,-146,19,18,-127,11.4853672,9.497515185,-16.12368857,2.0982882385,1.9878520155,-14.02540033
31039,2017,107,79,-6,19,28,13,11.86055534,8.7568586155,-0.66507787,2.1060799202,3.1036967245,1.4410020507
37053,2010,68,29,81,3,39,84,NA,NA,NA,NA,NA,NA
37053,2011,216,201,213,-1,15,212,9.0798268107,8.4492832822,8.953718105,-0.042036235,0.6305435285,8.9116818698
37053,2012,234,230,132,-3,4,129,9.762610038,9.5957278151,5.5071133547,-0.125161667,0.1668822229,5.3819516876
37053,2013,241,234,223,1,7,224,9.978882862,9.6890397913,9.2335721088,0.041406153,0.2898430707,9.2749782618
37053,2014,253,214,525,-1,39,524,10.304029975,8.7156617183,21.381880384,-0.040727391,1.5883682571,21.341152992
37053,2015,260,226,260,2,34,262,10.405410814,9.0447032457,10.405410814,0.0800416216,1.3607075679,10.485452435
37053,2016,258,214,483,2,44,485,10.157680269,8.425362704,19.016122365,0.0787417075,1.7323175653,19.094864072
37053,2017,266,224,621,2,42,623,10.231753053,8.6162130974,23.886912203,0.0769304741,1.6155399558,23.963842677
35009,2010,215,72,356,51,143,407,NA,NA,NA,NA,NA,NA
35009,2011,954,373,78,85,581,163,19.336400673,7.5602489004,1.580963577,1.7228449237,11.776151773,3.3038085007
35009,2012,952,388,15,352,564,367,18.971323808,7.7320101234,0.2989179171,7.0146071222,11.239313684,7.3135250394
35009,2013,909,385,-862,172,524,-690,17.974017757,7.6127577957,-17.0446681,3.401024262,10.361259961,-13.64364384
35009,2014,962,357,-375,158,605,-217,18.980348828,7.0436429642,-7.398784626,3.1173545892,11.936705864,-4.281430037
35009,2015,896,441,-1504,221,455,-1283,17.752768917,8.7376909512,-29.79929068,4.3787521547,9.0150779656,-25.42053853
35009,2016,875,387,-549,163,488,-386,17.458797239,7.7217766072,-10.95414821,3.2523245141,9.7370206313,-7.701823696
35009,2017,878,362,-955,82,516,-873,17.563512703,7.2414482897,-19.10382076,1.6403280656,10.322064413,-17.4634927
41015,2010,51,78,37,0,-27,37,NA,NA,NA,NA,NA,NA
41015,2011,179,343,281,-17,-164,264,7.9819847941,15.295088181,12.530378364,-0.758065595,-7.313103387,11.772312769
41015,2012,190,349,-44,-21,-159,-65,8.4961767205,15.606135134,-1.967535662,-0.939051111,-7.109958413,-2.906586773
41015,2013,176,370,183,-22,-194,161,7.9161606621,16.641928665,8.2310079611,-0.989520083,-8.725768003,7.2414878784
41015,2014,180,386,143,-25,-206,118,8.1177982727,17.408167407,6.4491397389,-1.127471982,-9.290369134,5.3216677566
41015,2015,174,385,383,-25,-211,358,7.8355436471,17.337266116,17.247202396,-1.125796501,-9.501722469,16.121405895
41015,2016,173,394,552,-26,-221,526,7.7109937376,17.561453946,24.603864411,-1.158877672,-9.850460208,23.44498674
41015,2017,181,362,288,-26,-181,262,7.9987626224,15.997525245,12.727312902,-1.148993526,-7.998762622,11.578319376
08027,2010,5,4,26,0,1,26,NA,NA,NA,NA,NA,NA
08027,2011,21,29,-46,0,-8,-46,4.9347902714,6.8147103748,-10.80954059,0,-1.879920103,-10.80954059
08027,2012,26,36,3,0,-10,3,6.1538461538,8.5207100592,0.7100591716,0,-2.366863905,0.7100591716
08027,2013,20,36,58,0,-16,58,4.7130906092,8.4835630965,13.667962767,0,-3.770472487,13.667962767
08027,2014,22,36,92,0,-14,92,5.1103368177,8.362369338,21.370499419,0,-3.25203252,21.370499419
08027,2015,25,33,102,0,-8,102,5.6921675774,7.5136612022,23.224043716,0,-1.821493625,23.224043716
08027,2016,23,44,183,0,-21,183,5.0884955752,9.7345132743,40.486725664,0,-4.646017699,40.486725664
08027,2017,25,39,285,0,-14,285,5.2770448549,8.2321899736,60.158311346,0,-2.955145119,60.158311346
16037,2010,6,14,0,1,-8,1,NA,NA,NA,NA,NA,NA
16037,2011,46,44,-36,1,2,-35,10.595416331,10.134746056,-8.292064955,0.2303351376,0.4606702753,-8.061729817
16037,2012,35,40,5,4,-5,9,8.0896798798,9.2453484341,1.1556685543,0.9245348434,-1.155668554,2.0802033977
16037,2013,38,37,-106,1,1,-105,8.8836937463,8.649912332,-24.78082992,0.2337814144,0.2337814144,-24.54704851
16037,2014,36,38,-92,2,-2,-90,8.6103802918,9.0887347525,-22.00430519,0.4783544607,-0.478354461,-21.52595073
16037,2015,36,41,-69,2,-5,-67,8.7826299097,10.002439619,-16.83337399,0.4879238839,-1.21980971,-16.34545011
16037,2016,46,42,39,2,4,41,11.257953989,10.279001468,9.5447870778,0.4894762604,0.9789525208,10.034263338
16037,2017,39,29,51,2,10,53,9.4191522763,7.003985026,12.317352977,0.4830334501,2.4151672503,12.800386427
30017,2010,34,41,0,1,-7,1,NA,NA,NA,NA,NA,NA
30017,2011,152,142,54,1,10,55,12.965411353,12.112423764,4.6061329808,0.0852987589,0.852987589,4.6914317397
30017,2012,139,137,44,-5,2,39,11.804670913,11.634819533,3.7367303609,-0.42462845,0.16985138,3.3121019108
30017,2013,175,161,55,1,14,56,14.793524663,13.61004269,4.6493934655,0.0845344266,1.183481973,4.7339278921
30017,2014,152,122,108,-1,30,107,12.737785972,10.223749267,9.0505321378,-0.083801223,2.5140367049,8.9667309143
30017,2015,164,137,43,-1,27,42,13.626355365,11.382991982,3.5727639068,-0.083087533,2.2433633833,3.4896763741
30017,2016,155,147,-255,-1,8,-256,12.976140645,12.306404353,-21.34784429,-0.083717036,0.6697362913,-21.43156132
30017,2017,157,144,-111,-1,13,-112,13.337864243,12.233455102,-9.429954974,-0.084954549,1.1044091411,-9.514909523
31041,2010,29,38,-24,0,-9,-24,NA,NA,NA,NA,NA,NA
31041,2011,105,157,52,-2,-52,50,9.6259625963,14.393105977,4.767143381,-0.183351669,-4.767143381,4.5837917125
31041,2012,122,132,-47,-2,-10,-49,11.216843654,12.136257068,-4.321243047,-0.183882683,-0.919413414,-4.50512573
31041,2013,118,136,6,-2,-18,4,10.886110983,12.546704184,0.5535310669,-0.184510356,-1.660593201,0.3690207113
31041,2014,137,127,-66,-1,10,-67,12.679901893,11.754361609,-6.108565875,-0.092554028,0.9255402841,-6.201119904
31041,2015,136,124,48,0,12,48,12.585600592,11.475106422,4.4419766796,0,1.1104941699,4.4419766796
31041,2016,140,125,-13,0,15,-13,12.919896641,11.535622001,-1.199704688,0,1.3842746401,-1.199704688
31041,2017,143,124,43,0,19,43,13.159105549,11.410692924,3.9569338364,0,1.7484126254,3.9569338364
40039,2010,106,92,-11,4,14,-7,NA,NA,NA,NA,NA,NA
40039,2011,464,302,25,22,162,47,16.825615549,10.951154948,0.9065525619,0.7977662545,5.8744606012,1.7043188164
40039,2012,476,268,541,30,208,571,16.953680124,9.5453493135,19.268783502,1.0685092515,7.4083308105,20.337292754
40039,2013,456,292,522,28,164,550,15.814389013,10.126757877,18.103313739,0.9710589745,5.6876311363,19.074372713
40039,2014,491,287,-68,56,204,-12,16.762255906,9.7978970367,-2.321452956,1.9117847877,6.9643588693,-0.409668169
40039,2015,441,327,-147,65,114,-82,14.998724598,11.121503274,-4.999574866,2.2106963694,3.8772213247,-2.788878497
40039,2016,435,293,-586,70,142,-516,14.881206917,10.023433625,-20.04686725,2.3946769752,4.8577732925,-17.65219027
40039,2017,418,279,-456,70,139,-386,14.452415939,9.646469012,-15.76627193,2.4202610424,4.8059469271,-13.34601089
46033,2010,26,11,40,0,15,40,NA,NA,NA,NA,NA,NA
46033,2011,81,86,75,-1,-5,74,9.7455332972,10.347109427,9.0236419419,-0.120315226,-0.601576129,8.903326716
46033,2012,68,90,-8,-1,-22,-9,8.161795595,10.802376523,-0.960211246,-0.120026406,-2.640580928,-1.080237652
46033,2013,67,85,104,1,-18,105,8.0138747683,10.166856049,12.439447401,0.1196100712,-2.152981281,12.559057473
46033,2014,69,64,22,1,5,23,8.1962344836,7.6023044485,2.6132921542,0.118786007,0.593930035,2.7320781612
46033,2015,72,92,36,1,-20,37,8.529795048,10.899182561,4.264897524,0.1184693757,-2.369387513,4.3833668997
46033,2016,79,105,192,1,-26,193,9.2581741474,12.305168171,22.500878941,0.1171920778,-3.046994023,22.618071018
46033,2017,80,88,84,1,-8,85,9.244814237,10.169295661,9.7070549489,0.115560178,-0.924481424,9.8226151268
39035,2010,3804,3273,-3136,626,531,-2510,NA,NA,NA,NA,NA,NA
39035,2011,15002,13763,-11934,2797,1239,-9137,11.772456203,10.800180958,-9.3649175,2.1948780163,0.9722752457,-7.170039483
39035,2012,14857,13875,-8028,2809,982,-5219,11.713777624,10.939534532,-6.329555547,2.2147136937,0.7742430926,-4.114841854
39035,2013,14873,13796,-5534,2962,1077,-2572,11.753447088,10.902343577,-4.373265393,2.3407322177,0.8511035106,-2.032533175
39035,2014,15135,13412,-7546,3724,1723,-3822,11.978246839,10.61461821,-5.97210774,2.9472739497,1.3636286292,-3.02483379
39035,2015,14990,13549,-9851,3924,1441,-5927,11.894861801,10.751399769,-7.816963549,3.1137716948,1.1434620317,-4.703191854
39035,2016,14651,13585,-9556,3996,1066,-5560,11.667544659,10.818619493,-7.610064621,3.1822748248,0.848925166,-4.427789796
39035,2017,14637,13439,-10087,3961,1198,-6126,11.700389453,10.742743312,-8.063252608,3.1663074827,0.957646141,-4.896945125
13083,2010,22,29,-4,0,-7,-4,NA,NA,NA,NA,NA,NA
13083,2011,148,142,-37,1,6,-36,8.9132464091,8.5518985817,-2.228311602,0.0602246379,0.3613478274,-2.168086964
13083,2012,204,156,-125,-6,48,-131,12.327401275,9.4268362691,-7.553554703,-0.362570626,2.9005650059,-7.916125329
13083,2013,155,181,-30,-6,-26,-36,9.4073377234,10.985342761,-1.820775043,-0.364155009,-1.578005037,-2.184930052
13083,2014,172,179,-151,-5,-7,-156,10.511198704,10.938980047,-9.227854677,-0.305558102,-0.427781343,-9.533412778
13083,2015,162,202,-79,-5,-40,-84,9.9879774346,12.454144702,-4.870680354,-0.308270908,-2.466167268,-5.178951262
13083,2016,168,171,94,-6,-3,88,10.370690453,10.555881354,5.8026482299,-0.370381802,-0.185190901,5.432266428
13083,2017,165,173,59,-6,-8,53,10.145417653,10.637316691,3.6277554032,-0.368924278,-0.491899038,3.2588311249
29057,2010,15,41,-13,0,-26,-13,NA,NA,NA,NA,NA,NA
29057,2011,71,103,-41,0,-32,-41,9.0955675122,13.194978222,-5.252369972,0,-4.09941071,-5.252369972
29057,2012,71,95,-189,0,-24,-189,9.2628832355,12.393998695,-24.65753425,0,-3.13111546,-24.65753425
29057,2013,65,90,-3,2,-25,-1,8.6109823144,11.922898589,-0.397429953,0.264953302,-3.311916275,-0.132476651
29057,2014,57,95,98,2,-38,100,7.5317124736,12.552854123,12.949260042,0.2642706131,-5.021141649,13.213530655
29057,2015,75,115,14,2,-40,16,9.8846787479,15.156507414,1.8451400329,0.2635914333,-5.271828666,2.1087314662
29057,2016,66,103,65,2,-37,67,8.6950793755,13.569593571,8.5633357486,0.2634872538,-4.874514195,8.8268230024
29057,2017,72,108,18,2,-36,20,9.4774252995,14.216137949,2.3693563249,0.2632618139,-4.73871265,2.6326181387
49009,2010,10,0,5,0,10,5,NA,NA,NA,NA,NA,NA
49009,2011,11,5,78,0,6,78,9.825815096,4.4662795891,69.67396159,0,5.3595355069,69.67396159
49009,2012,8,5,-74,0,3,-74,7.0921985816,4.4326241135,-65.60283688,0,2.6595744681,-65.60283688
49009,2013,14,9,39,0,5,39,12.539184953,8.0609046126,34.930586655,0,4.4782803403,34.930586655
49009,2014,9,12,-14,1,-3,-13,7.9575596817,10.610079576,-12.37842617,0.884173298,-2.652519894,-11.49425287
49009,2015,11,10,-20,1,1,-19,9.8698968147,8.9726334679,-17.94526694,0.8972633468,0.8972633468,-17.04800359
49009,2016,10,10,-26,1,0,-25,9.1449474166,9.1449474166,-23.77686328,0.9144947417,0,-22.86236854
49009,2017,8,6,-55,1,2,-54,7.5829383886,5.6872037915,-52.13270142,0.9478672986,1.8957345972,-51.18483412
27037,2010,1322,481,-407,166,841,-241,NA,NA,NA,NA,NA,NA
27037,2011,5122,2268,-849,617,2854,-232,12.789189365,5.6629991173,-2.119879299,1.5405954389,7.1261902473,-0.57928386
27037,2012,5219,2136,-753,638,3083,-115,12.941573223,5.2966469448,-1.86721683,1.5820509133,7.6449262784,-0.285165917
27037,2013,5156,2319,12,577,2837,589,12.685650035,5.7055900759,0.0295243988,1.4196315109,6.9800599591,1.4491559097
27037,2014,5291,2327,128,660,2964,788,12.905145594,5.6757274236,0.3122015944,1.6097894712,7.2294181709,1.9219910657
27037,2015,5307,2460,-1325,765,2847,-560,12.850423444,5.9566688661,-3.208368393,1.8523787328,6.893754578,-1.355989661
27037,2016,5247,2465,-238,759,2782,521,12.619942973,5.9287515589,-0.572431185,1.8255263421,6.6911914145,1.2530951571
27037,2017,5219,2575,956,753,2644,1709,12.438451235,6.1370017112,2.2784363635,1.7946261315,6.3014495241,4.0730624949
31043,2010,106,63,-41,21,43,-20,NA,NA,NA,NA,NA,NA
31043,2011,353,172,-443,43,181,-400,16.867757735,8.2188507944,-21.1683192,2.0547126986,8.6489069406,-19.1136065
31043,2012,383,136,-362,31,247,-331,18.428079967,6.5436524166,-17.41766305,1.4915678302,11.884427551,-15.92609522
31043,2013,371,144,-190,20,227,-170,17.859721754,6.93207529,-9.14648823,0.9627882347,10.927646464,-8.183699995
31043,2014,357,176,-422,40,181,-382,17.240962983,8.4997464564,-20.38007389,1.9317605583,8.7412165262,-18.44831333
31043,2015,373,149,-243,50,224,-193,18.082656648,7.2233668646,-11.78039026,2.4239486123,10.859289783,-9.356441643
31043,2016,353,156,-492,51,197,-441,17.200633451,7.6014130832,-23.97368742,2.4850773541,9.5992203679,-21.48861006
31043,2017,347,149,-463,49,198,-414,17.099071131,7.3422524454,-22.81518713,2.4145662404,9.7568186858,-20.40062089
01045,2010,173,74,-1,50,99,49,NA,NA,NA,NA,NA,NA
01045,2011,693,470,-564,51,223,-513,13.791182002,9.3533268988,-11.22399228,1.014935472,4.437855103,-10.20905681
01045,2012,704,451,-242,174,253,-68,14.024742514,8.9846006733,-4.821005239,3.4663426101,5.0401418411,-1.354662629
01045,2013,649,492,-776,82,157,-694,12.974031945,9.8354756812,-15.51286408,1.6392459469,3.1385562641,-13.87361814
01045,2014,667,461,-632,66,206,-566,13.451919974,9.2973539852,-12.74604711,1.3310745402,4.154565989,-11.41497257
01045,2015,640,533,-270,101,107,-169,12.961631545,10.794608771,-5.468188308,2.0455074783,2.167022774,-3.42268083
01045,2016,649,522,-285,44,127,-241,13.168039606,10.591242949,-5.782575173,0.8927484478,2.5767966563,-4.889826726
01045,2017,638,543,-101,7,95,-94,12.960367278,11.030532025,-2.051719585,0.1421983871,1.929835253,-1.909521198
48111,2010,25,1,16,4,24,20,NA,NA,NA,NA,NA,NA
48111,2011,137,42,19,22,95,41,20.105664808,6.163780452,2.7883768711,3.2286469034,13.941884356,6.0170237746
48111,2012,135,60,67,24,75,91,19.382627423,8.6145010768,9.6195262024,3.4458004307,10.768126346,13.065326633
48111,2013,147,46,-72,27,101,-45,20.777385159,6.5017667845,-10.17667845,3.816254417,14.275618375,-6.360424028
48111,2014,141,48,-24,33,93,9,19.713386928,6.7109402307,-3.355470115,4.6137714086,13.002446697,1.2583012933
48111,2015,151,40,-87,36,111,-51,20.875095044,5.5298265017,-12.02737264,4.9768438515,15.345268542,-7.05052879
48111,2016,147,25,-167,38,122,-129,20.247933884,3.4435261708,-23.00275482,5.2341597796,16.804407713,-17.76859504
48111,2017,163,30,-220,38,133,-182,22.538716814,4.1482300885,-30.42035398,5.2544247788,18.390486726,-25.1659292
01047,2010,130,76,-5,0,54,-5,NA,NA,NA,NA,NA,NA
01047,2011,584,544,-652,-7,40,-659,13.406949116,12.48866493,-14.96803223,-0.160699733,0.918284186,-15.12873196
01047,2012,585,504,-547,-6,81,-553,13.59658807,11.713983568,-12.7133909,-0.139452185,1.882604502,-12.85284308
01047,2013,510,555,-776,-5,-45,-781,12.031707087,13.0933283,-18.30706804,-0.117957913,-1.061621214,-18.42502595
01047,2014,551,536,-436,-3,15,-439,13.191285612,12.832176203,-10.43811348,-0.071821882,0.3591094087,-10.50993536
01047,2015,490,515,-602,-1,-25,-603,11.879075856,12.485151155,-14.59429319,-0.024243012,-0.606075299,-14.61853621
01047,2016,509,568,-799,-1,-59,-800,12.564798815,14.021229326,-19.72352506,-0.024685263,-1.456430511,-19.74821032
01047,2017,492,552,-807,-1,-60,-808,12.409200969,13.92251816,-20.35411622,-0.025221953,-1.513317191,-20.37933818
05039,2010,26,50,-35,-1,-24,-36,NA,NA,NA,NA,NA,NA
05039,2011,98,101,-15,3,-3,-12,12.165601142,12.538017504,-1.862081807,0.3724163615,-0.372416361,-1.489665446
05039,2012,79,119,-66,4,-40,-62,9.8787045142,14.880580218,-8.253094911,0.5001875703,-5.001875703,-7.75290734
05039,2013,78,113,-27,3,-35,-24,9.8522167488,14.273083239,-3.410382721,0.3789314134,-4.42086649,-3.031451307
05039,2014,65,107,-161,2,-42,-159,8.347245409,13.740850135,-20.67548478,0.2568383203,-5.393604726,-20.41864646
05039,2015,81,115,-127,2,-34,-125,10.646687697,15.115667718,-16.69295478,0.2628811777,-4.468980021,-16.43007361
05039,2016,73,71,-104,2,2,-102,9.7600106959,9.4926131426,-13.90467277,0.2673975533,0.2673975533,-13.63727522
05039,2017,70,76,-32,2,-6,-30,9.4447817581,10.25433448,-4.317614518,0.2698509074,-0.809552722,-4.047763611
19049,2010,286,59,324,22,227,346,NA,NA,NA,NA,NA,NA
19049,2011,1008,354,1996,166,654,2162,14.7863461,5.1928239281,29.279312318,2.4350530284,9.5935221722,31.714365346
19049,2012,1127,374,1544,234,753,1778,15.89775781,5.2757421657,21.780069262,3.3008654192,10.622015644,25.080934681
19049,2013,1218,371,1542,246,847,1788,16.569399665,5.0470010475,20.977023222,3.3465289964,11.522398618,24.323552218
19049,2014,1190,419,1660,259,771,1919,15.615670785,5.4982908058,21.783204624,3.3987048179,10.117379979,25.181909442
19049,2015,1254,426,1781,286,828,2067,15.86739213,5.3903580919,22.535745919,3.6188789067,10.477034038,26.154624826
19049,2016,1287,465,2570,297,822,2867,15.630692997,5.6474531808,31.212805752,3.6070829993,9.9832398164,34.819888751
19049,2017,1312,474,1907,295,838,2202,15.307432038,5.5302765138,22.249445806,3.4418387586,9.7771555244,25.691284564
29059,2010,46,60,-32,-1,-14,-33,NA,NA,NA,NA,NA,NA
29059,2011,190,182,-39,-3,8,-42,11.36941627,10.890704006,-2.333722287,-0.179517099,0.478712264,-2.513239386
29059,2012,210,141,-55,-7,69,-62,12.57710966,8.444630772,-3.294004911,-0.419236989,4.1324788884,-3.7132419
29059,2013,199,185,-248,-6,14,-254,12.000241211,11.156003136,-14.95507447,-0.361816318,0.8442380751,-15.31689079
29059,2014,191,189,-119,-6,2,-125,11.643856494,11.521931295,-7.254549334,-0.365775597,0.1219251989,-7.620324931
29059,2015,200,200,10,-6,0,4,12.238029677,12.238029677,0.6119014839,-0.36714089,0,0.2447605935
29059,2016,221,204,25,-6,17,19,13.507319011,12.468294472,1.5279772637,-0.366714543,1.0390245393,1.1612627204
29059,2017,218,205,286,-6,13,280,13.19093577,12.404320334,17.305539588,-0.363053278,0.7866154358,16.94248631
48113,2010,9738,3409,-2710,1931,6329,-779,NA,NA,NA,NA,NA,NA
48113,2011,39036,14313,1232,10163,24723,11395,16.331721889,5.9882143507,0.5154391169,4.2519543385,10.343507538,4.7673934553
48113,2012,38572,14314,12582,9641,24258,22223,15.863739314,5.8870051989,5.1746751022,3.9651122763,9.9767341146,9.1397873785
48113,2013,38849,15067,-5060,10541,23782,5481,15.732836997,6.1017440613,-2.04916871,4.268831496,9.6310929359,2.2196627862
48113,2014,39264,15270,-2211,12281,23994,10070,15.70175621,6.1065051275,-0.884183552,4.9111977388,9.5952510825,4.0270141869
48113,2015,40130,15706,-1439,14093,24424,12654,15.825224532,6.1936450662,-0.567468181,5.5575601629,9.6315794662,4.9900919819
48113,2016,40506,16393,-5549,14667,24113,9118,15.755893728,6.3764964666,-2.15843219,5.7051225326,9.379397261,3.5466903424
48113,2017,40530,16520,-7859,14647,24010,6788,15.571662111,6.3469987187,-3.019434802,5.6273904499,9.224663392,2.6079556478
55025,2010,1600,721,12,291,879,303,NA,NA,NA,NA,NA,NA
55025,2011,5981,2983,2553,1356,2998,3909,12.139947348,6.0547505333,5.1819571276,2.7523438562,6.0851968149,7.9343009838
55025,2012,6109,2912,2384,1414,3197,3798,12.226925656,5.8282546259,4.7714831827,2.8300659481,6.3986710299,7.6015491309
55025,2013,6145,3169,1901,1526,2976,3427,12.136150026,6.2586589801,3.7544054027,3.0137941318,5.877491046,6.7681995345
55025,2014,6305,3234,1611,1699,3071,3310,12.297160243,6.3075362771,3.1420658449,3.3136994851,5.9896239663,6.45576533
55025,2015,6187,3222,1393,1849,2965,3242,11.921323504,6.2082599531,2.6840801101,3.562716528,5.7130635508,6.2467966381
55025,2016,6120,3119,3282,1886,3001,5168,11.631321324,5.9277926812,6.2375811413,3.5844235321,5.7035286426,9.8220046734
55025,2017,6138,3191,1343,1870,2947,3213,11.508681667,5.9830894754,2.5181100487,3.5062291818,5.5255921918,6.0243392305
30019,2010,6,12,4,0,-6,4,NA,NA,NA,NA,NA,NA
30019,2011,18,31,23,1,-13,24,10.256410256,17.663817664,13.105413105,0.5698005698,-7.407407407,13.675213675
30019,2012,17,13,9,0,4,9,9.6153846154,7.3529411765,5.0904977376,0,2.2624434389,5.0904977376
30019,2013,20,19,-1,2,1,1,11.264432554,10.701210926,-0.563221628,1.1264432554,0.5632216277,0.5632216277
30019,2014,24,32,23,4,-8,27,13.441612994,17.922150658,12.881545785,2.2402688323,-4.480537665,15.121814618
30019,2015,20,29,-41,4,-9,-37,11.289867344,16.370307649,-23.14422806,2.2579734688,-5.080440305,-20.88625459
30019,2016,12,15,-16,4,-3,-12,6.8925904652,8.6157380816,-9.19012062,2.2975301551,-1.723147616,-6.892590465
30019,2017,14,14,-2,4,0,2,8.0668395275,8.0668395275,-1.152405647,2.3048112936,0,1.1524056468
51590,2010,121,181,-98,1,-60,-97,NA,NA,NA,NA,NA,NA
51590,2011,516,681,-118,14,-165,-104,12.06171108,15.918653576,-2.75829827,0.327255727,-3.856942496,-2.4310425429999998
51590,2012,536,699,196,36,-163,232,12.560488359,16.38018911,4.5930144,0.8436148898,-3.819700751,5.4366292898
51590,2013,558,687,23,39,-129,62,13.077563073,16.100870666,0.5390393382,0.9140232256,-3.023307592,1.4530625637
51590,2014,540,648,-322,40,-108,-282,12.724744916,15.269693899,-7.587718265,0.9425736975,-2.544948983,-6.645144567
51590,2015,529,689,-211,43,-160,-168,12.572487879,16.375130716,-5.014735241,1.0219602624,-3.802642837,-3.992774979
51590,2016,527,691,-146,44,-164,-102,12.614747526,16.540399507,-3.49478774,1.0532237023,-3.925651981,-2.441564037
51590,2017,518,646,-428,44,-128,-384,12.516158651,15.608954611,-10.34153649,1.0631486113,-3.09279596,-9.27838788
37055,2010,96,91,57,2,5,59,NA,NA,NA,NA,NA,NA
37055,2011,361,300,139,-4,61,135,10.592412194,8.8025586104,4.0785188228000004,-0.117367448,1.7898535841,3.9611513747
37055,2012,385,304,153,15,81,168,11.223835345,8.8624569996000009,4.4603813189,0.4372922862,2.3613783453,4.897673605
37055,2013,368,292,341,5,76,346,10.623863275,8.4298045556,9.844395046,0.1443459684,2.1940587199,9.9887410145
37055,2014,354,306,13,1,48,14,10.149228057,8.7730615404,0.3727117648,0.0286701358,1.3761665161,0.4013819005
37055,2015,347,285,459,7,62,466,9.8652413715,8.1025757662,13.049411497,0.1990106329,1.7626656053,13.24842213
37055,2016,327,343,325,11,-16,336,9.1852642519,9.6346961419,9.1290852657,0.3089844244,-0.44943189,9.43806969
37055,2017,329,357,355,11,-28,366,9.1568209967,9.9361249113,9.880460346,0.3061551093,-0.779303915,10.186615455
39037,2010,156,149,-10,2,7,-8,NA,NA,NA,NA,NA,NA
39037,2011,601,555,-367,-2,46,-369,11.381497964,10.510368336,-6.950099422,-0.037875201,0.8711296279,-6.987974624
39037,2012,623,520,-242,0,103,-242,11.849287711,9.8902561957,-4.602773076,0,1.9590315157,-4.602773076
39037,2013,594,597,-216,3,-3,-213,11.335661533,11.392912349,-4.122058739,0.0572508158,-0.057250816,-4.064807924
39037,2014,655,566,-215,6,89,-209,12.539845119,10.835957767,-4.116132367,0.1148688102,1.703887352,-4.001263557
39037,2015,614,648,-189,9,-34,-180,11.793064372,12.44610051,-3.630112649,0.1728625071,-0.653036138,-3.457250142
39037,2016,617,579,-363,7,38,-356,11.912116766,11.17846938,-7.008263186,0.1351455711,0.7336473859,-6.873117615
39037,2017,594,592,-107,7,2,-100,11.514752065,11.475981856,-2.07420618,0.1356957314,0.038770209,-1.938510449
45031,2010,184,213,-60,6,-29,-54,NA,NA,NA,NA,NA,NA
45031,2011,798,799,-407,51,-1,-356,11.661892792,11.676506693,-5.947857602,0.7453089379,-0.014613901,-5.202548664
45031,2012,792,761,-136,9,31,-127,11.612732951,11.158194161,-1.994105658,0.1319628744,0.4545387898,-1.862142784
45031,2013,803,846,-198,4,-43,-194,11.804136593,12.436238552,-2.910609023,0.058800182300000003,-0.63210196,-2.851808841
45031,2014,737,790,-113,6,-53,-107,10.867241239,11.648738913,-1.666212022,0.0884714348,-0.781497674,-1.577740587
45031,2015,840,843,-143,8,-3,-135,12.414924513,12.459263529,-2.113493102,0.1182373763,-0.044339016,-1.995255725
45031,2016,821,802,-248,13,19,-235,12.166748174,11.885179093,-3.675217475,0.1926525289,0.2815690808,-3.482564946
45031,2017,795,816,-93,13,-21,-80,11.809707728,12.121662272,-1.38151298,0.1931147176,-0.311954544,-1.188398262
42043,2010,841,565,-293,163,276,-130,NA,NA,NA,NA,NA,NA
42043,2011,3455,2490,-858,787,965,-71,12.859713736,9.2679268318,-3.193526595,2.9292604083,3.5917869047,-0.264266187
42043,2012,3392,2407,-1045,911,985,-134,12.585196811,8.9305921944,-3.877220126,3.3800454878,3.6546046163,-0.497174638
42043,2013,3487,2443,-524,991,1044,467,12.882370327,9.0254174671,-1.935865228,3.6611496971,3.8569528595,1.7252844687
42043,2014,3486,2401,-1346,1073,1085,-273,12.824686971,8.8330675319,-4.951815451,3.9474724955,3.9916194386,-1.004342956
42043,2015,3472,2461,-1169,1134,1011,-35,12.732056583,9.0246518578,-4.286801309,4.1584539646,3.707404725,-0.128347345
42043,2016,3371,2534,-1067,1175,837,108,12.318722741,9.2600544129,-3.899162612,4.2938294929,3.0586683282,0.3946668811
42043,2017,3331,2518,-386,1172,813,786,12.116450327,9.159178002,-1.404067795,4.2631281248,2.9572723255,2.8590603294
37057,2010,414,326,-68,22,88,-46,NA,NA,NA,NA,NA,NA
37057,2011,1727,1585,-83,72,142,-11,10.600619955,9.7289997852,-0.509468128,0.4419482552,0.87162017,-0.067519872
37057,2012,1744,1602,-53,71,142,18,10.696630316,9.8256890862,-0.325069614,0.4354706149,0.8709412299,0.110401001
37057,2013,1680,1742,318,55,-62,373,10.290649597,10.67042357,1.9478729595,0.3368962666,-0.379773973,2.2847692261
37057,2014,1763,1702,45,51,61,96,10.785249352,10.4120785,0.2752899721,0.3119953017,0.3731708511,0.5872852738
37057,2015,1702,1780,205,59,-78,264,10.402787116,10.879530591,1.2529796467,0.3606136544,-0.47674347500000003,1.6135933011
37057,2016,1782,1787,760,65,-5,825,10.859430703,10.889900486,4.6314070336,0.3961071805,-0.030469783,5.0275142142
37057,2017,1757,1730,875,66,27,941,10.649452981,10.48580174,5.3035124405,0.4000363669,0.163651241,5.7035488075
47037,2010,2414,1205,-314,539,1209,225,NA,NA,NA,NA,NA,NA
47037,2011,9483,4931,556,2488,4552,3044,15.009793641,7.8048394436,0.8800427359,3.938032962,7.2049541974,4.8180756979
47037,2012,9713,4924,6171,2540,4789,8711,15.118356826,7.6642426657,9.6052074513,3.9535289137,7.4541141605,13.558736365
47037,2013,9895,5132,2765,2919,4763,5684,15.116170713,7.8399381604,4.2239729177,4.4592321688,7.2762325522,8.6832050865
47037,2014,10020,5163,1967,3527,4857,5494,15.065607563,7.76284749,2.9574900277,5.3030337202,7.3027600734,8.2605237479
47037,2015,10357,5143,1751,3918,5214,5669,15.325551439,7.6102453464,2.5910051724,5.7975775359,7.715306093,8.3885827083
47037,2016,10248,5462,-1179,4005,4786,2826,14.958553072,7.9726402109,-1.720934238,5.8459216486,6.9859128615,4.1249874105
47037,2017,10258,5456,-6371,3974,4802,-2397,14.865115524,7.9064213589,-9.232369956,5.7588193696,6.9586941652,-3.473550586
37059,2010,75,105,61,5,-30,66,NA,NA,NA,NA,NA,NA
37059,2011,371,400,111,20,-29,131,8.9821809026,9.6842920782,2.6873910517,0.4842146039,-0.702111176,3.1716056556
37059,2012,399,401,-60,14,-2,-46,9.6549387795,9.7033344626,-1.451870493,0.3387697817,-0.048395683,-1.113100711
37059,2013,390,430,172,19,-40,191,9.4264375317,10.393251638,4.157300655,0.4592367003,-0.966814106,4.6165373553
37059,2014,392,421,-153,14,-29,-139,9.477068878,10.178178565,-3.698958006,0.3384667456,-0.701109687,-3.36049126
37059,2015,360,464,482,18,-104,500,8.6791952457,11.186518317,11.620478079,0.4339597623,-2.507323071,12.054437841
37059,2016,398,495,371,24,-97,395,9.5158398087,11.835026898,8.870292887,0.573819486,-2.319187089,9.444112373
37059,2017,402,429,488,23,-27,511,9.5227943005,10.162384963,11.560009002,0.5448364898,-0.639590662,12.104845491
18027,2010,144,92,11,5,52,16,NA,NA,NA,NA,NA,NA
18027,2011,522,329,11,26,193,37,16.399365389,10.335998492,0.3455804967,0.8168266285,6.0633668965,1.1624071252
18027,2012,535,351,-30,14,184,-16,16.704655447,10.959502919,-0.936709651,0.4371311706,5.7451525276,-0.499578481
18027,2013,524,327,-42,13,197,-29,16.276324781,10.157172144,-1.304590918,0.4038019507,6.1191526371,-0.900788967
18027,2014,533,333,199,4,200,203,16.411361712,10.253252252,6.1273189131,0.1231621892,6.1581094604,6.2504811023
18027,2015,543,348,-57,6,195,-51,16.581165262,10.626603151,-1.740564309,0.1832172957,5.9545621107,-1.557347014
18027,2016,513,301,-39,7,212,-32,15.589151409,9.1468510218,-1.185140166,0.2127174656,6.4423003874,-0.9724227
18027,2017,523,318,-95,8,205,-87,15.822114657,9.6203297534,-2.873997882,0.2420208743,6.2017849039,-2.631977008
21059,2010,318,260,7,4,58,11,NA,NA,NA,NA,NA,NA
21059,2011,1318,960,96,32,358,128,13.594636411,9.9020113461,0.9902011346,0.3300670449,3.6926250645,1.3202681795
21059,2012,1368,959,236,64,409,300,14.026165771,9.8326703031,2.4197186564,0.6561948899,4.1934954682,3.0759135463
21059,2013,1296,986,20,92,310,112,13.213164227,10.052607969,0.2039068553,0.9379715346,3.1605562579,1.14187839
21059,2014,1332,1010,-285,110,322,-175,13.54277871,10.268923796,-2.897666616,1.1183976412,3.2738549133,-1.779268975
21059,2015,1356,1059,536,116,297,652,13.711858837,10.70859772,5.4200267968,1.1729908739,3.0032611169,6.5930176707
21059,2016,1399,1007,-30,119,392,89,14.045620658,10.110035742,-0.301192723,1.1947311353,3.9355849163,0.8935384121
21059,2017,1371,1031,77,118,340,195,13.695072371,10.298774336,0.7691616138,1.1787152004,3.3962980351,1.9478768143
29061,2010,23,11,8,0,12,8,NA,NA,NA,NA,NA,NA
29061,2011,119,92,-185,-1,27,-186,14.211500567,10.987042455,-22.09350929,-0.119424375,3.2244581119,-22.21293366
29061,2012,114,78,-31,1,36,-30,13.73990599,9.400988309,-3.736290225,0.1205254911,4.3389176811,-3.615764734
29061,2013,103,105,4,1,-2,5,12.409638554,12.65060241,0.4819277108,0.1204819277,-0.240963855,0.6024096386
29061,2014,124,86,-16,1,38,-15,14.918190568,10.346487007,-1.924927815,0.1203079885,4.5717035611,-1.804619827
29061,2015,123,97,-69,1,26,-68,14.814814815,11.683227943,-8.310749774,0.1204456489,3.1315868714,-8.190304125
29061,2016,112,89,-73,1,23,-72,13.563427187,10.778080533,-8.840448078,0.1211020285,2.7853466546,-8.719346049
29061,2017,107,85,105,1,22,106,12.896227552,10.244666747,12.65517657,0.1205254911,2.6515608051,12.775702061
19051,2010,29,14,7,0,15,7,NA,NA,NA,NA,NA,NA
19051,2011,132,90,-47,0,42,-47,15.047021944,10.259333143,-5.357651753,0,4.7876888002,-5.357651753
19051,2012,139,85,-118,0,54,-118,15.906620129,9.7270698632,-13.50346169,0,6.1795502661,-13.50346169
19051,2013,126,95,31,0,31,31,14.420600858,10.87267525,3.547925608,0,3.547925608,3.547925608
19051,2014,136,83,-65,0,53,-65,15.521570418,9.4727231226,-7.418397626,0,6.0488472951,-7.418397626
19051,2015,139,69,-48,0,70,-48,15.855814749,7.8708720698,-5.475389266,0,7.9849426795,-5.475389266
19051,2016,165,100,60,0,65,60,18.667270053,11.313497002,6.7880982012,0,7.3537730513,6.7880982012
19051,2017,151,80,-6,0,71,-6,16.902669726,8.9550568086,-0.671629261,0,7.9476129177,-0.671629261
49011,2010,1571,348,126,84,1223,210,NA,NA,NA,NA,NA,NA
49011,2011,5708,1427,-507,244,4281,-263,18.418933941,4.6047334853,-1.636019535,0.7873545693,13.814200456,-0.848664966
49011,2012,5719,1486,-700,490,4233,-210,18.21888788,4.7339163123,-2.229974037,1.5609818257,13.484971568,-0.668992211
49011,2013,5823,1590,1858,317,4233,2175,18.247711985,4.9826312994,5.8224710404,0.9933925295,13.265080686,6.8158635699
49011,2014,5768,1602,2077,238,4166,2315,17.718143895,4.9210240153000004,6.3801291385,0.7310884617,12.79711988,7.1112176002
49011,2015,5889,1718,1603,310,4171,1913,17.748322815,5.1777243329,4.8311362664,0.934280875,12.570598482,5.7654171413
49011,2016,5855,1719,2101,262,4136,2363,17.318309343,5.0845728027,6.21447787,0.7749610671,12.23373654,6.9894389371
49011,2017,5905,1647,1843,222,4258,2065,17.14162963,4.781077731,5.3500463013,0.6444439929,12.3605519,5.9944902942
46035,2010,61,76,-3,0,-15,-3,NA,NA,NA,NA,NA,NA
46035,2011,245,176,5,17,69,22,12.545124043,9.0120074759,0.2560229397,0.8704779948,3.5331165672,1.1265009345
46035,2012,268,224,113,11,44,124,13.633126463,11.394851969,5.7482958592,0.5595686235,2.2382744938,6.3078644827
46035,2013,273,200,-70,-2,73,-72,13.828736418,10.130942431,-3.545829851,-0.101309424,3.6977939873,-3.647139275
46035,2014,273,195,-43,-4,78,-47,13.819286257,9.8709187547,-2.176664136,-0.202480385,3.9483675019,-2.37914452
46035,2015,240,243,-43,-2,-3,-45,12.15528375,12.307224797,-2.177821672,-0.101294031,-0.151941047,-2.279115703
46035,2016,259,208,62,-2,51,60,13.097013982,10.518065283,3.1351925362,-0.101135243,2.5789486991,3.0340572931
46035,2017,249,189,-185,-2,60,-187,12.59643354,9.5611483496,-9.358796004,-0.101176173,3.0352851903,-9.459972177
31045,2010,25,22,-15,-2,3,-17,NA,NA,NA,NA,NA,NA
31045,2011,101,83,6,10,18,16,10.996788067,9.036964451,0.6532745386,1.0887908977,1.9598236159,1.7420654363
31045,2012,109,81,-106,9,28,-97,11.89047671,8.8360423257,-11.56321588,0.9817824806,3.0544343842,-10.5814334
31045,2013,100,97,-90,16,3,-74,10.990218705,10.660512144,-9.891196835,1.7584349929,0.3297065612,-8.132761842
31045,2014,102,77,-76,10,25,-66,11.276325245,8.5125200376,-8.401967829,1.1055220828,2.763805207,-7.296445747
31045,2015,87,72,-87,13,15,-74,9.6715024179,8.004002001,-9.671502418,1.445167028,1.6675004169,-8.22633539
31045,2016,91,95,-63,13,-4,-50,10.180679085,10.628181462,-7.048162443,1.4543827264,-0.447502377,-5.593779717
31045,2017,97,96,-35,12,1,-23,10.897651949,10.785305022,-3.932142456,1.3481631277,0.1123469273,-2.583979328
13085,2010,54,31,-75,-3,23,-78,NA,NA,NA,NA,NA,NA
13085,2011,243,167,-63,-7,76,-70,10.901505126,7.4919808887,-2.826316144,-0.314035127,3.4095242368,-3.140351271
13085,2012,222,175,136,-6,47,130,9.9195710456,7.8194816801,6.0768543342,-0.268096515,2.1000893655,5.8087578195
13085,2013,232,182,167,2,50,169,10.276172126,8.0614798574,7.3970721768,0.0885876907,2.2146922685,7.4856598676
13085,2014,249,155,195,10,94,205,10.903358585,6.7872312475,8.5387747953,0.4378858869,4.1161273372,8.9766606822
13085,2015,216,211,307,13,5,320,9.3294460641,9.1134866645,13.259907137,0.561494439,0.2159593996,13.821401577
13085,2016,251,201,234,11,50,245,10.696782442,8.5659492862,9.972299169,0.4687832943,2.1308331558,10.441082463
13085,2017,261,192,684,11,69,695,10.876812802,8.0013335556,28.504750792,0.458409735,2.8754792465,28.963160527
30021,2010,32,19,-27,-1,13,-28,NA,NA,NA,NA,NA,NA
30021,2011,129,114,62,-6,15,56,14.356463191,12.687107006,6.9000055645,-0.667742474,1.669356185,6.2322630905
30021,2012,99,104,214,-7,-5,207,10.848720618,11.396635801,23.450769821,-0.767081256,-0.547915183,22.683688565
30021,2013,110,111,149,-8,-1,141,11.826049562,11.933559103,16.018921679,-0.860076332,-0.107509541,15.158845348
30021,2014,129,92,94,-11,37,83,13.673945304,9.7519609922,9.9639601442,-1.165995336,3.9219843121,8.7979648081
30021,2015,133,94,35,-11,39,24,13.961788789,9.867730422,3.6741549444,-1.154734411,4.0940583666,2.5194205333
30021,2016,119,88,-334,-11,31,-345,12.658901122,9.3612041913,-35.530025,-1.170150524,3.297696931,-36.70017552
30021,2017,113,81,-316,-11,32,-327,12.422360248,8.9045237179,-34.73863574,-1.209256307,3.5178365305,-35.94789205
31047,2010,92,72,-47,19,20,-28,NA,NA,NA,NA,NA,NA
31047,2011,342,192,-283,52,150,-231,14.085377155,7.9075801569,-11.65544367,2.1416362925,6.1777969976,-9.513807376
31047,2012,393,214,-472,63,179,-409,16.285092717,8.8677095204,-19.55868642,2.6105873822,7.4173831969,-16.94809904
31047,2013,388,247,-163,73,141,-90,16.13473334,10.271337977,-6.778251377,3.0356585924,5.8633953633,-3.742592785
31047,2014,392,202,-336,113,190,-223,16.292263253,8.3955030028,-13.96479707,4.6964942541,7.8967602502,-9.26830282
31047,2015,423,210,-421,128,213,-293,17.618026198,8.7465378288,-17.53472584,5.3312230575,8.8714883692,-12.20350278
31047,2016,408,185,-506,136,223,-370,17.073272796,7.7415575177,-21.17420597,5.6910909319,9.3317152781,-15.48311504
31047,2017,405,187,-470,138,218,-332,17.041151224,7.8683834049,-19.7761508,5.8066144913,9.1727678196,-13.96953631
48115,2010,36,52,10,1,-16,11,NA,NA,NA,NA,NA,NA
48115,2011,192,135,-141,2,57,-139,13.927677632,9.7928983352,-10.22813826,0.1450799753,4.1347792971,-10.08305829
48115,2012,198,131,-219,7,67,-212,14.481623697,9.5812762845,-16.01755348,0.5119765954,4.9003474127,-15.50557689
48115,2013,180,143,-478,22,37,-456,13.431332314,10.670447338,-35.66764914,1.6416072828,2.7608849756,-34.02604186
48115,2014,171,148,176,27,23,203,12.839765731,11.112779697,13.215197477,2.0273314311,1.7269860339,15.242528908
48115,2015,186,143,-537,32,43,-505,14.081308199,10.825952002,-40.65409948,2.4225906579,3.2553561965,-38.23150882
48115,2016,193,111,-61,35,82,-26,14.831322524,8.5299316069,-4.687620072,2.6896180742,6.3013909168,-1.998001998
48115,2017,191,127,-327,35,64,-292,14.774705086,9.8240185651,-25.29491394,2.7074066912,4.950686521,-22.58750725
46037,2010,17,30,11,1,-13,12,NA,NA,NA,NA,NA,NA
46037,2011,75,66,21,1,9,22,13.100436681,11.528384279,3.6681222707,0.1746724891,1.5720524017,3.8427947598
46037,2012,58,78,-132,1,-20,-131,10.235595165,13.765110739,-23.29480279,0.1764757787,-3.529515574,-23.11832701
46037,2013,62,82,2,5,-20,7,11.101163832,14.682184423,0.3581020591,0.8952551477,-3.581020591,1.2533572068
46037,2014,53,67,-63,4,-14,-59,9.5641974195,12.090589191,-11.36876297,0.7218262203,-2.526391771,-10.64693675
46037,2015,68,71,-5,4,-3,-1,12.356896238,12.902053425,-0.908595312,0.7268762493,-0.545157187,-0.181719062
46037,2016,60,62,11,4,-2,15,10.894235134,11.257376305,1.9972764412,0.7262823423,-0.363141171,2.7235587835
46037,2017,61,80,24,4,-19,28,11.055731763,14.499320344,4.3497961033,0.7249660172,-3.443588582,5.0747621205
35011,2010,7,1,1,0,6,1,NA,NA,NA,NA,NA,NA
35011,2011,22,18,-37,1,4,-36,10.931677019,8.9440993789,-18.38509317,0.4968944099,1.9875776398,-17.88819876
35011,2012,19,31,-32,0,-12,-32,9.6226892884,15.70017726,-16.20663459,0,-6.077487972,-16.20663459
35011,2013,9,38,-4,1,-29,-3,4.6463603511,19.617965927,-2.065049045,0.5162622612,-14.97160558,-1.548786784
35011,2014,11,35,-48,3,-24,-45,5.8293587705,18.547959724,-25.43720191,1.5898251192,-12.71860095,-23.84737679
35011,2015,19,27,19,3,-8,22,10.212308519,14.512227896,10.212308519,1.6124697662,-4.299919377,11.824778285
35011,2016,14,23,-20,3,-9,-17,7.5492046374,12.402264761,-10.78457805,1.617686708,-4.853060124,-9.166891345
35011,2017,16,16,-16,3,0,-13,8.719346049,8.719346049,-8.719346049,1.6348773842,0,-7.084468665
22031,2010,57,101,54,1,-44,55,NA,NA,NA,NA,NA,NA
22031,2011,338,271,43,-2,67,41,12.6492272,10.141836009,1.6092212118,-0.074847498,2.5073911904,1.5343737136
22031,2012,395,297,150,3,98,153,14.685106699,11.041713139,5.5766227972,0.1115324559,3.6433935609,5.6881552532
22031,2013,350,281,4,1,69,5,12.935654359,10.3854825,0.1478360498,0.0369590125,2.5501718594,0.1847950623
22031,2014,331,282,-73,1,49,-72,12.223494221,10.413973928,-2.695815946,0.0369289856,1.8095202925,-2.65888696
22031,2015,363,296,-22,2,67,-20,13.400520516,10.927146206,-0.812152759,0.073832069,2.4733743101,-0.73832069
22031,2016,335,288,50,3,47,53,12.333861051,10.603438754,1.8408747837,0.110452487,1.7304222967,1.9513272707
22031,2017,345,278,62,3,67,65,12.648714047,10.192297116,2.2731022346,0.1099888178,2.4564169309,2.3830910524
17039,2010,44,17,6,0,27,6,NA,NA,NA,NA,NA,NA
17039,2011,184,186,-39,-1,-2,-40,11.103735441,11.224428218,-2.353509142,-0.060346388,-0.120692777,-2.413855531
17039,2012,198,161,-91,0,37,-91,11.984746686,9.7451728104,-5.508141154,0,2.2395738757,-5.508141154
17039,2013,168,173,-115,1,-5,-114,10.222398004,10.52663604,-6.997474824,0.0608476072,-0.304238036,-6.936627217
17039,2014,173,189,-143,2,-16,-141,10.615450696,11.597226483,-8.774621096,0.1227219734,-0.981775787,-8.651899123
17039,2015,176,199,-9,3,-23,-6,10.862521216,12.282055238,-0.555469835,0.1851566116,-1.419534023,-0.370313223
17039,2016,199,197,-32,2,2,-30,12.304458047,12.180795152,-1.978606319,0.1236628949,0.1236628949,-1.854943424
17039,2017,194,211,-203,2,-17,-201,12.086850877,13.146007913,-12.64758107,0.1246067101,-1.059157036,-12.52297436
48117,2010,83,12,1,14,71,15,NA,NA,NA,NA,NA,NA
48117,2011,351,141,-231,50,210,-181,18.024032043,7.2404231283,-11.86196981,2.567525932,10.783608914,-9.294443874
48117,2012,338,144,-377,11,194,-366,17.415050107,7.4194296313,-19.42447897,0.5667619857,9.9956204756000009,-18.85771698
48117,2013,369,151,-431,27,218,-404,19.18128655,7.8492527615,-22.40415854,1.4035087719,11.332033788,-21.00064977
48117,2014,318,168,-234,31,150,-203,16.628755196,8.7850027453,-12.23625382,1.6210421732,7.8437524512,-10.615211650000001
48117,2015,352,154,-535,33,198,-502,18.574707791,8.1264346587,-28.23144508,1.7413788554,10.448273133,-26.49006623
48117,2016,325,122,-190,35,203,-155,17.263359184,6.4803994476,-10.09242537,1.8591309891,10.782959737,-8.23329438
48117,2017,340,162,-230,37,178,-193,18.043835907,8.5973571087,-12.20612429,1.9635939076,9.4464787985,-10.24253038
18029,2010,128,75,6,2,53,8,NA,NA,NA,NA,NA,NA
18029,2011,550,465,-175,-16,85,-191,10.992085698,9.2933088177,-3.497481813,-0.319769766,1.6987768806,-3.817251579
18029,2012,529,458,-319,-12,71,-331,10.611196919,9.1870098088,-6.398812509,-0.240707681,1.4241871101,-6.639520189
18029,2013,514,430,-56,-14,84,-70,10.335813392,8.6466921375,-1.126080837,-0.281520209,1.6891212548,-1.407601046
18029,2014,510,433,-381,-15,77,-396,10.286717025,8.7336244541,-7.684782718,-0.302550501,1.5530925704,-7.987333219
18029,2015,506,474,18,-13,32,5,10.235352422,9.588057407,0.3641034458,-0.2629636,0.6472950148,0.1011398461
18029,2016,529,455,-40,-14,74,-54,10.695187166,9.1990740273,-0.808709805,-0.283048432,1.4961131385,-1.091758236
18029,2017,524,440,204,-14,84,190,10.563238318,8.8698947708,4.1124057574,-0.282223925,1.6933435472,3.8301818328
13087,2010,89,59,-57,-3,30,-60,NA,NA,NA,NA,NA,NA
13087,2011,373,313,-220,-1,60,-221,13.448711015,11.285379484,-7.932215612,-0.036055526,2.1633315306,-7.968271138
13087,2012,371,317,-246,-12,54,-258,13.463248235,11.50363798,-8.927113385,-0.435468946,1.9596102553,-9.362582331
13087,2013,362,274,-132,-4,88,-136,13.196507665,9.9885168511,-4.81198622,-0.145817764,3.2079908135,-4.957803984
13087,2014,367,316,-267,0,51,-267,13.442977235,11.574879581,-9.780040659,0,1.8680976539,-9.780040659
13087,2015,344,306,-148,2,38,-146,12.675718997,11.275494224,-5.45350701,0.0736960407,1.4002247729,-5.37981097
13087,2016,385,322,-434,2,63,-432,14.312799732,11.970705231,-16.13442879,0.0743522064,2.3420945017,-16.06007658
13087,2017,372,330,-41,2,42,-39,13.924500758,12.352379705,-1.5346896,0.0748629073,1.5721210533,-1.459826692
18031,2010,74,29,6,9,45,15,NA,NA,NA,NA,NA,NA
18031,2011,317,257,6,29,60,35,12.270413594,9.9479378351,0.2322475759,1.1225299503,2.3224757592,1.3547775262
18031,2012,291,246,78,22,45,100,11.213872832,9.4797687861,3.0057803468,0.8477842004,1.7341040462,3.8535645472
18031,2013,368,293,86,38,75,124,14.089899686,11.21831687,3.2927482962,1.4549352937,2.8715828164,4.7476835899
18031,2014,343,259,92,39,84,131,13.031172236,9.8398647493,3.4952415326,1.4816784758,3.1913074863,4.9769200084
18031,2015,341,240,-188,41,101,-147,12.914954457,9.0897040165,-7.120268146,1.5528244362,3.8252504403,-5.56744371
18031,2016,354,270,137,42,84,179,13.353199676,10.18464382,5.1677637163,1.5842779276,3.1685558552,6.7520416439
18031,2017,351,272,-24,42,79,18,13.151485631,10.191464648,-0.899246881,1.5736820413,2.9600209824,0.6744351606
19053,2010,28,39,-27,-1,-11,-28,NA,NA,NA,NA,NA,NA
19053,2011,81,97,-167,7,-16,-160,9.7215554489,11.641862698,-20.04320691,0.8401344215,-1.920307249,-19.20307249
19053,2012,89,90,-14,9,-1,-5,10.799660235,10.921004732,-1.698822958,1.0921004732,-0.121344497,-0.606722485
19053,2013,87,94,-21,1,-7,-20,10.580080263,11.431351088,-2.553812477,0.121610118,-0.851270826,-2.432202359
19053,2014,106,115,-6,4,-9,-2,12.919739168,14.016698153,-0.731305991,0.4875373271,-1.096958986,-0.243768664
19053,2015,93,81,-94,5,12,-89,11.394964161,9.9246462047,-11.51749066,0.6126324818,1.4703179563,-10.90485818
19053,2016,98,80,-101,5,18,-96,12.122711529,9.896091044,-12.49381494,0.6185056903,2.2266204849,-11.87530925
19053,2017,92,80,-112,5,12,-107,11.503594873,10.003125977,-14.00437637,0.6251953736,1.5004688965,-13.37918099
20039,2010,4,4,-8,0,0,-8,NA,NA,NA,NA,NA,NA
20039,2011,32,65,3,-1,-33,2,10.878803332,22.097569267,1.0198878123,-0.339962604,-11.21876594,0.6799252082
20039,2012,27,58,-12,0,-31,-12,9.2959201239,19.9690136,-4.131520055,0,-10.67309348,-4.131520055
20039,2013,43,47,29,1,-4,30,14.850630288,16.232084269,10.015541357,0.3453634951,-1.38145398,10.360904852000001
20039,2014,32,38,-8,4,-6,-4,11.023079573,13.089906993,-2.755769893,1.3778849466,-2.06682742,-1.377884947
20039,2015,35,38,26,4,-3,30,12.021294865,13.051691568,8.930104757,1.3738622703,-1.030396703,10.303967027
20039,2016,27,35,-84,4,-8,-80,9.3717459216,12.148559528,-29.15654287,1.3884068032,-2.776813606,-27.76813606
20039,2017,29,37,51,4,-8,55,10.136315973,12.93254107,17.825934988,1.3981125481,-2.796225096,19.224047536
47039,2010,27,61,3,1,-34,4,NA,NA,NA,NA,NA,NA
47039,2011,103,159,9,10,-56,19,8.803795034,13.590324373,0.7692636437,0.8547373819,-4.786529339,1.6240010257
47039,2012,104,163,5,10,-59,15,8.9216779617,13.983014498,0.4289268251,0.8578536502,-5.061336536,1.2867804753
47039,2013,119,151,47,12,-32,59,10.216784718,12.964155398,4.0352006868,1.0302640052,-2.74737068,5.065464692
47039,2014,136,184,53,14,-48,67,11.652814669,15.765572787,4.5411704224,1.1995544512,-4.112758118,5.7407248736
47039,2015,127,189,-30,14,-62,-16,10.910652921,16.237113402,-2.577319588,1.2027491409,-5.326460481,-1.374570447
47039,2016,117,168,148,15,-51,163,10.0381794,14.413796062,12.697867959,1.286946077,-4.375616662,13.984814036
47039,2017,119,172,78,15,-53,93,10.14406274,14.662006649,6.6490495269,1.2786633706,-4.517943909,7.9277128975
30023,2010,25,40,13,0,-15,13,NA,NA,NA,NA,NA,NA
30023,2011,71,127,48,-3,-56,45,7.6479775947,13.680185275,5.170463726,-0.323153983,-6.03220768,4.8473097431
30023,2012,68,134,5,-3,-66,2,7.3549294251,14.493537397,0.5408036342,-0.324482181,-7.138607971,0.2163214537
30023,2013,62,119,99,-2,-57,97,6.7146802404,12.88785401,10.721828126,-0.216602588,-6.173173769,10.505225537
30023,2014,67,117,-84,-2,-50,-86,7.2937078162,12.736773351,-9.144350098,-0.217722621,-5.443065535,-9.362072719
30023,2015,83,132,42,-2,-49,40,9.107867881,14.484801931,4.6088006145,-0.219466696,-5.37693405,4.3893339186
30023,2016,78,120,5,-2,-42,3,8.5822743027,13.203498927,0.5501457886,-0.220058315,-4.621224625,0.3300874732
30023,2017,83,130,87,-2,-47,85,9.1334250344,14.305364512,9.5735900963,-0.220082531,-5.171939477,9.3535075653
39039,2010,110,117,52,2,-7,54,NA,NA,NA,NA,NA,NA
39039,2011,497,376,-232,15,121,-217,12.732163443,9.6323811964,-5.943384142,0.3842705265,3.0997822467,-5.559113616
39039,2012,450,381,-283,19,69,-264,11.570354181,9.7962332069,-7.276467185,0.4885260654,1.7741209745,-6.78794112
39039,2013,439,367,-369,18,72,-351,11.355699837,9.493261595,-9.544995991,0.4656095605,1.8624382421,-9.07938643
39039,2014,400,360,-109,32,40,-77,10.389340537,9.3504064829,-2.831095296,0.8311472429,1.0389340537,-1.999948053
39039,2015,436,419,-257,36,17,-221,11.360527379,10.917571036,-6.696457652,0.9380251964,0.4429563427,-5.758432456
39039,2016,426,369,-249,37,57,-212,11.152270377,9.6600651858,-6.518580573,0.9686244224,1.4922051913,-5.54995615
39039,2017,413,386,-26,37,27,11,10.828952371,10.121006332,-0.681725815,0.9701482754,0.7079460388,0.2884224602
01049,2010,232,151,-42,22,81,-20,NA,NA,NA,NA,NA,NA
01049,2011,904,783,-5,77,121,72,12.685760795,10.987777326,-0.070164606,1.080534935,1.6979834692,1.0103703288
01049,2012,868,710,-642,70,158,-572,12.199835555,9.9791281615,-9.023380676,0.9838577061,2.2207073937,-8.03952297
01049,2013,797,782,-99,55,15,-44,11.237301638,11.025809135,-1.395850517,0.7754725095,0.2114925026,-0.620378008
01049,2014,816,723,-32,78,93,46,11.497896984,10.187474901,-0.450897921,1.0990636823,1.3104220827,0.6481657613
01049,2015,838,808,52,94,30,146,11.78356488,11.361718882,0.73119973,1.3217841273,0.4218459981,2.0529838574
01049,2016,848,796,-127,94,52,-33,11.908941537,11.178676254,-1.783532518,1.3200949345,0.7302652829,-0.463437583
01049,2017,839,770,246,92,69,338,11.74798541,10.781822128,3.4445821344,1.2882177088,0.9661632816,4.7327998432
13089,2010,2666,984,-2135,949,1682,-1186,NA,NA,NA,NA,NA,NA
13089,2011,11046,4215,-4039,4338,6831,299,15.867771444,6.0549209341,-5.802093868,6.231612577,9.8128505103,0.4295187092
13089,2012,11006,4156,-347,4471,6850,4124,15.608159468,5.8938316145,-0.492098068,6.3405488808,9.7143278536,5.8484508129
13089,2013,10891,4262,-4336,4429,6629,93,15.254302572,5.9695011993,-6.0731481,6.2034070417,9.2848013726,0.1302589422
13089,2014,11017,4403,-3296,5117,6614,1821,15.269915896,6.1026994362,-4.568361876,7.0923263718,9.1672164594,2.5239644954
13089,2015,11108,4383,-526,5621,6725,5095,15.184561178,5.9915314767,-0.719038457,7.6838691377,9.1930297013,6.9648306808
13089,2016,11079,4652,-2894,5747,6427,2853,14.930180283,6.2690855382,-3.899985715,7.744719387,8.6610947451,3.8447336717
13089,2017,11021,4637,-5506,5729,6384,223,14.695225085,6.1829016169,-7.341612315,7.638956947,8.5123234683,0.2973446324
17037,2010,347,191,-219,42,156,-177,NA,NA,NA,NA,NA,NA
17037,2011,1267,675,-1491,122,592,-1369,12.092175399,6.4421613213,-14.23001856,1.1643610092,5.6500140773,-13.06565755
17037,2012,1195,687,-823,202,508,-621,11.45063769,6.5829189065,-7.886087715,1.9355889652,4.8677187838,-5.95049875
17037,2013,1166,694,-859,189,472,-670,11.187818136,6.6589586502,-8.242140462,1.8134628024,4.5288594854,-6.428677659
17037,2014,1180,685,-165,199,495,34,11.303927157,6.5620255105,-1.580633882,1.9063402578,4.7419016463,0.3257063757
17037,2015,1219,721,-962,214,498,-748,11.662002822,6.8977063452,-9.203319701,2.0473081247,4.764296477,-7.156011576
17037,2016,1209,710,-686,224,499,-462,11.577465598,6.7990079194,-6.5691823,2.1450391182,4.7784576786,-4.424143181
17037,2017,1178,707,-410,223,471,-187,11.263027058,6.7597284635,-3.92006884,2.1321350033,4.5032985945,-1.787933837
18033,2010,156,68,-9,2,88,-7,NA,NA,NA,NA,NA,NA
18033,2011,517,389,19,10,128,29,12.201021865,9.1802659681,0.4483934535,0.2359965545,3.020755897,0.6843900079
18033,2012,520,364,-323,-1,156,-324,12.27370359,8.591592513,-7.623858192,-0.023603276,3.682111077,-7.647461468
18033,2013,496,399,-48,-4,97,-52,11.724521032,9.4316207496,-1.134631068,-0.094552589,2.2929002825,-1.229183657
18033,2014,520,406,-36,-8,114,-44,12.276891113,9.5854188309,-0.849938616,-0.188875248,2.6914722826,-1.038813863
18033,2015,562,451,-33,-7,111,-40,13.248623864,10.631902781,-0.777944106,-0.165018447,2.6167210835,-0.942962553
18033,2016,534,398,38,-6,136,32,12.554071845,9.3567801392,0.8933609178,-0.141056987,3.1972917058,0.7523039308
18033,2017,518,402,108,-6,116,102,12.123197903,9.4083504962,2.5276165512,-0.140423142,2.7148474069,2.3871934095
29063,2010,23,17,2,3,6,5,NA,NA,NA,NA,NA,NA
29063,2011,116,134,-70,4,-18,-66,9.0198670347,10.419501575,-5.443023211,0.3110298977,-1.39963454,-5.131993313
29063,2012,107,116,-22,-2,-9,-24,8.3580690517,9.0610842056,-1.718481487,-0.15622559,-0.703015154,-1.874707077
29063,2013,99,136,-107,-8,-37,-115,7.7888360017,10.699815113,-8.418236891,-0.629400889,-2.910979112,-9.04763778
29063,2014,115,114,-83,-7,1,-90,9.1335080613,9.0540862521,-6.592010166,-0.555952665,0.0794218092,-7.147962831
29063,2015,107,117,15,-7,-10,8,8.5289546052,9.3260531665,1.1956478419,-0.557968993,-0.797098561,0.637678849
29063,2016,112,107,-38,-7,5,-45,8.9424727534,8.5432552198,-3.034053256,-0.558904547,0.3992175336,-3.592957803
29063,2017,116,96,71,-7,20,64,9.2456063444,7.651536285,5.6589487108,-0.557924521,1.5940700594,5.10102419
47041,2010,57,86,4,3,-29,7,NA,NA,NA,NA,NA,NA
47041,2011,222,229,46,25,-7,71,11.854858089,12.22865992,2.4564120364,1.3350065415,-0.373801832,3.791418578
47041,2012,227,236,86,25,-9,111,12.069011351,12.547518409,4.5724007762,1.3291862722,-0.478507058,5.9015870484
47041,2013,227,233,214,44,-6,258,11.956493113,12.272523768,11.271760027,2.3175581365,-0.316030655,13.589318164
47041,2014,212,253,93,57,-41,150,11.061542877,13.200803527,4.8524692807,2.9740940753,-2.139260651,7.826563356
47041,2015,254,242,-21,67,12,46,13.197204687,12.573714701,-1.091107474,3.4811524173,0.6234899852,2.3900449432
47041,2016,219,247,125,70,-28,195,11.313152185,12.759582602,6.4572786445,3.6160760409,-1.446430416,10.073354685
47041,2017,224,231,347,69,-7,416,11.40123174,11.757520232,17.661729526,3.5119865628,-0.356288492,21.173716089
06015,2010,89,93,-43,1,-4,-42,NA,NA,NA,NA,NA,NA
06015,2011,335,296,-167,8,39,-159,11.751705751,10.383596724,-5.858313016,0.2806377493,1.3681090278,-5.577675267
06015,2012,324,283,-315,23,41,-292,11.438658429,9.9911738747,-11.12091792,0.8120035305,1.4474845543,-10.30891439
06015,2013,333,275,-431,-6,58,-437,11.885852979,9.8156443524,-15.38379169,-0.214159513,2.0702086271,-15.59795121
06015,2014,312,259,-694,-4,53,-698,11.338033287,9.4120212225,-25.21985609,-0.145359401,1.9260120648,-25.3652155
06015,2015,289,240,4,-2,49,2,10.613489047,8.8139701427,0.1468995024,-0.073449751,1.7995189041,0.0734497512
06015,2016,293,255,161,-2,38,159,10.712392373,9.3230718608,5.8863316454,-0.073122132,1.3893205126,5.8132095132
06015,2017,306,264,-18,-2,42,-20,11.143481428,9.6139839767,-0.655498908,-0.072833212,1.5294974508,-0.72833211899999994
18035,2010,322,264,-93,24,58,-69,NA,NA,NA,NA,NA,NA
18035,2011,1264,1166,0,119,98,119,10.735017474,9.9027139041,0,1.010654335,0.83230357,1.010654335
18035,2012,1221,1232,-1037,143,-11,-894,10.400606489,10.494305647,-8.833275126,1.2180890483,-0.093699158,-7.615186078
18035,2013,1294,1252,-370,151,42,-219,11.07336317,10.713949528,-3.166263039,1.2921776188,0.3594136423,-1.874085421
18035,2014,1237,1187,-545,184,50,-361,10.608373497,10.179579095,-4.673858978,1.5779633981,0.4287944017,-3.09589558
18035,2015,1186,1236,-780,192,-50,-588,10.212736643,10.643290465,-6.716639614,1.6533266741,-0.430553821,-5.063312939
18035,2016,1205,1158,-571,195,47,-376,10.419639073999999,10.013229915,-4.937438931,1.6861656593,0.4064091589,-3.251273271
18035,2017,1168,1181,-480,194,-13,-286,10.127152995,10.239869596,-4.161843697,1.6820784941,-0.1127166,-2.479765203
19055,2010,48,54,1,0,-6,1,NA,NA,NA,NA,NA,NA
19055,2011,187,158,-169,2,29,-167,10.570645262,8.9313473333,-9.553149996,0.1130550295,1.6392979283,-9.440094966
19055,2012,199,170,-95,4,29,-91,11.310995538,9.6626595049,-5.399721488,0.2273566942,1.6483360332,-5.172364794
19055,2013,195,171,-133,5,24,-128,11.135221562,9.7647327547,-7.594792143,0.2855185016,1.3704888077,-7.309273641
19055,2014,212,172,-135,7,40,-128,12.171666427,9.8751255921,-7.750825319,0.4018946462,2.2965408354,-7.348930673
19055,2015,232,186,-56,8,46,-48,13.354439488,10.706576486,-3.223485394,0.4604979134,2.6478630019,-2.76298748
19055,2016,203,162,-151,8,41,-143,11.720554273,9.3533487298,-8.718244804,0.4618937644,2.3672055427,-8.256351039
19055,2017,203,171,-156,9,32,-147,11.794782407,9.9355063622,-9.063970716,0.5229213875,1.8592760444,-8.541049329
36025,2010,121,102,-95,3,19,-92,NA,NA,NA,NA,NA,NA
36025,2011,467,551,-247,24,-84,-223,9.7832804366,11.543013963,-5.174454535,0.5027810074,-1.759733526,-4.671673528
36025,2012,400,519,-265,25,-119,-240,8.4388185654,10.949367089,-5.5907173,0.5274261603,-2.510548523,-5.063291139
36025,2013,407,576,-252,24,-169,-228,8.6561672533,12.250497145,-5.359592501,0.510437381,-3.594329891,-4.84915512
36025,2014,387,537,-124,25,-150,-99,8.2888903168,11.501638502,-2.655871833,0.5354580308,-3.212748185,-2.120413802
36025,2015,387,524,-506,26,-137,-480,8.3668439486,11.328749946,-10.93959441,0.5621135469,-2.961905997,-10.37748087
36025,2016,336,533,-353,28,-197,-325,7.3544701389,11.666466024,-7.726571307,0.6128725116,-4.311995885,-7.113698795
36025,2017,337,559,-228,28,-222,-200,7.4536084754,12.363700706,-5.042797426,0.6192909119,-4.91009223,-4.423506514
39041,2010,556,248,525,72,308,597,NA,NA,NA,NA,NA,NA
39041,2011,2092,922,1994,248,1170,2242,11.830504832,5.2140179041,11.276303363,1.4024690241,6.6164869282,12.678772387
39041,2012,2108,901,1120,282,1207,1402,11.721074024,5.0098138974,6.2275156105,1.5679994662,6.7112601267,7.7955150767
39041,2013,2178,991,2705,248,1187,2953,11.886472725,5.4083996649,14.762584353,1.3534642956,6.4780730598,16.116048648
39041,2014,2248,992,2465,318,1256,2783,11.998900457,5.2948884577,13.157157307,1.6973533564,6.7040119989,14.854510663
39041,2015,2157,1031,2325,335,1126,2660,11.276633008,5.3899900931,12.154924313,1.7513546859,5.8866429145,13.906278999
39041,2016,2177,1105,2191,339,1072,2530,11.165362246,5.667306055,11.237165219,1.7386576947,5.498056191,12.975822913
39041,2017,2146,1133,2346,336,1013,2682,10.804524206,5.7043457245999996,11.811469612,1.691668282,5.1001784811,13.503137894
40041,2010,86,83,80,8,3,88,NA,NA,NA,NA,NA,NA
40041,2011,312,466,161,18,-154,179,7.5016229473,11.204347094,3.8710297901,0.4327859393,-3.702724147,4.3038157294
40041,2012,378,533,168,9,-155,177,9.0844638844,12.809574737,4.0375395042,0.2162967592,-3.725110852,4.2538362634
40041,2013,440,554,86,12,-114,98,10.574635295,13.314427167,2.066860535,0.2883991444,-2.739791872,2.3552596794
40041,2014,397,494,168,13,-97,181,9.5343307956,11.863877615,4.0346790269,0.3122073057,-2.329546819,4.3468863325
40041,2015,416,565,90,15,-149,105,9.986796303,13.563797863,2.1606049694,0.3601008282,-3.57700156,2.5207057976
40041,2016,445,567,354,18,-122,372,10.657151068,13.578886867,8.4778235463,0.4310757735,-2.921735798,8.9088993199
40041,2017,439,549,813,18,-110,831,10.392746384,12.9968514,19.24670344,0.4261262754,-2.604105016,19.672829715
42045,2010,1693,1353,-487,372,340,-115,NA,NA,NA,NA,NA,NA
42045,2011,6904,5500,-2813,1580,1404,-1233,12.350847063,9.8391742249,-5.032290381,2.8265264137,2.5116728385,-2.205763967
42045,2012,6736,5308,-1295,1612,1428,317,12.030064445,9.479747933,-2.312787033,2.8789287242,2.5503165125,0.5661416908
42045,2013,6499,5592,-1682,1640,907,-42,11.580634556,9.9644419814,-2.997172999,2.92233277,1.6161925746,-0.074840229
42045,2014,6725,5252,-1943,1817,1473,-126,11.960637498,9.3408577155,-3.455690507,3.2315952912,2.619779782,-0.224095216
42045,2015,6811,5450,-2522,1983,1361,-539,12.091054821,9.6749741261,-4.477116467,3.5202704022,2.4160806946,-0.956846065
42045,2016,6430,5410,-2769,2036,1020,-733,11.40374213,9.5947503769,-4.910880553,3.6108894209,1.8089917531,-1.299991132
42045,2017,6473,5480,-2317,2026,993,-291,11.469924009,9.7103635982,-4.105640959,3.5899993887,1.7595604111,-0.515641571
08029,2010,85,110,-73,3,-25,-70,NA,NA,NA,NA,NA,NA
08029,2011,340,358,-489,10,-18,-479,11.105485783,11.693423266,-15.97230161,0.3266319348,-0.587937483,-15.64566968
08029,2012,340,316,48,10,24,58,11.180348893,10.391147794,1.5784021966,0.328833791,0.7892010983,1.9072359876
08029,2013,317,318,-132,3,-1,-129,10.432779332,10.465690308,-4.344248807,0.0987329274,-0.032910976,-4.24551588
08029,2014,297,365,-309,3,-68,-306,9.8559766377,12.112563881,-10.25419792,0.0995553196,-2.256587244,-10.1546426
08029,2015,271,381,66,4,-110,70,9.0561245802,12.732042306,2.2055506358,0.1336697355,-3.675917726,2.3392203713
08029,2016,285,361,516,4,-76,520,9.4608949675,11.983800292,17.12919931,0.1327844908,-2.522905325,17.2619838
08029,2017,297,369,290,4,-72,294,9.751452868,12.115441442,9.5216206455,0.1313326986,-2.363988574,9.6529533441
26041,2010,81,113,18,0,-32,18,NA,NA,NA,NA,NA,NA
26041,2011,372,445,-29,-2,-73,-31,10.055548798,12.028815094,-0.78390031,-0.05406209,-1.973266296,-0.8379624
26041,2012,360,424,-36,-2,-64,-38,9.7596681713,11.494720291,-0.975966817,-0.054220379,-1.735052119,-1.030187196
26041,2013,389,413,-9,2,-24,-7,10.566201736,11.218101072,-0.244462251,0.0543249447,-0.651899336,-0.190137306
26041,2014,374,407,-189,-1,-33,-190,10.19448571,11.093999155,-5.151758821,-0.027257983,-0.899513445,-5.179016805
26041,2015,374,441,-93,-1,-67,-94,10.2484004,12.084343787,-2.54839903,-0.02740214,-1.835943387,-2.57580117
26041,2016,352,409,-130,1,-57,-129,9.6920302325,11.26147831,-3.579442984,0.0275341768,-1.569448077,-3.551908807
26041,2017,345,421,-184,0,-76,-184,9.5581105416,11.663665328,-5.097658956,0,-2.105554786,-5.097658956
48119,2010,15,26,19,2,-11,21,NA,NA,NA,NA,NA,NA
48119,2011,59,82,-74,0,-23,-74,11.360354289,15.788966978,-14.24857996,0,-4.428612689,-14.24857996
48119,2012,63,80,110,0,-17,110,12.1305478,15.403870222,21.180321556,0,-3.273322422,21.180321556
48119,2013,54,82,-96,0,-28,-96,10.425716768,15.831643981,-18.53460759,0,-5.405927213,-18.53460759
48119,2014,67,82,36,0,-15,36,13.064248806,15.989080628,7.0195963732,0,-2.924831822,7.0195963732
48119,2015,76,73,16,0,3,16,14.763014763,14.18026418,3.108003108,0,0.5827505828,3.108003108
48119,2016,57,63,-5,0,-6,-5,11.064738426,12.229447734,-0.97059109,0,-1.164709308,-0.97059109
48119,2017,67,59,145,0,8,145,12.830333206,11.298353121,27.767139027,0,1.5319800843,27.767139027
02068,2010,9,3,3,4,6,7,NA,NA,NA,NA,NA,NA
02068,2011,19,5,5,16,14,21,10.256410256,2.6990553306,2.6990553306,8.636977058,7.5573549258,11.336032389
02068,2012,21,7,5,19,14,24,11.114051336,3.7046837788,2.6462026991,10.055570257,7.4093675576,12.701772956
02068,2013,24,11,-5,17,13,12,12.496745639,5.7276750846,-2.603488675,8.8518614944,6.7690705545,6.2483728196
02068,2014,16,6,-53,23,10,-30,8.322496749,3.1209362809,-27.56827048,11.963589077,5.2015604681,-15.6046814
02068,2015,16,8,-14,24,8,10,8.3246618106,4.1623309053,-7.284079084,12.486992716,4.1623309053,5.2029136316
02068,2016,22,9,75,26,13,101,11.06639839,4.5271629779,37.726358149,13.078470825,6.5392354125,50.804828974
02068,2017,29,7,-20,26,22,6,14.081087643,3.3988832241,-9.711094926,12.624423404,10.682204419,2.9133284778
29065,2010,47,29,25,5,18,30,NA,NA,NA,NA,NA,NA
29065,2011,161,205,-77,-1,-44,-78,10.293130454,13.106159895,-4.922801522,-0.063932487,-2.813029441,-4.986734009
29065,2012,162,186,58,6,-24,64,10.384282555,11.922694785,3.7178295567,0.3846030576,-1.53841223,4.1024326143
29065,2013,181,189,89,6,-8,95,11.556264964,12.067039106,5.6823623304,0.3830806065,-0.510774142,6.065442937
29065,2014,177,173,-120,10,4,-110,11.308097748,11.052547516,-7.666506948,0.638875579,0.2555502316,-7.027631369
29065,2015,194,221,41,10,-27,51,12.42753275,14.157137824,2.6264373338,0.6405944717,-1.729605074,3.2670318055
29065,2016,191,191,-204,9,0,-195,12.304322618,12.304322618,-13.1417896,0.5797848354,0,-12.56200477
29065,2017,183,205,68,9,-22,77,11.842743893,13.266461738,4.40058243,0.5824300275,-1.423717845,4.9830124575
48121,2010,2189,693,2152,404,1496,2556,NA,NA,NA,NA,NA,NA
48121,2011,9218,2738,10289,2209,6480,12498,13.629199429,4.04824778,15.212717826,3.2660991037,9.5809516487,18.47881693
48121,2012,9109,2890,13674,1993,6219,15667,13.068182226,4.1461243421,19.617337112,2.8592476865,8.9220578836,22.476584799
48121,2013,9494,3036,12169,2033,6458,14202,13.21224199,4.2250228229,16.934882323,2.8292066532,8.9872191668,19.764088976
48121,2014,9732,3141,15162,2378,6591,17540,13.12896115,4.237368164,20.454306305,3.2080425005,8.891592986,23.662348805
48121,2015,9920,3348,16595,2653,6572,19248,12.941243233,4.3676695913,21.649186639,3.4609998285,8.5735736421,25.110186467
48121,2016,10286,3659,19339,2718,6627,22057,12.955712397,4.6086867258,24.35840191,3.4234519051,8.3470256715,27.781853816
48121,2017,10371,3893,18633,2700,6478,21333,12.612883237,4.7345438669,22.660867165,3.2836548781,7.8783393706,25.944522043
08031,2010,2408,1003,1510,263,1405,1773,NA,NA,NA,NA,NA,NA
08031,2011,9605,4124,8573,1701,5481,10274,15.712750312,6.7464218935,14.024508946,2.7826536471,8.9663284186,16.807162593
08031,2012,9227,4127,7343,1649,5100,8992,14.726043248,6.5865807395,11.719230039,2.6317595443,8.1394625082,14.350989583
08031,2013,9254,4164,7133,1731,5090,8864,14.438540637,6.4968752121,11.129253335,2.7007903439,7.941665425,13.830043679
08031,2014,9323,4175,7850,1882,5148,9732,14.219259982,6.3676295641,11.972668761,2.8703901412,7.8516304182,14.843058902
08031,2015,9363,4317,10752,2214,5046,12966,13.923825684,6.4198606725,15.989423662,3.2924650287,7.5039650112,19.281888691
08031,2016,9451,4607,6008,2272,4844,8280,13.732976362,6.6942992382,8.7300520563,3.3013778748,7.0386771239,12.031429931
08031,2017,9894,4821,2490,2242,5073,4732,14.140366072,6.8901056026,3.5586730866,3.2042349639,7.2502604691,6.7629080505
19057,2010,118,157,-50,4,-39,-46,NA,NA,NA,NA,NA,NA
19057,2011,476,452,-212,7,24,-205,11.856279968,11.258484339,-5.280528053,0.1743570583,0.5977956286,-5.106170994
19057,2012,456,449,158,6,7,164,11.360380672,11.185988864,3.9362722505,0.1494786931,0.1743918086,4.0857509436
19057,2013,481,476,135,23,5,158,11.935039639,11.810974778,3.34975125,0.5706983611,0.1240648611,3.9204496111
19057,2014,466,464,-330,30,2,-300,11.582243873,11.532534672,-8.202018194,0.7456380176,0.0497092012,-7.456380176
19057,2015,444,453,-238,33,-9,-205,11.105969459,11.331090461,-5.953199845,0.825443676,-0.225121003,-5.127756169
19057,2016,481,466,-293,34,15,-259,12.101390025,11.724007799,-7.371532801,0.8553997107,0.3773822253,-6.51613309
19057,2017,452,432,-266,35,20,-231,11.436957567,10.930897498,-6.730598922,0.8856051213,0.5060600693,-5.844993801
41017,2010,426,371,-15,-13,55,-28,NA,NA,NA,NA,NA,NA
41017,2011,1711,1217,1433,-74,494,1359,10.783217004,7.6698860861,9.0311805763,-0.466369409,3.1133309175,8.5648111677
41017,2012,1666,1312,1430,-58,354,1372,10.381744083,8.175779254,8.9111008637,-0.361429266,2.2059648292,8.5496715979
41017,2013,1696,1333,3523,-20,363,3503,10.385379639,8.1625654827,21.57293188,-0.1224691,2.2228141562,21.45046278
41017,2014,1751,1342,3707,9,409,3716,10.461007208,8.0175166608,22.146746842,0.0537687406,2.4434905472,22.200515582
41017,2015,1813,1394,4279,20,419,4299,10.547289731,8.1097197376,24.893465393,0.1163517896,2.4375699929,25.009817182
41017,2016,1775,1457,6040,19,318,6059,10.001042362,8.2093063221,34.031715982,0.1070534112,1.7917360401,34.138769393
41017,2017,1869,1478,5753,19,391,5772,10.170044892,8.042443205,31.30458441,0.1033872942,2.1276016868,31.407971705
05041,2010,42,51,-41,1,-9,-40,NA,NA,NA,NA,NA,NA
05041,2011,195,148,-279,0,47,-279,15.187507302,11.526928619,-21.72981814,0,3.6605786830000002,-21.72981814
05041,2012,173,154,-167,3,19,-164,13.669405815,12.168141593,-13.19532238,0.2370417193,1.5012642225,-12.95828066
05041,2013,154,133,-136,17,21,-119,12.283640424,10.608598548,-10.84789024,1.3559862806,1.675041876,-9.491903964
05041,2014,172,153,-261,17,19,-244,13.895059983,12.360140566,-21.08494567,1.3733489518,1.5349194167,-19.71159672
05041,2015,162,172,-253,20,-10,-233,13.334979627,14.158126518,-20.82561633,1.6462937811,-0.823146891,-19.17932255
05041,2016,162,165,-126,21,-3,-105,13.528748591,13.779280972,-10.52236002,1.7537266692,-0.250532381,-8.768633346
05041,2017,158,174,-163,22,-16,-141,13.342340821,14.693463942,-13.7645668,1.8577942915,-1.351123121,-11.9067725
12027,2010,101,56,15,19,45,34,NA,NA,NA,NA,NA,NA
12027,2011,423,311,-385,126,112,-259,12.132511114,8.9201204646,-11.04259286,3.6139394809,3.2123906496,-7.428653377
12027,2012,382,278,-55,111,104,56,10.954033206,7.9717833281,-1.577151378,3.1829782353,2.9822498781,1.6058268575
12027,2013,357,300,-233,66,57,-167,10.2303989,8.5969738652,-6.676983035,1.8913342503,1.6334250344,-4.785648785
12027,2014,380,295,253,92,85,345,10.839953788,8.4152272825,7.217127127,2.6244098644,2.4247265051,9.8415369913
12027,2015,371,325,52,111,46,163,10.488225483,9.1877986035,1.4700477766,3.1379865999,1.3004268793,4.6080343765
12027,2016,370,307,267,119,63,386,10.364145658,8.5994397759,7.4789915966,3.3333333333,1.7647058824,10.81232493
12027,2017,368,306,753,120,62,873,10.11169577,8.4080948521,20.69050792,3.2972920989,1.7036009177,23.987800019
28033,2010,490,218,235,1,272,236,NA,NA,NA,NA,NA,NA
28033,2011,2022,1098,1260,20,924,1280,12.414504464,6.7414074683,7.7360413571,0.1227943073,5.6730969952,7.8588356644
28033,2012,2078,1174,1469,4,904,1473,12.581243775,7.1079789182,8.8940553926,0.0242179861,5.473264857,8.9182733787
28033,2013,2106,1257,1098,16,849,1114,12.585532017,7.5118773717,6.5616876326,0.0956165775,5.0736546449,6.6573042101
28033,2014,2020,1246,1524,23,774,1547,11.91902146,7.352030069,8.9923706462,0.1357116305,4.5669913912,9.1280822767
28033,2015,2126,1272,1552,47,854,1599,12.370390197,7.4012870792,9.0305012161,0.2734752301,4.9691031176,9.3039764462
28033,2016,2163,1392,1643,49,771,1692,12.408606283,7.9855663183,9.4254924289,0.2811011132,4.4230399651,9.7065935421
28033,2017,2169,1360,2357,45,809,2402,12.243999368,7.6771964685,13.30525888,0.2540248831,4.5668028993,13.559283763
31049,2010,3,10,0,0,-7,0,NA,NA,NA,NA,NA,NA
31049,2011,14,25,43,0,-11,43,7.2016460905,12.860082305,22.119341564,0,-5.658436214,22.119341564
31049,2012,16,23,8,0,-7,8,8.1611833716,11.731701097,4.0805916858,0,-3.570517725,4.0805916858
31049,2013,16,21,-34,1,-5,-33,8.2389289392,10.813594233,-17.507724,0.5149330587,-2.574665294,-16.99279094
31049,2014,18,20,6,-1,-2,5,9.3482212412,10.38691249,3.1160737471,-0.519345625,-1.038691249,2.5967281226
31049,2015,17,22,-10,0,-5,-10,8.8564730399,11.461318052,-5.209690023,0,-2.604845012,-5.209690023
31049,2016,17,18,-42,0,-1,-42,8.997089177,9.5263297169,-22.22810267,0,-0.52924054,-22.22810267
31049,2017,15,19,18,0,-4,18,7.9978672354,10.130631832,9.5974406825,0,-2.132764596,9.5974406825
46039,2010,12,15,-11,0,-3,-11,NA,NA,NA,NA,NA,NA
46039,2011,49,38,-13,4,11,-9,11.26307321,8.7346282037,-2.98816228,0.9194345478,2.5284450063,-2.068727732
46039,2012,39,49,8,2,-10,10,8.9624267494,11.26048489,1.8384465127,0.4596116282,-2.298058141,2.2980581409
46039,2013,52,34,-83,0,18,-83,12.037037037,7.8703703704,-19.21296296,0,4.1666666667,-19.21296296
46039,2014,53,39,-5,3,14,-2,12.342803912,9.0824406148,-1.164415463,0.6986492781,3.2603632976,-0.465766185
46039,2015,47,48,3,3,-1,6,10.923881464,11.156304474,0.6972690296,0.6972690296,-0.23242301,1.3945380593
46039,2016,46,31,-83,3,15,-80,10.769050685,7.2574037223,-19.43111319,0.7023293925,3.5116469624,-18.7287838
46039,2017,53,38,25,3,15,28,12.442774974,8.9212348867,5.8692334781,0.7043080174,3.5215400869,6.5735414955
40043,2010,14,24,8,0,-10,8,NA,NA,NA,NA,NA,NA
40043,2011,47,65,-15,1,-18,-14,9.811084438,13.568521031,-3.131197161,0.2087464774,-3.757436593,-2.922450684
40043,2012,64,67,32,1,-3,33,13.362563942,13.988934127,6.681281971,0.2087900616,-0.626370185,6.8900720326
40043,2013,61,66,39,6,-5,45,12.643797285,13.680174111,8.0837392476,1.2436521919,-1.036376827,9.3273914395
40043,2014,69,67,96,6,2,102,14.091698152,13.683243133,19.605840907,1.2253650567,0.4084550189,20.831205963
40043,2015,53,76,27,8,-23,35,10.696266398,15.338042381,5.4490413724,1.614530777,-4.641775984,7.0635721493
40043,2016,77,64,-97,8,13,-89,15.639280999,12.998882909,-19.70143191,1.6248603636,2.6403980908,-18.07657154
40043,2017,70,76,-11,8,-6,-3,14.338385907,15.567390414,-2.253174928,1.6386726751,-1.229004506,-0.614502253
46041,2010,34,21,11,0,13,11,NA,NA,NA,NA,NA,NA
46041,2011,115,52,8,1,63,9,21.447221186,9.6978739276,1.4919806043,0.1864975755,11.749347258,1.6784781798
46041,2012,151,51,33,0,100,33,27.632903285,9.3329673346,6.0389788636,0,18.29993595,6.0389788636
46041,2013,139,86,-4,0,53,-4,25.020250203,15.480154802,-0.7200072,0,9.540095401,-0.7200072
46041,2014,157,62,-15,0,95,-15,27.93594306,11.03202847,-2.669039146,0,16.903914591,-2.669039146
46041,2015,153,68,-46,0,85,-46,26.941362916,11.973939074,-8.100017609,0,14.967423842,-8.100017609
46041,2016,155,63,-15,0,92,-15,27.022315202,10.983263598,-2.615062762,0,16.039051604,-2.615062762
46041,2017,152,74,-18,0,78,-18,26.186579378,12.748729434,-3.101042295,0,13.437849944,-3.101042295
48123,2010,57,91,-6,1,-34,-5,NA,NA,NA,NA,NA,NA
48123,2011,225,260,177,2,-35,179,11.178180192,12.917008222,8.7935017512,0.0993616017,-1.73882803,8.892863353
48123,2012,243,217,135,1,26,136,11.980180935,10.698350876,6.6556560751,0.0493011561,1.2818300589,6.7049572312
48123,2013,260,254,13,1,6,14,12.761675706,12.467175498,0.6380837853,0.0490833681,0.2945002086,0.6871671534
48123,2014,278,246,101,1,32,102,13.594796812,12.029928114,4.9391168272,0.0489021468,1.5648686977,4.988018974
48123,2015,306,269,79,0,37,79,14.873863802,13.075390074,3.8399844456,0,1.7984737277,3.8399844456
48123,2016,243,259,5,0,-16,5,11.782389449,12.558184639,0.2424359969,0,-0.77579519,0.2424359969
48123,2017,266,233,-425,0,33,-425,13.025168935,11.409264519,-20.81089022,0,1.6159044168,-20.81089022
48125,2010,2,2,6,0,0,6,NA,NA,NA,NA,NA,NA
48125,2011,19,21,-48,2,-2,-46,7.8399009697,8.6651537033,-19.80606561,0.8252527336,-0.825252734,-18.98081287
48125,2012,21,34,-68,3,-13,-65,8.8964202499,14.403728024,-28.80745605,1.2709171786,-5.507307774,-27.53653887
48125,2013,25,25,-27,1,0,-26,10.827197921,10.827197921,-11.69337375,0.4330879168,0,-11.26028584
48125,2014,22,39,-71,1,-17,-70,9.7582612553,17.298735862,-31.49257041,0.4435573298,-7.540474606,-31.04901308
48125,2015,15,23,0,1,-8,1,6.7965564114,10.421386498,0,0.4531037608,-3.624830086,0.4531037608
48125,2016,24,21,-6,1,3,-5,10.90165796,9.5389507154,-2.72541449,0.4542357484,1.3627072451,-2.271178742
48125,2017,21,16,1,1,5,2,9.5238095238,7.2562358277,0.4535147392,0.4535147392,2.2675736961,0.9070294785
51051,2010,39,77,9,2,-38,11,NA,NA,NA,NA,NA,NA
51051,2011,178,195,-56,3,-17,-53,11.253358622,12.328117591,-3.540382488,0.1896633476,-1.074758969,-3.35071914
51051,2012,184,212,-42,2,-28,-40,11.684765352,13.462881819,-2.6671747,0.127008319,-1.778116467,-2.540166381
51051,2013,174,198,-160,2,-24,-158,11.138495023,12.674839164,-10.24229427,0.1280286784,-1.536344141,-10.1142656
51051,2014,144,206,-125,2,-62,-123,9.3267269018,13.342400984,-8.096117102,0.1295378736,-4.015674083,-7.966579229
51051,2015,161,234,-69,2,-73,-67,10.538718335,15.317143418,-4.516593572,0.1309157557,-4.778425083,-4.385677816
51051,2016,148,204,-112,2,-56,-110,9.7864180387,13.489387026,-7.405937975,0.1322488924,-3.702968988,-7.273689083
51051,2017,145,189,-218,2,-44,-216,9.7243645631,12.675206224,-14.62007914,0.1341291664,-2.950841661,-14.48594997
38021,2010,15,24,-1,0,-9,-1,NA,NA,NA,NA,NA,NA
38021,2011,40,74,10,1,-34,11,7.595898215,14.052411698,1.8989745537,0.1898974554,-6.456513483,2.0888720091
38021,2012,38,78,6,0,-40,6,7.2560626313,14.894023296,1.1456940997,0,-7.637960665,1.1456940997
38021,2013,72,59,-41,2,13,-39,13.82753985,11.330900711,-7.874015748,0.3840983292,2.4966391396,-7.489917419
38021,2014,70,73,-94,6,-3,-88,13.594872791,14.177510196,-18.25597203,1.1652748106,-0.582637405,-17.09069722
38021,2015,53,80,-31,6,-27,-25,10.437179992,15.75423395,-6.104765656,1.1815675463,-5.317053958,-4.923198109
38021,2016,73,63,-72,5,10,-67,14.531701005,12.541057032,-14.33263661,0.9953219867,1.9906439733,-13.33731462
38021,2017,69,61,-147,5,8,-142,14.001623377,12.378246753,-29.82954545,1.0146103896,1.6233766234,-28.81493506
19059,2010,46,51,12,-1,-5,11,NA,NA,NA,NA,NA,NA
19059,2011,140,199,240,2,-59,242,8.3514779133,11.87102932,14.31681928,0.1193068273,-3.519551406,14.436126107
19059,2012,180,186,70,5,-6,75,10.656878127,11.012107398,4.1443414937,0.2960243924,-0.355229271,4.4403658861
19059,2013,155,222,14,6,-67,20,9.1715976331,13.136094675,0.8284023669,0.3550295858,-3.964497041,1.1834319527
19059,2014,174,229,8,3,-55,11,10.324571293,13.588085207,0.474692933,0.1780098499,-3.263513914,0.6527027829
19059,2015,174,184,166,3,-10,169,10.289769367,10.881135423,9.8166765228,0.1774098167,-0.591366056,9.9940863394
19059,2016,162,173,122,3,-11,125,9.5031383821,10.148413211,7.1566844606,0.1759840441,-0.645274828,7.3326685047
19059,2017,168,172,98,3,-4,101,9.7950616564,10.02827741,5.7137859662,0.1749118153,-0.233215754,5.8886977815
20041,2010,64,40,1,1,24,2,NA,NA,NA,NA,NA,NA
20041,2011,256,235,-122,3,21,-119,12.977137933,11.912607087,-6.184417296,0.1520758351,1.064530846,-6.032341461
20041,2012,209,261,71,6,-52,77,10.61452514,13.255459624,3.6058913154,0.3047232098,-2.640934485,3.9106145251
20041,2013,216,250,-248,4,-34,-244,11.040969152,12.778899481,-12.67666829,0.2044623917,-1.737930329,-12.47220589
20041,2014,225,217,-143,6,8,-137,11.620400258,11.207230471,-7.385409942,0.3098773402,0.413169787,-7.075532602
20041,2015,238,241,-99,6,-3,-93,12.36299413,12.518830191,-5.142589995,0.3116721209,-0.15583606,-4.830917874
20041,2016,223,226,-224,6,-3,-218,11.680284936,11.837418814,-11.7326629,0.3142677561,-0.157133878,-11.41839514
20041,2017,225,202,-108,6,23,-102,11.878679091,10.664414117,-5.701765964,0.3167647758,1.2142649737,-5.385001188
26043,2010,58,44,-25,0,14,-25,NA,NA,NA,NA,NA,NA
26043,2011,220,334,26,-6,-114,20,8.4266973092,12.793258642,0.9958824093,-0.229819018,-4.366561333,0.7660633917
26043,2012,264,293,142,-5,-29,137,10.110100527,11.220679751,5.4380086166,-0.191479177,-1.110579225,5.2465294399
26043,2013,253,319,-90,-2,-66,-92,9.6990607629,12.229250527,-3.450258769,-0.076672417,-2.530189764,-3.526931187
26043,2014,255,288,-79,-2,-33,-81,9.8275363715,11.099335196,-3.044609307,-0.077078717,-1.271798825,-3.121688024
26043,2015,218,332,-128,-1,-114,-129,8.4599414013,12.883947455,-4.967305043,-0.038807071,-4.424006054,-5.006112114
26043,2016,291,310,-111,-2,-19,-113,11.375630351,12.118369102,-4.339157969,-0.078183026,-0.742738751,-4.417340995
26043,2017,253,302,-47,-2,-49,-49,9.9352051836,11.859414883,-1.845670528,-0.078539171,-1.9242097,-1.9242097
47043,2010,159,150,32,0,9,32,NA,NA,NA,NA,NA,NA
47043,2011,598,495,136,-6,103,130,12.005982915,9.9380627804,2.7304576528,-0.120461367,2.0679201341,2.6099962858
47043,2012,568,504,128,3,64,131,11.355571327,10.076070333,2.5590019892,0.0599766091,1.2795009946,2.6189785983
47043,2013,640,472,-139,-8,168,-147,12.76858927,9.4168345869,-2.773177982,-0.159607366,3.3517546835,-2.932785348
47043,2014,622,529,256,-3,93,253,12.365313506,10.516480458,5.0892608644,-0.059639776,1.8488330484,5.0296210886
47043,2015,630,514,733,0,116,733,12.377210216,10.098231827,14.400785855,0,2.278978389,14.400785855
47043,2016,592,583,586,0,9,586,11.467423413,11.293087584,11.351199527,0,0.1743358289,11.351199527
47043,2017,605,517,843,0,88,843,11.54855643,9.8687664042,16.091624911,0,1.6797900262,16.091624911
02070,2010,19,17,2,0,2,2,NA,NA,NA,NA,NA,NA
02070,2011,111,37,22,0,74,22,22.657685242,7.5525617473,4.4907123903,0,15.105123495,4.4907123903
02070,2012,102,38,-60,1,64,-59,20.603979396,7.675992324,-12.11998788,0.201999798,12.927987072,-11.91798808
02070,2013,105,27,-50,0,78,-50,21.139520838,5.4358767868,-10.06643849,0,15.703644051,-10.06643849
02070,2014,91,38,-47,0,53,-47,18.258426966,7.6243980738,-9.430176565,0,10.634028892,-9.430176565
02070,2015,99,37,-56,0,62,-56,19.839679359,7.4148296593,-11.22244489,0,12.424849699,-11.22244489
02070,2016,113,35,-96,0,78,-96,22.670277861,7.0217674792,-19.25970509,0,15.648510382,-19.25970509
02070,2017,104,38,-111,0,66,-111,20.993136859,7.670569237,-22.40613646,0,13.322567622,-22.40613646
45033,2010,119,135,37,1,-16,38,NA,NA,NA,NA,NA,NA
45033,2011,444,329,-477,29,115,-448,13.910428122,10.307501919,-14.94431129,0.9085639989,3.6029262027,-14.03574729
45033,2012,429,357,-366,61,72,-305,13.557715098,11.282294383,-11.56672197,1.9277869953,2.2754207158,-9.638934977
45033,2013,455,376,-256,50,79,-206,14.459592589,11.949025964,-8.135507039,1.5889662186,2.5105666254,-6.546540821
45033,2014,427,333,-263,61,94,-202,13.620197445,10.621840162,-8.389020909,1.9457424921,2.998357283,-6.443278417
45033,2015,406,406,-179,66,0,-113,12.996366779,12.996366779,-5.729925255,2.1127098705,0,-3.617215384
45033,2016,395,369,-464,72,26,-392,12.741935484,11.903225806,-14.96774194,2.3225806452,0.8387096774,-12.64516129
45033,2017,388,366,-245,72,22,-173,12.621375014,11.905730039,-7.969682677,2.3421108274,0.715644975,-5.627571849
48127,2010,32,9,21,2,23,23,NA,NA,NA,NA,NA,NA
48127,2011,148,80,-6,7,68,1,14.686910787,7.9388706956,-0.595415302,0.6946511859,6.7480400913,0.0992358837
48127,2012,183,88,242,24,95,266,17.777346027,8.5486691276,23.508840101,2.3314552166,9.2286768992,25.840295318
48127,2013,198,92,295,21,106,316,18.520250678,8.605369002,27.593302778,1.9642690113,9.9148816762,29.557571789
48127,2014,192,93,-13,32,99,19,17.513454346,8.4830794491,-1.185806805,2.9189090577,9.0303748974,1.733102253
48127,2015,185,114,-143,31,71,-112,16.816653032,10.362694301,-12.998818290000001,2.8179256431,6.453958731,-10.18089265
48127,2016,161,91,-302,34,70,-268,14.79439467,8.3620491615,-27.75097634,3.1242821043,6.4323455088,-24.62669423
48127,2017,163,94,-469,34,69,-435,15.375907933,8.8670880106,-44.24110933,3.2072445996,6.5088199226,-41.03386473
51053,2010,70,35,3,4,35,7,NA,NA,NA,NA,NA,NA
51053,2011,304,245,-10,17,59,7,10.824861574,8.7239838339,-0.356080973,0.6053376538,2.1008777396,0.249256681
51053,2012,318,216,-46,26,102,-20,11.295622058,7.672498002,-1.633957908,0.9235414262,3.6231240565,-0.710416482
51053,2013,333,292,-190,27,41,-163,11.837474672,10.380007821,-6.754114678,0.9597952437,1.4574668515,-5.794319434
51053,2014,274,261,-101,28,13,-73,9.7712319241,9.3076333292,-3.601804468,0.9985200506,0.4635985949,-2.603284418
51053,2015,258,233,-216,29,25,-187,9.2372137985,8.3421349421,-7.73348132,1.0382914735,0.8950788564,-6.695189846
51053,2016,197,268,220,27,-71,247,7.0515803415,9.5930128503,7.8748612951,0.9664602498,-2.541432509,8.8413215449
51053,2017,202,272,226,28,-70,254,7.1843935056,9.6740348194,8.0379848132,0.9958565255,-2.489641314,9.0338413387
11001,2010,2246,1180,1335,657,1066,1992,NA,NA,NA,NA,NA,NA
11001,2011,9199,4671,7413,3020,4528,10433,15.01416708,7.6237824145,12.099143447,4.9290993132,7.3903846656,17.02824276
11001,2012,9231,4542,6879,3470,4689,10349,14.699442501,7.2326798655,10.954118185,5.5256272861,7.4667626353,16.479745471
11001,2013,9446,4811,6026,3629,4635,9655,14.693438196,7.4836048234,9.3735611444,5.6449806493,7.2098333727,15.018541794
11001,2014,9334,4650,2125,3784,4684,5909,14.240478568,7.094303122,3.2420202439,5.7730845191,7.1461754459,9.015104763
11001,2015,9652,4892,2910,4190,4760,7100,14.475832244,7.336901299,4.3643464391,6.2840589622,7.1389309451,10.648405401
11001,2016,9589,5181,2947,4215,4408,7162,14.131895728,7.6355565512,4.3431741278,6.2119032741,6.4963391773,10.555077402
11001,2017,9715,5422,1152,4160,4293,5312,14.096994286,7.8676173976,1.6716147624,6.0363866422,6.2293768882,7.7080014046
38023,2010,6,9,11,1,-3,12,NA,NA,NA,NA,NA,NA
38023,2011,23,18,51,3,5,54,10.895310279,8.5267645666,24.159166272,1.4211274278,2.3685457129,25.5802937
38023,2012,20,35,113,6,-15,119,9.1116173121,15.945330296,51.480637813,2.7334851936,-6.833712984,54.214123007
38023,2013,34,29,67,4,5,71,14.866637516,12.680367293,29.296020988,1.7490161784,2.186270223,31.045037167
38023,2014,30,26,91,9,4,100,12.612991381,10.931259197,38.259407189,3.7838974143,1.6817321841,42.043304604
38023,2015,35,31,8,10,4,18,14.329580348,12.691914023,3.275332651,4.0941658137,1.6376663255,7.3694984647
38023,2016,25,27,-76,13,-2,-63,10.324179228,11.150113566,-31.38550485,5.3685731984,-0.825934338,-26.01693165
38023,2017,23,22,-116,13,1,-103,9.8353645499,9.4077400043,-49.6044473,5.5591190934,0.4276245456,-44.0453282
12029,2010,37,49,-8,2,-12,-6,NA,NA,NA,NA,NA,NA
12029,2011,158,209,51,4,-51,55,9.6329715888,12.742348494,3.1093769053,0.2438726985,-3.109376905,3.3532496037
12029,2012,131,187,-201,3,-56,-198,8.0479189065,11.488250653,-12.34833359,0.1843034864,-3.440331746,-12.1640301
12029,2013,175,204,-39,-2,-29,-41,10.858773889,12.658227848,-2.419955324,-0.124100273,-1.799453959,-2.544055597
12029,2014,169,246,35,-2,-77,33,10.525004671,15.320421,2.1797346951,-0.124556268,-4.795416329,2.0551784269
12029,2015,145,224,389,-1,-79,388,8.9547630076,13.833564922,24.023467655,-0.061756986,-4.878801914,23.961710669
12029,2016,156,208,178,0,-52,178,9.5040818813,12.672109175,10.844401121,0,-3.168027294,10.844401121
12029,2017,153,191,234,0,-38,234,9.2307692308,11.523378582,14.117647059,0,-2.292609351,14.117647059
31051,2010,21,6,-30,0,15,-30,NA,NA,NA,NA,NA,NA
31051,2011,79,81,10,1,-2,11,13.188647746,13.522537563,1.6694490818,0.1669449082,-0.333889816,1.83639399
31051,2012,65,69,-107,2,-4,-105,10.940919037,11.614206363,-18.01043595,0.3366436627,-0.673287325,-17.67379229
31051,2013,67,70,-80,3,-3,-77,11.458867795,11.971951428,-13.6822302,0.5130836326,-0.513083633,-13.16914657
31051,2014,77,52,-84,4,25,-80,13.319494897,8.9949835669,-14.53035807,0.6919218128,4.3245113302,-13.83843626
31051,2015,83,67,-12,6,16,-6,14.409722222,11.631944444,-2.083333333,1.0416666667,2.7777777778,-1.041666667
31051,2016,74,54,-47,6,20,-41,12.85950126,9.3839603788,-8.16752107,1.0426622643,3.475540881,-7.124858806
31051,2017,74,54,-16,6,20,-10,12.871803792,9.3929379022,-2.783092712,1.0436597669,3.4788658897,-1.739432945
54017,2010,18,28,8,0,-10,8,NA,NA,NA,NA,NA,NA
54017,2011,66,77,61,1,-11,62,8.0282204111,9.3662571463,7.4200218951,0.1216397032,-1.338036735,7.5416615983
54017,2012,64,86,70,0,-22,70,7.7378793374,10.39777536,8.4633055253,0,-2.659896022,8.4633055253
54017,2013,67,84,264,-2,-17,262,7.9567721632,9.9756546523,31.352057479,-0.237515587,-2.018882489,31.114541892
54017,2014,71,80,-68,-3,-9,-71,8.3465585141,9.4045729736,-7.993887028,-0.352671487,-1.05801446,-8.346558514
54017,2015,67,90,250,-3,-23,247,7.8074928626,10.48767698,29.132436054,-0.349589233,-2.680184117,28.782846822
54017,2016,88,81,-118,-3,7,-121,10.18577464,9.3755425661,-13.65819781,-0.347242317,0.8102320736,-14.00544013
54017,2017,82,75,-26,-3,7,-29,9.5665869451,8.7499270839,-3.033308056,-0.349997083,0.8166598612,-3.383305139
13091,2010,62,24,-75,0,38,-75,NA,NA,NA,NA,NA,NA
13091,2011,251,245,-156,-1,6,-157,11.574287559,11.297611362,-7.193581112,-0.046112699,0.2766761966,-7.239693812
13091,2012,241,239,-96,-1,2,-97,11.176552428,11.083800955,-4.452070677,-0.046375736,0.0927514724,-4.498446413
13091,2013,279,228,-139,4,51,-135,12.993363605,10.618232623,-6.473396204,0.1862847829,2.3751309815,-6.287111422
13091,2014,221,197,-286,5,24,-281,10.373882226,9.2473067806,-13.42502406,0.2347032178,1.1265754453,-13.19032084
13091,2015,242,230,-50,5,12,-45,11.437213479,10.870078926,-2.363060636,0.2363060636,0.5671345527,-2.126754573
13091,2016,211,236,-285,6,-25,-279,10.052884844,11.243984944,-13.57854114,0.285864024,-1.1911001,-13.29267712
13091,2017,201,241,-73,6,-40,-67,9.671133351,11.595737003,-3.512401665,0.2886905478,-1.924603652,-3.223711117
27039,2010,71,24,22,3,47,25,NA,NA,NA,NA,NA,NA
27039,2011,262,125,-112,16,137,-96,12.985082024,6.1951727214,-5.550874758,0.7929821083,6.7899093027,-4.75789265
27039,2012,263,133,-80,18,130,-62,12.998887928,6.573582108,-3.954034351,0.88965772890000006,6.4253058198,-3.064376622
27039,2013,235,139,-49,19,96,-30,11.576069555,6.8471219921,-2.413733652,0.9359375385,4.7289475629,-1.477796113
27039,2014,238,143,-68,14,95,-54,11.692458855,7.0253009089,-3.34070253,0.6877916974,4.6671579465,-2.652910833
27039,2015,268,163,-90,14,105,-76,13.143697891,7.9941147621,-4.413928396,0.6866110839,5.149583129,-3.727317312
27039,2016,243,125,11,16,118,27,11.867842055,6.1048570242,0.5372274181,0.7814216991,5.7629850309,1.3186491172
27039,2017,255,125,70,16,130,86,12.345977874,6.0519499383,3.3890919654,0.7746495921,6.2940279358,4.1637415575
31053,2010,96,76,-34,2,20,-32,NA,NA,NA,NA,NA,NA
31053,2011,480,422,189,9,58,198,13.043478261,11.467391304,5.1358695652,0.2445652174,1.5760869565,5.3804347826
31053,2012,453,474,-333,13,-21,-320,12.323009752,12.894275105,-9.058636308,0.3536404565,-0.571265353,-8.704995852
31053,2013,493,445,-139,9,48,-130,13.488372093,12.175102599,-3.803009576,0.2462380301,1.3132694938,-3.556771546
31053,2014,494,428,-9,30,66,21,13.51591677,11.710146514,-0.246241399,0.8208046622,1.8057702568,0.5745632635
31053,2015,510,474,-154,35,36,-119,13.954251943,12.969245923,-4.213636861,0.9576447412,0.9850060195,-3.25599212
31053,2016,522,431,-65,39,91,-26,14.287278301,11.796584191000001,-1.779067221,1.0674403328,2.4906941099,-0.711626889
31053,2017,504,406,5,39,98,44,13.756584873,11.08169337,0.1364740563,1.064497639,2.6748915031,1.2009716953
55027,2010,224,207,-45,10,17,-35,NA,NA,NA,NA,NA,NA
55027,2011,862,904,-334,40,-42,-294,9.7315360473,10.205694416,-3.770687981,0.4515793989,-0.474158369,-3.319108582
55027,2012,817,822,-238,43,-5,-195,9.2519718477,9.3085934625,-2.695188861,0.4869458867,-0.056621615,-2.208242975
55027,2013,846,895,-196,14,-49,-182,9.6045775008,10.160870997,-2.225173984,0.1589409988,-0.556293496,-2.066232985
55027,2014,857,821,124,17,36,141,9.7337694789,9.3248830130000009,1.4083867157,0.1930852755,0.4088864659,1.6014719913
55027,2015,817,968,-123,24,-151,-99,9.284671201,11.000687543,-1.397814636,0.2727443192,-1.716016342,-1.125070317
55027,2016,809,906,-371,31,-97,-340,9.2302601929,10.336978659,-4.232912894,0.3536935303,-1.106718466,-3.879219364
55027,2017,797,886,420,31,-89,451,9.0974465510999991,10.113347107,4.7941374548,0.3538530026,-1.015900556,5.1479904574
08033,2010,5,0,0,0,5,0,NA,NA,NA,NA,NA,NA
08033,2011,17,17,-25,0,0,-25,8.2664721614,8.2664721614,-12.15657671,0,0,-12.15657671
08033,2012,24,18,-42,0,6,-42,11.843079201,8.8823094004,-20.7253886,0,2.9607698001,-20.7253886
08033,2013,17,18,24,0,-1,24,8.4116773874,8.9064819396,11.875309253,0,-0.494804552,11.875309253
08033,2014,16,29,-45,0,-13,-45,7.9800498753,14.463840399,-22.44389027,0,-6.483790524,-22.44389027
08033,2015,19,14,0,0,5,0,9.6032347738,7.0760677281,0,0,2.5271670457,0
08033,2016,15,9,77,0,6,77,7.422068283,4.4532409698,38.09995052,0,2.9688273132,38.09995052
08033,2017,15,9,-2,0,6,-2,7.2656817631,4.3594090579,-0.968757568,0,2.9062727053,-0.968757568
35013,2010,748,396,564,-54,352,510,NA,NA,NA,NA,NA,NA
35013,2011,3385,1444,838,-22,1941,816,16.005711935,6.8278428461,3.9624184938,-0.104025307,9.1778690889,3.8583931873
35013,2012,3146,1491,-494,49,1655,-445,14.738469467,6.9850788222,-2.314305123,0.229556581,7.7533906444,-2.084748542
35013,2013,3069,1447,-2351,81,1622,-2270,14.358734429,6.7699865489,-10.99947365,0.3789695304,7.58874788,-10.62050412
35013,2014,2933,1519,-1864,213,1414,-1651,13.749780252,7.1210079109,-8.738353355,0.9985350132,6.628772341,-7.739818342
35013,2015,2922,1468,-1796,303,1454,-1493,13.70656597,6.8861187011,-8.424706531,1.4213174158,6.8204472694,-7.003389115
35013,2016,2852,1507,-931,297,1345,-634,13.357093849,7.0579033765,-4.360257494,1.3909736581,6.2991904721,-2.969283836
35013,2017,2883,1559,96,294,1324,390,13.426381932,7.2603986932,0.4470803557,1.3691835894,6.1659832391,1.8162639451
20043,2010,19,10,3,0,9,3,NA,NA,NA,NA,NA,NA
20043,2011,93,68,-30,3,25,-27,11.685619149,8.5443236791,-3.769554564,0.3769554564,3.1412954703,-3.392599108
20043,2012,84,82,-77,4,2,-73,10.603382984,10.350921484,-9.719767735,0.50492299919999994,0.25246149959999997,-9.214844736
20043,2013,84,76,-28,5,8,-23,10.661251428,9.645894149,-3.553750476,0.6345982993,1.0153572788,-2.919152177
20043,2014,72,75,-35,5,-3,-30,9.166136219,9.5480585614,-4.455760662,0.6365372374,-0.381922342,-3.819223425
20043,2015,82,82,-59,5,0,-54,10.496,10.496,-7.552,0.64,0,-6.912
20043,2016,97,80,-80,6,17,-74,12.50402836,10.312600709,-10.31260071,0.7734450532,2.1914276507,-9.539155656
20043,2017,100,69,-40,6,31,-34,12.939958592,8.9285714286,-5.175983437,0.7763975155,4.0113871636,-4.399585921
48129,2010,12,13,8,1,-1,9,NA,NA,NA,NA,NA,NA
48129,2011,34,53,-32,3,-19,-29,9.1594827586,14.278017241,-8.620689655,0.8081896552,-5.118534483,-7.8125
48129,2012,29,49,-25,1,-20,-24,7.9094504296,13.364243829,-6.81849175,0.27273967,-5.4547934,-6.54575208
48129,2013,35,61,-57,2,-26,-55,9.7073914852,16.918596589,-15.80918042,0.5547080849,-7.211205103,-15.25447233
48129,2014,28,42,-55,2,-14,-53,7.9230333899,11.884550085,-15.5631013,0.5659309564,-3.961516695,-14.99717035
48129,2015,35,57,-87,2,-22,-85,10.147868948,16.526529429,-25.22470281,0.5798782256,-6.378660481,-24.64482459
48129,2016,33,44,6,2,-11,8,9.72304066,12.964054213,1.7678255745,0.5892751915,-3.241013553,2.3571007661
48129,2017,31,44,-72,2,-13,-70,9.2495897359,13.128449948,-21.4829181,0.5967477249,-3.878860212,-20.88617037
13093,2010,32,46,-66,3,-14,-63,NA,NA,NA,NA,NA,NA
13093,2011,132,115,-286,22,17,-264,8.9673913043,7.8125,-19.42934783,1.4945652174,1.1548913043,-17.93478261
13093,2012,120,128,-215,26,-8,-189,8.2738649292,8.8254559244,-14.824008,1.7926707347,-0.551590995,-13.03133726
13093,2013,109,123,-34,7,-14,-27,7.5765474577,8.5496819935,-2.36332673,0.4865672679,-0.973134536,-1.876759462
13093,2014,106,110,-118,2,-4,-116,7.4097375135,7.6893502499,-8.248575723,0.1398063682,-0.279612736,-8.108769354
13093,2015,97,130,-183,2,-33,-181,6.8602142933,9.1941016302,-12.94246614,0.1414477174,-2.333887337,-12.80101842
13093,2016,113,117,-151,5,-4,-146,8.0948458039,8.3813890182,-10.81700634,0.3581790179,-0.286543214,-10.45882732
13093,2017,106,109,-151,5,-3,-146,7.6750416335,7.8922597929,-10.93331403,0.3620302657,-0.217218159,-10.57128376
55029,2010,58,59,-34,4,-1,-30,NA,NA,NA,NA,NA,NA
55029,2011,204,303,118,-4,-99,114,7.3496298164,10.916361933,4.2512564625,-0.144110389,-3.566732117,4.1071460739
55029,2012,210,319,-122,3,-109,-119,7.5953487531,11.537696439,-4.412535942,0.1085049822,-3.942347686,-4.30403096
55029,2013,196,351,227,0,-155,227,7.109047714,12.730998712,8.2334379137,0,-5.621950998,8.2334379137
55029,2014,209,311,-27,1,-102,-26,7.589237082,11.293075275,-0.980427757,0.0363121391,-3.703838193,-0.944115618
55029,2015,209,355,-14,1,-146,-13,7.6308006864,12.961407864,-0.511154113,0.0365110081,-5.330607178,-0.474643105
55029,2016,225,321,137,1,-96,138,8.2334644589,11.746409295,5.0132650261,0.0365931754,-3.512944836,5.0498582014
55029,2017,226,351,260,1,-125,261,8.243511882,12.802976418,9.4836862359,0.0364757163,-4.559464536,9.5201619522
24019,2010,81,57,35,4,24,39,NA,NA,NA,NA,NA,NA
24019,2011,370,327,-49,27,43,-22,11.318099783,10.002753051,-1.498883485,0.8259153896,1.3153467315,-0.672968095
24019,2012,360,377,-219,11,-17,-208,11.047180667,11.568853088,-6.720368239,0.3375527426,-0.52167242,-6.382815497
24019,2013,404,378,51,27,26,78,12.42121445,11.621829362,1.5680245965,0.8301306687,0.7993850884,2.3981552652
24019,2014,399,371,-121,35,28,-86,12.260324484,11.399950836,-3.718043265,1.07546706,0.860373648,-2.642576205
24019,2015,380,387,-134,41,-7,-93,11.705994701,11.921631446,-4.127903395,1.2630152178,-0.215636745,-2.864888177
24019,2016,368,393,-162,45,-25,-117,11.379448963,12.152509354,-5.009431337,1.3915087047,-0.773060391,-3.617922632
24019,2017,367,391,-122,45,-24,-77,11.392385417,12.137391547,-3.787114498,1.3968864952,-0.745006131,-2.390228003
45035,2010,433,174,542,53,259,595,NA,NA,NA,NA,NA,NA
45035,2011,1761,863,2111,102,898,2213,12.665420023,6.2068469505,15.182681243,0.7336018412,6.4585730725,15.916283084
45035,2012,1842,907,1252,276,935,1528,12.985273487,6.3939430255,8.8260382227,1.9456761577,6.5913304618,10.77171438
45035,2013,1804,942,1905,146,862,2051,12.479117884,6.5162577865,13.177782466,1.0099507822,5.9628600976,14.187733248
45035,2014,1829,945,2129,165,884,2294,12.388367533,6.400769447,14.420357833,1.1175946653,5.9875980859,15.537952499
45035,2015,1936,1047,2991,212,889,3203,12.794924328,6.9195690966,19.767365012,1.4010970855,5.875355231,21.168462098
45035,2016,1792,1137,-745,182,655,-563,11.680164252,7.4109077873,-4.855871857,1.1862666819,4.269256465,-3.669605175
45035,2017,1803,1121,2159,142,682,2301,11.634997919,7.2339615458,13.932313093,0.9163448167,4.4010363731,14.84865791
13095,2010,381,267,-170,14,114,-156,NA,NA,NA,NA,NA,NA
13095,2011,1569,761,-311,60,808,-251,16.552466254,8.0283153725,-3.280954114,0.6329815011,8.5241508817,-2.647972613
13095,2012,1385,894,-967,96,491,-871,14.598001602,9.4228255829,-10.19225094,1.0118470425,5.1751760192,-9.180403896
13095,2013,1403,922,-1912,96,481,-1816,14.919341975,9.8044428375,-20.33198992,1.0208530503,5.1148991376,-19.31113687
13095,2014,1275,852,-1167,99,423,-1068,13.699218876,9.1543015547,-12.53881445,1.0637040539,4.5449173212,-11.4751104
13095,2015,1279,875,-1730,122,404,-1608,13.877812319,9.4942031108,-18.77139586,1.3237631766,4.3836092077,-17.44763269
13095,2016,1206,1004,-1482,106,202,-1376,13.255369194,11.03514981,-16.28893627,1.1650656174,2.2202193841,-15.12387066
13095,2017,1221,933,-1288,104,288,-1184,13.57443426,10.3726021,-14.31930494,1.1562171687,3.2018321595,-13.16308777
08035,2010,923,260,735,49,663,784,NA,NA,NA,NA,NA,NA
08035,2011,3550,903,2449,328,2647,2777,12.255811585,3.1174641863,8.454783823,1.1323679436,9.1383473987,9.5871517666
08035,2012,3485,1039,3157,444,2446,3601,11.797243135,3.5171694741,10.686914369,1.503006012,8.2800736608,12.189920381
08035,2013,3425,1046,4612,457,2379,5069,11.333741458,3.461341187,15.26166879,1.5122685683,7.8724002713,16.773937358
08035,2014,3537,1033,5218,498,2504,5716,11.406108411,3.3312157164,16.826992844,1.6059491062,8.0748926949,18.43294195
08035,2015,3371,1259,4544,550,2112,5094,10.605064382,3.9607760478,14.295287023,1.7302834204,6.6442883344,16.025570443
08035,2016,3554,1356,3483,555,2198,4038,10.948758946,4.17741056,10.730030222,1.7097808708,6.7713483856,12.439811092
08035,2017,3478,1396,4934,545,2082,5479,10.491372068,4.2110280067,14.883389817,1.6439901602,6.2803440615,16.527379977
13097,2010,434,154,-33,50,280,17,NA,NA,NA,NA,NA,NA
13097,2011,1748,828,-492,172,920,-320,13.150915787,6.2293811621,-3.701516343,1.2940260385,6.9215346246,-2.407490304
13097,2012,1761,842,-568,118,919,-450,13.194668185,6.3088646291,-4.255861175,0.8841401737,6.885803556,-3.371721001
13097,2013,1742,834,1408,133,908,1541,12.910063105,6.1808224051,10.43476972,0.9856707193,6.7292407,11.420440439
13097,2014,1714,899,1092,162,815,1254,12.49303007,6.5526452934,7.959386719,1.1807881396,5.9403847766,9.1401748587
13097,2015,1745,962,1268,193,783,1461,12.522650209,6.9036042986,9.0995532751,1.385026642,5.6190459104,10.484579917
13097,2016,1797,998,564,193,799,757,12.722709364,7.0658118781,3.9931041074,1.3664345616,5.6568974855,5.359538669
13097,2017,1762,1015,929,192,747,1121,12.32585877,7.1003102451,6.4987076036,1.3431128739,5.2255485252,7.8418204776
17041,2010,64,27,-39,7,37,-32,NA,NA,NA,NA,NA,NA
17041,2011,260,192,-214,26,68,-188,13.046969089,9.6346848655,-10.73865917,1.3046969089,3.4122842232,-9.433962264
17041,2012,243,192,-53,22,51,-31,12.223647476,9.6581905984,-2.66606303,1.1066676727,2.5654568777,-1.559395357
17041,2013,268,196,-104,6,72,-98,13.48359831,9.8611390622,-5.232441135,0.3018716039,3.6224592473,-4.930569531
17041,2014,258,223,15,8,35,23,12.971668468,11.211946002,0.7541667714,0.4022222781,1.7597224666,1.1563890495
17041,2015,254,198,-129,9,56,-120,12.773768513,9.957504589,-6.487465111,0.452613845,2.8162639242,-6.034851266
17041,2016,290,185,-196,8,105,-188,14.638701699,9.3384821181,-9.893743217,0.4038262538,5.3002195805,-9.489916963
17041,2017,279,162,-146,8,117,-138,14.120505099,8.1990029608,-7.389224891,0.4048890351,5.9215021383,-6.984335855
20045,2010,289,119,108,117,170,225,NA,NA,NA,NA,NA,NA
20045,2011,1232,607,16,530,625,546,11.019431587,5.4292166991,0.1431095011,4.7405022249,5.5902148879,4.883611726
20045,2012,1266,592,-434,590,674,156,11.223603255,5.2483200057,-3.84758595,5.2305891948,5.9752832497,1.3830032447
20045,2013,1221,711,272,573,510,845,10.721388775,6.2431674196,2.3883847231,5.0314134057,4.4782213558,7.4197981288
20045,2014,1226,664,563,646,562,1209,10.620373619,5.7519804918,4.8770557483,5.5960533098,4.8683931271,10.473109058
20045,2015,1258,677,283,690,581,973,10.743459343,5.7816549881,2.4168513466,5.892676428,4.9618043546,8.3095277746
20045,2016,1337,715,303,698,622,1001,11.265683061,6.0246547409,2.5531054357,5.8814112016,5.2410283201,8.4345166373
20045,2017,1318,651,-58,696,667,638,10.970306095,5.4185654535,-0.482760056,5.7931206692,5.5517406413,5.3103606134
27041,2010,98,100,-19,3,-2,-16,NA,NA,NA,NA,NA,NA
27041,2011,382,380,174,14,2,188,10.587436427,10.532004823,4.8225495766,0.3880212303,0.0554316043,5.2105708069
27041,2012,399,379,84,10,20,94,11.01282069,10.460799603,2.3184885663,0.2760105436,0.5520210872,2.5944991099
27041,2013,407,413,55,10,-6,65,11.208107289,11.373337372,1.5146090932,0.2753834715,-0.165230083,1.7899925646
27041,2014,416,374,184,11,42,195,11.410859518,10.258801585,5.0471109404,0.3017294584,1.1520579321,5.3488403988
27041,2015,423,397,188,11,26,199,11.531069827,10.822304306,5.1249199231,0.2998623359,0.7087655213,5.4247822591
27041,2016,425,441,384,11,-16,395,11.491611124,11.924236484,10.383008639,0.297429935,-0.43262536,10.680438574
27041,2017,429,429,391,11,0,402,11.478567988,11.478567988,10.461818376,0.2943222561,0,10.756140633
29067,2010,34,23,-47,0,11,-47,NA,NA,NA,NA,NA,NA
29067,2011,143,156,-4,-5,-13,-9,10.485024013,11.438208014,-0.293287385,-0.366609231,-0.953184001,-0.659896616
29067,2012,159,143,-65,-6,16,-71,11.692466081,10.51586572,-4.779938964,-0.441225135,1.1766003603,-5.221164099
29067,2013,151,173,-106,-6,-22,-112,11.182700141,12.811967711,-7.850107384,-0.444345701,-1.62926757,-8.294453084
29067,2014,135,173,123,-5,-38,118,10.017809439,12.837637281,9.1273374889,-0.371029979,-2.819827842,8.7563075096
29067,2015,162,157,-165,-5,5,-170,12.058506085,11.686329971,-12.28181175,-0.372176114,0.3721761137,-12.65398787
29067,2016,145,179,38,-4,-34,34,10.859389627,13.405729264,2.8459090058,-0.299569369,-2.546339637,2.5463396368
29067,2017,149,164,-32,-4,-15,-36,11.181149632,12.306768723,-2.401320726,-0.300165091,-1.12561909,-2.701485817
31055,2010,2083,917,85,257,1166,342,NA,NA,NA,NA,NA,NA
31055,2011,8127,3735,344,1192,4392,1536,15.583235223,7.1617304735,0.6596078401,2.2856178646,8.4215047496,2.9452257048
31055,2012,8338,3725,923,1353,4613,2276,15.795316342,7.0565547342,1.7485100724,2.5630922296,8.7387616078,4.311602302
31055,2013,8481,3997,350,1435,4484,1785,15.869763525,7.4792412228,0.6549248006,2.6851916825,8.3905223025,3.3401164831
31055,2014,8536,3890,-191,1692,4646,1501,15.791367472,7.1963940331,-0.353344797,3.1301539085,8.594973439,2.7768091115
31055,2015,8757,4151,-71,1894,4606,1823,16.016622024,7.5922117186,-0.12985956,3.4641409287,8.424410305,3.3342813691
31055,2016,8696,3983,-645,1914,4713,1269,15.727794844,7.2037496394,-1.16656252,3.4617064549,8.5240452047,2.2951439348
31055,2017,8704,3835,-1017,1900,4869,883,15.577433482,6.8634486906,-1.820111426,3.4004048271,8.7139847912,1.5802934012
32005,2010,97,82,23,6,15,29,NA,NA,NA,NA,NA,NA
32005,2011,392,419,-14,0,-27,-14,8.3387400419,8.9130920346,-0.297812144,0,-0.574351993,-0.297812144
32005,2012,325,418,53,-2,-93,51,6.9207836457,8.9011925043,1.1286201022,-0.042589438,-1.980408859,1.0860306644
32005,2013,340,430,124,9,-90,133,7.2412067258,9.1579967415,2.6409106882,0.1916790016,-1.916790016,2.8325896898
32005,2014,377,490,535,39,-113,574,7.9868651025,10.380806101,11.334145437,0.8262274244,-2.393940999,12.160372862
32005,2015,354,512,187,44,-158,231,7.4577342392,10.786327487,3.9395375783,0.9269500184,-3.328593248,4.8664875968
32005,2016,368,506,535,51,-138,586,7.7110049451,10.6026318,11.210292515,1.0686447071,-2.891626854,12.278937222
32005,2017,365,524,470,51,-159,521,7.5839428191,10.887632979,9.765625,1.0596742021,-3.30369016,10.825299202
41019,2010,263,364,60,2,-101,62,NA,NA,NA,NA,NA,NA
41019,2011,1072,1407,-79,-15,-335,-94,9.9824469101,13.101961569,-0.735646741,-0.139679761,-3.119514659,-0.875326501
41019,2012,1082,1400,37,-4,-318,33,10.11073214,13.082278185,0.3457459235,-0.037377938,-2.971546045,0.3083679858
41019,2013,1118,1308,-91,-2,-190,-93,10.476502835,12.256946071,-0.852738603,-0.018741508,-1.780443237,-0.871480111
41019,2014,1062,1427,468,6,-365,474,9.961448631,13.385110354,4.3897909221,0.0562793708,-3.423661723,4.4460702929
41019,2015,1119,1405,773,13,-286,786,10.467286223,13.142571173,7.2307526811,0.1216038614,-2.675284951,7.3523565425
41019,2016,1092,1461,1304,16,-369,1320,10.146247189,13.574786762,12.116031442,0.1486629625,-3.428539572,12.264694405
41019,2017,1108,1402,1582,16,-294,1598,10.188271534,12.891657663,14.546792028,0.1471230546,-2.703386129,14.693915082
46043,2010,5,6,-7,1,-1,-6,NA,NA,NA,NA,NA,NA
46043,2011,38,55,-3,1,-17,-2,12.73458445,18.431635389,-1.00536193,0.3351206434,-5.697050938,-0.670241287
46043,2012,30,49,-7,0,-19,-7,10.131712259,16.548463357,-2.364066194,0,-6.416751098,-2.364066194
46043,2013,34,34,27,2,0,29,11.478730587,11.478730587,9.1154625253,0.6752194463,0,9.7906819716
46043,2014,38,47,-40,4,-9,-36,12.866091078,15.913323176,-13.54325377,1.3543253767,-3.047232098,-12.18892839
46043,2015,45,48,21,4,-3,25,15.298317185,16.318204997,7.1392146864,1.3598504165,-1.019887812,8.4990651028
46043,2016,40,33,-54,5,7,-49,13.647219379,11.258955988,-18.42374616,1.7059024224,2.3882633913,-16.71784374
46043,2017,47,30,0,5,17,5,16.093134737,10.272213662,0,1.7120356103,5.8209210752,1.7120356103
53017,2010,140,99,42,12,41,54,NA,NA,NA,NA,NA,NA
53017,2011,541,306,-76,6,235,-70,14.014454835,7.9268450639,-1.968758905,0.1554283346,6.0876097713,-1.81333057
53017,2012,519,283,315,13,236,328,13.319987681,7.26311467,8.0843855867,0.3336413099,6.056873011,8.4180268966
53017,2013,507,306,-41,31,201,-10,12.887318573,7.7781449379,-1.042169747,0.7879820035,5.1091736356,-0.254187743
53017,2014,525,307,81,46,218,127,13.255567338,7.7513508054,2.045144675,1.1614401858,5.5042165328,3.2065848609
53017,2015,540,310,426,63,230,489,13.454590756,7.7239317304,10.614177152,1.5697022549,5.7306590258,12.183879407
53017,2016,526,327,510,69,199,579,12.865983416,7.9984345572,12.474622704,1.6877430717,4.8675488589,14.162365776
53017,2017,536,311,381,67,225,448,12.881983249,7.4744343103,9.1567828689,1.6102479061,5.4075489383,10.767030775
55031,2010,118,124,-12,-1,-6,-13,NA,NA,NA,NA,NA,NA
55031,2011,466,442,-218,11,24,-207,10.580809228,10.035874847,-4.949820626,0.2497615912,0.5449343808,-4.700059035
55031,2012,482,401,-307,20,81,-287,10.992644963,9.1453332573,-7.001539426,0.456126347,1.8473117053,-6.545413079
55031,2013,421,426,-25,25,-5,0,9.6252772126,9.7395916688,-0.571572281,0.571572281,-0.114314456,0
55031,2014,419,423,-128,33,-4,-95,9.5922712392,9.6838442343,-2.930335844,0.7554772098,-0.091572995,-2.174858634
55031,2015,399,389,-195,34,10,-161,9.1614621602,8.9318515797,-4.477406319,0.7806759735,0.2296105805,-3.696730345
55031,2016,429,412,-131,33,17,-98,9.877168545,9.4857655957,-3.01610508,0.7597821958,0.3914029493,-2.256322884
55031,2017,410,420,-130,33,-10,-97,9.4605196363,9.6912640177,-2.999676958,0.7614564585,-0.230744381,-2.238220499
05043,2010,45,65,145,3,-20,148,NA,NA,NA,NA,NA,NA
05043,2011,220,165,-10,17,55,7,11.767537643,8.8256532321,-0.534888075,0.9093097269,2.9418844107,0.3744216523
05043,2012,241,179,-17,7,62,-10,12.852990587,9.5464120957,-0.90664249,0.373323378,3.3065784912,-0.533319111
05043,2013,224,176,-164,9,48,-155,11.963255715,9.3997009186,-8.75881222,0.4806665242,2.563554796,-8.278145695
05043,2014,255,230,-66,6,25,-60,13.67035677,12.330125714,-3.538209987,0.3216554534,1.3402310558,-3.216554534
05043,2015,240,196,-67,6,44,-61,12.885214217,10.522924944,-3.597122302,0.3221303554,2.3622892731,-3.274991947
05043,2016,256,194,-57,7,62,-50,13.746811653,10.417505705,-3.060813532,0.3758893811,3.3293059471,-2.684924151
05043,2017,241,198,-132,7,43,-125,12.965702757,10.652320108,-7.101546738,0.3765971755,2.3133826496,-6.724949563
18037,2010,126,65,-60,12,61,-48,NA,NA,NA,NA,NA,NA
18037,2011,506,401,111,36,105,147,12.039735887,9.5413717209,2.641127833,0.8565819999,2.4983641663,3.4977098328
18037,2012,508,411,-212,37,97,-175,12.063499602,9.7600360955,-5.03437385,0.8786407191,2.3034635067,-4.155733131
18037,2013,538,378,1,41,160,42,12.758187294,8.9639308497,0.0237141028,0.9722782139,3.7942564443,0.9959923166
18037,2014,541,415,-159,55,126,-104,12.796556047,9.8162121248,-3.760910188,1.3009437756,2.9803439222,-2.459966412
18037,2015,571,422,-170,64,149,-106,13.49658449,9.9747086771,-4.018247571,1.5127520269,3.5218758125,-2.505495544
18037,2016,578,393,-125,69,185,-56,13.634808865,9.2707264428,-2.948704339,1.6276847953,4.3640824222,-1.321019544
18037,2017,570,401,-135,69,169,-66,13.409556073,9.4337403251,-3.175947491,1.623262051,3.975815748,-1.55268544
19061,2010,316,165,121,12,151,133,NA,NA,NA,NA,NA,NA
19061,2011,1160,867,310,71,293,381,12.305799108,9.1975239884,3.2886187271,0.753199773,3.1082751195,4.0418185001
19061,2012,1163,862,181,59,301,240,12.259720546,9.0867404218,1.9080046593,0.6219462702,3.1729801241,2.5299509295
19061,2013,1170,917,437,73,253,510,12.250282699,9.6012899443,4.5755329396,0.7643338778,2.6489927545,5.3398668174
19061,2014,1286,938,128,64,348,192,13.375213213,9.7557931522,1.3312809419,0.6656404709,3.6194200607,1.9969214128
19061,2015,1236,952,62,73,284,135,12.793640443,9.8540013767,0.6417521905,0.7556114501,2.9396390661,1.3973636406
19061,2016,1203,853,-530,73,350,-457,12.433016221,8.8157629562,-5.477554943,0.7544556809,3.6172532646,-4.723099263
19061,2017,1219,865,-85,71,354,-14,12.583550543,8.9292626907,-0.877441999,0.7329221399,3.6542878526,-0.144519859
49013,2010,118,19,-60,0,99,-60,NA,NA,NA,NA,NA,NA
49013,2011,389,138,-201,7,251,-194,20.828871279,7.3891625616,-10.7624759,0.3748125937,13.439708717,-10.38766331
49013,2012,427,141,13,11,286,24,22.641709529,7.4765364017,0.6893260512,0.5832758895,15.165173127,1.2726019407
49013,2013,448,148,636,10,300,646,22.982609142,7.5924690915,32.627096907,0.5130046683,15.39014005,33.140101575
49013,2014,437,117,-88,11,320,-77,21.748326573,5.8227785105,-4.379525717,0.5474407147,15.925548063,-3.832085003
49013,2015,444,146,244,12,298,256,21.669106881,7.1254270376,11.908247926,0.5856515373,14.543679844,12.493899463
49013,2016,416,129,-750,13,287,-737,20.252671551,6.2802755532,-36.51322996,0.632895986,13.972395998,-35.88033397
49013,2017,395,114,-585,12,281,-573,19.583054461,5.6518182494,-29.00275154,0.5949282368,13.931236211,-28.40782331
25007,2010,42,19,12,4,23,16,NA,NA,NA,NA,NA,NA
25007,2011,173,147,96,1,26,97,10.40101004,8.837852462,5.7716587507,0.0601214453,1.5631575783,5.831780196
25007,2012,149,134,121,-2,15,119,8.8891540389,7.9942727598,7.2187089846,-0.119317504,0.8948812791,7.0993914807
25007,2013,159,145,314,-1,14,313,9.3551423864,8.5314191574,18.474935279,-0.058837373,0.823723229,18.416097905
25007,2014,152,142,126,0,10,126,8.8210544642,8.2407219337,7.3121898848,0,0.5803325305,7.3121898848
25007,2015,175,140,-58,1,35,-57,10.122335657,8.0978685253,-3.354831246,0.057841918,2.0244671312999998,-3.296989328
25007,2016,149,151,36,2,-2,38,8.6154557807,8.7310994825,2.0815866316,0.1156437018,-0.115643702,2.1972303333
25007,2017,162,138,-11,2,24,-9,9.3541588475,7.9683575367,-0.635158934,0.1154834426,1.3858013107,-0.519675492
31057,2010,6,8,2,0,-2,2,NA,NA,NA,NA,NA,NA
31057,2011,15,21,-27,0,-6,-27,7.5301204819,10.542168675,-13.55421687,0,-3.012048193,-13.55421687
31057,2012,8,41,39,-1,-33,38,4.0434672732,20.722769775,19.711902957,-0.505433409,-16.6793025,19.206469548
31057,2013,19,32,-7,-2,-13,-9,9.647118558,16.247778624,-3.554201574,-1.015486164,-6.600660066,-4.569687738
31057,2014,14,36,-68,-2,-22,-70,7.3202614379,18.823529412,-35.55555556,-1.045751634,-11.50326797,-36.60130719
31057,2015,14,21,-86,-2,-7,-88,7.6901950014,11.535292502,-47.23976929,-1.098599286,-3.845097501,-48.33836858
31057,2016,24,15,32,-1,9,31,13.374198941,8.3588743383,17.832265255,-0.557258289,5.015324603,17.275006966
31057,2017,22,29,-7,-1,-7,-8,12.168141593,16.039823009,-3.871681416,-0.553097345,-3.871681416,-4.424778761
29069,2010,108,78,-39,4,30,-35,NA,NA,NA,NA,NA,NA
29069,2011,504,433,3,-10,71,-7,15.761821366,13.541406055,0.0938203653,-0.312734551,2.2204153115,-0.218914186
29069,2012,437,454,-145,-5,-17,-150,13.688975206,14.221498269,-4.542108478,-0.15662443,-0.532523063,-4.698732908
29069,2013,478,464,-140,8,14,-132,15.039959726,14.599458813,-4.405009125,0.2517148071,0.4405009125,-4.153294318
29069,2014,442,406,-483,19,36,-464,14.025735002,12.883367446,-15.32676472,0.6029162105,1.1423675568,-14.72384851
29069,2015,430,463,-471,23,-33,-448,13.842167104,14.904472951,-15.16200164,0.7403949846,-1.062305848,-14.42160666
29069,2016,421,408,-304,22,13,-282,13.717599909,13.294016064,-9.905345302,0.7168341995,0.4235838452,-9.188511103
29069,2017,402,428,-436,23,-26,-413,13.25092707,14.107952204,-14.37165225,0.7581376185,-0.857025134,-13.61351463
38025,2010,11,19,2,4,-8,6,NA,NA,NA,NA,NA,NA
38025,2011,41,40,166,11,1,177,11.308784995,11.032960971,45.786788029,3.034064267,0.2758240243,48.820852296
38025,2012,45,35,209,8,10,217,11.735558743,9.1276568001,54.505150606,2.0863215543,2.6079019429,56.591472161
38025,2013,49,44,171,2,5,173,12.119713084,10.883007668,42.295325254,0.4946821667,1.2367054168,42.79000742
38025,2014,61,22,182,12,39,194,14.341130833,5.1722111203,42.788291995,2.8212060656,9.1689197132,45.60949806
38025,2015,91,38,136,12,53,148,20.335195531,8.4916201117,30.391061453,2.6815642458,11.843575419,33.072625698
38025,2016,58,26,-250,13,32,-237,12.960893855,5.8100558659,-55.86592179,2.905027933,7.1508379888,-52.96089385
38025,2017,65,21,-143,13,44,-130,15.008081275,4.8487647195,-33.0177788,3.0016162549,10.159316555,-30.01616255
55033,2010,120,92,0,-3,28,-3,NA,NA,NA,NA,NA,NA
55033,2011,472,297,-285,7,175,-278,10.769494039,6.7765672238,-6.502766528,0.1597170726,3.9929268154,-6.343049455
55033,2012,433,284,-171,34,149,-137,9.8899090951,6.4866840254,-3.905714677,0.7765748481,3.4032250697,-3.129139829
55033,2013,443,323,75,38,120,113,10.091231107,7.3577147804,1.7084477044,0.8656135036,2.7335163271,2.574061208
55033,2014,467,327,-158,47,140,-111,10.606525171,7.426838824,-3.588503163,1.0674661307,3.1796863467,-2.521037032
55033,2015,465,336,-2,50,129,48,10.536452728,7.6134368096,-0.045318076,1.1329519062,2.923015918,1.0876338299
55033,2016,446,310,-76,48,136,-28,10.073859915,7.0020102546,-1.716621869,1.084182233,3.0718496601,-0.632439636
55033,2017,446,321,193,47,125,240,10.020220175,7.2118625028,4.3361042462,1.0559424848,2.8083576724,5.3920467311
17043,2010,2804,1367,-600,523,1437,-77,NA,NA,NA,NA,NA,NA
17043,2011,10731,5873,-1140,2652,4858,1512,11.648095312,6.3749197436,-1.237426955,2.8786458641,5.2731755686,1.641218909
17043,2012,10717,5863,-3672,2665,4854,-1007,11.569092592,6.3291583342,-3.963955211,2.8768901519,5.2399342579,-1.087065059
17043,2013,10412,5938,-3420,2445,4474,-975,11.195403992,6.3847780354,-3.677322479,2.6289630004,4.8106259566,-1.048359479
17043,2014,10683,5887,-6479,2802,4796,-3677,11.457940627,6.3140406696,-6.948984117,3.0052559803,5.1438999578,-3.943728137
17043,2015,10935,6172,-7731,3069,4763,-4662,11.719798743,6.6149609367,-8.285849482,3.289260388,5.1048378065,-4.996589094
17043,2016,10749,6321,-9489,3079,4428,-6410,11.531603825,6.7812138598,-10.17986684,3.3031731489,4.7503899654,-6.876693694
17043,2017,10652,6451,-8353,3070,4201,-5283,11.445880552,6.9317851523,-8.97553889,3.298803351,4.5140953999,-5.676735539
37061,2010,174,91,111,51,83,162,NA,NA,NA,NA,NA,NA
37061,2011,778,478,139,189,300,328,13.194827221,8.1068475726,2.3574305703,3.2054271783,5.0879796481,5.5628577486
37061,2012,785,496,-140,107,289,-33,13.2148208,8.3497466458,-2.356783327,1.8012558288,4.8650741545,-0.555527499
37061,2013,781,542,-447,118,239,-329,13.129139629,9.1113875534,-7.51437313,1.9836600208,4.0177520761,-5.530713109
37061,2014,755,527,-176,128,228,-48,12.682681001,8.8526793214,-2.956492525,2.1501763817,3.8300016798,-0.806316143
37061,2015,716,562,-848,163,154,-685,12.062909082,9.4683727708,-14.28679735,2.7461650563,2.5945363109,-11.54063229
37061,2016,751,556,103,169,195,272,12.65886795,9.3719448471,1.7361696389,2.8486666891,3.2869231029,4.5848363281
37061,2017,714,544,-862,170,170,-692,12.040675222,9.1738477883,-14.53650146,2.8668274339,2.8668274339,-11.66967402
37063,2010,1106,359,287,267,747,554,NA,NA,NA,NA,NA,NA
37063,2011,4213,1811,1765,1341,2402,3106,15.37007851,6.6069812918,6.439161778,4.8923036512,8.7630972186,11.331465429
37063,2012,4322,1693,2128,1299,2629,3427,15.439105375,6.047756918,7.6016696524,4.6403049241,9.3913484569,12.241974577
37063,2013,4249,1879,2172,1365,2370,3537,14.857786263,6.570435488,7.5949898244,4.7730944338,8.2873507752,12.368084258
37063,2014,4345,1825,2441,1472,2520,3913,14.869392323,6.245486994,8.353552741,5.037455811,8.6239053287,13.391008552
37063,2015,4345,1986,1665,1647,2359,3312,14.564994402,6.6573254044,5.5812924463,5.5209541496,7.9076689975,11.102246596
37063,2016,4316,1960,1841,1707,2356,3548,14.19120645,6.4445701209,6.0532926492,5.6126944879,7.746636329,11.665987137
37063,2017,4299,2046,599,1700,2253,2299,13.896206746,6.6135471046,1.9362242012,5.4951271152,7.2826596415,7.4313513164
36027,2010,765,562,-85,215,203,130,NA,NA,NA,NA,NA,NA
36027,2011,2753,2282,-757,906,471,149,9.2365193118,7.6562793569,-2.53979118,3.0396972381,1.5802399549,0.4999060579
36027,2012,2666,2372,-2044,784,294,-1260,8.9495521867,7.9626173244,-6.861547138,2.6318262995,0.9869348623,-4.229720838
36027,2013,2745,2402,-1602,749,343,-853,9.2370592837,8.0828475044,-5.390808369,2.5204216406,1.1542117794,-2.870386728
36027,2014,2572,2336,-1869,755,236,-1114,8.6748288307,7.8788492023,-6.303753921,2.5464602516,0.7959796283,-3.757293669
36027,2015,2680,2332,-1920,820,348,-1100,9.0637455252,7.8868114048,-6.49342963,2.7732355711,1.1769341204,-3.720194059
36027,2016,2608,2512,-1693,851,96,-842,8.8425363975,8.5170442601,-5.740189464,2.8853521757,0.3254921373,-2.854837288
36027,2017,2576,2611,201,850,-35,1051,8.7302058004,8.848822727,0.6812000644,2.8806967897,-0.118616927,3.5618968541
12031,2010,3021,1750,-435,650,1271,215,NA,NA,NA,NA,NA,NA
12031,2011,12575,7034,-1365,2679,5541,1314,14.470123079,8.0940632796,-1.570713161,3.0827403364,6.3760597999,1.5120271751
12031,2012,12388,7286,-341,3470,5102,3129,14.134041785,8.3129341657,-0.389062661,3.9590833866,5.8211076192,3.5700207253
12031,2013,12308,7555,-1616,3048,4753,1432,13.93000253,8.5506312245,-1.828963608,3.4496788845,5.3793713051,1.6207152764
12031,2014,12666,7664,2746,3360,5002,6106,14.197371032,8.5906088415,3.0780025938,3.7662376967,5.6067621901,6.8442402904
12031,2015,12819,7805,5122,3783,5014,8905,14.170081882,8.6276222085,5.6618425307,4.1817161838,5.5424596737,9.8435587145
12031,2016,13173,8212,6102,3671,4961,9773,14.334011967,8.9357706123,6.6398042226,3.9945462637,5.398241355,10.634350486
12031,2017,13171,8437,3379,3435,4734,6814,14.129594049,9.0510504132,3.624925844,3.6850015609,5.0785436359,7.3099274049
48131,2010,39,48,-55,0,-9,-55,NA,NA,NA,NA,NA,NA
48131,2011,172,109,13,0,63,13,14.628960238,9.2706782905,1.1056772273,0,5.3582819477,1.1056772273
48131,2012,182,116,-288,2,66,-286,15.568862275,9.9230111206,-24.6364414,0.1710863986,5.6458511548,-24.465355
48131,2013,160,135,-25,4,25,-21,13.809770413,11.651993786,-2.157776627,0.3452442603,2.157776627,-1.812532367
48131,2014,174,129,-119,5,45,-114,15.060371316,11.1654477,-10.29990912,0.4327692907,3.8949236162,-9.8671398279999991
48131,2015,180,131,-234,5,49,-229,15.745965096,11.459563487,-20.46975463,0.4373879193,4.2864016096,-20.03236671
48131,2016,174,140,67,5,34,72,15.268515269,12.285012285,5.8792558793,0.4387504388,2.9835029835,6.318006318
48131,2017,163,132,-212,5,31,-207,14.34732858,11.618695537,-18.6603292,0.4401021037,2.7286330429,-18.22022709
47045,2010,116,107,-21,4,9,-17,NA,NA,NA,NA,NA,NA
47045,2011,474,441,-260,13,33,-247,12.403831057,11.540273198,-6.803789187,0.3401894594,0.8635578584,-6.463599728
47045,2012,520,412,-48,16,108,-32,13.631656902,10.800466622,-1.258306791,0.419435597,2.8311902796,-0.838871194
47045,2013,478,444,-141,13,34,-128,12.534252862,11.642695127,-3.697342371,0.3408897222,0.8915577349,-3.356452649
47045,2014,464,438,-319,19,26,-300,12.226130719,11.541045808,-8.40546487,0.5006389734,0.685084911,-7.904825896
47045,2015,445,427,-71,20,18,-51,11.772953953,11.29674458,-1.878381417,0.529121526,0.4762093734,-1.349259891
47045,2016,486,452,-231,21,34,-210,12.893469696,11.991457413,-6.128377572,0.5571252338,0.9020122833,-5.571252338
47045,2017,467,463,-165,21,4,-144,12.442052539,12.335482496,-4.39601428,0.5594927266,0.1065700432,-3.836521554
08037,2010,195,9,-335,29,186,-306,NA,NA,NA,NA,NA,NA
08037,2011,655,83,-903,104,572,-799,12.596880589,1.5962459373,-17.36638652,2.0001153913,11.000634652,-15.36627113
08037,2012,697,98,-377,75,599,-302,13.393414744,1.8831487015,-7.24435776,1.4411852307,11.510266043,-5.803172529
08037,2013,601,118,-53,65,483,12,11.461372695,2.2503194309,-1.010736694,1.2395827374,9.2110532639,0.2288460438
08037,2014,658,121,-131,61,537,-70,12.435272329,2.28672941,-2.475715312,1.1528140001,10.148542919,-1.322901312
08037,2015,645,111,-84,75,534,-9,12.077860065,2.0785154531,-1.572930613,1.4044023332,9.9993446122,-0.16852828
08037,2016,656,100,68,75,556,143,12.144999445,1.8513718666,1.2589328693,1.3885288999,10.293627578,2.6474617692
08037,2017,636,115,-190,76,521,-114,11.655182525,2.1074622489,-3.48189415,1.3927576602,9.5477202756,-2.08913649
13099,2010,41,12,-53,0,29,-53,NA,NA,NA,NA,NA,NA
13099,2011,157,121,-240,2,36,-238,14.427494946,11.119279544,-22.05476934,0.1837897445,3.3082154016,-21.8709796
13099,2012,156,123,-187,1,33,-186,14.565826331,11.484593838,-17.46031746,0.0933706816,3.081232493,-17.36694678
13099,2013,141,170,-71,-1,-29,-72,13.319478557,16.058945777,-6.706971472,-0.094464387,-2.739467221,-6.801435859
13099,2014,120,137,-75,0,-17,-75,11.439466158,13.060057197,-7.149666349,0,-1.620591039,-7.149666349
13099,2015,131,135,9,0,-4,9,12.540085196,12.922988561,0.8615325707,0,-0.382903365,0.8615325707
13099,2016,136,125,-161,0,11,-161,13.110329204,12.04993493,-15.52031619,0,1.0603942739,-15.52031619
13099,2017,125,140,14,0,-15,14,12.139458095,13.596193066,1.3596193066,0,-1.456734971,1.3596193066
22033,2010,1412,933,-213,221,479,8,NA,NA,NA,NA,NA,NA
22033,2011,5997,3456,-2880,867,2541,-2013,13.601985976,7.8386632539,-6.532219378,1.9664702087000001,5.7633227223,-4.56574917
22033,2012,6018,3550,-1550,949,2468,-601,13.613259469,8.0304205905,-3.506239976,2.1467237015,5.5828388781,-1.359516275
22033,2013,6130,3699,-1866,927,2431,-939,13.815158587,8.3364227754,-4.205397377,2.0891765106,5.4787358116,-2.116220867
22033,2014,6197,3700,-2163,1130,2497,-1033,13.920556014,8.3114502582,-4.858828894,2.5383618356,5.6091057553,-2.320467059
22033,2015,6199,3827,-2994,1235,2372,-1759,13.893137812,8.5770347485,-6.710123344,2.7678698496,5.3161030634,-3.942253494
22033,2016,6129,3851,-2306,1263,2278,-1043,13.707928747,8.6130255517,-5.157527116,2.8247861002,5.0949031957,-2.332741015
22033,2017,6121,3878,-4974,1252,2243,-3722,13.693527621,8.6756249168,-11.12752923,2.8008979876,5.0179027046,-8.326631238
22035,2010,23,6,-40,0,17,-40,NA,NA,NA,NA,NA,NA
22035,2011,126,82,-125,-2,44,-127,16.370014291,10.653501364,-16.24009354,-0.259841497,5.7165129271,-16.49993504
22035,2012,127,66,-143,-1,61,-144,16.673230931,8.6648286727,-18.77379546,-0.131285283,8.0084022581,-18.90508074
22035,2013,117,108,-84,-3,9,-87,15.52238806,14.328358209,-11.14427861,-0.39800995,1.1940298507,-11.54228856
22035,2014,138,83,-112,-2,55,-114,18.476368992,11.112598741,-14.99531396,-0.267773464,7.3637702504,-15.26308743
22035,2015,114,83,-197,-2,31,-199,15.494393476,11.281005776,-26.77539925,-0.271831464,4.2133876996,-27.04723072
22035,2016,96,63,-57,-2,33,-59,13.219498761,8.6752960617,-7.849077389,-0.275406224,4.544202699,-8.124483613
22035,2017,96,74,-143,-2,22,-145,13.356521739,10.295652174,-19.89565217,-0.27826087,3.0608695652,-20.17391304
22037,2010,62,83,-87,1,-21,-86,NA,NA,NA,NA,NA,NA
22037,2011,203,184,-90,-2,19,-92,10.087959052,9.1437658401,-4.472494161,-0.099388759,0.9441932117,-4.57188292
22037,2012,209,237,-199,-1,-28,-200,10.463602683,11.865425053,-9.962951837,-0.050065085,-1.401822369,-10.01301692
22037,2013,213,260,-207,-3,-47,-210,10.793827755,13.175564396,-10.48977627,-0.152025743,-2.381736641,-10.64180201
22037,2014,220,238,99,-2,-18,97,11.199633467,12.115967114,5.0398350599,-0.10181485,-0.916333647,4.9380202102
22037,2015,219,244,-109,-2,-25,-111,11.165778673,12.440410941,-5.557396691,-0.101970581,-1.274632269,-5.659367273
22037,2016,202,217,-4,-2,-15,-6,10.340943995,11.108835876,-0.204771168,-0.102385584,-0.767891881,-0.307156752
22037,2017,193,233,-67,-2,-40,-69,9.9139591627,11.968665725,-3.441633492,-0.102735328,-2.054706562,-3.54436882
48133,2010,48,47,11,2,1,13,NA,NA,NA,NA,NA,NA
48133,2011,221,267,21,6,-46,27,11.891310196,14.366424536,1.1299435028,0.3228410008,-2.47511434,1.4527845036
48133,2012,185,230,-96,23,-45,-73,9.9916286355,12.42202479,-5.18484513,1.242202479,-2.430396155,-3.942642651
48133,2013,179,257,-124,24,-78,-100,9.746270282,13.993248394,-6.751606229,1.3067624959,-4.246978112,-5.444843733
48133,2014,214,257,-13,19,-43,6,11.721210461,14.076406956,-0.71203615,1.0406682185,-2.355196495,0.328632069
48133,2015,212,276,-52,40,-64,-12,11.648671667,15.165251793,-2.857221352,2.1978625786,-3.516580126,-0.659358774
48133,2016,213,254,154,30,-41,184,11.682755595,13.931548925,8.4466871435,1.6454585344,-2.24879333,10.092145678
48133,2017,214,252,125,23,-38,148,11.65767827,13.72773329,6.8093915128,1.2529280384,-2.07005502,8.0623195511
26045,2010,283,237,-99,37,46,-62,NA,NA,NA,NA,NA,NA
26045,2011,1193,951,-296,173,242,-123,11.067303678,8.822301591,-2.745952966,1.6048981864,2.2450020873,-1.14105478
26045,2012,1130,915,-319,158,215,-161,10.474795602,8.4818035188,-2.957044068,1.4646174382,1.9929920837,-1.49242663
26045,2013,1179,1028,-1,103,151,102,10.914291798,9.51644781,-0.009257245,0.95349623,1.3978439877,0.944238985
26045,2014,1192,958,17,101,234,118,11.005447327,8.8449819961,0.156956883,0.9325085403,2.160465331,1.0894654233
26045,2015,1178,997,-313,100,181,-213,10.861647688,9.1927527546,-2.885989581,0.9220413997,1.6688949334,-1.963948181
26045,2016,1156,975,138,98,181,236,10.640550069,8.9745123848,1.270238676,0.9020535525,1.6660376837,2.1722922285
26045,2017,1149,979,-83,96,170,13,10.547380596,8.986845608,-0.761908259,0.8812432874,1.5605349881,0.1193350285
55035,2010,279,141,-4,8,138,4,NA,NA,NA,NA,NA,NA
55035,2011,1133,732,464,50,401,514,11.389567438,7.3584848759,4.6643947847,0.5026287484,4.0310825618,5.1670235331
55035,2012,1193,774,407,82,419,489,11.884068077,7.7102000767,4.0543300145,0.8168429022,4.1738680002,4.8711729167
55035,2013,1176,801,387,108,375,495,11.612234318,7.909353477,3.8213730282,1.0664296823,3.7028808413,4.8878027105
55035,2014,1218,840,-546,107,378,-439,11.979228136,8.2615366458,-5.36999882,1.0523624061,3.7176914906,-4.317636414
55035,2015,1235,900,-51,118,335,67,12.127103832,8.8375655453,-0.500795381,1.1587030382,3.2895382863,0.6579076573
55035,2016,1202,847,380,117,355,497,11.731579127,8.2667616645,3.7088186924,1.1419257553,3.4648174627,4.8507444478
55035,2017,1197,763,238,117,434,355,11.590077267,7.38782703,2.3044598075,1.1328646953,4.2022502372,3.4373245028
13101,2010,14,10,-9,-1,4,-10,NA,NA,NA,NA,NA,NA
13101,2011,64,32,14,16,32,30,15.779092702,7.8895463511,3.4516765286,3.9447731755,7.8895463511,7.3964497041
13101,2012,78,23,-161,6,55,-155,19.31171082,5.6944788314,-39.86135182,1.4855162169,13.617231988,-38.3758356
13101,2013,74,33,-16,3,41,-13,18.47690387,8.2397003745,-3.995006242,0.7490636704,10.237203496,-3.245942572
13101,2014,75,29,-11,7,46,-4,18.566654289,7.179106325,-2.723109296,1.7328877336,11.387547964,-0.990221562
13101,2015,59,29,-40,8,30,-32,14.533809582,7.1437369134,-9.853430225,1.9706860451,7.390072669,-7.88274418
13101,2016,44,24,-107,9,20,-98,10.945273632,5.9701492537,-26.61691542,2.2388059701,4.9751243781,-24.37810945
13101,2017,34,24,-65,10,10,-55,8.5891120374,6.0629026146,-16.42036125,2.5262094228,2.5262094228,-13.89415183
48135,2010,577,219,-413,-20,358,-433,NA,NA,NA,NA,NA,NA
48135,2011,2408,1242,1348,-3,1166,1345,17.40576096,8.9775561097,9.7437565507,-0.021684918,8.4282048502,9.7220716325
48135,2012,2585,1111,3181,109,1474,3290,18.199995776,7.822125844,22.396203699,0.767427288,10.377869932,23.163630987
48135,2013,2847,1177,3256,197,1670,3453,19.360366671,8.0039169551,22.14167681,1.3396530503,11.356449715,23.481329861
48135,2014,3043,1149,2689,254,1894,2943,20.005456631,7.5538184914,17.678170516,1.6698606587,12.45163814,19.348031175
48135,2015,3170,1201,2933,318,1969,3251,20.165330263,7.6399248094,18.65770147,2.0228943292,12.525405454,20.6805958
48135,2016,2873,1189,-4279,336,1684,-3943,18.10248413,7.4917694501,-26.96154876,2.1171022163,10.61071468,-24.84444654
48135,2017,2797,1220,-2416,338,1577,-2078,17.777523541,7.7542290739,-15.35591594,2.148302809,10.023294467,-13.20761313
35015,2010,194,106,-2,0,88,-2,NA,NA,NA,NA,NA,NA
35015,2011,767,578,-38,-13,189,-51,14.210940757,10.709157441,-0.704062254,-0.240863403,3.5017833156,-0.944925657
35015,2012,701,509,117,16,192,133,12.934175931,9.3915771023,2.158771161,0.295216569,3.5425988284,2.4539877301
35015,2013,896,587,817,20,309,837,16.309294113,10.684771925,14.871309476,0.3640467436,5.6245221886,15.23535622
35015,2014,867,589,669,37,278,706,15.477444347,10.514665191,11.942803078,0.6605137726,4.9627791563,12.60331685
35015,2015,918,540,528,51,378,579,16.10596956,9.4740997412,9.2635641914,0.8947760867,6.6318698189,10.158340278
35015,2016,893,550,-423,56,343,-367,15.539217819,9.5706268761,-7.360682125,0.9744638274,5.9685909427,-6.386218297
35015,2017,873,531,-861,57,342,-804,15.255170245,9.2789179838,-15.04547718,0.9960420435,5.9762522608,-14.04943514
38027,2010,4,2,-1,0,2,-1,NA,NA,NA,NA,NA,NA
38027,2011,23,60,-3,0,-37,-3,9.7231029381,25.36461636,-1.268230818,0,-15.64151342,-1.268230818
38027,2012,28,53,28,1,-25,29,11.925042589,22.572402044,11.925042589,0.4258943782,-10.64735945,12.350936968
38027,2013,23,50,43,0,-27,43,9.754028838,21.204410517,18.235793045,0,-11.45038168,18.235793045
38027,2014,27,38,-27,0,-11,-27,11.501597444,16.18743344,-11.50159744,0,-4.685835996,-11.50159744
38027,2015,27,50,-5,0,-23,-5,11.660548478,21.593608292,-2.159360829,0,-9.933059814,-2.159360829
38027,2016,36,38,-12,0,-2,-12,15.68627451,16.557734205,-5.22875817,0,-0.871459695,-5.22875817
38027,2017,34,44,37,0,-10,37,14.769765421,19.113814075,16.072980017,0,-4.344048653,16.072980017
17045,2010,47,82,-32,0,-35,-32,NA,NA,NA,NA,NA,NA
17045,2011,186,226,-75,-6,-40,-81,10.083213618,12.251646654,-4.065811943,-0.325264955,-2.168433036,-4.391076898
17045,2012,186,219,-200,-3,-33,-203,10.181181236,11.987519842,-10.94750671,-0.164212601,-1.806338606,-11.11171931
17045,2013,205,265,-188,-6,-60,-194,11.372777454,14.701395246,-10.42966908,-0.332861779,-3.328617791,-10.76253086
17045,2014,180,245,-67,-2,-65,-69,10.094495696,13.739730253,-3.75739562,-0.112161063,-3.645234557,-3.869556683
17045,2015,165,235,-139,-1,-70,-140,9.3436774449,13.307661816,-7.871340393,-0.056628348,-3.963984371,-7.927968741
17045,2016,175,240,-16,-1,-65,-17,9.9925769428,13.704105522,-0.913607035,-0.05710044,-3.711528579,-0.970707474
17045,2017,166,227,-81,-1,-61,-82,9.5402298851,13.045977011,-4.655172414,-0.057471264,-3.505747126,-4.712643678
37065,2010,202,104,-6,-4,98,-10,NA,NA,NA,NA,NA,NA
37065,2011,644,566,-652,-5,78,-657,11.430194171,10.045791772,-11.57218416,-0.088743744,1.3844023996000001,-11.6609279
37065,2012,685,585,-488,10,100,-478,12.259069027,10.469423913,-8.733468153,0.1789645113,1.7896451134,-8.554503642
37065,2013,628,614,-268,16,14,-252,11.30014665,11.048232553,-4.822355577,0.2879018255,0.2519140973,-4.534453751
37065,2014,650,581,-637,2,69,-635,11.780911299,10.530322253,-11.54529307,0.0362489578,1.2505890456,-11.50904411
37065,2015,607,674,-1081,4,-67,-1077,11.172053302,12.405212398,-19.89619377,0.0736214386,-1.233159096,-19.82257233
37065,2016,603,649,-434,4,-46,-430,11.26439573,12.123702867,-8.107376031,0.0747223597,-0.859307137,-8.032653671
37065,2017,591,648,-494,4,-57,-490,11.14673708,12.221803093,-9.317238778,0.075443229,-1.075066013,-9.241795549
45037,2010,48,18,-24,-1,30,-25,NA,NA,NA,NA,NA,NA
45037,2011,152,182,-41,0,-30,-41,5.6414348544,6.7548759441,-1.521702823,0,-1.11344109,-1.521702823
45037,2012,185,206,-394,2,-21,-392,6.9271525659,7.7134779922,-14.75296276,0.0748881358,-0.786325426,-14.67807463
45037,2013,212,204,-41,-3,8,-44,8.004379755,7.7023276887,-1.548016839,-0.113269525,0.3020520662,-1.661286364
45037,2014,236,227,179,-2,9,177,8.8858767273,8.547008547,6.7397115855,-0.07530404,0.3388681803,6.6644075455
45037,2015,204,237,92,2,-33,94,7.6460336201,8.8828919998,3.4482112404,0.0749611139,-1.23685838,3.5231723543
45037,2016,203,230,-105,3,-27,-102,7.6188331551,8.6321754959,-3.94077577,0.1125935934,-1.013342341,-3.828182176
45037,2017,199,268,176,5,-69,181,7.4709515139,10.061381938,6.6074747058,0.1877123496,-2.590430424,6.7951870554
21061,2010,26,18,39,-1,8,38,NA,NA,NA,NA,NA,NA
21061,2011,112,124,17,-1,-12,16,9.1709314227,10.153531218,1.3920163767,-0.081883316,-0.982599795,1.3101330604
21061,2012,100,122,-120,4,-22,-116,8.2338410869,10.045286126,-9.880609304,0.3293536435,-1.811445039,-9.551255661
21061,2013,97,143,9,5,-46,14,8.043451221,11.857871388,0.7462995978,0.4146108877,-3.814420167,1.1609104855
21061,2014,107,138,-23,7,-31,-16,8.9036821302,11.483253589,-1.913875598,0.5824838777,-2.579571458,-1.33139172
21061,2015,110,148,26,7,-38,33,9.1746945244,12.344134451,2.1685641603,0.583844197,-3.169439927,2.7524083573
21061,2016,104,136,106,7,-32,113,8.6472104432,11.30789058,8.8135029517,0.5820237798,-2.660680136,9.3955267315
21061,2017,103,147,195,7,-44,202,8.479459949,12.101753519,16.053346505,0.5762739771,-3.62229357,16.629620482
46045,2010,10,18,2,0,-8,2,NA,NA,NA,NA,NA,NA
46045,2011,34,47,-11,0,-13,-11,8.3888477671,11.596348384,-2.714038983,0,-3.207500617,-2.714038983
46045,2012,43,53,-19,0,-10,-19,10.680576254,13.164431197,-4.719324391,0,-2.483854943,-4.719324391
46045,2013,54,59,17,4,-5,21,13.437849944,14.682095309,4.2304342416,0.9953962921,-1.244245365,5.2258305338
46045,2014,44,30,-75,5,14,-70,11.001375172,7.5009376172,-18.75234404,1.2501562695,3.5004375547,-17.50218777
46045,2015,52,39,7,5,13,12,13.048933501,9.7867001255,1.756587202,1.2547051443,3.2622333752,3.0112923463
46045,2016,43,34,-72,4,9,-68,10.838059231,8.5696282294,-18.14744802,1.0081915564,2.2684310019,-17.13925646
46045,2017,45,40,-28,4,5,-24,11.454753723,10.182003309,-7.127402316,1.0182003309,1.2727504136,-6.109201985
17047,2010,14,15,14,0,-1,14,NA,NA,NA,NA,NA,NA
17047,2011,74,64,-79,0,10,-79,11.043951944,9.5515260055,-11.79016491,0,1.4924259384,-11.79016491
17047,2012,86,80,48,1,6,49,12.84828565,11.951893628,7.1711361769,0.1493986704,0.8963920221,7.3205348472
17047,2013,74,80,-28,0,-6,-28,11.039832911,11.934954498,-4.177234074,0,-0.895121587,-4.177234074
17047,2014,85,76,-68,0,9,-68,12.769473447,11.417411553,-10.21557876,0,1.3520618944,-10.21557876
17047,2015,69,77,-111,0,-8,-111,10.506280929,11.724400457,-16.90140845,0,-1.218119528,-16.90140845
17047,2016,84,60,12,0,24,12,12.870604459,9.1932888991,1.8386577798,0,3.6773155596,1.8386577798
17047,2017,77,65,-71,0,12,-71,11.817972527,9.9762105748,-10.89709155,0,1.8417619523,-10.89709155
20047,2010,10,2,8,0,8,8,NA,NA,NA,NA,NA,NA
20047,2011,39,31,-44,3,8,-41,12.835280566,10.202402501,-14.48082936,0.9873292743,2.6328780648,-13.49350008
20047,2012,28,50,-34,4,-22,-30,9.3442349408,16.686133823,-11.346571,1.3348907058,-7.341898882,-10.01168029
20047,2013,41,31,-16,5,10,-11,13.807038222,10.439467924,-5.388112477,1.683785149,3.367570298,-3.704327328
20047,2014,29,37,53,2,-8,55,9.6876565893,12.360113579,17.70502756,0.6681142475,-2.67245699,18.373141807
20047,2015,34,36,-69,2,-2,-67,11.394101877,12.064343164,-23.1233244,0.6702412869,-0.670241287,-22.45308311
20047,2016,30,32,-51,3,-2,-48,10.256410256,10.94017094,-17.43589744,1.0256410256,-0.683760684,-16.41025641
20047,2017,26,25,-10,3,1,-7,8.9763507682,8.6311065079,-3.452442603,1.0357327809,0.3452442603,-2.416709822
48137,2010,9,2,-9,0,7,-9,NA,NA,NA,NA,NA,NA
48137,2011,25,16,-31,2,9,-29,12.569130216,8.0442433384,-15.58572147,1.0055304173,4.5248868778,-14.58019105
48137,2012,28,22,2,1,6,3,14.116460802,11.091504916,1.0083186287,0.5041593143,3.0249558861,1.512477943
48137,2013,18,18,-94,1,0,-93,9.2664092664,9.2664092664,-48.39124839,0.5148005148,0,-47.87644788
48137,2014,25,16,-6,1,9,-5,13.161358252,8.4232692814,-3.158725981,0.5264543301,4.7380889708,-2.63227165
48137,2015,22,31,17,1,-9,18,11.542497377,16.264428122,8.9192025184,0.5246589717,-4.721930745,9.44386149
48137,2016,26,25,5,1,1,6,13.584117032,13.061650993,2.6123301985,0.5224660397,0.5224660397,3.1347962382
48137,2017,23,12,24,1,11,25,11.883234306,6.1999483338,12.399896668,0.5166623611,5.6832859726,12.916559029
13103,2010,140,53,119,2,87,121,NA,NA,NA,NA,NA,NA
13103,2011,663,327,-121,19,336,-102,12.608997461,6.2189172998,-2.301189582,0.3613438186,6.3900801613,-1.939845763
13103,2012,699,346,283,20,353,303,13.182958339,6.525470079,5.3373064519,0.3771948023,6.6574882598,5.7145012542
13103,2013,738,397,720,18,341,738,13.693927726,7.3665166767,13.359929489,0.3339982372,6.3274110498,13.693927726
13103,2014,776,405,584,18,371,602,14.128228236,7.3736242729,10.632584137,0.3277166344,6.7546039636,10.960300771
13103,2015,760,424,1260,21,336,1281,13.515796587,7.5403917803,22.407768026,0.3734628004,5.975404807,22.781230827
13103,2016,755,439,1170,20,316,1190,13.062283737,7.5951557093,20.242214533,0.3460207612,5.4671280277,20.588235294
13103,2017,788,442,1061,20,346,1081,13.295651074,7.4577129118,17.901885519,0.3374530729,5.8379381617,18.239338592
17049,2010,131,98,-56,-1,33,-57,NA,NA,NA,NA,NA,NA
17049,2011,438,350,-56,10,88,-46,12.792616499,10.222410444,-1.635585671,0.2920688698,2.5702060546,-1.343516801
17049,2012,445,348,-95,4,97,-91,12.988718787,10.157469973,-2.77287255,0.1167525284,2.8312488142,-2.656120022
17049,2013,431,372,-133,17,59,-116,12.589822983,10.866390138,-3.885026582,0.496582345,1.7234328445,-3.388444237
17049,2014,446,345,-219,20,101,-199,13.057735098,10.100714369,-6.411757817,0.5855486591,2.9570207284,-5.826209158
17049,2015,448,383,4,24,65,28,13.118018242,11.214734345,0.1171251629,0.7027509773,1.9032838968,0.8198761401
17049,2016,469,361,-145,23,108,-122,13.71786247,10.55895171,-4.241130188,0.6727309953,3.1589107608,-3.568399193
17049,2017,467,339,-201,23,128,-178,13.672160904,9.9247592002,-5.884591738,0.6733612437,3.7474017039,-5.211230494
06017,2010,382,296,-12,36,86,24,NA,NA,NA,NA,NA,NA
06017,2011,1632,1312,-627,138,320,-489,9.0134870928,7.2461366825,-3.46290221,0.7621698645,1.7673504104,-2.700732346
06017,2012,1599,1421,-628,156,178,-472,8.8426815612,7.8583180103,-3.47292309,0.8627006401,0.9843635509,-2.61022245
06017,2013,1493,1329,651,150,164,801,8.2418340703,7.3365019956,3.5937267112,0.8280476293,0.9053320747,4.4217743405
06017,2014,1609,1378,1321,178,231,1499,8.8176220917,7.5516987212,7.2393280194,0.9754734197,1.2659233705,8.2148014391
06017,2015,1601,1483,1228,202,118,1430,8.696407911,8.0554484272,6.6703241191,1.0972357264000001,0.6409594838,7.7675598455
06017,2016,1570,1578,1208,213,-8,1421,8.4604876366,8.5035984017,6.5097255191,1.1478241189,-0.043110765,7.657549638
06017,2017,1587,1635,2557,210,-48,2767,8.458158232,8.7139815434,13.627920983,1.1192269872,-0.255823311,14.74714797
08041,2010,2259,861,2606,383,1398,2989,NA,NA,NA,NA,NA,NA
08041,2011,9232,3675,3563,630,5557,4193,14.614185194,5.8174968142,5.6402016732,0.9972851682,8.79668838,6.6374868414
08041,2012,9164,3784,429,2535,5380,2964,14.302793446,5.9059112178,0.669565516,3.9565235035,8.3968822283,4.6260890194
08041,2013,9084,3911,2437,1523,5173,3960,13.988544608,6.0225889433,3.7527612515,2.3452832934,7.9659556644,6.098044545
08041,2014,9185,4065,1433,1361,5120,2794,13.961756795,6.1790464204,2.1782468685,2.0688025038,7.7827103745,4.2470493723
08041,2015,9437,4130,3468,1902,5307,5370,14.14582779,6.190767063,5.1984455628,2.8510505942,7.9550607272,8.049496157
08041,2016,9584,4555,7964,1241,5029,9205,14.102838594,6.7026742272,11.719011536,1.8261292461,7.4001643663,13.545140782
08041,2017,9661,4606,6624,811,5055,7435,13.941460585,6.6467619764,9.5588691558,1.1703265225,7.2946986085,10.729195678
48141,2010,3290,1128,486,260,2162,746,NA,NA,NA,NA,NA,NA
48141,2011,13812,4775,5220,1513,9037,6733,17.021937373,5.8847198781,6.4331387987,1.86462433,11.137217495,8.2977631286
48141,2012,13928,4813,-229,3042,9115,2813,16.877698487,5.8323063482,-0.277498058,3.6862405799,11.045392139,3.4087425218
48141,2013,13680,4839,-12637,2650,8841,-9987,16.468921231,5.8255197251,-15.21328637,3.1902515543,10.643401506,-12.02303482
48141,2014,13564,4922,-8278,2890,8642,-5388,16.306020389,5.9170032699,-9.951432968,3.4742258127,10.389017119,-6.477207155
48141,2015,13695,5296,-12865,3725,8399,-9140,16.436777815,6.3562742103,-15.44060946,4.4707555577,10.080503605,-10.96985391
48141,2016,13277,5300,-7127,3412,7977,-3715,15.900246521,6.3471647634,-8.535140239,4.0861370137,9.5530817581,-4.449003226
48141,2017,13224,5384,-7673,3083,7840,-4590,15.765783219,6.4188578987,-9.147826274,3.6755830055,9.3469253206,-5.472243268
08039,2010,33,12,32,3,21,35,NA,NA,NA,NA,NA,NA
08039,2011,180,109,-45,1,71,-44,7.774034724,4.7076099162,-1.943508681,0.0431890818,3.0664248078,-1.900319599
08039,2012,161,117,61,-9,44,52,6.9351712255,5.0398449278,2.6276114581,-0.387680379,1.8953262977,2.239931079
08039,2013,160,127,236,-3,33,233,6.8389220149,5.4283943493,10.087409972,-0.128229788,1.4105276656,9.9591801842
08039,2014,175,119,407,3,56,410,7.3642350664,5.0076798451,17.127106697,0.1262440297,2.3565552212,17.253350727
08039,2015,206,138,478,4,68,482,8.4859220201,5.6847438776,19.69063459,0.1647751849,2.8011781426,19.855409775
08039,2016,209,126,403,1,83,404,8.4284389241,5.0812598298,16.251965964,0.040327459,3.3471790942,16.292293423
08039,2017,219,139,520,2,80,522,8.64195095,5.4850738907,20.519700886,0.0789219265,3.1568770594,20.598622812
13105,2010,58,62,-60,0,-4,-60,NA,NA,NA,NA,NA,NA
13105,2011,253,262,-270,-6,-9,-276,12.673128459,13.123951211,-13.52468255,-0.300548501,-0.450822752,-13.82523105
13105,2012,228,223,-250,-5,5,-255,11.573310322,11.319509657,-12.69003325,-0.253800665,0.253800665,-12.94383391
13105,2013,240,266,-64,5,-26,-59,12.286270093,13.617282687,-3.276338692,0.2559639603,-1.331012593,-3.020374731
13105,2014,223,270,-53,6,-47,-47,11.470013373,13.887460138,-2.72605699,0.3086102253,-2.417446765,-2.417446765
13105,2015,217,236,-72,6,-19,-66,11.214470284,12.196382429,-3.720930233,0.3100775194,-0.981912145,-3.410852713
13105,2016,215,259,-126,7,-44,-119,11.183645869,13.472392,-6.554136649,0.3641187027,-2.288746131,-6.190017946
13105,2017,215,259,4,7,-44,11,11.241242288,13.541775593,0.2091393914,0.365993935,-2.300533305,0.5751333264
20049,2010,11,18,-8,0,-7,-8,NA,NA,NA,NA,NA,NA
20049,2011,26,42,-67,0,-16,-67,9.1986555811,14.859366708,-23.70422784,0,-5.660711127,-23.70422784
20049,2012,21,41,-108,0,-20,-108,7.7106664219,15.054158252,-39.65485588,0,-7.34349183,-39.65485588
20049,2013,25,55,2,0,-30,2,9.4446543257,20.778239516,0.7555723461,0,-11.33358519,0.7555723461
20049,2014,37,24,47,0,13,47,13.891496152,9.0107002065,17.645954571,0,4.8807959452,17.645954571
20049,2015,22,51,-96,0,-29,-96,8.3570750237,19.373219373,-36.46723647,0,-11.01614435,-36.46723647
20049,2016,23,31,-51,0,-8,-51,9.0515545061,12.199921291,-20.07083825,0,-3.148366785,-20.07083825
20049,2017,16,35,6,0,-19,6,6.3885006987,13.974845278,2.395687762,0,-7.58634458,2.395687762
42047,2010,75,121,-54,0,-46,-54,NA,NA,NA,NA,NA,NA
42047,2011,290,400,23,0,-110,23,9.1190667107,12.578023049,0.7232363253,0,-3.458956339,0.7232363253
42047,2012,309,392,-96,1,-83,-95,9.7576379569,12.378621615,-3.031499171,0.0315781164,-2.620983658,-2.999921055
42047,2013,297,372,-100,2,-75,-98,9.4317153337,11.81346163,-3.175661729,0.0635132346,-2.381746296,-3.112148494
42047,2014,308,397,-222,2,-89,-220,9.8567885431,12.705016401,-7.104568365,0.0640051204,-2.848227858,-7.040563245
42047,2015,272,401,-178,2,-129,-176,8.7909246631,12.960149963,-5.7528845219999996,0.0646391519,-4.1692253,-5.68824537
42047,2016,299,381,-286,2,-82,-284,9.7694858767,12.448742873,-9.344725621,0.0653477316,-2.679256996,-9.27937789
42047,2017,286,366,-147,2,-80,-145,9.4358297592,12.075222699,-4.849884527,0.0659848235,-2.63939294,-4.783899703
18039,2010,737,319,-565,13,418,-552,NA,NA,NA,NA,NA,NA
18039,2011,3053,1515,-662,57,1538,-605,15.425619261,7.6547046118,-3.344828022,0.2879987874,7.7709146488,-3.056829234
18039,2012,2985,1661,-665,54,1324,-611,15.020114877,8.35792657,-3.346189747,0.2717206712,6.6621883075,-3.074469075
18039,2013,3021,1653,-150,84,1368,-66,15.125797972,8.2763800225,-0.75103267,0.4205782952,6.8494179497,-0.330454375
18039,2014,3041,1620,-216,135,1421,-81,15.127885603,8.058919657,-1.074522621,0.6715766381,7.0689659461,-0.402945983
18039,2015,3183,1728,116,184,1455,300,15.715647018,8.5317744412,0.5727348583,0.9084759822,7.1838725764,1.4812108405
18039,2016,3134,1589,-993,195,1545,-798,15.379821223,7.7978736195,-4.873057586,0.9569448432,7.5819476036,-3.916112743
18039,2017,3145,1621,-831,195,1524,-636,15.372282967,7.9232021272,-4.061801954,0.9531304225,7.4490808401,-3.108671532
32007,2010,185,39,-4,11,146,7,NA,NA,NA,NA,NA,NA
32007,2011,683,278,-28,27,405,-1,13.856766078,5.6400892676,-0.568066545,0.547778454,8.2166768107,-0.020288091
32007,2012,624,236,1141,6,388,1147,12.412723041,4.6945555091,22.696982356,0.1193531062,7.718167532,22.816335462
32007,2013,628,245,993,-9,383,984,12.135500203,4.7343910027,19.188776595,-0.173916404,7.4011092002,19.014860191
32007,2014,736,253,-287,11,483,-276,14.005442332,4.8143708017,-5.461361344,0.2093204696,9.1910715305,-5.252040875
32007,2015,789,267,-1374,17,522,-1357,15.099611506,5.1097544639,-26.29514095,0.3253401719,9.9898570417,-25.96980078
32007,2016,826,340,-76,24,486,-52,15.864479699,6.5301732417,-1.459685783,0.4609534053,9.3343064572,-0.998732378
32007,2017,803,343,-115,22,460,-93,15.305150002,6.5375671864,-2.1918957039999998,0.4193191781,8.7675828155,-1.772576526
21063,2010,17,27,4,0,-10,4,NA,NA,NA,NA,NA,NA
21063,2011,59,68,-55,1,-9,-54,7.5505502943,8.7023291528,-7.038648579,0.1279754287,-1.151778858,-6.910673151
21063,2012,55,72,-135,0,-17,-135,7.1349808653,9.3403385873,-17.51313485,0,-2.205357722,-17.51313485
21063,2013,65,86,-61,0,-21,-61,8.560516265,11.32622152,-8.033715264,0,-2.765705255,-8.033715264
21063,2014,67,66,-18,0,1,-18,8.8818187844,8.7492543249,-2.38616027,0,0.1325644595,-2.38616027
21063,2015,80,70,4,0,10,4,10.607969237,9.2819730823,0.5303984618,0,1.3259961546,0.5303984618
21063,2016,75,55,-62,0,20,-62,9.9634672866,7.3065426769,-8.23646629,0,2.6569246098,-8.23646629
21063,2017,73,72,16,0,1,16,9.7139055223,9.5808383234,2.129075183,0,0.1330671989,2.129075183
20051,2010,90,81,-47,8,9,-39,NA,NA,NA,NA,NA,NA
20051,2011,393,225,134,26,168,160,13.747026724,7.8704351476,4.6872813768,0.9094725059,5.8765915769,5.5967538827
20051,2012,402,233,102,51,169,153,13.903780306,8.0586587348,3.5278248539,1.7639124269,5.8451215716,5.2917372808
20051,2013,384,267,-227,47,117,-180,13.22177461,9.1932651586,-7.81599697,1.6182901215,4.0285094515,-6.197706848
20051,2014,354,255,-226,49,99,-177,12.218272184,8.80129776,-7.800365858,1.6912297656,3.4169744245,-6.109136092
20051,2015,357,243,-172,53,114,-119,12.339491558,8.3991497157,-5.945077165,1.8319133125,3.9403418419,-4.113163853
20051,2016,352,257,-255,54,95,-201,12.190054024,8.900124671,-8.830863,1.870065106,3.2899293531,-6.960797894
20051,2017,358,252,-293,52,106,-241,12.449575741,8.7633885102,-10.18917791,1.808318264,3.6861872305,-8.380859647
40045,2010,11,7,0,0,4,0,NA,NA,NA,NA,NA,NA
40045,2011,37,60,-96,0,-23,-96,9.0321005737,14.646649579,-23.43463933,0,-5.614549005,-23.43463933
40045,2012,41,50,48,2,-9,50,10.105989648,12.324377619,11.831402514,0.4929751048,-2.218387971,12.324377619
40045,2013,45,45,48,4,0,52,10.963576562,10.963576562,11.694481666,0.9745401389,0,12.669021805
40045,2014,43,63,0,4,-20,4,10.426770126,15.27643065,0,0.9699321048,-4.849660524,0.9699321048
40045,2015,44,65,115,4,-21,119,10.562957628,15.604369223,27.607730164,0.9602688753,-5.041411595,28.56799904
40045,2016,53,50,-138,4,3,-134,12.774162449,12.05109665,-33.26102675,0.964087732,0.723065799,-32.29693902
40045,2017,43,53,-111,4,-10,-107,10.684557088,13.169337806,-27.58106597,0.9939122872,-2.484780718,-26.58715368
48139,2010,481,195,452,3,286,455,NA,NA,NA,NA,NA,NA
48139,2011,1998,980,987,33,1018,1020,13.198573127,6.4737746069,6.5200158541,0.2179944511,6.7247985203,6.7380103052
48139,2012,1889,1113,477,84,776,561,12.342049211,7.2719432357,3.116547101,0.5488259046,5.0701059757,3.6653730056
48139,2013,1912,1099,1381,82,813,1463,12.347472869,7.0972137463,8.9183368367,0.5295464306,5.2502591226,9.4478832673
48139,2014,2105,1145,2111,106,960,2217,13.35778559,7.265873872,13.395860038,0.6726485855,6.091911718,14.068508624
48139,2015,2152,1151,2940,136,1001,3076,13.346978013,7.1386485565,18.234254349,0.8434893168,6.208329457,19.077743666
48139,2016,2221,1275,3992,156,946,4148,13.392991745,7.6884576652,24.072410196,0.9407054085,5.7045340795,25.013115604
48139,2017,2245,1263,4093,158,982,4251,13.128616583,7.385943316,23.935602527,0.9239739065,5.742673267,24.859576434
20053,2010,20,23,22,0,-3,22,NA,NA,NA,NA,NA,NA
20053,2011,54,86,-25,4,-32,-21,8.3269082498,13.261372398,-3.855050116,0.6168080185,-4.934464148,-3.238242097
20053,2012,68,72,5,0,-4,5,10.528760548,11.148099404,0.7741735697,0,-0.619338856,0.7741735697
20053,2013,65,75,-86,-1,-10,-87,10.138823896,11.698642957,-13.41444392,-0.155981906,-1.559819061,-13.57042583
20053,2014,51,86,16,1,-35,17,8.0258084822,13.533716264,2.5179007003,0.1573687938,-5.507907782,2.6752694941
20053,2015,65,102,-6,1,-37,-5,10.27586752,16.125207493,-0.948541617,0.1580902695,-5.849339973,-0.790451348
20053,2016,60,69,13,1,-9,14,9.5117311351,10.938490805,2.0608750793,0.1585288523,-1.42675967,2.2194039315
20053,2017,67,69,22,1,-2,23,10.600427181,10.916857844,3.4807372834,0.1582153311,-0.316430662,3.6389526145
01051,2010,235,188,217,9,47,226,NA,NA,NA,NA,NA,NA
01051,2011,967,708,147,31,259,178,12.118781605,8.8729031813,1.8422553215,0.3885028229,3.2458784237,2.2307581445
01051,2012,961,662,-150,72,299,-78,11.995556277,8.2633280491,-1.872355298,0.8987305431,3.7322282276,-0.973624755
01051,2013,987,752,45,62,235,107,12.2780283,9.3546882289,0.5597885243,0.7712641891,2.9233400715,1.3310527134
01051,2014,950,742,-233,43,208,-190,11.792672406,9.2106978159,-2.892308074,0.5337735931,2.5819745899,-2.358534481
01051,2015,935,773,144,54,162,198,11.580811772,9.5742967908,1.7835688718,0.6688383269,2.0065149807,2.4524071987
01051,2016,896,779,170,41,117,211,11.051359219,9.6082687848,2.096798066,0.5056983571,1.4430904337,2.6024964231
01051,2017,889,803,319,36,86,355,10.913532658,9.8577803421,3.9161045195,0.4419428298,1.0557523156,4.3580473493
16039,2010,132,23,-78,51,109,-27,NA,NA,NA,NA,NA,NA
16039,2011,467,171,-1285,31,296,-1254,17.517536292,6.4143441239,-48.20135789,1.1628343149,11.103192168,-47.03852358
16039,2012,476,176,-492,259,300,-233,18.145430287,6.7092347279,-18.75536072,9.8732488326,11.436195559,-8.882111884
16039,2013,446,175,-453,146,271,-307,16.987564037,6.6655240054,-17.254185,5.5609514559,10.322040031,-11.69323354
16039,2014,498,185,-497,154,313,-343,18.986255933,7.0531272041,-18.94813092,5.8712518348,11.933128729,-13.07687909
16039,2015,464,181,-916,190,283,-726,17.842722553,6.9601999615,-35.22399539,7.3062872525,10.882522592,-27.91770813
16039,2016,456,186,-102,133,270,31,17.579028527,7.1703932151,-3.932151118,5.1272166538,10.408635312,1.1950655359
16039,2017,448,185,372,96,263,468,16.933456806,6.9926105116,14.060816813,3.6285978871,9.9408462949,17.6894147
13107,2010,85,87,14,0,-2,14,NA,NA,NA,NA,NA,NA
13107,2011,335,278,-173,0,57,-173,14.857523007,12.329526555,-7.672690986,0,2.5279964519,-7.672690986
13107,2012,320,253,179,-4,67,175,14.150213359,11.187512437,7.9152755975,-0.176877667,2.962700922,7.7383979305
13107,2013,302,286,-118,-6,16,-124,13.312468317,12.607171982,-5.201560468,-0.264486125,0.7052963347,-5.466046594
13107,2014,338,284,-203,-4,54,-207,14.984262092,12.590326728,-8.999423682,-0.177328545,2.3939353637,-9.176752228
13107,2015,320,277,-53,-4,43,-57,14.23962621,12.326176438,-2.358438091,-0.177995328,1.9134497719,-2.536433419
13107,2016,299,271,-83,-4,28,-87,13.32798431,12.079878755,-3.699741464,-0.178300793,1.2481055541,-3.878042257
13107,2017,291,280,120,-4,11,116,12.952330084,12.462723105,5.341167045,-0.178038901,0.4896069791,5.1631281435
49015,2010,53,13,-11,0,40,-11,NA,NA,NA,NA,NA,NA
49015,2011,180,80,-120,-2,100,-122,16.371822275,7.2763654555,-10.91454818,-0.181909136,9.0954568193,-11.09645732
49015,2012,177,83,-141,-1,94,-142,16.148161664,7.5723017973,-12.8637898,-0.091232552,8.5758598668,-12.95502235
49015,2013,154,89,-250,0,65,-250,14.1955109,8.2038991566,-23.04466055,0,5.9916117436,-23.04466055
49015,2014,133,107,-152,0,26,-152,12.432230323,10.001869508,-14.20826323,0,2.4303608151,-14.20826323
49015,2015,139,79,-344,0,60,-344,13.242509408,7.5263182966,-32.77282904,0,5.7161911113,-32.77282904
49015,2016,137,76,-195,0,61,-195,13.315190981,7.3865293031,-18.95227913,0,5.9286616775,-18.95227913
49015,2017,137,82,-202,0,55,-202,13.498201882,8.0792157249,-19.90245825,0,5.418986157,-19.90245825
19063,2010,29,49,-25,10,-20,-15,NA,NA,NA,NA,NA,NA
19063,2011,101,114,-241,44,-13,-197,9.9355663765,11.214401653,-23.70763858,4.3283655501,-1.278835276,-19.37927303
19063,2012,115,130,-133,3,-15,-130,11.509783316,13.0110594,-13.31131462,0.3002552169,-1.501276085,-13.0110594
19063,2013,112,146,-39,4,-34,-35,11.330871567,14.770600435,-3.945571349,0.4046739845,-3.439728868,-3.540897365
19063,2014,112,113,-62,4,-1,-58,11.404714628,11.506542437,-6.313324169,0.4073112367,-0.101827809,-5.906012932
19063,2015,109,115,-123,7,-6,-116,11.200164406,11.816687217,-12.63871763,0.7192766132,-0.616522811,-11.91944102
19063,2016,112,110,-125,10,2,-115,11.648465939,11.440457618,-13.00052002,1.0400416017,0.2080083203,-11.96047842
19063,2017,106,112,-131,10,-6,-121,11.163770405,11.795681938,-13.79673512,1.0531858873,-0.631911532,-12.74354924
26047,2010,61,98,-7,1,-37,-6,NA,NA,NA,NA,NA,NA
26047,2011,336,308,46,13,28,59,10.278529803,9.4219856529,1.4071796754,0.3976812126,0.8565441503,1.8048608881
26047,2012,311,343,84,14,-32,98,9.492849839,10.469606093,2.5639851655,0.4273308609,-0.976756254,2.9913160264
26047,2013,291,307,146,12,-16,158,8.8556169261,9.3425236987,4.4430242997,0.3651800794,-0.486906773,4.8082043791
26047,2014,298,391,111,12,-93,123,9.0464770347,11.869706445,3.3696609089,0.3642876658,-2.82322941,3.7339485747
26047,2015,292,373,19,12,-81,31,8.8683714997,11.328433457,0.5770515702,0.3644536233,-2.460061957,0.9415051935
26047,2016,316,314,4,12,2,16,9.6026741624,9.5418977437,0.1215528375,0.3646585125,0.0607764187,0.48621135
26047,2017,298,309,276,12,-11,288,9.0154139376,9.3481976735,8.3498464657,0.3630368029,-0.332783736,8.7128832685
38029,2010,8,24,4,0,-16,4,NA,NA,NA,NA,NA,NA
38029,2011,26,57,6,0,-31,6,7.3769328983,16.172506739,1.7023691304,0,-8.79557384,1.7023691304
38029,2012,26,47,-17,1,-21,-16,7.4413279908,13.451631368,-4.865483686,0.2862049227,-6.010303377,-4.579278764
38029,2013,26,43,22,2,-17,24,7.4734119,12.359873527,6.3236562231,0.5748778385,-4.886461627,6.8985340615
38029,2014,33,56,-42,3,-23,-39,9.5624456679,16.227180527,-12.1703854,0.8693132425,-6.664734859,-11.30107215
38029,2015,33,41,-10,3,-8,-7,9.6703296703,12.014652015,-2.93040293,0.8791208791,-2.344322344,-2.051282051
38029,2016,23,52,-45,3,-29,-42,6.824925816,15.430267062,-13.35311573,0.8902077151,-8.605341246,-12.46290801
38029,2017,31,49,-18,3,-18,-15,9.3429776974,14.767932489,-5.424954792,0.904159132,-5.424954792,-4.52079566
51595,2010,21,36,10,1,-15,11,NA,NA,NA,NA,NA,NA
51595,2011,80,102,-63,2,-22,-61,13.607756421,17.349889437,-10.71610818,0.3401939105,-3.742133016,-10.37591427
51595,2012,62,87,-1,0,-25,-1,10.644690531,14.936904455,-0.171688557,0,-4.292213924,-0.171688557
51595,2013,65,105,-84,2,-40,-82,11.302382194,18.257694314,-14.60615545,0.347765606,-6.95531212,-14.25838985
51595,2014,73,90,-76,1,-17,-75,12.931798051,15.943312666,-13.46324181,0.1771479185,-3.011514615,-13.28609389
51595,2015,37,33,-77,2,4,-75,6.6498921639,5.9309849029,-13.83896477,0.3594536305,0.718907261,-13.47951114
51595,2016,0,37,-119,2,-37,-117,0,6.7865003668,-21.82685253,0.3668378577,-6.786500367,-21.46001467
51595,2017,0,76,-18,2,-76,-16,0,14.262925776,-3.378061368,0.375340152,-14.26292578,-3.002721216
48143,2010,117,81,-27,3,36,-24,NA,NA,NA,NA,NA,NA
48143,2011,456,321,830,19,135,849,11.869281726,8.3553496362,21.604175072,0.4945534053,3.51393209,22.098728477
48143,2012,490,308,287,17,182,304,12.509733338,7.8632609556,7.3271295268,0.4340111566,4.6464723828,7.7611406834
48143,2013,502,272,241,10,230,251,12.658068258,6.8585549126,6.0768813747,0.2521527541,5.7995133452,6.3290341289
48143,2014,529,323,410,13,206,423,13.151679387,8.0302314596,10.19317306,0.3231981702,5.1214479278,10.51637123
48143,2015,473,309,481,26,164,507,11.569884057,7.5583386331,11.765569199,0.6359767135,4.0115454234,12.401545913
48143,2016,469,346,67,32,123,99,11.34714023,8.3712377819,1.6210200329,0.7742185232,2.9759024485,2.3952385561
48143,2017,468,341,365,32,127,397,11.221406992,8.1762815902,8.751738359,0.7672756917,3.0451254016,9.5190140507
36029,2010,2554,2259,-702,587,295,-115,NA,NA,NA,NA,NA,NA
36029,2011,9774,9747,-1667,2834,27,1167,10.626592793,10.597237564,-1.812413565,3.0812117838,0.0293552287,1.2687982187
36029,2012,9817,9381,-2820,3091,436,271,10.663425385,10.189833303,-3.063141447,3.3575071677,0.4735920819,0.2943657206
36029,2013,10023,9842,-1549,3296,181,1747,10.872742913,10.67639786,-1.680323134,3.5754325693,0.1963450531,1.8951094352
36029,2014,10021,9684,-2057,3534,337,1477,10.849893921,10.485018734,-2.227146173,3.8263172454,0.3648751872,1.5991710729
36029,2015,10340,10017,-4337,3736,323,-601,11.187019595,10.837560472,-4.692273113,4.0420411226,0.3494591227,-0.65023199
36029,2016,9995,9667,-5123,3794,328,-1329,10.821561705,10.466436918,-5.546659391,4.1077543879,0.3551247863,-1.438905003
36029,2017,10080,9638,-1769,3769,442,2000,10.905290581,10.427102244,-1.913835222,4.077583353,0.478188337,2.1637481311
39043,2010,196,253,-26,5,-57,-21,NA,NA,NA,NA,NA,NA
39043,2011,762,887,-191,10,-125,-181,9.9182589681,11.545269954,-2.486072786,0.1301608788,-1.627010986,-2.355911907
39043,2012,754,910,-133,29,-156,-104,9.851122623,11.889285924,-1.737664866,0.3788893317,-2.038163301,-1.358775534
39043,2013,815,936,-280,13,-121,-267,10.694485451,12.282255683,-3.674179051,0.1705868845,-1.587770233,-3.503592166
39043,2014,812,871,-210,23,-59,-187,10.700119915,11.477591682,-2.767272392,0.3030822143,-0.777471767,-2.464190178
39043,2015,806,969,-313,26,-163,-287,10.670338181,12.828235356,-4.143692122,0.3442044574,-2.157897176,-3.799487665
39043,2016,765,942,-213,26,-177,-187,10.182757198,12.538767687,-2.835199063,0.3460806368,-2.356010489,-2.489118426
39043,2017,782,914,-16,26,-132,10,10.443306335,12.206115077,-0.213673787,0.3472199037,-1.762808742,0.1335461168
42049,2010,838,547,-116,64,291,-52,NA,NA,NA,NA,NA,NA
42049,2011,3285,2804,-441,498,481,57,11.689081117,9.9775292094,-1.569219109,1.7720433475,1.7115519079,0.2028242386
42049,2012,3203,2816,-997,843,387,-154,11.382555869,10.007267351,-3.543055948,2.9957835147,1.3752885174,-0.547272433
42049,2013,3114,2917,-1614,556,197,-1058,11.078893534,10.378012986,-5.742239616,1.9781197189,0.7008805479,-3.764119897
42049,2014,3159,2853,-2181,561,306,-1620,11.282183151,10.189322105,-7.789313533,2.0035785842,1.0928610459,-5.785734949
42049,2015,3140,2929,-1967,516,211,-1451,11.265341853,10.508339582,-7.056983256,1.8512472599,0.757002271,-5.205735996
42049,2016,3150,2774,-3095,928,376,-2167,11.362980492,10.006637424,-11.16457925,3.3475701258,1.3563430682,-7.817009119
42049,2017,3031,2756,-2990,924,275,-2066,11.004571018,10.006135838,-10.85571341,3.354742204,0.9984351798,-7.500971205
01053,2010,121,63,-28,1,58,-27,NA,NA,NA,NA,NA,NA
01053,2011,484,440,-190,3,44,-187,12.645660239,11.496054763,-4.964205466,0.0783821916,1.1496054763,-4.885823274
01053,2012,447,480,-137,-1,-33,-138,11.727666273,12.593467139,-3.594385413,-0.02623639,-0.865800866,-3.620621802
01053,2013,441,447,-253,2,-6,-251,11.635730399,11.794039656,-6.675373676,0.0527697524,-0.158309257,-6.622603923
01053,2014,447,467,-5,-2,-20,-7,11.839021096,12.368731212,-0.132427529,-0.052971012,-0.529710116,-0.185398541
01053,2015,400,473,7,-2,-73,5,10.609094646,12.545254419,0.1856591563,-0.053045473,-1.936159773,0.1326136831
01053,2016,468,530,-126,-2,-62,-128,12.456250083,14.10643706,-3.353605792,-0.053231838,-1.650186977,-3.40683763
01053,2017,429,499,44,-1,-70,43,11.451757137,13.320342218,1.1745391936,-0.026694073,-1.868585081,1.147845121
12033,2010,1000,754,-24,226,246,202,NA,NA,NA,NA,NA,NA
12033,2011,3817,3017,182,369,800,551,12.778664953,10.100401405,0.6093049571,1.2353490614,2.6782635478,1.8446540186
12033,2012,3941,3030,1827,1335,911,3162,13.0749312,10.052535279,6.0613801832,4.429087326,3.0223959206,10.490467509
12033,2013,3839,3243,1915,761,596,2676,12.582058686,10.628709643,6.2762809021,2.4941252044,1.9533490432,8.7704061065
12033,2014,3836,3087,-80,723,749,643,12.477434254,10.041146909,-0.260217607,2.351716623,2.4362873453,2.0914990161
12033,2015,3853,3342,13,946,511,959,12.476685146,10.821978136,0.0420962644,3.0633127817,1.65470701,3.1054090462
12033,2016,3989,3417,948,666,572,1614,12.84205782,11.000579486,3.0519605949,2.144098899,1.8414783337,5.1960594939
12033,2017,3948,3443,850,452,505,1302,12.629093939,11.013670322,2.7190298501,1.4458841086,1.6154236169,4.1649139587
32009,2010,5,1,-4,0,4,-4,NA,NA,NA,NA,NA,NA
32009,2011,2,14,-3,3,-12,0,2.5723472669,18.006430868,-3.8585209,3.8585209003,-15.4340836,0
32009,2012,2,13,31,-1,-11,30,2.557544757,16.624040921,39.641943734,-1.278772379,-14.06649616,38.363171355
32009,2013,3,16,68,-1,-13,67,3.6540803898,19.488428745,82.825822168,-1.218026797,-15.83434836,81.607795371
32009,2014,3,15,-11,-1,-12,-12,3.5820895522,17.910447761,-13.13432836,-1.194029851,-14.32835821,-14.32835821
32009,2015,3,5,6,-1,-2,5,3.6253776435,6.0422960725,7.250755287,-1.208459215,-2.416918429,6.0422960725
32009,2016,8,4,-5,-1,4,-6,9.656004828,4.828002414,-6.035003018,-1.207000604,4.828002414,-7.242003621
32009,2017,5,3,22,-1,2,21,5.9594755662,3.5756853397,26.221692491,-1.191895113,2.3837902265,25.029797378
25009,2010,2179,1390,644,831,789,1475,NA,NA,NA,NA,NA,NA
25009,2011,8486,6276,341,3632,2210,3973,11.338007845,8.3852624603,0.4556046047,4.8526566692,2.9527453852,5.3082612739
25009,2012,8349,6141,-442,4014,2208,3572,11.06815886,8.1410424671,-0.585953553,5.3213067029,2.9271163926,4.7353531497
25009,2013,8364,6368,1126,4361,1996,5487,10.992831134,8.3694821449,1.4799052913,5.7316758219,2.6233489889,7.2115811132
25009,2014,8420,6419,311,4764,2001,5075,10.963363227,8.3579368825,0.4049413258,6.2030240393,2.605426344,6.6079653651
25009,2015,8550,6833,-818,5172,1717,4354,11.040050203,8.8230015249,-1.056229364,6.6782619475,2.2170486782,5.622032583
25009,2016,8500,6845,-3810,5352,1655,1542,10.910927679,8.7865058781,-4.890662877,6.8700335222,2.1244218011,1.9793706449
25009,2017,8430,6760,-2408,5325,1670,2917,10.767397394,8.6343542563,-3.075669386,6.8014698839,2.1330431373,3.7258004979
34013,2010,2580,1426,-1918,1402,1154,-516,NA,NA,NA,NA,NA,NA
34013,2011,10518,5982,-7334,5417,4536,-1917,13.3807601,7.6101641872,-9.330147802,6.8913840525,5.7705959133,-2.438763749
34013,2012,10392,5714,-8611,5344,4678,-3267,13.184838958,7.2496314284,-10.9251971,6.7801943216,5.9352075293,-4.145002779
34013,2013,10429,5735,-6734,5615,4694,-1119,13.188728184,7.2525991115,-8.515955086,7.1008446401,5.9361290722,-1.415110446
34013,2014,10360,5725,-6004,5873,4635,-131,13.034414124,7.2028977667,-7.553921081,7.3891036827,5.8315163578,-0.164817399
34013,2015,10154,5726,-7738,6405,4428,-1333,12.714082154,7.1696705157,-9.688946988,8.0198637187,5.5444116388,-1.669083269
34013,2016,10315,6132,-7197,6671,4183,-526,12.860938531,7.6454944323,-8.973356724,8.3175299018,5.2154440982,-0.655826822
34013,2017,10170,6252,-6179,6658,3918,479,12.61660591,7.7560491787,-7.665487504,8.2597209584,4.860556731,0.5942334544
36031,2010,96,66,-48,13,30,-35,NA,NA,NA,NA,NA,NA
36031,2011,305,353,-108,74,-48,-34,7.7586426191,8.9796749002,-2.747322632,1.8824247666,-1.221032281,-0.864897866
36031,2012,342,415,-378,63,-73,-315,8.7520632605,10.620193723,-9.673333077,1.6122221796,-1.868130462,-8.061110898
36031,2013,323,442,-198,53,-119,-145,8.3349461325,11.40571576,-5.109347784,1.3676536998,-3.070769628,-3.741694084
36031,2014,290,380,-216,65,-90,-151,7.5323697095,9.8700016883,-5.610316749,1.6882897625,-2.337631979,-3.922026987
36031,2015,323,443,-131,69,-120,-62,8.4360635186,11.570204764,-3.421437526,1.802131216,-3.134141245,-1.61930631
36031,2016,332,408,-176,70,-76,-106,8.7127673534,10.707256266,-4.618816428,1.8370292613,-1.994488912,-2.781787167
36031,2017,322,415,-32,70,-93,38,8.4770304067,10.925365276,-0.842437804,1.8428326971,-2.448334869,1.0003948927
50009,2010,18,8,-3,0,10,-3,NA,NA,NA,NA,NA,NA
50009,2011,63,54,1,1,9,2,9.972299169,8.547685002,0.158290463,0.158290463,1.424614167,0.316580926
50009,2012,47,55,-93,1,-8,-92,7.4918307165,8.7670359448,-14.82426078,0.1594006535,-1.275205228,-14.66486013
50009,2013,43,62,-10,-1,-19,-11,6.9259885641,9.9863090924,-1.610695015,-0.161069501,-3.060320528,-1.771764516
50009,2014,58,58,-41,1,0,-40,9.394233884,9.394233884,-6.640751539,0.1619695497,0,-6.478781989
50009,2015,55,61,45,1,-6,46,8.9068825911,9.8785425101,7.2874493927,0.1619433198,-0.971659919,7.4493927126
50009,2016,54,63,54,2,-9,56,8.6851628468,10.132689988,8.6851628468,0.321672698,-1.447527141,9.0068355448
50009,2017,58,62,-8,2,-4,-6,9.3023255814,9.9438652767,-1.283079391,0.3207698476,-0.641539695,-0.962309543
51057,2010,34,50,14,0,-16,14,NA,NA,NA,NA,NA,NA
51057,2011,129,117,9,1,12,10,11.563802609,10.48810004,0.8067769262,0.0896418807,1.0757025682,0.8964188069
51057,2012,125,146,-18,3,-21,-15,11.213276519,13.097106975,-1.614711819,0.2691186365,-1.883830455,-1.345593182
51057,2013,131,132,23,4,-1,27,11.757842301,11.847596823,2.0643539918,0.3590180855,-0.089754521,2.4233720774
51057,2014,116,122,-95,5,-6,-90,10.445274864,10.985547702,-8.554319932,0.4502273648,-0.540272838,-8.104092567
51057,2015,126,119,11,5,7,16,11.384684888,10.752202394,0.9939010617,0.4517732098,0.6324824938,1.4456742715
51057,2016,122,116,7,5,6,12,11.003878416,10.462704068,0.6313700731,0.4509786236,0.5411743483,1.0823486967
51057,2017,119,111,-81,5,8,-76,10.757548364,10.034351835,-7.322364853,0.4519978304,0.7231965287,-6.870367022
21065,2010,44,24,14,0,20,14,NA,NA,NA,NA,NA,NA
21065,2011,174,188,-42,0,-14,-42,11.855283777,12.809157185,-2.861620222,0,-0.953873407,-2.861620222
21065,2012,152,182,-122,0,-30,-122,10.429889869,12.488420764,-8.371358973,0,-2.058530895,-8.371358973
21065,2013,157,180,5,0,-23,5,10.835806474,12.423217613,0.3450893781,0,-1.587411139,0.3450893781
21065,2014,154,214,22,0,-60,22,10.650805727,14.800470295,1.5215436752,0,-4.149664569,1.5215436752
21065,2015,161,198,-30,0,-37,-30,11.177062723,13.745704467,-2.082682495,0,-2.568641744,-2.082682495
21065,2016,174,187,-11,0,-13,-11,12.119101515,13.024551628,-0.766150096,0,-0.905450113,-0.766150096
21065,2017,164,175,-57,0,-11,-57,11.459716302,12.22835581,-3.982950178,0,-0.768639508,-3.982950178
01055,2010,260,288,60,12,-28,72,NA,NA,NA,NA,NA,NA
01055,2011,1251,1355,-19,33,-104,14,11.982127378,12.978243483,-0.18198275,0.3160753025,-0.996116105,0.1340925526
01055,2012,1156,1408,163,6,-252,169,11.082828806,13.498808788,1.5627172105,0.0575233329,-2.415979982,1.6202405434
01055,2013,1145,1347,-168,-9,-202,-177,11.003161607,12.944330729,-1.614437686,-0.086487733,-1.941169122,-1.700925419
01055,2014,1205,1382,-303,1,-177,-302,11.629085259,13.337257949,-2.924160028,0.0096506932,-1.70817269,-2.914509335
01055,2015,1154,1374,-205,5,-220,-200,11.186723279,13.319374164,-1.98724287,0.0484693383,-2.132650885,-1.938773532
01055,2016,1216,1432,-4,9,-216,5,11.824882821,13.925355427,-0.038897641,0.0875196919,-2.100472606,0.0486220511
01055,2017,1192,1444,278,8,-252,286,11.602045931,14.054827454,2.7058462826,0.0778660801,-2.452781522,2.7837123627
32011,2010,4,12,10,0,-8,10,NA,NA,NA,NA,NA,NA
32011,2011,22,12,-25,1,10,-24,11.091504916,6.0499117721,-12.60398286,0.5041593143,5.0415931434,-12.09982354
32011,2012,15,10,9,0,5,9,7.5585789872,5.0390526581,4.5351473923,0,2.5195263291,4.5351473923
32011,2013,12,16,61,0,-4,61,5.9376546264,7.9168728352,30.183077684,0,-1.979218209,30.183077684
32011,2014,17,15,-65,0,2,-65,8.417925229,7.4275810844,-32.1861847,0,0.9903441446,-32.1861847
32011,2015,28,15,27,0,13,27,13.933814382,7.4645434188,13.436178154,0,6.4692709629,13.436178154
32011,2016,13,11,-92,0,2,-92,6.5491183879,5.5415617128,-46.34760705,0,1.0075566751,-46.34760705
32011,2017,16,9,13,0,7,13,8.2030248654,4.6142014868,6.6649577032,0,3.5888233786,6.6649577032
22039,2010,119,130,-17,4,-11,-13,NA,NA,NA,NA,NA,NA
22039,2011,466,361,-282,41,105,-241,13.750774588,10.65242409,-8.321284193,1.2098320989,3.0983504972,-7.111452094
22039,2012,506,346,-299,65,160,-234,14.976395898,10.240776642,-8.849688485,1.9238453228,4.7356192562,-6.925843162
22039,2013,466,375,-76,71,91,-5,13.790042169,11.097136939,-2.249019753,2.1010579271,2.6929052305,-0.147961826
22039,2014,484,362,-267,73,122,-194,14.320162137,10.710534491,-7.899758865,2.1598591653,3.6096276462,-5.7398997
22039,2015,492,373,-223,78,119,-145,14.578425708,11.052343067,-6.607701083,2.3112138317,3.5260826407,-4.296487251
22039,2016,512,369,-249,82,143,-167,15.182966609,10.942411482,-7.383903683,2.431646996,4.2405551272,-4.952256687
22039,2017,493,382,-196,82,111,-114,14.625174286,11.332285146,-5.814470913,2.4325847696,3.2928891394,-3.381886143
13109,2010,47,5,-23,2,42,-21,NA,NA,NA,NA,NA,NA
13109,2011,150,105,-82,-1,45,-83,13.630787405,9.5415511836,-7.451497115,-0.090871916,4.0892362215,-7.542369031
13109,2012,179,109,-374,-8,70,-382,16.518248512,10.058598256,-34.51298851,-0.738245744,6.4596502561,-35.25123425
13109,2013,171,123,73,-2,48,71,15.912157447,11.445586935,6.7929093193,-0.186107105,4.4665705113,6.6068022147
13109,2014,162,114,-27,0,48,-27,14.977118291,10.539453613,-2.496186382,0,4.437664679,-2.496186382
13109,2015,160,133,-147,0,27,-147,14.860221046,12.352558744,-13.65282809,0,2.5076623015,-13.65282809
13109,2016,133,98,-75,0,35,-75,12.444444444,9.1695906433,-7.01754386,0,3.2748538012,-7.01754386
13109,2017,141,107,74,-1,34,73,13.151144896,9.9799468358,6.902019307,-0.093270531,3.17119806,6.8087487758
02090,2010,481,118,195,104,363,299,NA,NA,NA,NA,NA,NA
02090,2011,1775,448,-1640,138,1327,-1502,18.074252082,4.5618393988,-16.69959066,1.4052094577,13.512412684,-15.2943812
02090,2012,1600,450,585,443,1150,1028,16.121718978,4.5342334626,5.8945035014,4.4637009421,11.587485516,10.358204444
02090,2013,1711,472,-1071,384,1239,-687,17.003557729,4.6906366148,-10.64337249,3.8161111442,12.312921114,-6.827261344
02090,2014,1701,436,-3228,299,1265,-2929,16.992497727,4.3555138208,-32.24678581,2.9869234688,12.636983907,-29.25986234
02090,2015,1697,491,-1307,430,1206,-877,17.059476957,4.9358887364,-13.1389136,4.3226724168,12.12358822,-8.816241185
02090,2016,1699,508,-524,291,1191,-233,16.969212714,5.0737846138,-5.233588854,2.9064396115,11.895428101,-2.327149242
02090,2017,1700,494,-2242,132,1206,-2110,16.974114475,4.9324779711,-22.38586156,1.3179900652,12.041636504,-21.0678715
51600,2010,77,34,-6,35,43,29,NA,NA,NA,NA,NA,NA
51600,2011,219,186,-334,165,33,-169,9.7130438639,8.2494345146,-14.81350069,7.3180467468,1.4636093494,-7.495453941
51600,2012,337,188,56,203,149,259,14.854321858,8.2866840041,2.4683739587,8.9478556001,6.5676378543,11.416229559
51600,2013,270,171,34,246,99,280,11.697933365,7.4086911312,1.4730730904,10.658117066,4.2892422339,12.131190156
51600,2014,273,162,-332,248,111,-84,11.723279083,6.956671104,-14.25688152,10.649718727,4.7666079787,-3.607162795
51600,2015,429,229,-372,268,200,-104,18.369444207,9.8056007536,-15.92874882,11.475550227,8.5638434529,-4.453198596
51600,2016,700,237,-307,265,463,-42,29.641548983,10.035781584,-12.99993648,11.221443543,19.605767399,-1.778492939
51600,2017,658,250,-402,263,408,-139,27.46014523,10.433185878,-16.77656289,10.975711543,17.026959352,-5.800851348
51059,2010,3845,1050,270,2082,2795,2352,NA,NA,NA,NA,NA,NA
51059,2011,15353,4648,-769,9174,10705,8405,14.005310944,4.2399977377,-0.701497044,8.368704657,9.7653132061,7.667207613
51059,2012,15213,4685,-4104,9737,10528,5633,13.658928134,4.2064075663,-3.684759157,8.7423245407,9.4525205674,5.0575653834
51059,2013,15244,4907,-6322,9632,10337,3310,13.506437354,4.3476835538,-5.601397071,8.5341120829,9.1587537999,2.9327150119
51059,2014,15169,4807,-16912,10077,10362,-6835,13.336838477,4.2263947894,-14.86931323,8.8598669218,9.1104436879,-6.009446304
51059,2015,14984,5076,-18327,11080,9908,-7247,13.135281389,4.4497255959,-16.06582368,9.7129550044,8.6855557927,-6.352868675
51059,2016,14256,5381,-17516,11032,8875,-6484,12.467897743,4.706071672,-15.31900231,9.648277771,7.7618260713,-5.670724535
51059,2017,13949,5671,-15348,10795,8278,-4553,12.166227881,4.9462096431,-13.38642666,9.4153294122,7.2200182376,-3.97109725
09001,2010,2721,1513,484,1266,1208,1750,NA,NA,NA,NA,NA,NA
09001,2011,10408,6479,92,5754,3929,5846,11.25708232,7.0075553755,0.0995053395,6.2234100372,4.249526944,6.3229153767
09001,2012,10197,6322,-2132,5269,3875,3137,10.93076592,6.7769247962,-2.285416587,5.6481519695,4.1538411239,3.3627353821
09001,2013,10047,6632,-2219,5409,3415,3190,10.69279112,7.0582851305,-2.361630685,5.7566743472,3.6345059892,3.395043662
09001,2014,10065,6539,-5367,5503,3526,136,10.654108262,6.9217301467,-5.681132543,5.8250926743,3.7323781155,0.1439601315
09001,2015,10106,6743,-7896,6055,3363,-1841,10.667860195,7.117888511,-8.3349915,6.3916379852,3.5499716836,-1.943353515
09001,2016,9989,6768,-8401,6237,3221,-2164,10.529661251,7.1343224897,-8.855709698,6.5745817625,3.3953387617,-2.281127936
09001,2017,9921,6774,-8690,6218,3147,-2472,10.448040979,7.1338604569,-9.151645611,6.5483236376,3.3141805223,-2.603321974
39045,2010,414,279,80,22,135,102,NA,NA,NA,NA,NA,NA
39045,2011,1603,1107,182,84,496,266,10.921999346,7.5425160798,1.2400523275,0.5723318435,3.3794832661,1.8123841709
39045,2012,1658,1137,-541,148,521,-393,11.263127862,7.723869951,-3.675121938,1.0053938019,3.5392579107,-2.669728136
39045,2013,1728,1183,759,143,545,902,11.676306827,7.9936753338,5.128655603,0.9662684469,3.6826314936,6.0949240499
39045,2014,1644,1184,977,179,460,1156,10.995883232,7.9191762451,6.5346581009,1.1972403276,3.0767069871,7.7318984285
39045,2015,1670,1248,290,198,422,488,11.077723163,8.2784422201,1.9236764774,1.3134066984,2.799280943,3.2370831758
39045,2016,1707,1284,868,199,423,1067,11.234771849,8.4507598444,5.7128189602,1.3097361441,2.7840120048,7.0225551044
39045,2017,1689,1311,1491,195,378,1686,10.988439043,8.5292146747,9.7002738977,1.2686474917,2.4592243684,10.968921389
45039,2010,58,100,-80,1,-42,-79,NA,NA,NA,NA,NA,NA
45039,2011,231,271,-251,21,-40,-230,9.744574044,11.431946173,-10.58826011,0.8858703676,-1.687372129,-9.702389741
45039,2012,242,263,-169,21,-21,-148,10.303133515,11.197207084,-7.195163488,0.8940735695,-0.894073569,-6.301089918
45039,2013,231,284,-174,22,-53,-152,9.9139503444,12.188579644,-7.467650909,0.9441857471,-2.2746293,-6.523465162
45039,2014,210,289,-104,16,-79,-88,9.0857958725,12.503785748,-4.499632242,0.6922511141,-3.417989876,-3.807381128
45039,2015,215,301,-82,19,-86,-63,9.366967281,13.113754193,-3.572517754,0.8277785039,-3.746786912,-2.74473925
45039,2016,198,304,-158,17,-106,-141,8.7017667223,13.360288301,-6.943834051,0.7471213853,-4.658521579,-6.196712666
45039,2017,205,290,45,18,-85,63,9.0633773239,12.821363044,1.9895218516,0.7958087406,-3.75798572,2.7853305922
46047,2010,8,13,25,0,-5,25,NA,NA,NA,NA,NA,NA
46047,2011,52,117,-90,2,-65,-88,7.3879377708,16.622859984,-12.78681537,0.2841514527,-9.234922214,-12.50266392
46047,2012,52,115,73,0,-63,73,7.4626865672,16.50401837,10.476463835,0,-9.041331803,10.476463835
46047,2013,72,117,-113,-2,-45,-115,10.44386423,16.971279373,-16.39106469,-0.29010734,-6.527415144,-16.68117203
46047,2014,54,127,107,-4,-73,103,7.9068745882,18.595797643,15.667325573,-0.585694414,-10.68892305,15.081631159
46047,2015,74,125,9,-4,-51,5,10.848849142,18.325758686,1.3194546254,-0.586424278,-7.476909544,0.7330303475
46047,2016,59,107,22,-4,-48,18,8.6975749982,15.773568217,3.2431635586,-0.589666102,-7.075993219,2.6534974571
46047,2017,63,95,-45,-4,-32,-49,9.3638525565,14.120095125,-6.688466112,-0.594530321,-4.756242568,-7.282996433
30025,2010,6,2,-6,0,4,-6,NA,NA,NA,NA,NA,NA
30025,2011,58,36,18,0,22,18,19.934696683,12.37326001,6.1866300052,0,7.561436673,6.1866300052
30025,2012,51,27,71,0,24,71,17.125587643,9.0664875756,23.841504365,0,8.0591000672,23.841504365
30025,2013,40,39,21,-1,1,20,13.175230567,12.845849802,6.9169960474,-0.329380764,0.3293807642,6.5876152833
30025,2014,58,27,34,-1,31,33,18.843404808,8.7719298246,11.046133853,-0.32488629,10.071474984,10.721247563
30025,2015,52,29,38,-1,23,37,16.560509554,9.2356687898,12.101910828,-0.318471338,7.3248407643,11.78343949
30025,2016,46,28,-96,-1,18,-97,14.694138317,8.9442581057,-30.66602779,-0.319437789,5.7498802108,-30.98546558
30025,2017,41,26,-96,-1,15,-97,13.442622951,8.5245901639,-31.47540984,-0.327868852,4.9180327869,-31.80327869
51610,2010,27,13,114,21,14,135,NA,NA,NA,NA,NA,NA
51610,2011,135,60,125,74,75,199,10.732599277,4.7700441229,9.9375919227,5.8830544183,5.9625551536,15.820646341
51610,2012,152,70,243,81,82,324,11.764705882,5.4179566563,18.808049536,6.2693498452,6.346749226,25.077399381
51610,2013,148,71,145,70,77,215,11.152556422,5.3502128782,10.926491089,5.2748577672,5.802343544,16.201348856
51610,2014,180,76,-134,72,104,-62,13.392358915,5.654551542,-9.969867192,5.3569435661,7.7378073732,-4.612923626
51610,2015,214,72,193,79,142,272,15.651283552,5.2658524099,14.115409932,5.777810283,10.385431142,19.893220215
51610,2016,222,60,-259,82,162,-177,16.000576597,4.3244801614,-18.66733936,5.9101228873,11.676096436,-12.75721648
51610,2017,218,80,492,83,138,575,15.32459316,5.623703912,34.585779059,5.8345928087,9.7008892482,40.420371867
48145,2010,49,22,1,-1,27,0,NA,NA,NA,NA,NA,NA
48145,2011,195,198,-46,8,-3,-38,10.911227373,11.07909241,-2.57393056,0.4476400974,-0.167865037,-2.126290462
48145,2012,206,208,-298,6,-2,-292,11.634802745,11.747761995,-16.83092824,0.3388777499,-0.11295925,-16.49205049
48145,2013,201,171,-375,15,30,-360,11.551392201,9.8273038131,-21.55110485,0.8620441941,1.7240883883,-20.68906066
48145,2014,211,190,-67,14,21,-53,12.25070398,11.031439603,-3.890033965,0.8128429181,1.2192643772,-3.077191047
48145,2015,211,199,-8,20,12,12,12.254261405,11.557336586,-0.464616546,1.1615413654,0.6969248192,0.6969248192
48145,2016,226,172,26,21,54,47,13.07832528,9.9534156998,1.5045860942,1.2152426145,3.1249095802,2.7198287087
48145,2017,226,158,18,21,68,39,13.000460193,9.0888173033,1.0354348827,1.2080073631,3.91164289,2.2434422457
13111,2010,48,56,-10,1,-8,-9,NA,NA,NA,NA,NA,NA
13111,2011,198,267,35,-1,-69,34,8.3701464776,11.287015705,1.479571347,-0.042273467,-2.916869227,1.43729788
13111,2012,185,291,87,-8,-106,79,7.8315165626,12.31876389,3.6829294105,-0.338660176,-4.487247328,3.3442692348
13111,2013,200,341,367,-17,-141,350,8.433303114,14.378781809,15.475111214,-0.716830765,-5.945478695,14.758280449
13111,2014,203,314,146,-12,-111,134,8.5170655982,13.174180285,6.1255742726,-0.503471858,-4.657114687,5.6221024146
13111,2015,225,320,668,-10,-95,658,9.3237195425,13.260401127,27.681087353,-0.414387535,-3.936681585,27.266699818
13111,2016,191,332,724,-11,-141,713,7.7313849703,13.438847174,29.306401668,-0.445263009,-5.707462203,28.861138659
13111,2017,210,328,457,-10,-118,447,8.347743128,13.038379743,18.166279093,-0.397511578,-4.690636615,17.768767515
48147,2010,88,79,4,0,9,4,NA,NA,NA,NA,NA,NA
48147,2011,361,404,-5,5,-43,0,10.650695541,11.919337946,-0.147516559,0.1475165587,-1.268642405,0
48147,2012,302,410,-193,9,-108,-184,8.9550468509,12.157513937,-5.722927292,0.2668722571,-3.202467086,-5.456055035
48147,2013,353,408,11,14,-55,25,10.51894453,12.157873564,0.3277858069,0.417181936,-1.638929034,0.7449677429
48147,2014,316,379,126,16,-63,142,9.4109238192,11.287152302,3.7524569659,0.4765024719,-1.876228483,4.2289594377
48147,2015,333,456,-30,19,-123,-11,9.9268158173,13.593477516,-0.894307731,0.5663948965,-3.666661698,-0.327912835
48147,2016,373,439,424,21,-66,445,11.079591867,13.040055844,12.594495849,0.6237839925,-1.960463976,13.218279841
48147,2017,370,447,647,21,-77,668,10.834394811,13.089120218,18.945549846,0.6149251109,-2.254725407,19.560474956
27043,2010,27,58,-42,0,-31,-42,NA,NA,NA,NA,NA,NA
27043,2011,150,193,22,1,-43,23,10.365558704,13.337018865,1.5202819432,0.0691037247,-2.971460162,1.5893856679
27043,2012,137,202,-222,1,-65,-221,9.5673731625,14.106637802,-15.50333461,0.0698348406,-4.539264639,-15.43349977
27043,2013,154,204,-27,1,-50,-26,10.891474239,14.427667174,-1.909544185,0.0707238587,-3.536192935,-1.838820326
27043,2014,152,172,26,0,-20,26,10.777084515,12.195121951,1.843448667,0,-1.418037436,1.843448667
27043,2015,149,190,-86,0,-41,-86,10.609512959,13.528909143,-6.123611507,0,-2.919396183,-6.123611507
27043,2016,149,181,-93,0,-32,-93,10.705561144,13.004742061,-6.681994539,0,-2.299180917,-6.681994539
27043,2017,155,168,-58,0,-13,-58,11.216035312,12.156735048,-4.196968052,0,-0.940699736,-4.196968052
46049,2010,5,5,3,0,0,3,NA,NA,NA,NA,NA,NA
46049,2011,29,26,-15,0,3,-15,12.277730737,11.00762066,-6.350550381,0,1.2701100762,-6.350550381
46049,2012,23,26,4,-1,-3,3,9.7623089983,11.03565365,1.6977928693,-0.424448217,-1.273344652,1.273344652
46049,2013,31,23,-11,-2,8,-13,13.174670633,9.7747556311,-4.674883128,-0.849978751,3.3999150021,-5.524861878
46049,2014,29,35,-23,-1,-6,-24,12.419700214,14.989293362,-9.850107066,-0.428265525,-2.569593148,-10.27837259
46049,2015,31,36,-8,-1,-5,-9,13.402507566,15.564202335,-3.45871163,-0.432338954,-2.161694769,-3.891050584
46049,2016,33,28,16,-1,5,15,14.251781473,12.092420643,6.9099546534,-0.431872166,2.1593608292,6.4780824876
46049,2017,30,18,-7,-1,12,-8,12.892135797,7.7352814783,-3.008165019,-0.42973786,5.1568543189,-3.437902879
05045,2010,388,238,570,17,150,587,NA,NA,NA,NA,NA,NA
05045,2011,1576,806,1341,56,770,1397,13.689408515,7.0010553699999996,11.64815788,0.4864256833,6.688353145,12.134583563
05045,2012,1563,832,1349,96,731,1445,13.322309541,7.0915940744,11.498269719,0.8182608547,6.2307154668,12.316530574
05045,2013,1514,905,10,68,609,78,12.748561156,7.6205071637,0.084204499,0.5725905935,5.1280539919,0.6567950926
05045,2014,1546,872,598,100,674,698,12.907050038,7.2800437471,4.9925070651,0.8348674022,5.6270062907,5.8273744673
05045,2015,1550,918,-78,112,632,34,12.83240057,7.6000927244,-0.645759513,0.9272444283,5.2323078452,0.2814849157
05045,2016,1536,894,218,110,642,328,12.631786707,7.3520946068,1.7927926446,0.9046201418,5.2796921002,2.6974127864
05045,2017,1530,867,800,106,663,906,12.452337255,7.0563244444,6.5110260156,0.8627109471,5.3960128104,7.3737369627
51061,2010,207,91,95,3,116,98,NA,NA,NA,NA,NA,NA
51061,2011,748,527,364,11,221,375,11.373225784,8.0129545299,5.5345644191,0.1672533204,3.3602712545,5.7018177395
51061,2012,774,481,222,22,293,244,11.669455878,7.2519486785,3.3470532362,0.3316899603,4.4175071992,3.6787431966
51061,2013,707,499,350,29,208,379,10.570777109,7.4608455127,5.2330579748,0.4335962322,3.1099315965,5.666654207
51061,2014,784,549,716,36,235,752,11.586064211,8.1132005763,10.581150478,0.5320131525,3.4728636347,11.113163631
51061,2015,740,540,52,41,200,93,10.834077566,7.9059484942,0.7613135587,0.6002664597,2.9281290719,1.3615800184
51061,2016,777,578,102,40,199,142,11.324137026,8.4238754199,1.4865662506,0.5829671571,2.9002616065,2.0695334077
51061,2017,781,621,486,40,160,526,11.298454238,8.9837901178,7.0307922661,0.5786660301,2.3146641205,7.6094582963
01057,2010,42,39,-3,-2,3,-5,NA,NA,NA,NA,NA,NA
01057,2011,186,256,-102,-7,-70,-109,10.85149208,14.935386949,-5.950818238,-0.408389487,-4.083894869,-6.359207724
01057,2012,164,255,-11,-4,-91,-15,9.6487615462,15.002647526,-0.647173031,-0.235335647,-5.35388598,-0.882508678
01057,2013,186,238,-69,0,-52,-69,11.016673083,14.096603192,-4.086830337,0,-3.079930109,-4.086830337
01057,2014,182,218,-17,0,-36,-17,10.836235897,12.979667173,-1.01217588,0,-2.143431276,-1.01217588
01057,2015,192,230,-39,0,-38,-39,11.477761836,13.7494022,-2.331420373,0,-2.271640363,-2.331420373
01057,2016,161,223,-88,0,-62,-88,9.6912056823,13.423222777,-5.297056522,0,-3.732017095,-5.297056522
01057,2017,165,230,-5,0,-65,-5,9.9981821487,13.936859965,-0.302975217,0,-3.938677816,-0.302975217
13113,2010,193,229,368,47,-36,415,NA,NA,NA,NA,NA,NA
13113,2011,779,764,68,173,15,241,7.2752063955,7.1351189809,0.6350629459,1.6156748478,0.1400874145,2.2507377937
13113,2012,806,667,-181,202,139,21,7.5112295678,6.2158686374,-1.686764953,1.8824669636,1.2953609304,0.1957020111
13113,2013,814,818,553,180,-4,733,7.5535078806,7.5906258555,5.1315600221,1.6703088679,-0.037117975,6.80186889
13113,2014,829,794,955,208,35,1163,7.6247763843,7.3028618205,8.7836688143,1.9130922653,0.3219145639,10.69676108
13113,2015,929,834,650,226,95,876,8.4606067229,7.5954208901,5.9196925403,2.0582315602,0.8651858328,7.9779241004
13113,2016,856,897,785,224,-41,1009,7.7279334098,8.098079753,7.0869482787999996,2.0222629484,-0.370146343,9.1092112272
13113,2017,895,864,1060,226,31,1286,7.998319906,7.7212831271,9.4728705032,2.0196874846,0.2770367789,11.492557988
17051,2010,67,80,-3,5,-13,2,NA,NA,NA,NA,NA,NA
17051,2011,236,179,159,21,57,180,10.606503225,8.044763039,7.1459068336,0.9437990158,2.5617401856,8.0897058493
17051,2012,256,247,-252,16,9,-236,11.500707563,11.096385813,-11.32100901,0.7187942227,0.4043217503,-10.60221478
17051,2013,228,204,20,0,24,20,10.284631693,9.2020388831,0.9021606748,0,1.0825928098,0.9021606748
17051,2014,248,206,-169,0,42,-169,11.208279665,9.3101032698,-7.637900255,0,1.8981763948000001,-7.637900255
17051,2015,256,237,-30,0,19,-30,11.606819006,10.745375408,-1.360174102,0,0.8614435981,-1.360174102
17051,2016,228,221,-239,0,7,-239,10.395531745,10.076370683,-10.89707056,0,0.3191610624,-10.89707056
17051,2017,231,200,-63,0,31,-63,10.596330275,9.1743119266,-2.889908257,0,1.4220183486,-2.889908257
18041,2010,63,53,17,0,10,17,NA,NA,NA,NA,NA,NA
18041,2011,233,322,-86,0,-89,-86,9.612806073,13.284650453,-3.548074345,0,-3.67184438,-3.548074345
18041,2012,234,307,-129,3,-73,-126,9.7297297297,12.765072765,-5.363825364,0.1247401247,-3.035343035,-5.239085239
18041,2013,265,344,-45,7,-79,-38,11.092739488,14.399631637,-1.883672743,0.2930157601,-3.306892149,-1.590656983
18041,2014,238,299,-336,6,-61,-330,10.069385683,12.650194618,-14.21560332,0.2538500592,-2.580808936,-13.96175326
18041,2015,248,311,9,6,-63,15,10.590596575,13.280949737,0.384336166,0.2562241107,-2.690353162,0.6405602767
18041,2016,243,312,-69,5,-69,-64,10.418453096,13.376779283,-2.958326188,0.2143714629,-2.958326188,-2.743954725
18041,2017,239,284,-8,6,-45,-2,10.287091637,12.223991736,-0.344337795,0.2582533465,-1.936900099,-0.086084449
19065,2010,50,42,-32,2,8,-30,NA,NA,NA,NA,NA,NA
19065,2011,219,237,107,14,-18,121,10.474209054,11.335102949,5.1175359304,0.6695841404,-0.860893895,5.7871200708
19065,2012,220,246,-194,18,-26,-176,10.546753278,11.793187756,-9.3003188,0.8629161773,-1.246434478,-8.437402622
19065,2013,222,274,-230,20,-52,-210,10.76102763,13.281628696,-11.14881241,0.9694619486,-2.520601066,-10.17935046
19065,2014,194,266,-178,23,-72,-155,9.5158679551,13.047530289,-8.731054103,1.1281699122,-3.531662334,-7.602884191
19065,2015,209,267,-99,24,-58,-75,10.343206394,13.213569891,-4.899413555,1.1877366194,-2.870363497,-3.711676936
19065,2016,218,239,-157,25,-21,-132,10.866043614,11.912772586000001,-7.825545171,1.246105919,-1.046728972,-6.579439252
19065,2017,213,227,-201,25,-14,-176,10.708360565,11.412196471,-10.10507265,1.2568498316,-0.703835906,-8.848222814
21067,2010,966,450,175,213,516,388,NA,NA,NA,NA,NA,NA
21067,2011,4067,2072,1659,986,1995,2645,13.600414667,6.9289548046,5.5478455699,3.2972728945,6.6714598626,8.8451184644
21067,2012,4053,2069,908,1051,1984,1959,13.361443023,6.8208304007,2.9933852121,3.4648104162,6.540612622,6.4581956283
21067,2013,4048,2221,373,1107,1827,1480,13.187944499,7.2357768605,1.2151935025,3.6064858103,5.9521676381,4.8216793127
21067,2014,4097,2203,-926,1382,1894,456,13.227286889,7.1124513097,-2.989618662,4.4618282842,6.114835579,1.472209622
21067,2015,3965,2348,1008,1539,1617,2547,12.668925666,7.5023045303,3.2207508375,4.917396368,5.1666211352,8.1381472056
21067,2016,4115,2303,609,1571,1812,2180,12.978882113,7.2637583247,1.9208114719,4.9549997083,5.7151237883,6.8758111801
21067,2017,4035,2244,-427,1558,1791,1131,12.589487544,7.0014399129,-1.332270429,4.8610710269,5.588047631,3.5288005978
39047,2010,84,99,-1,3,-15,2,NA,NA,NA,NA,NA,NA
39047,2011,354,348,-162,1,6,-161,12.236221289,12.028827708,-5.599626692,0.0345655969,0.2073935812,-5.565061095
39047,2012,374,340,-139,6,34,-133,12.984307735,11.803916123,-4.82571865,0.2083044022,1.1803916123,-4.617414248
39047,2013,363,377,-82,11,-14,-71,12.643678161,13.131313131,-2.856147684,0.3831417625,-0.48763497,-2.473005921
39047,2014,330,351,-27,14,-21,-13,11.519128735,12.2521642,-0.942474169,0.48869031,-0.733035465,-0.453783859
39047,2015,345,360,-45,16,-15,-29,12.060196109,12.584552462,-1.573069058,0.5593134427,-0.524356353,-1.013755615
39047,2016,353,341,51,16,12,67,12.332954843,11.913704254,1.7818150057,0.5590007861,0.4192505896,2.3408157918
39047,2017,346,318,45,17,28,62,12.052809419,11.077437559,1.5675619187,0.5921900582,0.9753718605,2.1597519769
42051,2010,343,470,-20,4,-127,-16,NA,NA,NA,NA,NA,NA
42051,2011,1374,1820,0,15,-446,15,10.087254013,13.361573729,0,0.1101228604,-3.274319716,0.1101228604
42051,2012,1333,1761,-287,0,-428,-287,9.8290062602,12.984906245,-2.116222653,0,-3.155899985,-2.116222653
42051,2013,1399,1814,-311,71,-415,-240,10.369107619,13.445004447,-2.305069671,0.5262377705,-3.075896828,-1.7788319
42051,2014,1438,1744,-305,71,-306,-234,10.706853354,12.985224096,-2.270925086,0.5286415773,-2.278370742,-1.742283508
42051,2015,1420,1788,-434,78,-368,-356,10.624090499,13.377375924,-3.247081181,0.5835768021,-2.753285425,-2.663504379
42051,2016,1410,1804,-583,80,-394,-503,10.614192907,13.580144684,-4.388705294,0.6022237111,-2.965951777,-3.786481583
42051,2017,1388,1835,-516,80,-447,-436,10.51929548,13.906993664,-3.910631461,0.6062994513,-3.387698184,-3.30433201
47047,2010,105,135,17,2,-30,19,NA,NA,NA,NA,NA,NA
47047,2011,446,323,17,-1,123,16,11.585167868,8.3901552049,0.441587116,-0.025975713,3.1950126632,0.4156114033
47047,2012,418,302,-13,8,116,-5,10.823827958,7.8200862281,-0.336626228,0.2071546021,3.00374173,-0.129471626
47047,2013,423,331,46,11,92,57,10.917255975,8.5428173231,1.1872193259,0.2839002736,2.3744386517,1.4711195994
47047,2014,443,394,138,22,49,160,11.380568258,10.121769511,3.545188306,0.5651749473,1.2587987463,4.1103632534
47047,2015,417,409,154,25,8,179,10.658283173,10.453807716,3.9361525387,0.6389858017,0.2044754566,4.5751383404
47047,2016,410,441,363,25,-31,388,10.407015852,11.193887782,9.2140164735,0.6345741373,-0.78687193,9.8485906108
47047,2017,418,430,445,25,-12,470,10.501061411,10.802527289,11.179359636,0.6280539121,-0.301465878,11.807413548
48149,2010,54,38,-10,-1,16,-11,NA,NA,NA,NA,NA,NA
48149,2011,248,292,229,2,-44,231,10.060647857,11.845601509,9.2898724164,0.0811342569,-1.784953652,9.3710066733
48149,2012,225,281,-29,-1,-56,-30,9.1096805539,11.376978825,-1.174136605,-0.040487469,-2.267298271,-1.214624074
48149,2013,240,345,146,24,-105,170,9.7225035447,13.976098845,5.9145229897,0.9722503545,-4.253595301,6.8867733441
48149,2014,244,322,128,26,-78,154,9.8575901424,13.008786991,5.1711948288,1.0503989496,-3.151196849,6.2215937784
48149,2015,263,327,212,30,-64,242,10.571589356,13.14414342,8.5215853364,1.2058847174,-2.572554064,9.7274700539
48149,2016,253,291,111,31,-38,142,10.112516738,11.631392769,4.4367168295,1.2390830785,-1.518876032,5.6757999081
48149,2017,260,286,196,31,-26,227,10.329347264999999,11.362281991,7.7867387072,1.23157602,-1.032934726,9.0183147273
54019,2010,141,180,25,4,-39,29,NA,NA,NA,NA,NA,NA
54019,2011,565,640,-51,7,-75,-44,12.289955952,13.921366034,-1.109358856,0.152264941,-1.631410082,-0.957093915
54019,2012,551,619,16,1,-68,17,12.009590235,13.491717524,0.3487358326,0.0217959895,-1.482127289,0.3705318221
54019,2013,575,670,-213,10,-95,-203,12.582194554,14.660991915,-4.660882504,0.2188207748,-2.078797361,-4.442061729
54019,2014,548,645,-310,10,-97,-300,12.083659497,14.222555429,-6.835646796,0.2205047353,-2.138895933,-6.61514206
54019,2015,501,679,-297,11,-178,-286,11.153285322,15.115929607,-6.611827825,0.244882512,-3.962644286,-6.366945313
54019,2016,480,658,-417,11,-178,-406,10.812150154,14.821655836,-9.393055446,0.247778441,-4.009505682,-9.145277005
54019,2017,475,681,-387,11,-206,-376,10.84190224,15.543864054,-8.833297194,0.2510756308,-4.701961814,-8.582221563
47049,2010,49,84,-3,0,-35,-3,NA,NA,NA,NA,NA,NA
47049,2011,197,208,90,-5,-11,85,10.970957592,11.583549133,5.0121126055,-0.2784507,-0.612591541,4.7336619052
47049,2012,181,222,-59,-4,-41,-63,10.089186176,12.37458194,-3.288740245,-0.22296544,-2.285395764,-3.511705686
47049,2013,192,235,71,-4,-43,67,10.727155907,13.129591865,3.9668128614,-0.223482415,-2.402435958,3.7433304467
47049,2014,192,256,-4,0,-64,-4,10.741859684,14.322479579,-0.223788743,0,-3.580619895,-0.223788743
47049,2015,176,240,87,0,-64,87,9.8604963864,13.446131436,4.8742226455,0,-3.58563505,4.8742226455
47049,2016,204,242,133,0,-38,133,11.391874913,13.513890828,7.4270557029,0,-2.122015915,7.4270557029
47049,2017,191,253,244,0,-62,244,10.584356211,14.020115818,13.52137652,0,-3.435759608,13.52137652
30027,2010,40,52,7,1,-12,8,NA,NA,NA,NA,NA,NA
30027,2011,112,156,-85,2,-44,-83,9.7247547104,13.545194061,-7.3803942,0.1736563341,-3.820439351,-7.206737866
30027,2012,105,172,-2,2,-67,0,9.1943957968,15.061295972,-0.175131349,0.1751313485,-5.866900175,0
30027,2013,127,149,87,0,-22,87,11.122788579,13.049570853,7.619548082,0,-1.926782274,7.619548082
30027,2014,104,171,-73,0,-67,-73,9.1384385572,15.025701858,-6.41448091,0,-5.887263301,-6.41448091
30027,2015,149,150,-24,0,-1,-24,13.188174898,13.276686139,-2.124269782,0,-0.088511241,-2.124269782
30027,2016,117,151,49,1,-34,50,10.360858977,13.371706885,4.3391631614,0.0885543502,-3.010847908,4.4277175116
30027,2017,133,141,-1,1,-8,0,11.774600505,12.482847152,-0.088530831,0.0885308309,-0.708246647,0
53019,2010,20,34,3,2,-14,5,NA,NA,NA,NA,NA,NA
53019,2011,54,85,114,6,-31,120,7.1150932209,11.199683774,15.020752355,0.7905659134,-4.084590553,15.811318269
53019,2012,74,82,31,4,-8,35,9.6738348912,10.719654879,4.0525524544,0.5229099941,-1.045819988,4.5754624485
53019,2013,71,82,-63,2,-11,-61,9.3090336961,10.751278353,-8.260128491,0.2622263013,-1.442244657,-7.99790219
53019,2014,76,92,14,2,-16,16,10.012515645,12.120413675,1.8444107766,0.2634872538,-2.10789803,2.1078980304
53019,2015,70,81,-60,2,-11,-58,9.2647740057,10.720667064,-7.941234862,0.2647078287,-1.455893058,-7.676527033
53019,2016,66,69,24,2,-3,26,8.7631945828,9.1615216092,3.1866162119,0.265551351,-0.398327026,3.4521675629
53019,2017,64,78,64,2,-14,66,8.4566596195,10.306553911,8.4566596195,0.2642706131,-1.849894292,8.7209302326
27045,2010,63,29,-40,0,34,-40,NA,NA,NA,NA,NA,NA
27045,2011,251,246,-45,9,5,-36,12.042123444,11.802240507,-2.158946434,0.4317892868,0.2398829371,-1.727157147
27045,2012,243,243,-13,12,0,-1,11.668107174,11.668107174,-0.624219725,0.5762028234,0,-0.048016902
27045,2013,237,226,-110,20,11,-90,11.402453693,10.873225884,-5.292278085,0.9622323791,0.5292278085,-4.330045706
27045,2014,280,237,-45,21,43,-24,13.491050134,11.419210292,-2.168204486,1.01182876,2.071839842,-1.156375726
27045,2015,242,246,-63,22,-4,-41,11.668273867,11.861137898,-3.037608486,1.0607521697,-0.192864031,-1.976856316
27045,2016,271,219,127,25,52,152,13.017893599,10.519995196,6.1006364837,1.2009126936,2.4978984028,7.3015491774
27045,2017,260,226,2,25,34,27,12.410797394,10.787846965,0.0954676723,1.1933459032,1.6229504284,1.2888135755
31059,2010,11,27,-2,0,-16,-2,NA,NA,NA,NA,NA,NA
31059,2011,54,76,-22,1,-22,-21,9.2331367017,12.994784988,-3.761648286,0.170984013,-3.761648286,-3.590664273
31059,2012,55,92,-77,1,-37,-76,9.5312364613,15.943159172,-13.34373105,0.1732952084,-6.41192271,-13.17043584
31059,2013,44,90,-32,0,-46,-32,7.7526209145,15.857633689,-5.638269756,0,-8.105012774,-5.638269756
31059,2014,60,80,-13,0,-20,-13,10.676156584,14.234875445,-2.31316726,0,-3.558718861,-2.31316726
31059,2015,61,100,-10,0,-39,-10,10.933859115,17.924359204,-1.79243592,0,-6.99050009,-1.79243592
31059,2016,69,68,86,0,1,86,12.328032875,12.149365732,15.365374308,0,0.1786671431,15.365374308
31059,2017,70,82,-46,0,-12,-46,12.475494564,14.614150775,-8.198182142,0,-2.138656211,-8.198182142
20055,2010,196,70,7,41,126,48,NA,NA,NA,NA,NA,NA
20055,2011,753,181,-568,147,572,-421,20.333216321,4.8875327411,-15.33767181,3.9694326682,15.44568358,-11.36823914
20055,2012,672,210,-585,134,462,-451,18.101253889,5.6566418403,-15.75778798,3.6094762219,12.444612049,-12.14831176
20055,2013,707,227,-688,139,480,-549,19.054035844,6.1177738849,-18.54197548,3.746125859,12.936261959,-14.79584962
20055,2014,686,209,-606,181,477,-425,18.487327018,5.6324363656,-16.33137051,4.8778515893,12.854890653,-11.45351893
20055,2015,732,207,-684,204,525,-480,19.696480465,5.569906361,-18.40490798,5.4891830804,14.126574104,-12.9157249
20055,2016,679,203,-886,217,476,-669,18.304600412,5.4725094017,-23.88494251,5.8499238432,12.832091011,-18.03501867
20055,2017,686,209,-610,218,477,-392,18.520018358,5.6423962636,-16.4682379,5.8853702654,12.877622094,-10.58286763
48151,2010,11,4,-13,0,7,-13,NA,NA,NA,NA,NA,NA
48151,2011,37,44,-7,1,-7,-6,9.3363613424,11.102699975,-1.766338632,0.2523340903,-1.766338632,-1.514004542
48151,2012,35,62,-84,1,-27,-83,8.9686098655,15.887251762,-21.52466368,0.2562459962,-6.918641896,-21.26841768
48151,2013,31,51,41,1,-20,42,8.0342101853,13.217571595,10.62589089,0.2591680705,-5.18336141,10.885058961
48151,2014,42,54,18,0,-12,18,10.849909584,13.949883751,4.6499612503,0,-3.099974167,4.6499612503
48151,2015,41,65,20,2,-24,22,10.588842975,16.787190083,5.1652892562,0.5165289256,-6.198347107,5.6818181818
48151,2016,46,33,-5,2,13,-3,11.867905057,8.5139318885,-1.28998968,0.515995872,3.3539731682,-0.773993808
48151,2017,43,47,2,2,-4,4,11.081046257,12.111841258,0.5153975003,0.5153975003,-1.030795001,1.0307950006
12035,2010,227,226,322,40,1,362,NA,NA,NA,NA,NA,NA
12035,2011,805,1038,1386,237,-233,1623,8.3180061584,10.725578127,14.32143669,2.4489036765,-2.407571969,16.770340367
12035,2012,875,1111,1048,200,-236,1248,8.9289814328,11.337255282,10.694368619,2.0409100418,-2.408273849,12.735278661
12035,2013,747,1227,1652,201,-480,1853,7.5299762609,12.368515224,16.652638264,2.0261381907,-4.838538963,18.678776454
12035,2014,801,1187,2330,211,-386,2541,7.9299471832,11.751369921,23.067137249,2.088912429,-3.821422737,25.156049678
12035,2015,814,1209,2748,229,-395,2977,7.8701711811,11.689234592,26.569079122,2.2140899269,-3.819063411,28.783169049
12035,2016,808,1279,3301,233,-471,3534,7.6031315869,12.035155074,31.061803674,2.1924872026,-4.432023487,33.254290876
12035,2017,802,1261,2919,233,-459,3152,7.3471818244,11.552115063,26.74117674,2.1345303804,-4.204933239,28.87570712
30029,2010,266,187,-170,11,79,-159,NA,NA,NA,NA,NA,NA
30029,2011,1100,745,8,34,355,42,12.082003855,8.182811702,0.0878691189,0.3734437555,3.8991921533,0.4613128745
30029,2012,1069,788,91,-18,281,73,11.695074722,8.6208782793,0.9955582784,-0.196923616,3.0741964422,0.7986346629
30029,2013,1104,821,999,-30,283,969,11.973255391,8.9040241634,10.834494688,-0.325360201,3.0692312281,10.509134488
30029,2014,1133,808,1317,-33,325,1284,12.098044345,8.6277315366,14.062775289,-0.352370224,3.4703128087,13.710405066
30029,2015,1107,932,1115,-28,175,1087,11.640011356,9.7999011598,11.724130679,-0.294417631,1.8401101963,11.429713048
30029,2016,1196,898,1687,-29,298,1658,12.366166747,9.2849646644,17.44291246,-0.299848525,3.0812020824,17.143063935
30029,2017,1177,844,1994,-29,333,1965,11.907351297,8.5384914994,20.172692002,-0.293384187,3.3688597978,19.879307816
21069,2010,49,18,23,0,31,23,NA,NA,NA,NA,NA,NA
21069,2011,190,167,67,-2,23,65,13.146969278,11.555494049,4.6360365347,-0.13838915,1.5914752283,4.4976473844
21069,2012,189,165,28,-5,24,23,13.018322083,11.365201818,1.9286403086,-0.344400055,1.6531202645,1.5842402535
21069,2013,206,194,0,-1,12,-1,14.162942592,13.33791681,0,-0.068752149,0.8250257821,-0.068752149
21069,2014,187,192,-58,0,-5,-58,12.880562061,13.224962116,-3.995040639,0,-0.344400055,-3.995040639
21069,2015,193,184,93,0,9,93,13.276010318,12.656921754,6.3972484953,0,0.6190885641,6.3972484953
21069,2016,188,163,-107,0,25,-107,12.923626865,11.205059462,-7.355468481,0,1.7185674022,-7.355468481
21069,2017,179,170,-68,0,9,-68,12.36529428,11.743575573,-4.697430229,0,0.6217187068,-4.697430229
45041,2010,424,270,30,16,154,46,NA,NA,NA,NA,NA,NA
45041,2011,1815,1473,149,39,342,188,13.217639541,10.727042999,1.0850844582,0.2840153951,2.4905965416,1.3690998533
45041,2012,1838,1439,4,42,399,46,13.339816959,10.443958979,0.0290311577,0.3048271557,2.8958579796,0.3338583134
45041,2013,1774,1583,-30,26,191,-4,12.847717611,11.46445151,-0.217266927,0.1882980033,1.3832661013,-0.028968924
45041,2014,1767,1412,237,65,355,302,12.760241773,10.196639153,1.7114755519,0.469392029,2.5636026199,2.1808675809
45041,2015,1735,1441,-432,77,294,-355,12.50400885,10.385173921,-3.1133901,0.5549329576,2.1188349291,-2.558457142
45041,2016,1660,1538,-470,78,122,-392,11.97833797,11.098002287,-3.391457136,0.5628375672,0.8803356821,-2.8286195689999998
45041,2017,1653,1529,-79,79,124,0,11.934414867,11.039153256,-0.570368285,0.5703682846,0.8952616113,0
55037,2010,5,23,-8,0,-18,-8,NA,NA,NA,NA,NA,NA
55037,2011,26,56,17,-3,-30,14,5.9225512528,12.756264237,3.8724373576,-0.683371298,-6.833712984,3.1890660592
55037,2012,30,44,2,-1,-14,1,6.8579266202,10.058292376,0.457195108,-0.228597554,-3.200365756,0.228597554
55037,2013,26,52,42,0,-26,42,5.9421780368,11.884356074,9.5989029825,0,-5.942178037,9.5989029825
55037,2014,32,40,-31,0,-8,-31,7.3318822316,9.1648527896,-7.102760912,0,-1.832970558,-7.102760912
55037,2015,22,45,24,0,-23,24,5.0627085491,10.355540214,5.5229547808,0,-5.292831665,5.5229547808
55037,2016,33,56,12,0,-23,12,7.6036866359,12.903225806,2.7649769585,0,-5.299539171,2.7649769585
55037,2017,33,51,54,0,-18,54,7.5818495118,11.717403791,12.406662837,0,-4.135554279,12.406662837
13115,2010,325,202,-24,22,123,-2,NA,NA,NA,NA,NA,NA
13115,2011,1301,979,-627,102,322,-525,13.50642879,10.163561711,-6.509247388,1.0589206277,3.3428670795,-5.45032676
13115,2012,1128,1006,-446,105,122,-341,11.73649081,10.467118577,-4.640491934,1.0924924956,1.269372233,-3.547999438
13115,2013,1186,1041,-323,105,145,-218,12.359251984,10.848213588,-3.365968289,1.0942002178,1.511038396,-2.271768071
13115,2014,1135,1022,-190,130,113,-60,11.830310611,10.65249114,-1.980404419,1.3550135501,1.1778194705,-0.625390869
13115,2015,1170,1044,22,145,126,167,12.17469121,10.863570618,0.2289258176,1.5088292526,1.3111205919,1.7377550702
13115,2016,1263,1131,95,152,132,247,13.097380005,11.728532689,0.9851552657,1.576248425,1.3688473165,2.5614036907
13115,2017,1217,1079,702,153,138,855,12.531341224,11.110367445,7.2284318319,1.5754274505,1.4209737789,8.8038592824
18043,2010,261,130,6,3,131,9,NA,NA,NA,NA,NA,NA
18043,2011,870,718,124,-3,152,121,11.624411264,9.5934796406,1.6568126399,-0.040084177,2.0309316231,1.6167284631
18043,2012,897,729,115,3,168,118,11.941927882,9.7053126269,1.5310163952,0.0399395581,2.2366152556,1.5709559533
18043,2013,845,736,625,15,109,640,11.172888886,9.7316523314,8.2639710695,0.1983353057,1.4412365545,8.4623063752
18043,2014,919,739,-117,18,180,-99,12.084949701,9.7179301729,-1.538562693,0.2367019528,2.3670195279,-1.30186074
18043,2015,860,766,323,30,94,353,11.271149788,10.039186904,4.2332341647,0.3931796438,1.2319628838,4.6264138085
18043,2016,923,747,-5,33,176,28,12.046305843,9.7492854439,-0.065256261,0.4306913248,2.2970203991,0.3654350635
18043,2017,910,748,156,33,162,189,11.83401173,9.7272975539,2.0286877251,0.4291454803,2.1067141761,2.4578332055
19067,2010,34,29,11,0,5,11,NA,NA,NA,NA,NA,NA
19067,2011,194,185,-227,-1,9,-228,11.9682902,11.413060242,-14.00413338,-0.061692218,0.5552299577,-14.0658256
19067,2012,200,199,1,-5,1,-4,12.422746048,12.360632318,0.0621137302,-0.310568651,0.0621137302,-0.248454921
19067,2013,166,209,-13,-5,-43,-18,10.332378937,13.008838541,-0.809162206,-0.311216233,-2.676459604,-1.120378439
19067,2014,209,210,-20,-4,-1,-24,13.044563725,13.106977905,-1.24828361,-0.249656722,-0.062414181,-1.497940332
19067,2015,198,202,-105,-4,-4,-109,12.41223671,12.662988967,-6.58224674,-0.250752257,-0.250752257,-6.832998997
19067,2016,190,168,-79,-3,22,-82,11.976047904,10.589347621,-4.979514655,-0.189095493,1.3867002836,-5.168610148
19067,2017,195,183,-100,-3,12,-103,12.349979417,11.589980683,-6.333322778,-0.189999683,0.7599987333,-6.523322461
21071,2010,130,155,443,1,-25,444,NA,NA,NA,NA,NA,NA
21071,2011,540,516,-205,2,24,-203,13.553706562,12.951319604,-5.145388602,0.0501989132,0.6023869583,-5.095189689
21071,2012,542,522,-657,6,20,-651,13.74065154,13.233616428,-16.65610344,0.1521105337,0.5070351122,-16.5039929
21071,2013,530,516,-701,7,14,-694,13.658209744,13.297426845,-18.06491515,0.1803914494,0.3607828989,-17.8845237
21071,2014,474,467,-500,10,7,-490,12.397829072,12.214738769,-13.07787877,0.2615575754,0.1830903028,-12.81632119
21071,2015,460,508,-432,12,-48,-420,12.181719476,13.452855422,-11.44022351,0.3177839863,-1.271135945,-11.12243952
21071,2016,470,572,-469,12,-102,-457,12.617788397,15.356116943,-12.59094204,0.3221562995,-2.738328546,-12.26878574
21071,2017,441,548,-607,12,-107,-595,12.042599672,14.964500273,-16.57564173,0.327689787,-2.921900601,-16.24795194
48153,2010,22,34,-32,1,-12,-31,NA,NA,NA,NA,NA,NA
48153,2011,90,64,-71,9,26,-62,14.093329158,10.021922956,-11.11807078,1.4093329158,4.0714062011,-9.708737864
48153,2012,80,69,-42,11,11,-31,12.580594433,10.850762699,-6.604812077,1.7298317345,1.7298317345,-4.874980343
48153,2013,99,59,-157,11,40,-146,15.723020726,9.370285079,-24.93448741,1.7470023029,6.3527356468,-23.18748511
48153,2014,67,74,-306,7,-7,-299,10.993518746,12.142095332,-50.20920502,1.1485765854,-1.148576585,-49.06062844
48153,2015,64,68,-103,7,-4,-96,10.855737427,11.534221016,-17.47095242,1.1873462811,-0.678483589,-16.28360614
48153,2016,81,51,-6,6,30,0,13.820167207,8.7015867599,-1.023716089,1.0237160894,5.118580447,0
48153,2017,75,55,-46,5,20,-41,12.786633706,9.3768647174,-7.842468673,0.852442247,3.4097689882,-6.990026426
51063,2010,55,16,34,1,39,35,NA,NA,NA,NA,NA,NA
51063,2011,160,150,22,2,10,24,10.401430197,9.7513408094,1.430196652,0.1300178775,0.6500893873,1.5602145295
51063,2012,144,143,30,1,1,31,9.3415504379,9.2766785598,1.9461563412,0.064871878,0.064871878,2.0110282193
51063,2013,150,145,52,-4,5,48,9.7046549995,9.3811664995,3.3642803998,-0.2587908,0.3234885,3.1054895998
51063,2014,158,178,67,-2,-20,65,10.190918473,11.480908153,4.3214654283,-0.128998968,-1.28998968,4.1924664603
51063,2015,136,180,67,-1,-44,66,8.7535802787,11.585620957,4.3124255785,-0.064364561,-2.832040678,4.2480610176
51063,2016,120,145,138,-1,-25,137,7.6910751482,9.2933824708,8.8447364204,-0.064092293,-1.602307323,8.7806441275
51063,2017,131,157,124,-1,-26,123,8.340495973,9.995861586,7.8948206157,-0.063667908,-1.655365613,7.8311527075
51065,2010,68,54,35,2,14,37,NA,NA,NA,NA,NA,NA
51065,2011,264,194,90,7,70,97,10.203687242,7.4981641093,3.4785297414,0.2705523132,2.7055231322,3.7490820547
51065,2012,257,191,-137,1,66,-136,9.9149321965,7.3686850177,-5.285391871,0.0385795027,2.5462471789,-5.246812369
51065,2013,268,214,-107,-3,54,-110,10.365299453,8.276768966,-4.138384483,-0.116029471,2.0885304867,-4.254413954
51065,2014,261,197,88,-1,64,87,10.077220077,7.6061776062,3.3976833977,-0.038610039,2.471042471,3.3590733591
51065,2015,246,201,105,0,45,105,9.4441031941,7.7165233415,4.031019656,0,1.7275798526,4.031019656
51065,2016,264,235,18,1,29,19,10.097339886,8.9881623989,0.6884549923,0.0382474996,1.1091774875,0.7267024918
51065,2017,243,207,245,1,36,246,9.2358564071,7.8675813839,9.3118716862,0.0380076395,1.3682750233,9.3498793257
48155,2010,3,2,7,0,1,7,NA,NA,NA,NA,NA,NA
48155,2011,18,19,18,0,-1,18,13.298854821,14.037680089,13.298854821,0,-0.738825268,13.298854821
48155,2012,15,15,-54,1,0,-53,11.223344557,11.223344557,-40.4040404,0.7482229704,0,-39.65581743
48155,2013,14,23,-14,1,-9,-13,10.773374375,17.699115044,-10.77337437,0.7695267411,-6.925740669,-10.00384763
48155,2014,5,28,10,1,-23,11,3.8986354776,21.832358674,7.7972709552,0.7797270955,-17.9337232,8.5769980507
48155,2015,10,21,-39,1,-11,-38,7.9840319361,16.766467066,-31.13772455,0.7984031936,-8.78243513,-30.33932136
48155,2016,11,14,-14,1,-3,-13,9.0200902009,11.480114801,-11.4801148,0.8200082001,-2.4600246,-10.6601066
48155,2017,11,12,12,1,-1,13,9.0423345664,9.8643649815,9.8643649815,0.8220304151,-0.822030415,10.686395397
55039,2010,305,251,-108,11,54,-97,NA,NA,NA,NA,NA,NA
55039,2011,1096,916,-17,101,180,84,10.775417105,9.005731814,-0.167136944,0.9929900799,1.769685291,0.8258531358
55039,2012,1123,910,-343,116,213,-227,11.027967633,8.9362872182,-3.368292875,1.1391311179,2.0916804148,-2.229161757
55039,2013,1127,976,-345,158,151,-187,11.070400676,9.5871437973,-3.388898166,1.5520171311,1.4832568785,-1.836881035
55039,2014,1068,940,-118,168,128,50,10.484207426,9.2276732029,-1.158367487,1.6492011682,1.2565342234,0.490833681
55039,2015,1073,935,-347,178,138,-169,10.526419055,9.1726018796,-3.404163478,1.7462279514,1.3538171758,-1.657935527
55039,2016,1060,878,-74,188,182,114,10.38574214,8.60252981,-0.725042376,1.8419995493,1.7832123296,1.1169571735
55039,2017,1043,884,-5,189,159,184,10.187636136,8.6345832641,-0.048838141,1.846081716,1.5530528722,1.7972435753
17053,2010,39,30,-9,2,9,-7,NA,NA,NA,NA,NA,NA
17053,2011,130,219,-116,0,-89,-116,9.2996637814,15.666356678,-8.298161528,0,-6.366692896,-8.298161528
17053,2012,144,183,38,1,-39,39,10.376882612,13.187288319,2.7383440225,0.0720616848,-2.810405707,2.8104057073
17053,2013,135,198,-146,0,-63,-146,9.8010744882,14.374909249,-10.59968056,0,-4.573834761,-10.59968056
17053,2014,159,208,-85,-1,-49,-86,11.688168486,15.290182674,-6.248391958,-0.073510494,-3.602014188,-6.321902452
17053,2015,142,204,49,-1,-62,48,10.495971617,15.078719787,3.6218493606,-0.073915293000000007,-4.582748171,3.5479340676
17053,2016,137,183,-133,-1,-46,-134,10.199523526,13.62418106,-9.901727219,-0.074449077,-3.424657534,-9.976176295
17053,2017,135,195,0,-1,-60,-1,10.14198783,14.649537976,0,-0.075125836,-4.507550146,-0.075125836
20057,2010,162,94,71,33,68,104,NA,NA,NA,NA,NA,NA
20057,2011,663,247,-143,136,416,-7,19.369823393,7.216208715,-4.177805046,3.9732971062,12.153614678,-0.204507939
20057,2012,709,219,-309,150,490,-159,20.491921732,6.329662707,-8.930893956,4.3353854158,14.162259024999999,-4.595508541
20057,2013,668,246,-470,216,422,-254,19.167312272,7.0586209865,-13.48598319,6.1978135491,12.108691286000001,-7.288169636
20057,2014,674,230,-767,266,444,-501,19.304024058,6.5874266075,-21.96763569,7.6185020765,12.716597451,-14.34913361
20057,2015,660,227,-1073,310,433,-763,19.000734119,6.5351009774,-30.89058744,8.9245872378,12.465633142,-21.9660002
20057,2016,636,224,-820,332,412,-488,18.413700256,6.4853283921,-23.74093429,9.6121831526,11.928371864,-14.12875114
20057,2017,619,223,-854,334,396,-520,17.972765018,6.4748410325,-24.79602799,9.6977439679,11.497923986,-15.09828402
42053,2010,5,10,1,0,-5,1,NA,NA,NA,NA,NA,NA
42053,2011,33,97,20,3,-64,23,4.290729424,12.612144064,2.6004420752,0.3900663113,-8.32141464,2.9905083864
42053,2012,37,91,-34,3,-54,-31,4.8499147988,11.928168829,-4.456678464,0.393236335,-7.078254031,-4.063442129
42053,2013,33,88,-2,3,-55,1,4.3647906884,11.639441836,-0.264532769,0.3967991535,-7.274651147,0.1322663845
42053,2014,29,86,-32,1,-57,-31,3.8720875893,11.482742506,-4.272648374,0.1335202617,-7.610654917,-4.139128113
42053,2015,37,92,-32,1,-55,-31,4.9993244156,12.430752601,-4.323740035,0.1351168761,-7.431428185,-4.188623159
42053,2016,28,69,-11,1,-41,-10,3.8191366023,9.41144377,-1.500375094,0.1363977358,-5.592307168,-1.363977358
42053,2017,32,85,42,1,-53,43,4.382661097,11.641443539,5.7522426899,0.1369581593,-7.258782442,5.8892008491
55041,2010,30,33,-4,0,-3,-4,NA,NA,NA,NA,NA,NA
55041,2011,93,112,-32,2,-19,-30,10.031280337,12.080681696,-3.451623342,0.2157264589,-2.049401359,-3.235896883
55041,2012,113,122,-82,2,-9,-80,12.280606423,13.258707819,-8.911590502,0.2173558659,-0.978101397,-8.694234636
55041,2013,112,119,-62,1,-7,-61,12.276663378,13.043954839,-6.796010084,0.1096130659,-0.767291461,-6.686397019
55041,2014,120,108,0,0,12,0,13.195513525,11.875962173,0,0,1.3195513525,0
55041,2015,109,116,-94,0,-7,-94,12.045529893,12.819096033,-10.38788816,0,-0.77356614,-10.38788816
55041,2016,105,114,30,0,-9,30,11.654364837,12.653310395,3.3298185249,0,-0.998945557,3.3298185249
55041,2017,104,111,-42,0,-7,-42,11.561978877,12.340188994,-4.6692607,0,-0.778210117,-4.6692607
28035,2010,263,127,-73,15,136,-58,NA,NA,NA,NA,NA,NA
28035,2011,1160,692,245,82,468,327,15.384105302,9.177414542,3.249229137,1.0874970989,6.2066907596,4.3367262359
28035,2012,1022,704,181,144,318,325,13.425992827,9.2484334152,2.3777932502,1.8917250167,4.177559412,4.269518267
28035,2013,1129,763,-317,126,366,-191,14.752577454,9.9700767029,-4.142220596,1.6464346849,4.7825007513,-2.495785911
28035,2014,1041,711,-1264,104,330,-1160,13.659445487,9.3293619031,-16.58553227,1.3646324021,4.3300835837,-15.22089987
28035,2015,1075,724,-638,121,351,-517,14.196010591,9.5608480631,-8.425167216,1.5978765409,4.6351625278,-6.827290675
28035,2016,1038,776,-374,108,262,-266,13.722897938,10.259122158,-4.944473823,1.4278159704,3.46377578,-3.516657853
28035,2017,1047,765,-553,105,282,-448,13.857638245,10.12520846,-7.319268338,1.3897344945,3.7324297853,-5.929533843
13117,2010,602,224,724,108,378,832,NA,NA,NA,NA,NA,NA
13117,2011,2227,827,3440,363,1400,3803,12.413566294,4.6097976316,19.174974429,2.0234057319,7.8037686629,21.198380161
13117,2012,2189,908,3472,279,1281,3751,11.859356377,4.9192761946,18.810271969,1.5115397118,6.940080182,20.321811681
13117,2013,2098,944,5480,280,1154,5760,11.005526369,4.9519622937,28.746560773,1.4688023753,6.0535640752,30.215363148
13117,2014,2300,970,6971,340,1330,7311,11.584508993,4.8856407493,35.111135735,1.7124926338,6.6988682438,36.823628369
13117,2015,2351,1130,6731,391,1221,7122,11.348469453,5.4546025019,32.491088,1.8873890073,5.8938669511,34.378477007
13117,2016,2397,1176,7065,392,1221,7457,11.111342887,5.45137223,32.749953065,1.8171240767,5.6599706572,34.567077142
13117,2017,2367,1228,6350,395,1139,6745,10.566162389,5.4817268332,28.346063022,1.7632590384,5.0844355562,30.10932206
37067,2010,1194,686,104,163,508,267,NA,NA,NA,NA,NA,NA
37067,2011,4646,3000,1106,688,1646,1794,13.156702386,8.4955030471,3.13200879,1.9483020321,4.6611993385,5.0803108221
37067,2012,4584,3038,1067,517,1546,1584,12.862458121,8.5244650463,2.9939447678,1.4506742689,4.3379930749,4.4446190367
37067,2013,4584,3166,1294,375,1418,1669,12.752160481,8.8074476623,3.5997590888,1.0432068457,3.9447128191,4.6429659344
37067,2014,4513,3100,2052,496,1413,2548,12.433260418,8.5404625074,5.6532351823,1.3664740012,3.8927979106,7.0197091835
37067,2015,4410,3286,1298,582,1124,1880,12.03474521,8.9673861134,3.5421993838,1.5882588917,3.0673590966,5.1304582755
37067,2016,4471,3315,1937,603,1156,2540,12.091365397,8.9650808074,5.2384197659,1.6307522555,3.1262845893,6.8691720214
37067,2017,4403,3234,2928,605,1169,3533,11.773766134,8.6478218666,7.8295678496,1.617789805,3.1259442678,9.4473576546
48157,2010,1937,650,3323,789,1287,4112,NA,NA,NA,NA,NA,NA
48157,2011,7732,2334,7098,3634,5398,10732,12.921284943,3.9004499555,11.861779685,6.0729370773,9.0208349871,17.934716762
48157,2012,7904,2354,9668,3547,5550,13215,12.832283323,3.8217604938,15.696168417,5.7586170227,9.0105228295,21.45478544
48157,2013,8141,2574,17181,4025,5567,21206,12.741315763,4.0285157564,26.889638388,6.2994467442,8.7128000063,33.189085133
48157,2014,9089,2720,19964,4648,6369,24612,13.601817966,4.0705187442,29.876410371,6.955798207,9.5312992213,36.832208578
48157,2015,9655,2947,17910,5081,6708,22991,13.814328556,4.2165537292,25.625543702,7.269870885,9.5977748272,32.895414587
48157,2016,10028,3229,16086,5185,6799,21271,13.77624861,4.4359300719,22.098597441,7.1230403911,9.340318538,29.221637832
48157,2017,10214,3497,10995,5168,6717,16163,13.557333291,4.6416677617,14.593976849,6.8596336839,8.9156655291,21.453610533
38031,2010,5,7,6,1,-2,7,NA,NA,NA,NA,NA,NA
38031,2011,29,40,6,4,-11,10,8.6735456857,11.963511291,1.7945266936,1.1963511291,-3.289965605,2.9908778226
38031,2012,30,40,46,2,-10,48,8.9245872378,11.89944965,13.684367098,0.5949724825,-2.974862413,14.279339581
38031,2013,40,50,-16,0,-10,-16,11.88001188,14.85001485,-4.752004752,0,-2.97000297,-4.752004752
38031,2014,38,42,-12,1,-4,-11,11.355147169,12.550425818,-3.585835948,0.2988196623,-1.195278649,-3.287016286
38031,2015,44,46,-8,1,-2,-7,13.195381616,13.79517169,-2.399160294,0.2998950367,-0.599790073,-2.099265257
38031,2016,29,42,-9,1,-13,-8,8.734939759,12.65060241,-2.710843373,0.3012048193,-3.915662651,-2.409638554
38031,2017,37,42,-47,1,-5,-46,11.26846353,12.791228872,-14.31399421,0.3045530684,-1.522765342,-14.00944115
18045,2010,55,27,10,-1,28,9,NA,NA,NA,NA,NA,NA
18045,2011,184,200,-103,-1,-16,-104,10.686490882,11.615750958,-5.982111744,-0.058078755,-0.929260077,-6.040190498
18045,2012,176,199,-13,0,-23,-13,10.269276775,11.611284535,-0.758526125,0,-1.34200776,-0.758526125
18045,2013,194,213,-219,0,-19,-219,11.410422303,12.52793789,-12.88083755,0,-1.117515586,-12.88083755
18045,2014,207,197,-203,0,10,-203,12.32913428,11.733523929,-12.09089014,0,0.5956103517,-12.09089014
18045,2015,202,214,-148,3,-12,-145,12.157322982,12.879540188,-8.907345551,0.1805543017,-0.722217207,-8.726791249
18045,2016,188,192,-57,2,-4,-55,11.389107651,11.631429091,-3.453080511,0.1211607197,-0.242321439,-3.331919792
18045,2017,205,187,9,2,18,11,12.431022982,11.339518525,0.5457522285,0.121278273,1.091504457,0.6670305015
51620,2010,30,48,18,1,-18,19,NA,NA,NA,NA,NA,NA
51620,2011,97,134,-103,4,-37,-99,11.39233073,15.737858947,-12.09701098,0.4697868342,-4.345528217,-11.62722415
51620,2012,126,117,20,9,9,29,14.883061658,13.819985826,2.3623907394,1.0630758327,1.0630758327,3.4254665722
51620,2013,128,135,60,4,-7,64,15.03671072,15.859030837,7.0484581498,0.46989721,-0.822320117,7.5183553598
51620,2014,120,129,-143,4,-9,-139,14.170996693,15.233821445,-16.88710439,0.4723665564,-1.062824752,-16.41473784
51620,2015,96,145,-20,4,-49,-16,11.480507056,17.340349199,-2.391772303,0.4783544607,-5.859842143,-1.913417843
51620,2016,63,84,-82,4,-21,-78,7.6100742888,10.146765718,-9.905176058,0.4831793199,-2.53669143,-9.421996739
51620,2017,62,88,-30,4,-26,-26,7.559131919,10.729090466,-3.657644477,0.4876859303,-3.169958547,-3.169958547
01059,2010,120,66,-16,2,54,-14,NA,NA,NA,NA,NA,NA
01059,2011,419,418,-36,58,1,22,13.193526041,13.162037912,-1.133572643,1.8263114806,0.031488129,0.6927388375
01059,2012,405,380,-193,59,25,-134,12.770989358,11.982656681,-6.085928262,1.8604651163,0.7883326764,-4.225463145
01059,2013,432,410,-270,91,22,-179,13.679110858,12.982489472,-8.549444286,2.8814793705,0.6966213863,-5.667964916
01059,2014,412,406,-46,34,6,-12,13.07978031,12.889298073,-1.460363821,1.079399346,0.1904822375,-0.380964475
01059,2015,404,376,-103,49,28,-54,12.833341275,11.94390178,-3.271866711,1.556519115,0.8894394943,-1.715347596
01059,2016,406,366,17,54,40,71,12.879893408,11.610938392,0.5393058816,1.713089271,1.2689550155,2.2523951526
01059,2017,421,365,-191,54,56,-137,13.349822425,11.574074074,-6.056570269,1.7123287671,1.7757483511,-4.344241502
05047,2010,45,35,-3,1,10,-2,NA,NA,NA,NA,NA,NA
05047,2011,201,233,-104,1,-32,-103,11.129259987,12.901082473,-5.758423078,0.0553694527,-1.771822486,-5.703053625
05047,2012,208,246,-14,1,-38,-13,11.575491124,13.69024431,-0.779119595,0.0556513996,-2.114753186,-0.723468195
05047,2013,181,216,-12,4,-35,-8,10.099037523,12.051890082,-0.669549449,0.2231831497,-1.95285256,-0.446366299
05047,2014,196,221,-67,7,-25,-60,10.975780484,12.375752485,-3.751924962,0.3919921602,-1.399972001,-3.359932801
05047,2015,215,250,-47,7,-35,-40,12.094279125,14.063115261,-2.643865669,0.3937672273,-1.968836137,-2.250098442
05047,2016,186,213,-48,7,-27,-41,10.505506919,12.030499859,-2.71109856,0.39536854,-1.52499294,-2.31573002
05047,2017,186,181,208,7,5,215,10.460898175,10.179691235,11.698208712,0.3936897163,0.2812069402,12.091898428
12037,2010,28,54,-7,5,-26,-2,NA,NA,NA,NA,NA,NA
12037,2011,105,127,-34,5,-22,-29,9.13400896,11.047801314,-2.957679092,0.4349528076,-1.913792354,-2.522726284
12037,2012,106,119,140,9,-13,149,9.1866360445,10.313298956,12.133292889,0.7799974,-1.126662911,12.913290289
12037,2013,105,132,-68,6,-27,-62,9.0802957582,11.415228953,-5.880572491,0.5188740433,-2.334933195,-5.361698448
12037,2014,104,129,142,4,-25,146,8.9798385356,11.138453568,12.260933385,0.3453784052,-2.158615033,12.60631179
12037,2015,110,134,60,4,-24,64,9.4307270233,11.488340192,5.1440329218,0.3429355281,-2.057613169,5.4869684499
12037,2016,92,134,149,7,-42,156,7.8354554358,11.412511178,12.690031086,0.5961759571,-3.577055742,13.286207043
12037,2017,96,112,-61,7,-16,-54,8.1611833716,9.5213806002,-5.185751934,0.5950862875,-1.360197229,-4.590665647
13119,2010,75,87,1,1,-12,2,NA,NA,NA,NA,NA,NA
13119,2011,272,252,-126,4,20,-122,12.351565516,11.443362169,-5.721681084,0.1816406693,0.9082033467,-5.540040415
13119,2012,274,251,-76,6,23,-70,12.485190923,11.437163948,-3.463045658,0.2733983414,1.0480269753,-3.189647316
13119,2013,261,291,132,23,-30,155,11.872270742,13.236899563,6.0043668122,1.0462154294,-1.364628821,7.0505822416
13119,2014,244,283,152,26,-39,178,11.032487057,12.795876382,6.8726968553,1.1755928831,-1.763389325,8.0482897384
13119,2015,277,307,95,31,-30,126,12.458957406,13.808302973,4.2729276301,1.394323753,-1.349345567,5.6672513831
13119,2016,267,275,4,30,-8,34,11.976853721,12.335710761,0.1794285202,1.3457139012,-0.35885704,1.5251424214
13119,2017,265,272,489,30,-7,519,11.74489208,12.055134512,21.672649914,1.3296104241,-0.310242432,23.002260338
16041,2010,59,35,-31,0,24,-31,NA,NA,NA,NA,NA,NA
16041,2011,222,87,-105,-5,135,-110,17.35052755,6.7995310668,-8.206330598,-0.390777648,10.550996483,-8.597108245
16041,2012,199,93,-117,-2,106,-119,15.542625063,7.2636388488,-9.138126294,-0.156207287,8.2789862147,-9.294333581
16041,2013,186,101,-77,-7,85,-84,14.532385343,7.8912415032,-6.016095007,-0.546917728,6.6411438394,-6.563012735
16041,2014,179,112,60,-7,67,53,13.920752809,8.710191702,4.6661741261,-0.544386981,5.2105611074,4.1217871447
16041,2015,206,96,-52,-6,110,-58,15.915324294,7.4168501564,-4.017460501,-0.463553135,8.4984741376,-4.481013636
16041,2016,197,78,263,-5,119,258,14.97131132,5.9277273245,19.987080594,-0.379982521,9.0435839951,19.607098073
16041,2017,214,86,97,-5,128,92,15.904277061,6.3914384452,7.2089480138,-0.371595258,9.5128386162,6.8373527554
17055,2010,117,109,35,0,8,35,NA,NA,NA,NA,NA,NA
17055,2011,446,537,77,11,-91,88,11.143731651,13.417452683,1.9239177962,0.2748453995,-2.273721032,2.1987631957
17055,2012,466,547,-94,10,-81,-84,11.669108165,13.697429541,-2.353854437,0.2504100465,-2.028321376,-2.10344439
17055,2013,472,576,-224,17,-104,-207,11.890816108,14.510826437,-5.64309917,0.4282709191,-2.620010329,-5.214828251
17055,2014,490,512,-86,19,-22,-67,12.408204609,12.965307673,-2.177766523,0.4811344644,-0.557103064,-1.696632059
17055,2015,513,575,3,20,-62,23,13.013863697,14.586689329,0.0761044661,0.5073631071,-1.572825632,0.5834675732
17055,2016,458,517,-267,21,-59,-246,11.670425155,13.173820535,-6.803501128,0.5351068303,-1.50339538,-6.268394297
17055,2017,465,508,-24,21,-43,-3,11.902781155,13.003468445,-0.614337092,0.5375449554,-1.10068729,-0.076792136
18047,2010,64,60,-47,3,4,-44,NA,NA,NA,NA,NA,NA
18047,2011,248,195,-89,8,53,-81,10.762253998,8.4622561677,-3.862260507,0.3471694838,2.2999978302,-3.515091023
18047,2012,237,216,-35,8,21,-27,10.292042124,9.380089024,-1.519921833,0.3474107046,0.9119530996,-1.172511128
18047,2013,257,222,-103,7,35,-96,11.177314835,9.6551124255,-4.479624233,0.3044404819,1.5222024094,-4.175183752
18047,2014,242,211,-40,3,31,-37,10.540528769,9.1902957446,-1.74223616,0.130667712,1.3502330241,-1.611568448
18047,2015,245,219,-73,5,26,-68,10.682596089,9.5489328305,-3.18297761,0.2180121651,1.1336632584,-2.964965445
18047,2016,220,198,-215,6,22,-209,9.6410885665,8.6769797099,-9.421972917,0.2629387791,0.9641088567,-9.159034138
18047,2017,216,202,-126,6,14,-120,9.5271700776,8.9096683133,-5.557515879,0.2646436133,0.6175017643,-5.292872265
19069,2010,41,16,-3,1,25,-2,NA,NA,NA,NA,NA,NA
19069,2011,123,121,-16,3,2,-13,11.499088487,11.312111438,-1.495816389,0.2804655729,0.1869770486,-1.215350816
19069,2012,107,119,-172,-1,-12,-173,10.094339623,11.226415094,-16.22641509,-0.094339623,-1.132075472,-16.32075472
19069,2013,112,137,20,2,-25,22,10.659053057,13.038305972,1.9034023317,0.1903402332,-2.379252915,2.0937425648
19069,2014,132,111,-108,11,21,-97,12.608654122,10.602731875,-10.31617155,1.0507211768,2.0059222466,-9.265450377
19069,2015,124,108,-136,14,16,-122,11.947201079,10.405626746,-13.10338183,1.3488775412,1.5415743328,-11.75450429
19069,2016,123,122,-143,14,1,-129,11.984799766,11.88736237,-13.9335477,1.3641235506,0.0974373965,-12.56942414
19069,2017,120,113,-56,14,7,-42,11.78550383,11.098016107,-5.499901787,1.3749754469,0.6874877234,-4.124926341
20059,2010,82,90,-1,0,-8,-1,NA,NA,NA,NA,NA,NA
20059,2011,336,233,-250,7,103,-243,12.965464017,8.9909318927,-9.646922632,0.27011383369999997,3.9745321243,-9.376808798
20059,2012,322,250,-103,4,72,-99,12.46540077,9.6781061882,-3.98737975,0.154849699,2.7872945822,-3.832530051
20059,2013,302,236,-164,6,66,-158,11.718598425,9.1575802258,-6.363742191,0.2328198363,2.5610181988,-6.130922355
20059,2014,315,273,-254,14,42,-240,12.291243952,10.652411425,-9.911034806,0.546277509,1.6388325269,-9.364757297
20059,2015,330,250,-163,15,80,-148,12.943206778,9.8054596799,-6.393159711,0.5883275808,3.1377470976,-5.804832131
20059,2016,319,257,9,15,62,24,12.507841907,10.07685069,0.3528858218,0.5881430364,2.4309912171,0.9410288582
20059,2017,314,246,105,15,68,120,12.24648986,9.5943837754,4.0951638066,0.5850234009,2.6521060842,4.6801872075
21073,2010,149,155,-20,13,-6,-7,NA,NA,NA,NA,NA,NA
21073,2011,568,491,-100,62,77,-38,11.526324868,9.9637773065,-2.029282547,1.2581551792,1.5625475613,-0.771127368
21073,2012,544,471,23,40,73,63,11.021739571,9.5427193711,0.4659926657,0.8104220273,1.4790201998,1.276414693
21073,2013,601,513,-116,34,88,-82,12.160576262,10.379992716,-2.347132856,0.6879527336,1.7805835458,-1.659180122
21073,2014,598,493,123,42,105,165,12.067156348,9.9483412705,2.4820405198,0.8475260312,2.1188150779,3.329566551
21073,2015,587,535,222,49,52,271,11.775798427,10.732627187,4.4535387578,0.9829882844,1.0431712406,5.4365270422
21073,2016,572,529,146,47,43,193,11.411585153,10.553721234,2.9127472593,0.9376652136,0.8578639188,3.8504124729
21073,2017,576,504,127,48,72,175,11.436967615,10.007346663,2.5216925124,0.9530806346,1.4296209519,3.474773147
23007,2010,75,80,-53,6,-5,-47,NA,NA,NA,NA,NA,NA
23007,2011,240,301,47,33,-61,80,7.8117371350000004,9.7972203235,1.5297985223,1.0741138561,-1.985483188,2.6039123783
23007,2012,293,313,-79,24,-20,-55,9.5467726695,10.198429507,-2.574044508,0.781988205,-0.651656838,-1.792056303
23007,2013,245,283,-117,21,-38,-96,8.0104626451,9.2529017492,-3.82540461,0.6866110839,-1.242439104,-3.138793526
23007,2014,265,317,-243,11,-52,-232,8.7235618468,10.435355115,-7.999341618,0.3621101144,-1.711793268,-7.637231504
23007,2015,259,333,-99,13,-74,-86,8.5892418916,11.043311004,-3.283146515,0.4311202494,-2.454069112,-2.852026265
23007,2016,247,334,73,15,-87,88,8.213757212,11.106861979,2.427547678,0.4988111667,-2.893104767,2.9263588448
23007,2017,250,322,-25,15,-72,-10,8.3251469388,10.722789257,-0.832514694,0.4995088163,-2.397642318,-0.333005878
25011,2010,153,144,-50,26,9,-24,NA,NA,NA,NA,NA,NA
25011,2011,633,670,251,95,-37,346,8.8524658942,9.3699086084,3.5102194936,1.328569131,-0.517442714,4.8387886247
25011,2012,674,644,-188,140,30,-48,9.4075609433,8.9888267767,-2.624067444,1.9540927775,0.4187341666,-0.669974667
25011,2013,621,690,-413,160,-69,-253,8.6888388297,9.6542653664,-5.778567531,2.2386702299,-0.965426537,-3.539897301
25011,2014,583,708,-155,178,-125,23,8.1821116304,9.9364237295,-2.175347003,2.4981404292,-1.754312099,0.3227934262
25011,2015,598,729,-451,190,-131,-261,8.4226538402,10.26775025,-6.352202144,2.6760940295,-1.84509641,-3.676108114
25011,2016,602,687,-293,194,-85,-99,8.513587091,9.7156716471,-4.143656176,2.743581222,-1.202084556,-1.400074954
25011,2017,588,681,-12,194,-93,182,8.3215397679,9.63770167,-0.169827342,2.7455420323,-1.316161902,2.5757146901
28037,2010,21,36,6,0,-15,6,NA,NA,NA,NA,NA,NA
28037,2011,97,93,-132,0,4,-132,12.053432743,11.55638397,-16.40260951,0,0.4970487729,-16.40260951
28037,2012,84,107,-60,0,-23,-60,10.574018127,13.469284995,-7.552870091,0,-2.895266868,-7.552870091
28037,2013,99,101,-21,-1,-2,-22,12.546733414,12.800202775,-2.6614283,-0.126734681,-0.253469362,-2.788162981
28037,2014,72,118,-57,-2,-46,-59,9.2006900518,15.078908696,-7.283879624,-0.255574724,-5.878218644,-7.539454348
28037,2015,85,122,-15,-2,-37,-17,10.972697347,15.749047957,-1.936358355,-0.258181114,-4.77635061,-2.194539469
28037,2016,83,69,-7,-2,14,-9,10.748510749,8.9355089355,-0.906500907,-0.259000259,1.813001813,-1.165501166
28037,2017,78,75,40,-2,3,38,10.071663761,9.6842920782,5.1649557751,-0.258247789,0.3873716831,4.9067079863
29071,2010,296,268,-64,3,28,-61,NA,NA,NA,NA,NA,NA
29071,2011,1251,1007,-64,6,244,-58,12.320328542,9.9173228153,-0.630296584,0.0590903048,2.4030057268,-0.571206279
29071,2012,1264,931,-622,7,333,-615,12.454674444,9.1734983446,-6.128803405,0.0689736718,3.2811760996,-6.059829734
29071,2013,1269,936,62,9,333,71,12.496984081,9.2176336483,0.6105697502,0.0886310928,3.2793504326,0.699200843
29071,2014,1211,969,-19,10,242,-9,11.89026785,9.5141779907,-0.18655251,0.0981855314,2.3760898594,-0.088366978
29071,2015,1228,982,81,16,246,97,12.025127424,9.6161849598,0.7931883724,0.1566791847,2.4089424645,0.9498675571
29071,2016,1234,1047,270,16,187,286,12.03679318,10.212741053,2.6336581512,0.1560686312,1.8240521269,2.7897267824
29071,2017,1234,1025,357,16,209,373,11.975699229,9.9474000893,3.4646066652,0.1552764892,2.0282991402,3.6198831544
31061,2010,7,4,16,0,3,16,NA,NA,NA,NA,NA,NA
31061,2011,26,44,-21,0,-18,-21,8.064516129,13.64764268,-6.513647643,0,-5.583126551,-6.513647643
31061,2012,29,48,-3,0,-19,-3,9.0823676793,15.032884435,-0.939555277,0,-5.950516755,-0.939555277
31061,2013,24,39,-103,0,-15,-103,7.6836881703,12.485993277,-32.9758284,0,-4.802305106,-32.9758284
31061,2014,30,38,-8,0,-8,-8,9.8135426889,12.430487406,-2.616944717,0,-2.616944717,-2.616944717
31061,2015,24,40,-54,0,-16,-54,7.9628400796,13.271400133,-17.91639018,0,-5.308560053,-17.91639018
31061,2016,29,25,28,0,4,28,9.6811884493,8.3458521115,9.3473543649,0,1.3353363378,9.3473543649
31061,2017,29,31,-20,0,-2,-20,9.6634455182,10.329890037,-6.664445185,0,-0.666444518,-6.664445185
36033,2010,128,82,-6,13,46,7,NA,NA,NA,NA,NA,NA
36033,2011,542,448,-257,63,94,-194,10.503163545,8.6815816757,-4.980282345,1.2208474231,1.8215818694,-3.759434922
36033,2012,493,472,189,49,21,238,9.5390122382,9.1326851449,3.6569438398,0.9480965511,0.4063270933,4.6050403908
36033,2013,541,431,-721,29,110,-692,10.499044218,8.3643032497,-13.99225671,0.5627953463,2.1347409686,-13.42946137
36033,2014,485,403,-201,32,82,-169,9.4722862388,7.8707862974,-3.925627905,0.6249755869,1.6014999414,-3.300652318
36033,2015,478,465,-603,34,13,-569,9.3940078807,9.1385223108,-11.8505999,0.6681930292,0.25548557,-11.18240687
36033,2016,467,493,520,34,-26,554,9.1795416126,9.6906081692,10.221331132,0.6683178048,-0.511066557,10.889648937
36033,2017,476,492,-42,36,-16,-6,9.3100581879,9.6230013202,-0.821475722,0.7041220478,-0.312943132,-0.117353675
37069,2010,174,102,178,10,72,188,NA,NA,NA,NA,NA,NA
37069,2011,683,459,-113,31,224,-82,11.216119682,7.5376265508,-1.85566841,0.5090771745,3.6784931316,-1.346591236
37069,2012,649,521,300,26,128,326,10.606221554,8.5143935742,4.9027218277,0.4249025584,2.0918279798,5.3276243861
37069,2013,663,560,540,42,103,582,10.73492981,9.0672106993,8.7433817458,0.6800408024,1.6677191108,9.4234225482
37069,2014,671,528,445,44,143,489,10.749501374,8.4586240318,7.1289539662,0.704885336,2.2908773419,7.8338393022
37069,2015,706,586,742,52,120,794,11.171151214,9.2723719709,11.740784987,0.8228043387,1.8987792432,12.563589326
37069,2016,700,551,796,54,149,850,10.910394489,8.5880390904,12.406677161,0.8416590034,2.3223553983,13.248336165
37069,2017,708,587,1328,57,121,1385,10.823453874,8.9736828025,20.301619696,0.8713797611,1.8497710717,21.172999457
39049,2010,4509,1968,-634,959,2541,325,NA,NA,NA,NA,NA,NA
39049,2011,17856,8585,830,4430,9271,5260,15.215936171,7.3156816771,0.7072819793,3.775011046,7.9002544937,4.4822930252
39049,2012,18128,8564,3534,4811,9564,8345,15.237794235,7.1986137373,2.9705629318,4.043966685,8.0391804978,7.0145296167
39049,2013,18613,8932,2958,5046,9681,8004,15.415086378,7.3973863176,2.4497837805,4.1790429197,8.0177000605,6.6288267002
39049,2014,18873,8881,3338,5964,9992,9302,15.394711244,7.2442341207,2.7228075098,4.8648364256,8.1504771235,7.5876439354
39049,2015,18872,9554,2338,6484,9318,8822,15.162763492,7.6761891907,1.8784729252,5.2095887285,7.4865743017,7.0880616538
39049,2016,19068,9432,45,6636,9636,6681,15.11131399,7.4748224016,0.0356623206,5.2590035472,7.6364915884,5.2946658678
39049,2017,19039,9542,5861,6584,9497,12445,14.862729164,7.4489291286,4.5753692751,5.1397767117,7.4138000351,9.7151459868
42055,2010,511,290,76,34,221,110,NA,NA,NA,NA,NA,NA
42055,2011,1893,1392,368,171,501,539,12.583005962,9.2527967775,2.4461416768,1.1366582248,3.330209185,3.5827999016
42055,2012,1874,1387,-129,188,487,59,12.392991413,9.1724007949,-0.853092792,1.2432670147,3.220590618,0.3901742227
42055,2013,1686,1432,3,147,254,150,11.11653238,9.4417997442,0.0197803067,0.9692350296,1.6747326362,0.9890153363
42055,2014,1793,1405,49,200,388,249,11.783881123,9.233883423,0.322035792,1.314431804,2.5499976997,1.636467596
42055,2015,1807,1572,17,218,235,235,11.835133383,10.295976579,0.1113432582,1.4278135459,1.5391568041,1.5391568041
42055,2016,1833,1561,159,234,272,393,11.962136217,10.187067449,1.0376321105,1.5270812192,1.7750687676,2.5647133297
42055,2017,1810,1587,222,234,223,456,11.76096011,10.311957842,1.4425044997,1.5204777159,1.4490022677,2.9629822156
47051,2010,79,126,-53,0,-47,-53,NA,NA,NA,NA,NA,NA
47051,2011,375,482,-23,-7,-107,-30,9.1710585847,11.787867301,-0.562491593,-0.171193094,-2.616808716,-0.733684687
47051,2012,407,470,-90,19,-63,-71,9.9882202807,11.534308432,-2.208697359,0.4662805536,-1.546088152,-1.742416806
47051,2013,410,504,539,42,-94,581,10.018203809,12.315060292,13.170272813,1.0262550244,-2.296856483,14.196527837
47051,2014,366,507,193,45,-141,238,8.8790771582,12.299705244,4.6821363157,1.0916898145,-3.420628086,5.7738261302
47051,2015,399,490,102,50,-91,152,9.6619527315,11.865555986,2.4699728787,1.210771019,-2.203603255,3.6807438977
47051,2016,405,481,265,55,-76,320,9.7718690811,11.605602538,6.3939390284,1.3270439493,-1.833733457,7.7209829776
47051,2017,390,464,105,55,-74,160,9.3728595633,11.151299583,2.5234621901,1.3218135282,-1.77844002,3.8452757183
48159,2010,25,24,2,3,1,5,NA,NA,NA,NA,NA,NA
48159,2011,114,107,-66,10,7,-56,10.76894011,10.107689401,-6.234649537,0.9446438693,0.6612507085,-5.290005668
48159,2012,104,112,86,-1,-8,85,9.8103952457,10.565041034,8.1124422224,-0.094330724,-0.754645788,8.0181114989
48159,2013,103,110,-18,-1,-7,-19,9.6941176471,10.352941176,-1.694117647,-0.094117647,-0.658823529,-1.788235294
48159,2014,102,105,-44,0,-3,-44,9.6344573534,9.9178237461,-4.156040427,0,-0.283366393,-4.156040427
48159,2015,111,127,46,0,-16,46,10.493477028,12.006050293,4.3486481376,0,-1.5125732649999999,4.3486481376
48159,2016,116,119,72,-1,-3,71,10.916619612,11.198945982,6.7758328628,-0.09410879,-0.282326369,6.681724073
48159,2017,110,123,121,0,-13,121,10.267898815,11.481377765,11.294688696,0,-1.213478951,11.294688696
50011,2010,147,66,-15,1,81,-14,NA,NA,NA,NA,NA,NA
50011,2011,560,390,200,4,170,204,11.66654514,8.1249153655,4.1666232643,0.0833324653,3.5416297747,4.2499557296
50011,2012,602,372,-140,13,230,-127,12.480434535,7.7121622042,-2.902426636,0.2695110448,4.7682723305,-2.632915591
50011,2013,574,405,-100,41,169,-59,11.875206885,8.3788480636,-2.068851374,0.8482290632,3.4963588216,-1.22062231
50011,2014,604,379,119,39,225,158,12.434507818,7.8024477864,2.4498450833,0.8028904055,4.6320600315,3.2527354888
50011,2015,600,453,-12,43,147,31,12.283251786,9.2738550986,-0.245665036,0.8802997113,3.0093966876,0.6346346756
50011,2016,573,405,-173,48,168,-125,11.704985343,8.2731571798,-3.533965906,0.9805223324,3.4318281635,-2.553443574
50011,2017,560,376,-180,48,184,-132,11.428688048,7.6735476893,-3.673506873,0.9796018327,3.7551403586,-2.69390504
51067,2010,132,153,69,3,-21,72,NA,NA,NA,NA,NA,NA
51067,2011,485,527,211,-8,-42,203,8.6197703764,9.3662247183,3.7500444318,-0.142181779,-0.746454342,3.6078626524
51067,2012,513,552,11,-5,-39,6,9.108503045,9.8009623409,0.1953090322,-0.088776833,-0.692459296,0.1065321994
51067,2013,531,555,18,-7,-24,11,9.4334594681,9.8598305175,0.3197782871,-0.124358223,-0.426371049,0.1954200643
51067,2014,503,597,109,-9,-94,100,8.9381702517,10.608524136,1.9368997166,-0.1599275,-1.670353884,1.776972217
51067,2015,500,621,96,-8,-121,88,8.8886518582,11.039705608,1.7066211568,-0.14221843,-2.15105375,1.564402727
51067,2016,527,583,-8,-6,-56,-14,9.3780585461,10.374588487,-0.14236142,-0.106771065,-0.99652994,-0.249132485
51067,2017,512,632,414,-6,-120,408,9.093815495,11.225178502,7.3532023729,-0.10656815,-2.131363007,7.2466342226
53021,2010,425,114,565,-2,311,563,NA,NA,NA,NA,NA,NA
53021,2011,1685,350,2496,109,1335,2605,20.776434468,4.3155798598,30.776249514,1.3439948706,16.460854608000002,32.120244385
53021,2012,1763,379,1170,155,1384,1325,20.869585804,4.4864282586,13.849923648,1.8348189448,16.383157546,15.684742593
53021,2013,1629,367,-634,123,1262,-511,18.893089931,4.2564542692,-7.353111735,1.4265500684,14.636635661,-5.926561666
53021,2014,1582,353,-196,142,1229,-54,18.14553129,4.0489080565,-2.248118921,1.6287392182,14.096623234,-0.619379703
53021,2015,1672,365,-456,200,1307,-256,18.937806522,4.1341503472,-5.164856324,2.2652878615,14.803656175,-2.899568463
53021,2016,1661,364,-3,213,1297,210,18.545708304,4.064200977,-0.033496162,2.3782274948,14.481507327,2.3447313329
53021,2017,1642,416,362,218,1226,580,18.0004385,4.5604034203,3.9684279763,2.3898267924,13.44003508,6.3582547687
22041,2010,79,44,10,0,35,10,NA,NA,NA,NA,NA,NA
22041,2011,295,264,-67,-5,31,-72,14.190196739,12.699023522,-3.222858242,-0.240511809,1.4911732166,-3.463370051
22041,2012,296,261,-233,-3,35,-236,14.320270924,12.626995646,-11.27237542,-0.145137881,1.6932752782,-11.4175133
22041,2013,264,283,-38,-4,-19,-42,12.853282699,13.77832956,-1.850093722,-0.194746708,-0.925046861,-2.044840429
22041,2014,285,292,-66,-3,-7,-69,13.924514474,14.266520093,-3.224624405,-0.146573837,-0.342005619,-3.371198241
22041,2015,278,270,-51,-3,8,-54,13.625113338,13.233023746,-2.499571152,-0.147033597,0.3920895925,-2.646604749
22041,2016,305,278,-39,-3,27,-42,14.971897013,13.646515966,-1.91443929,-0.147264561,1.3253810471,-2.061703851
22041,2017,302,270,-133,-3,32,-136,14.868058291,13.292634896,-6.547853486,-0.147695943,1.575423395,-6.695549429
24021,2010,711,371,287,166,340,453,NA,NA,NA,NA,NA,NA
24021,2011,2854,1509,1192,673,1345,1865,12.105017602,6.4003053824,5.0557746957,2.8544768206,5.7047122195,7.9102515163
24021,2012,2722,1574,525,766,1148,1291,11.40964916,6.5976442973,2.2006119797,3.2107976694,4.8120048623,5.4114096492
24021,2013,2701,1712,-117,739,989,622,11.2276647,7.1165353447,-0.486352007,3.0719156657,4.1111293551,2.5855636591
24021,2014,2786,1587,504,748,1199,1252,11.485368111,6.5424548428,2.0777550352,3.0836523141,4.9429132682,5.1614073492
24021,2015,2828,1813,-95,816,1015,721,11.560362835,7.4112227087,-0.388343165,3.3356633923,4.1491401265,2.9473202278
24021,2016,2847,1715,455,815,1132,1270,11.54119786,6.9522846261,1.8444836763,3.3038553763,4.5889132343,5.1483390526
24021,2017,2838,1720,2241,788,1118,3029,11.354202715,6.881334979,8.9657393534,3.1526116067,4.4728677363,12.11835096
51069,2010,223,104,158,5,119,163,NA,NA,NA,NA,NA,NA
51069,2011,955,558,543,17,397,560,12.080885004,7.0587788819,6.8690267614,0.2150524032,5.022106122,7.0840791646
51069,2012,903,561,363,35,342,398,11.302546515,7.0218478349,4.5435485991,0.4380831983,4.2806986801,4.9816317973
51069,2013,961,658,892,44,303,936,11.881800198,8.1355093966,11.028684471,0.5440158259,3.7462908012,11.572700297
51069,2014,965,645,830,81,320,911,11.751024409,7.8543116518,10.107098715,0.9863554167,3.8967127575,11.093454131
51069,2015,932,689,449,87,243,536,11.211895195,8.2886220918,5.4014387797,1.0466039506,2.9232731035,6.4480427303
51069,2016,1020,693,756,89,327,845,12.128706985000001,8.2403862161,8.9895122357,1.0582891389,3.8883207686,10.047801375
51069,2017,1001,677,1389,89,324,1478,11.696111423,7.9103570761,16.229669097,1.0399140026,3.7857543466,17.2695831
51630,2010,101,17,65,33,84,98,NA,NA,NA,NA,NA,NA
51630,2011,402,185,1030,119,217,1149,16.040220254,7.3816934004,41.09807677,4.7482244035,8.6585268534,45.846301173
51630,2012,420,159,1030,94,261,1124,15.864921525,6.006006006,38.90683136,3.5507205319,9.8589155193,42.457551892
51630,2013,409,195,354,67,214,421,14.867591196,7.0884603501,12.868281866,2.4355222741,7.7791308457,15.30380414
51630,2014,433,171,54,76,262,130,15.44773457,6.100606493,1.9265073136,2.7113806636,9.3471280771,4.6378879772
51630,2015,420,198,-556,84,222,-472,14.943428449,7.0447591262,-19.7822529,2.9886856899,7.8986693233,-16.79356721
51630,2016,398,209,8,88,189,96,14.149601820000001,7.4303185438,0.2844141069,3.1285551763,6.7192832765,3.4129692833
51630,2017,392,229,-158,86,163,-72,13.844007699,8.0874432731,-5.579982695,3.0372057707,5.7565644258,-2.542776924
27047,2010,95,107,-39,6,-12,-33,NA,NA,NA,NA,NA,NA
27047,2011,358,363,-149,18,-5,-131,11.496467566,11.657032755,-4.784842646,0.5780346821,-0.160565189,-4.206807964
27047,2012,328,359,-25,16,-31,-9,10.563436982,11.561810599,-0.805140014,0.5152896089,-0.998373617,-0.289850405
27047,2013,364,313,-167,13,51,-154,11.74989509,10.10361858,-5.390748572,0.4196391104,1.6462765099,-4.971109461
27047,2014,346,360,-186,14,-14,-172,11.221197036,11.67523391,-6.032204187,0.4540368743,-0.454036874,-5.578167313
27047,2015,325,424,-166,15,-99,-151,10.616058013,13.849872607,-5.422355785,0.4899719083,-3.233814595,-4.932383877
27047,2016,343,334,-111,18,9,-93,11.266032747,10.970422558,-3.645858994,0.5912203774,0.2956101887,-3.054638617
27047,2017,320,351,146,19,-31,165,10.502477928,11.519905478,4.7917555548,0.623584627,-1.017427549,5.4153401818
48161,2010,53,62,-5,-1,-9,-6,NA,NA,NA,NA,NA,NA
48161,2011,231,204,-231,-4,27,-235,11.726781227,10.356118486,-11.72678123,-0.203061147,1.3706627408,-11.92984237
48161,2012,215,232,-103,0,-17,-103,11.00560518,11.875815822,-5.272452714,0,-0.870210642,-5.272452714
48161,2013,245,217,85,6,28,91,12.542876158,11.109404597,4.3516100957,0.3071724773,1.4334715609,4.6587825731
48161,2014,195,237,104,8,-42,112,9.9370652534,12.077356231,5.2997681351,0.4076744719,-2.140290978,5.7074426071
48161,2015,219,220,48,12,-1,60,11.125787442,11.176590124,2.4385287543,0.6096321886,-0.050802682,3.0481609429
48161,2016,212,177,-112,13,35,-99,10.772631418,8.9941309484,-5.691201504,0.6605858889,1.77850047,-5.030615615
48161,2017,206,195,-46,13,11,-33,10.490935017,9.9307394581,-2.342635975,0.6620492972,0.5601955592,-1.680586678
08043,2010,79,154,73,8,-75,81,NA,NA,NA,NA,NA,NA
08043,2011,379,529,582,38,-150,620,8.051410059,11.237983961,12.36390674,0.8072653885,-3.186573902,13.171172128
08043,2012,389,498,-288,49,-109,-239,8.2511400997,10.56315622,-6.108813236,1.0393466964,-2.31201612,-5.069466539
08043,2013,334,528,-511,-15,-194,-526,7.1646913713,11.326218695,-10.96154877,-0.321767577,-4.161527323,-11.28331635
08043,2014,381,542,-8,-9,-161,-17,8.2525586181,11.739860291,-0.173282071,-0.19494233,-3.487301673,-0.3682244
08043,2015,379,549,303,-4,-170,299,8.21421992,11.898698512,6.5670412553,-0.086693614,-3.684478592,6.4803476414
08043,2016,388,543,862,-5,-155,857,8.3342283321,11.663623671,18.515734078,-0.10739985,-3.329395339,18.408334228
08043,2017,392,548,811,-5,-156,806,8.2993701371,11.602180702,17.170380564,-0.105859313,-3.302810565,17.064521251
16043,2010,58,41,-32,2,17,-30,NA,NA,NA,NA,NA,NA
16043,2011,203,107,-217,0,96,-217,15.417331207,8.1263765474,-16.48059543,0,7.2909546594,-16.48059543
16043,2012,210,110,-257,-2,100,-259,16.114798757,8.4410850631,-19.72144419,-0.153474274,7.6737136937,-19.87491847
16043,2013,179,91,-176,1,88,-175,13.86307311,7.0477075589,-13.6307311,0.0774473358,6.8153655514,-13.55328377
16043,2014,177,95,-158,4,82,-154,13.789342474,7.4010595201,-12.30913057,0.3116235587,6.3882829542,-11.99750701
16043,2015,203,109,-107,4,94,-103,15.863092912,8.5176213175,-8.361334688,0.3125732594,7.3454715949,-8.048761428
16043,2016,173,115,33,4,58,37,13.473520249,8.9563862928,2.5700934579,0.3115264798,4.5171339564,2.8816199377
16043,2017,177,98,124,4,79,128,13.624817181,7.543684089,9.5450696636,0.307905473,6.0811330921,9.8529751366
19071,2010,22,13,-12,0,9,-12,NA,NA,NA,NA,NA,NA
19071,2011,82,89,-61,4,-7,-57,11.072851259,12.018094659,-8.237121059,0.5401390858,-0.9452434,-7.696981973
19071,2012,67,95,-208,1,-28,-207,9.2299214768,13.087202094,-28.65408458,0.137760022,-3.857280617,-28.51632456
19071,2013,70,101,-43,1,-31,-42,9.8480585256,14.209341587,-6.049521666,0.1406865504,-4.361283061,-5.908835115
19071,2014,79,92,-28,1,-13,-27,11.202495746,13.045944413,-3.970504821,0.1418037436,-1.843448667,-3.828701078
19071,2015,81,102,-100,1,-21,-99,11.617067049,14.628899247,-14.34205809,0.1434205809,-3.011832198,-14.1986375
19071,2016,76,76,45,1,0,46,10.956534275,10.956534275,6.4874216103,0.1441649247,0,6.631586535
19071,2017,84,78,-17,1,6,-16,12.079378775,11.216566005,-2.444636181,0.1438021283,0.8628127696,-2.300834052
56013,2010,163,147,57,0,16,57,NA,NA,NA,NA,NA,NA
56013,2011,614,381,94,3,233,97,15.214024655,9.4406244193,2.3291829276,0.0743356253,5.7734002354,2.4035185529
56013,2012,614,410,294,-4,204,290,15.059723823,10.056167374,7.2110078242,-0.09810895,5.0035564494,7.1128988742
56013,2013,572,465,-221,5,107,-216,13.962628001,11.350737798,-5.394651728,0.1220509441,2.611890203,-5.272600784
56013,2014,615,396,-571,2,219,-569,15.094987973,9.7196995729,-14.01502135,0.0490893918,5.3752884002,-13.96593196
56013,2015,576,438,-482,4,138,-478,14.255661428,10.840242544,-11.92921668,0.0989976488,3.4154188838,-11.83021903
56013,2016,563,437,-116,2,126,-114,13.990705996,10.859571084,-2.882632141,0.0497005542,3.1311349122,-2.832931587
56013,2017,545,475,-515,2,70,-513,13.616829902,11.867879272,-12.86727963,0.049970018,1.7489506296,-12.81730961
06019,2010,3896,1589,-868,294,2307,-574,NA,NA,NA,NA,NA,NA
06019,2011,16319,5997,-3632,1473,10322,-2159,17.429447532,6.4050736471,-3.879144153,1.5732321965,11.024373885,-2.305911957
06019,2012,15946,6264,-4614,1434,9682,-3180,16.899011292,6.638367411,-4.889755306,1.5197028843,10.260643881,-3.370052421
06019,2013,15728,6521,-3690,1458,9207,-2232,16.55023208,6.8619063704,-3.882906687,1.5342216666,9.6883257096,-2.348685021
06019,2014,15854,6287,-1716,1661,9567,-55,16.540798776,6.5593542265,-1.790337498,1.7329548863,9.9814445499,-0.057382612
06019,2015,15665,6489,-1945,2037,9176,92,16.187006685,6.7052337299,-2.00981347,2.1048791968,9.4817729551,0.0950657271
06019,2016,15290,6985,-3198,2093,8305,-1105,15.667051085,7.1572499561,-3.276862614,2.1446133369,8.5098011289,-1.132249277
06019,2017,15228,7120,-441,2083,8108,1642,15.469407844,7.2328725933,-0.447991126,2.1160215747,8.2365352509,1.6680304492
48163,2010,52,11,-5,7,41,2,NA,NA,NA,NA,NA,NA
48163,2011,258,106,48,35,152,83,14.847639053,6.1001927891,2.7623514517,2.0142146002,8.7474462636,4.7765660519
48163,2012,234,140,242,72,94,314,13.21921871,7.9089342711,13.671157811,4.0674519109,5.3102844392,17.738609722
48163,2013,253,129,195,153,124,348,13.942850845,7.1092006283,10.746466066,8.4318426056,6.8336502163,19.178308672
48163,2014,261,132,224,184,129,408,13.992012223,7.0764199748,12.00847026,9.8641005709,6.9155922481,21.872570831
48163,2015,283,147,1,201,136,202,14.822962497,7.6995600251,0.0523779594,10.52796983,7.1234024722,10.58034779
48163,2016,236,131,-188,208,105,20,12.213740458,6.7796610169,-9.729589856,10.764652607,5.4340794411,1.0350627507
48163,2017,244,134,-103,208,110,105,12.517634988,6.8744388868,-5.284083622,10.670770809,5.6431961011,5.3866871874
31063,2010,6,0,-1,0,6,-1,NA,NA,NA,NA,NA,NA
31063,2011,26,13,-63,2,13,-61,9.4994519547,4.7497259773,-23.01790281,0.7307270734,4.7497259773,-22.28717574
31063,2012,23,27,9,1,-4,10,8.4667771029,9.9392600773,3.3130866924,0.3681207436,-1.472482974,3.6812074360000002
31063,2013,22,18,-8,1,4,-7,8.095676173,6.6237350506,-2.943882245,0.3679852806,1.4719411224,-2.575896964
31063,2014,30,24,-1,2,6,1,11.033468187,8.8267745495,-0.367782273,0.7355645458,2.2066936374,0.3677822729
31063,2015,22,18,-98,2,4,-96,8.2196898935,6.725200822,-36.61498225,0.7472445358,1.4944890715,-35.86773772
31063,2016,26,16,5,2,10,7,9.8466199583,6.0594584359,1.8935807612,0.7574323045,3.7871615224,2.6510130657
31063,2017,27,15,-32,2,12,-30,10.225336111,5.6807422837,-12.11891687,0.7574323045,4.5445938269,-11.36148457
05049,2010,31,70,17,1,-39,18,NA,NA,NA,NA,NA,NA
05049,2011,94,167,98,-2,-73,96,7.6882182145,13.658855764,8.0153764364,-0.163579111,-5.97063755,7.8517973255
05049,2012,120,151,-32,-5,-31,-37,9.8328416912,12.372992461,-2.622091118,-0.409701737,-2.54015077,-3.031792855
05049,2013,117,152,43,-5,-35,38,9.6134094737,12.489215727,3.5331333963,-0.410829465,-2.875806253,3.1223039316
05049,2014,108,182,-18,-3,-74,-21,8.9090534131,15.013404826,-1.484842236,-0.247473706,-6.104351413,-1.732315941
05049,2015,114,154,89,-3,-40,86,9.4234345939,12.729902872,7.3568919198,-0.247985121,-3.306468279,7.1089067989
05049,2016,128,218,12,-3,-90,9,10.59602649,18.046357616,0.9933774834,-0.248344371,-7.450331126,0.7450331126
05049,2017,122,199,96,-3,-77,93,10.127002573,16.518635345,7.9687889101,-0.249024653,-6.391632772,7.7197642567
13121,2010,3157,1351,2531,824,1806,3355,NA,NA,NA,NA,NA,NA
13121,2011,13030,5605,11647,3650,7425,15297,13.901587854,5.9799232479,12.4260778,3.8941516244,7.9216646058,16.320229424
13121,2012,12687,5493,14821,3645,7194,18466,13.190021245,5.7107895247,15.408631266,3.789518991,7.4792317205,19.198150257000002
13121,2013,12443,5933,-2187,3689,6510,1502,12.710894819,6.0607360735,-2.234085588,3.7684232892,6.6501587457,1.5343377014
13121,2014,12490,6030,1421,3986,6460,5407,12.63154914,6.0983379754,1.4371041895,4.0311733283,6.5332111643,5.4682775179
13121,2015,12794,6371,3407,4397,6423,7804,12.771655988,6.3598734015,3.4010498633,4.3893208831,6.4117825864,7.7903707464
13121,2016,12537,6549,4936,4456,5988,9392,12.332957387,6.44241349,4.8556654431,4.3834775556,5.8905438965,9.2391429987
13121,2017,13053,7127,6760,4427,5926,11187,12.638024158,6.9004212191,6.5450887387,4.2862585571,5.7376029387,10.831347296
17057,2010,77,72,4,1,5,5,NA,NA,NA,NA,NA,NA
17057,2011,375,462,-75,-1,-87,-76,10.137875101,12.489862125,-2.02757502,-0.027034334,-2.351987024,-2.054609354
17057,2012,354,463,-210,-2,-109,-212,9.6337016274,12.600010886,-5.714907745,-0.054427693,-2.966309258,-5.769335438
17057,2013,347,416,-193,4,-69,-189,9.5184540056,11.411172525,-5.294125715,0.1097228127,-1.89271852,-5.184402902
17057,2014,333,473,-199,7,-140,-192,9.2094528258,13.081294855,-5.503546884,0.1935921014,-3.871842029,-5.309954782
17057,2015,339,452,-168,11,-113,-157,9.4543527673,12.60580369,-4.685342964,0.3067784084,-3.151450922,-4.378564556
17057,2016,328,451,-94,13,-123,-81,9.2085684607,12.661781633,-2.639040961,0.36497375,-3.453213173,-2.274067211
17057,2017,314,452,-281,13,-138,-268,8.8917835955,12.799637532,-7.957296785,0.368131168,-3.907853937,-7.589165617
18049,2010,53,82,-14,4,-29,-10,NA,NA,NA,NA,NA,NA
18049,2011,258,271,-72,6,-13,-66,12.421762157,13.047664901,-3.466538276,0.2888781897,-0.625902744,-3.177660087
18049,2012,240,230,-99,-5,10,-104,11.604013055,11.120512511,-4.786655385,-0.241750272,0.4835005439,-5.028405657
18049,2013,255,235,-208,-4,20,-212,12.414800389,11.441090555,-10.12658228,-0.194741967,0.9737098345,-10.32132425
18049,2014,268,225,33,-4,43,29,13.086896013,10.987132847,1.6114461508,-0.195326806,2.0997631662,1.4161193447
18049,2015,263,240,-205,-3,23,-208,12.879214515,11.752895375,-10.03893147,-0.146911192,1.1263191401,-10.18584266
18049,2016,256,224,-221,-3,32,-224,12.652597242,11.071022587,-10.92274996,-0.148272624,1.5815746553,-11.07102259
18049,2017,250,202,-124,-3,48,-127,12.439048662,10.050751319,-6.169768136,-0.149268584,2.388297343,-6.31903672
21075,2010,18,36,10,0,-18,10,NA,NA,NA,NA,NA,NA
21075,2011,96,104,-54,-1,-8,-55,14.168696037,15.349420707,-7.969891521,-0.147590584,-1.18072467,-8.117482105
21075,2012,76,102,-160,0,-26,-160,11.421701232,15.329125338,-24.0456868,0,-3.907424106,-24.0456868
21075,2013,75,130,-123,0,-55,-123,11.583011583,20.077220077,-18.996139,0,-8.494208494,-18.996139
21075,2014,80,97,-107,2,-17,-105,12.644223171,15.331120594,-16.91164849,0.3161055793,-2.686897424,-16.59554291
21075,2015,78,84,5,2,-6,7,12.444160817,13.401403957,0.7977026165,0.3190810466,-0.95724314,1.1167836631
21075,2016,77,91,-77,2,-14,-75,12.370471524,14.619648165,-12.37047152,0.3213109487,-2.249176641,-12.04916058
21075,2017,78,98,30,2,-20,32,12.609117362,15.842224378,4.8496605238,0.32331070159999997,-3.233107016,5.1729712253
36035,2010,137,167,-25,4,-30,-21,NA,NA,NA,NA,NA,NA
36035,2011,558,601,-331,23,-43,-308,10.091419581,10.869073778,-5.986128819,0.4159545705,-0.777654197,-5.570174249
36035,2012,556,623,-204,23,-67,-181,10.109918084,11.32819958,-3.709394405,0.4182160359,-1.218281496,-3.291178369
36035,2013,537,657,-399,26,-120,-373,9.8311135521,12.028010435,-7.304682136,0.4759943247,-2.196896883,-6.828687812
36035,2014,524,574,-387,30,-50,-357,9.67226883,10.595195245,-7.143450453,0.553755849,-0.92292641500000006,-6.589694604
36035,2015,547,581,-113,31,-34,-82,10.145787736,10.776421709,-2.095930556,0.5749897986,-0.630633973,-1.520940758
36035,2016,508,588,-106,30,-80,-76,9.4468567816,10.934550763,-1.971194525,0.557885243,-1.487693981,-1.413309282
36035,2017,512,574,218,31,-62,249,9.5191172506,10.671822855,4.0530616419,0.5763528023,-1.152705605,4.6294144441
39051,2010,112,113,-76,3,-1,-73,NA,NA,NA,NA,NA,NA
39051,2011,496,403,-382,7,93,-375,11.673747014,9.4849194488,-8.990668063,0.1647504619,2.1888275651,-8.825917601
39051,2012,453,374,-110,6,79,-104,10.699734278,8.8337762031,-2.598169472,0.1417183348,1.865958075,-2.456451137
39051,2013,499,428,-229,14,71,-215,11.809672572,10.129338398,-5.419669377,0.331333499,1.6803341735,-5.088335878
39051,2014,532,389,58,17,143,75,12.57965737,9.1982833024,1.371466405,0.4019815325,3.3813740675,1.7734479375
39051,2015,491,417,-207,18,74,-189,11.596462016,9.8487263967,-4.888936125,0.4251248804,1.7477356196,-4.463811245
39051,2016,487,390,-75,21,97,-54,11.511913767,9.2189863843,-1.772881997,0.4964069592,2.2929273828,-1.276475038
39051,2017,483,412,-127,21,71,-106,11.416550453,9.7383411729,-3.001867303,0.4963717588,1.6782092798,-2.505495544
42057,2010,47,18,4,0,29,4,NA,NA,NA,NA,NA,NA
42057,2011,155,150,-107,3,5,-104,10.454606772,10.117361392,-7.217051126,0.2023472278,0.3372453797,-7.014703899
42057,2012,141,123,-45,3,18,-42,9.5505808243,8.3313577404,-3.04805771,0.2032038473,1.219223084,-2.844853863
42057,2013,152,158,-56,4,-6,-52,10.325385504,10.73296651,-3.804089396,0.2717206712,-0.407581007,-3.532368725
42057,2014,157,142,-76,6,15,-70,10.706127041,9.6832486617,-5.182583791,0.4091513519,1.0228783798,-4.773432439
42057,2015,125,167,23,6,-42,29,8.5446715428,11.415681181,1.5722195639,0.4101442341,-2.871009638,1.9823637979
42057,2016,131,173,35,6,-42,41,8.9609412409,11.833914768,2.3941446063,0.4104247897,-2.872973528,2.804569396
42057,2017,123,139,-18,6,-16,-12,8.4226384086,9.5182661691,-1.232581231,0.4108604102,-1.09562776,-0.82172082
31065,2010,11,27,3,0,-16,3,NA,NA,NA,NA,NA,NA
31065,2011,41,76,6,1,-35,7,8.3147434597,15.412695194,1.2167917258,0.202798621,-7.097951734,1.4195903468
31065,2012,42,57,-16,0,-15,-16,8.5705540251,11.631466177,-3.264972962,0,-3.060912152,-3.264972962
31065,2013,46,71,-27,0,-25,-27,9.4689172499,14.615067929,-5.557842734,0,-5.146150679,-5.557842734
31065,2014,54,79,48,0,-25,48,11.148962527,16.310519253,9.910188913,0,-5.161556726,9.910188913
31065,2015,57,73,-7,0,-16,-7,11.768349334,15.071745638,-1.445235883,0,-3.303396304,-1.445235883
31065,2016,55,55,-62,0,0,-62,11.454753723,11.454753723,-12.912631470000001,0,0,-12.912631470000001
31065,2017,52,51,9,0,1,9,10.888912156,10.679509999,1.8846194116,0,0.2094021568,1.8846194116
12039,2010,157,69,-52,18,88,-34,NA,NA,NA,NA,NA,NA
12039,2011,593,446,-659,64,147,-595,12.46452969,9.3746715712,-13.85181293,1.345244351,3.0898581188,-12.50656858
12039,2012,580,446,-989,43,134,-946,12.350542466,9.4971412753,-21.05980431,0.9156436656,2.8534011903,-20.14416064
12039,2013,532,496,-603,62,36,-541,11.485443496,10.708233034,-13.01827524,1.3385291292,0.7772104621,-11.67974611
12039,2014,539,449,-80,69,90,-11,11.689691817,9.7377952244,-1.735019194,1.4964540545,1.9518965929,-0.238565139
12039,2015,559,468,-192,77,91,-115,12.117139575,10.14458197,-4.161879782,1.6690872044,1.9725576052,-2.492792578
12039,2016,560,483,-125,84,77,-41,12.137763617,10.46882112,-2.709322236,1.8206645426,1.6689424973,-0.888657693
12039,2017,546,482,-230,85,64,-145,11.840478824,10.45258387,-4.98774749,1.8432979854,1.3878949537,-3.144449504
31067,2010,62,94,-8,0,-32,-8,NA,NA,NA,NA,NA,NA
31067,2011,230,286,-308,-5,-56,-313,10.413129598,12.948500283,-13.94453877,-0.226372383,-2.535370685,-14.17091115
31067,2012,232,269,-217,-1,-37,-218,10.65221883,12.351064074,-9.963497785,-0.045914736,-1.698845244,-10.00941252
31067,2013,262,287,103,-1,-25,102,12.079577676,13.232209133,4.7488416054,-0.046105258,-1.152631458,4.7027363471
31067,2014,253,267,-177,-2,-14,-179,11.69698791,12.344252063,-8.183268222,-0.092466308,-0.647264153,-8.275734529
31067,2015,227,275,208,-2,-48,206,10.503667029,12.724706753,9.6245054716,-0.092543322,-2.221039724,9.5319621498
31067,2016,224,272,-29,-2,-48,-31,10.346659276,12.56380055,-1.339522853,-0.092380886,-2.217141273,-1.431903739
31067,2017,230,272,38,-2,-42,36,10.645683869,12.589678315,1.7588521176,-0.092571164,-1.943994446,1.6662809535
48165,2010,88,42,5,7,46,12,NA,NA,NA,NA,NA,NA
48165,2011,339,99,67,14,240,81,19.10612636,5.5796652201,3.7761370681,0.7890435665,13.52646114,4.5651806346
48165,2012,371,113,110,15,258,125,20.505167744,6.245509313,6.0796993312,0.8290499088,14.259658431,6.90874924
48165,2013,369,113,160,94,256,254,19.90452302,6.0954230385,8.6306874882,5.0705288993,13.809099981,13.701216388
48165,2014,393,124,143,113,269,256,20.623425693,6.5071368598,7.5041981528,5.929890848,14.116288833,13.434089001
48165,2015,438,119,439,132,319,571,22.159263382,6.0204391379,22.209855307,6.6781341698,16.138824244,28.887989477
48165,2016,459,110,-224,143,349,-81,22.558608149,5.4062023886,-11.00899395,7.0280631051,17.15240576,-3.98093085
48165,2017,456,123,-318,142,333,-176,22.179527712,5.9826357645,-15.46730222,6.9067827525,16.196891948,-8.560519468
51640,2010,25,35,12,-3,-10,9,NA,NA,NA,NA,NA,NA
51640,2011,107,105,-150,1,2,-149,15.468015902,15.178894109,-21.68413444,0.1445608963,0.2891217926,-21.53957355
51640,2012,106,115,22,0,-9,22,15.47219384,16.785870676,3.2112100423,0,-1.313676835,3.2112100423
51640,2013,95,95,70,9,0,79,13.775103313,13.775103313,10.150076126,1.3050097876,0,11.455085913
51640,2014,98,98,-32,6,0,-26,14.157757873,14.157757873,-4.622941346,0.8668015025,0,-3.756139844
51640,2015,86,174,-19,6,-88,-13,12.541927957,25.375528657,-2.77089106,0.8750182295,-12.8336007,-1.895872831
51640,2016,51,115,-86,7,-64,-79,7.5723830735,17.07498144,-12.76911656,1.0393466964,-9.502598367,-11.72976986
51640,2017,47,86,-6,6,-39,0,7.0735194522,12.943035593,-0.903002483,0.9030024833,-5.869516141,0
17059,2010,20,33,-2,0,-13,-2,NA,NA,NA,NA,NA,NA
17059,2011,58,88,-54,0,-30,-54,10.484454085,15.907447578,-9.761388286,0,-5.422993492,-9.761388286
17059,2012,49,70,-79,0,-21,-79,9.0065251356,12.866464479,-14.5207242,0,-3.859939344,-14.5207242
17059,2013,59,83,20,0,-24,20,10.948227872,15.401744294,3.7112636853,0,-4.453516422,3.7112636853
17059,2014,54,84,-80,0,-30,-80,10.125632852,15.750984437,-15.00093756,0,-5.625351584,-15.00093756
17059,2015,64,84,-37,0,-20,-37,12.19047619,16,-7.047619048,0,-3.80952381,-7.047619048
17059,2016,65,69,-55,0,-4,-55,12.519260401,13.289676425,-10.59322034,0,-0.770416025,-10.59322034
17059,2017,60,80,-62,0,-20,-62,11.715317778,15.620423704,-12.10582837,0,-3.905105926,-12.10582837
21077,2010,28,9,2,4,19,6,NA,NA,NA,NA,NA,NA
21077,2011,118,96,-35,8,22,-27,13.703402625,11.148530949,-4.064568575,0.9290442457,2.5548716758,-3.135524329
21077,2012,104,104,-74,1,0,-73,12.132524498,12.132524498,-8.632757816,0.1166588894,0,-8.516098927
21077,2013,122,97,-12,6,25,-6,14.278190649,11.352331909,-1.404412195,0.7022060975,2.9258587395,-0.702206097
21077,2014,103,105,49,9,-2,58,12.001165162,12.234197495,5.7092921643,1.0486454996,-0.233032333,6.7579376639
21077,2015,104,100,-36,11,4,-25,12.090914375,11.625879207,-4.185316515,1.2788467128,0.4650351683,-2.906469802
21077,2016,114,64,76,11,50,87,13.164732375,7.3907269473,8.7764882499,1.2702811941,5.7740054276,10.046769444
21077,2017,116,63,-16,11,53,-5,13.254113346,7.1983546618,-1.828153565,1.2568555759,6.0557586837,-0.571297989
30031,2010,290,148,-67,20,142,-47,NA,NA,NA,NA,NA,NA
30031,2011,1041,517,1081,64,524,1145,11.509248306,5.7159283132,11.951486473,0.7075810678,5.7933199925,12.659067541
30031,2012,1103,495,547,49,608,596,12.002110979,5.38626014,5.9520894881,0.5331853472,6.6158508387,6.4852748353
30031,2013,1119,537,1256,51,582,1307,11.97258823,5.7455584266,13.438401087,0.5456675601,6.2270298031,13.984068647
30031,2014,1205,494,1766,75,711,1841,12.588143118,5.1606163489,18.448681118,0.783494385,7.4275267694,19.232175503
30031,2015,1120,533,2586,79,587,2665,11.34964507,5.40121502,26.205519778,0.8005553219,5.9484300502,27.0060751
30031,2016,1284,555,2921,80,729,3001,12.563231999,5.4303689716,28.580374353,0.7827558878,7.1328630275,29.363130241
30031,2017,1269,589,2956,76,680,3032,11.978365317,5.5596983227,27.902322991,0.7173804287,6.4186669939,28.61970342
39053,2010,114,109,113,3,5,116,NA,NA,NA,NA,NA,NA
39053,2011,361,351,-76,17,10,-59,11.626034588,11.303983769,-2.447586229,0.5474863934,0.3220508196,-1.900099836
39053,2012,390,340,-231,20,50,-211,12.602190842,10.98652535,-7.464374576,0.646266197,1.6156654926,-6.818108379
39053,2013,369,377,-260,13,-8,-247,12.003122764,12.263353067,-8.457484874,0.4228742437,-0.260230304,-8.03461063
39053,2014,407,357,-329,8,50,-321,13.352580296,11.712214166,-10.79360913,0.2624585808,1.6403661297,-10.53115055
39053,2015,352,379,-245,9,-27,-236,11.649842793,12.543438689,-8.108555353,0.2978652987,-0.893595896,-7.810690055
39053,2016,373,368,-100,9,5,-91,12.416984304,12.250536793,-3.328950216,0.2996055194,0.1664475108,-3.029344696
39053,2017,363,357,-37,9,6,-28,12.106254898,11.906151512,-1.233970885,0.3001550801,0.2001033867,-0.933815805
48167,2010,960,599,645,133,361,778,NA,NA,NA,NA,NA,NA
48167,2011,3880,2207,941,551,1673,1492,13.195506046,7.5057942895,3.2002503065,1.8738978947,5.6897117564,5.0741482012
48167,2012,3936,2239,3209,489,1697,3698,13.193266607,7.505011162,10.756400544,1.6391024825,5.6882554452,12.395503027
48167,2013,3863,2380,3526,554,1483,4080,12.713070636,7.8325415775,11.604009077,1.8232050563,4.8805290586,13.427214133
48167,2014,4055,2435,4616,637,1620,5253,13.074930151,7.8514068851,14.883816912,2.0539409387,5.2235232664,16.937757851
48167,2015,4121,2705,5523,698,1416,6221,12.981285654,8.5208390428,17.397631805,2.1987229767,4.4604466117,19.596354782
48167,2016,4320,2761,5729,709,1559,6438,13.279824657,8.4874064533,17.611137838,2.1794897412,4.7924182038,19.790627579
48167,2017,4269,2857,3617,698,1412,4315,12.851814276,8.6009916579,10.888969838,2.1013273284,4.2508226185,12.990297166
31069,2010,5,3,15,0,2,15,NA,NA,NA,NA,NA,NA
31069,2011,23,37,2,-1,-14,1,11.11916848,17.887357989,0.9668842156,-0.483442108,-6.768189509,0.4834421078
31069,2012,15,30,-66,0,-15,-66,7.4165636588,14.833127318,-32.6328801,0,-7.416563659,-32.6328801
31069,2013,20,38,-43,0,-18,-43,10.240655402,19.457245264,-22.01740911,0,-9.216589862,-22.01740911
31069,2014,16,30,0,0,-14,0,8.3507306889,15.657620042,0,0,-7.306889353,0
31069,2015,26,30,12,0,-4,12,13.594771242,15.68627451,6.2745098039,0,-2.091503268,6.2745098039
31069,2016,15,19,-3,0,-4,-3,7.8390384113,9.9294486543,-1.567807682,0,-2.090410243,-1.567807682
31069,2017,20,21,-4,0,-1,-4,10.479434111,11.003405816,-2.095886822,0,-0.523971706,-2.095886822
08045,2010,230,81,-498,21,149,-477,NA,NA,NA,NA,NA,NA
08045,2011,862,294,-747,30,568,-717,15.384340811,5.2470953579,-13.33190555,0.5354178937,10.137245453,-12.79648766
08045,2012,790,256,170,33,534,203,14.024747466000001,4.5447282927,3.0179836319,0.5858438815,9.4800191731,3.6038275134
08045,2013,822,286,-340,-2,536,-342,14.474124421,5.0360092268,-5.986864116,-0.035216848,9.4381151943,-6.022080964
08045,2014,774,292,-259,14,482,-245,13.577994527,5.1224475475,-4.543540804,0.2455968002,8.4555469792,-4.297944004
08045,2015,764,344,121,36,420,157,13.308829293,5.9924571687,2.1078119692,0.6271176107,7.3163721246,2.7349295799
08045,2016,857,315,631,41,542,672,14.700206695,5.4032264981,10.823606096,0.7032770998,9.2969801967,11.526883196
08045,2017,827,344,-312,42,483,-270,14.014098827,5.8293228496,-5.287060259,0.7117196502,8.1847759778,-4.575340609
30033,2010,3,5,-15,0,-2,-15,NA,NA,NA,NA,NA,NA
30033,2011,15,10,56,0,5,56,12.264922322,8.1766148814,45.789043336,0,4.0883074407,45.789043336
30033,2012,14,8,-15,0,6,-15,11.208967174,6.4051240993,-12.00960769,0,4.8038430745,-12.00960769
30033,2013,11,16,14,0,-5,14,8.8070456365,12.810248199,11.208967174,0,-4.003202562,11.208967174
30033,2014,8,9,21,0,-1,21,6.3266113088000004,7.1174377224,16.607354686,0,-0.790826414,16.607354686
30033,2015,18,21,12,0,-3,12,14.067995311,16.412661196,9.3786635404,0,-2.344665885,9.3786635404
30033,2016,21,7,10,0,14,10,16.203703704,5.4012345679,7.7160493827,0,10.802469136,7.7160493827
30033,2017,19,12,-22,0,7,-22,14.609765475,9.2272202999,-16.91657055,0,5.3825451749,-16.91657055
31071,2010,1,16,1,1,-15,2,NA,NA,NA,NA,NA,NA
31071,2011,15,30,-10,0,-15,-10,7.4128984433,14.825796887,-4.941932296,0,-7.412898443,-4.941932296
31071,2012,9,30,6,0,-21,6,4.4932601098,14.977533699,2.9955067399,0,-10.48427359,2.9955067399
31071,2013,11,43,60,0,-32,60,5.4753608761,21.403683425,29.865604778,0,-15.92832255,29.865604778
31071,2014,19,28,-14,0,-9,-14,9.445687298,13.919960229,-6.959980114,0,-4.474272931,-6.959980114
31071,2015,24,27,18,0,-3,18,11.95516812,13.449564134,8.9663760897,0,-1.494396015,8.9663760897
31071,2016,15,26,-2,0,-11,-2,7.4701195219,12.948207171,-0.996015936,0,-5.478087649,-0.996015936
31071,2017,14,26,26,0,-12,26,6.9703759024,12.944983819,12.944983819,0,-5.974607916,12.944983819
40047,2010,251,180,40,49,71,89,NA,NA,NA,NA,NA,NA
40047,2011,965,719,-529,205,246,-324,15.89785832,11.845140033,-8.714991763,3.3772652389,4.0527182867,-5.337726524
40047,2012,937,643,73,249,294,322,15.368970099,10.546689193,1.1973690685,4.0841766857,4.8222809061,5.2815457543
40047,2013,949,718,612,156,231,768,15.363196322,11.623577407,9.9075618008,2.5254569296,3.739618915,12.43301873
40047,2014,994,697,23,119,297,142,15.907054154,11.154141595,0.3680706696,1.9043656382,4.7529125592,2.2724363078
40047,2015,1034,690,-26,151,344,125,16.430041234,10.963954015,-0.413134499,2.3993580525,5.466087219,1.9862235534
40047,2016,937,647,-1199,130,290,-1069,14.926680845,10.306897019,-19.10041658,2.0709375772,4.619783826,-17.029479
40047,2017,952,648,-1218,109,304,-1109,15.35917396,10.454563788,-19.65070786,1.7585608841,4.9046101722,-17.89214698
49017,2010,22,12,14,1,10,15,NA,NA,NA,NA,NA,NA
49017,2011,54,51,-58,6,3,-52,10.438816934,9.85888266,-11.21206263,1.1598685482,0.5799342741,-10.05219408
49017,2012,66,56,-106,7,10,-99,12.925969448,10.967489228,-20.75989033,1.3709361535,1.9584802193,-19.38895417
49017,2013,62,44,-59,9,18,-50,12.282091918,8.7163232964,-11.68779715,1.7828843106,3.5657686212,-9.904912837
49017,2014,62,56,-41,13,6,-28,12.344449975,11.149825784,-8.163265306,2.5883524141,1.1946241911,-5.574912892
49017,2015,50,34,-64,13,16,-51,10.01001001,6.8068068068,-12.81281281,2.6026026026,3.2032032032,-10.21021021
49017,2016,54,21,-20,10,33,-10,10.823812387,4.2092603728,-4.008819403,2.0044097013,6.6145520144,-2.004409701
49017,2017,49,23,42,10,26,52,9.7241516174,4.564397698,8.3349871006,1.9845207382,5.1597539194,10.319507839
53023,2010,3,13,6,0,-10,6,NA,NA,NA,NA,NA,NA
53023,2011,19,26,-21,0,-7,-21,8.4500778297,11.563264398,-9.339559706,0,-3.113186569,-9.339559706
53023,2012,21,39,-10,0,-18,-10,9.4509450945,17.551755176,-4.500450045,0,-8.100810081,-4.500450045
53023,2013,19,21,29,3,-2,32,8.5489313836,9.4488188976,13.048368954,1.3498312711,-0.899887514,14.398200225
53023,2014,20,22,-41,1,-2,-40,9.0211998196,9.9233198015,-18.49345963,0.451059991,-0.902119982,-18.04239964
53023,2015,27,8,14,2,19,16,12.195121951,3.613369467,6.3233965673,0.9033423668,8.5817524842,7.2267389341
53023,2016,30,21,16,1,9,17,13.368983957,9.3582887701,7.1301247772,0.4456327986,4.0106951872,7.5757575758
53023,2017,29,26,-51,1,3,-50,12.984105664,11.640922319,-22.83411686,0.4477277815,1.3431833445,-22.38638908
05051,2010,292,364,134,2,-72,136,NA,NA,NA,NA,NA,NA
05051,2011,1149,1342,956,-20,-193,936,11.912228955,13.913151661,9.91130625,-0.207349503,-2.000922705,9.7039567469
05051,2012,1079,1350,432,-18,-271,414,11.13501855,13.931672884,4.458135323,-0.185755638,-2.796654335,4.2723796845
05051,2013,1111,1423,970,-10,-312,960,11.418528644,14.625172152,9.9693724434,-0.102777035,-3.206643508,9.8665954079
05051,2014,1080,1308,349,-11,-228,338,11.057246848,13.391554516,3.5731288425,-0.112620107,-2.334307668,3.4605087357
05051,2015,1094,1387,319,-2,-293,317,11.194449845,14.192597747,3.2641951559,-0.020465173,-2.998147902,3.2437299825
05051,2016,1112,1312,700,1,-200,701,11.348965376,13.3901462,7.1441328809,0.0102059041,-2.041180823,7.154338785
05051,2017,1104,1277,601,1,-173,602,11.214440624,12.971775975,6.1049626947,0.0101580078,-1.757335351,6.1151207025
21079,2010,49,19,11,-2,30,9,NA,NA,NA,NA,NA,NA
21079,2011,172,153,-95,1,19,-94,10.170293283,9.0468306528,-5.61731315,0.0591296121,1.1234626301,-5.558183538
21079,2012,196,152,94,4,44,98,11.566151304,8.9696683583,5.5470317479,0.2360439042,2.5964829458,5.7830756521
21079,2013,171,170,-18,4,1,-14,10.052910053,9.9941211052,-1.058201058,0.2351557907,0.0587889477,-0.823045267
21079,2014,165,182,0,2,-17,2,9.7090235076,10.709347142,0,0.1176851334,-1.000323634,0.1176851334
21079,2015,190,171,211,2,19,213,11.109486917,9.9985382254,12.337377576,0.1169419675,1.1109486917,12.454319544
21079,2016,208,161,131,0,47,131,12.017216974,9.3017881388,7.5685356906,0,2.7154288355,7.5685356906
21079,2017,215,169,79,0,46,79,12.313507632,9.6789897197,4.524498153,0,2.6345179119,4.524498153
24023,2010,70,55,-13,4,15,-9,NA,NA,NA,NA,NA,NA
24023,2011,270,301,30,10,-31,40,8.9601274329,9.9888828049,0.9955697148,0.3318565716,-1.028755372,1.3274262864
24023,2012,300,306,-191,14,-6,-177,9.9848563013,10.184553427,-6.357025178,0.4659599607,-0.199697126,-5.891065218
24023,2013,293,293,1,2,0,3,9.78166522,9.78166522,0.0333845229,0.0667690459,0,0.1001535688
24023,2014,288,311,-305,5,-23,-300,9.6662135629,10.438168118,-10.23678867,0.1678162077,-0.771954555,-10.06897246
24023,2015,285,284,-226,5,1,-221,9.6526731131,9.6188040846,-7.654400434,0.1693451423,0.0338690285,-7.485055291
24023,2016,300,359,-16,4,-59,-12,10.21102791,12.219196732,-0.544588155,0.1361470388,-2.008168822,-0.408441116
24023,2017,292,333,-72,4,-41,-68,9.9697833621,11.369650204,-2.458302747,0.1365723748,-1.399866842,-2.321730372
40049,2010,114,114,-20,4,0,-16,NA,NA,NA,NA,NA,NA
40049,2011,347,428,-36,7,-81,-29,12.617722992,15.563070434,-1.309043308,0.2545361987,-2.945347442,-1.054507109
40049,2012,380,401,-120,24,-21,-96,13.875449583,14.642250744,-4.381720921,0.8763441842,-0.766801161,-3.505376737
40049,2013,374,379,54,39,-5,93,13.663847433,13.84651919,1.9728549769,1.4248397055,-0.182671757,3.3976946824
40049,2014,366,359,144,38,7,182,13.304736632,13.050274456,5.234650478,1.3813660984,0.254462176,6.6160165764
40049,2015,406,345,184,42,61,226,14.63300355,12.43444883,6.6317060424,1.5137589879,2.1985547206,8.1454650304
40049,2016,374,308,-57,46,66,-11,13.397814795,11.033494537,-2.04191295,1.6478595737,2.3643202579000002,-0.394053376
40049,2017,363,323,-117,46,40,-71,12.998871999,11.566489409,-4.189719074,1.6472399778,1.4323825894,-2.542479096
48169,2010,26,26,0,4,0,4,NA,NA,NA,NA,NA,NA
48169,2011,68,59,70,20,9,90,10.437452034,9.0560245587,10.744435917,3.0698388335,1.3814274751,13.814274751
48169,2012,58,45,-184,18,13,-166,8.9354490833,6.9326760129,-28.34694192,2.7730704052,2.0027730704,-25.57387151
48169,2013,58,49,-82,27,9,-55,9.0702947846,7.662835249,-12.82352021,4.2223786066,1.4074595355,-8.601141606
48169,2014,65,60,-7,38,5,31,10.172143975,9.3896713615,-1.095461659,5.9467918623,0.7824726135,4.8513302034
48169,2015,63,61,-90,47,2,-43,9.8614698286,9.5484072944,-14.08781404,7.3569695547,0.3130625342,-6.730844486
48169,2016,69,28,-12,48,41,36,10.770311402,4.3705611488,-1.873097635,7.4923905409,6.3997502536,5.6192929056
48169,2017,72,24,-13,48,48,35,11.100832562,3.7002775208,-2.00431699,7.4005550416,7.4005550416,5.3962380512
29073,2010,37,52,13,0,-15,13,NA,NA,NA,NA,NA,NA
29073,2011,178,203,-111,2,-25,-109,11.7538299,13.404648706,-7.329635499,0.13206550450000001,-1.650818806,-7.197569995
29073,2012,130,218,-74,-1,-88,-75,8.6692674469,14.537694642,-4.934813777,-0.066686673,-5.868427195,-5.00150045
29073,2013,159,212,-44,-1,-53,-45,10.696986006,14.262648009,-2.960172228,-0.067276642,-3.565662002,-3.02744887
29073,2014,163,182,18,0,-19,18,11.00496236,12.287749384,1.2152719171,0,-1.282787024,1.2152719171
29073,2015,151,216,3,0,-65,3,10.218582933,14.617310686,0.203018204,0,-4.398727753,0.203018204
29073,2016,154,174,26,0,-20,26,10.442447873,11.798609934,1.7630106798,0,-1.356162061,1.7630106798
29073,2017,160,195,11,0,-35,11,10.856289863,13.23110327,0.7463699281,0,-2.374813408,0.7463699281
37071,2010,622,550,-85,42,72,-43,NA,NA,NA,NA,NA,NA
37071,2011,2595,2056,166,152,539,318,12.564213054,9.9545364314,0.8037222994,0.735938491,2.6096766228,1.5396607905
37071,2012,2573,2120,453,137,453,590,12.402570171,10.218985139,2.1835850321,0.6603778132,2.1835850321,2.8439628453
37071,2013,2461,2278,1008,145,183,1153,11.796341744,10.91916558,4.8316588695,0.6950302937,0.8771761638,5.5266891633
37071,2014,2411,2166,1000,175,245,1175,11.481526457,10.314801454,4.762142869,0.8333750021,1.1667250029,5.5955178711
37071,2015,2630,2260,1901,206,370,2107,12.409289509,10.663495928,8.9696043182,0.97198237220000006,1.7457935811,9.9415866904
37071,2016,2493,2288,3297,220,205,3517,11.593057186,10.639757257,15.331853006,1.0230535824,0.9532999291,16.354906588
37071,2017,2561,2291,2781,221,270,3002,11.718544448,10.483086814,12.725213631,1.0112449524,1.2354576341,13.736458584
37073,2010,28,50,4,0,-22,4,NA,NA,NA,NA,NA,NA
37073,2011,100,118,-108,0,-18,-108,8.2610491532,9.7480380008,-8.921933086,0,-1.486988848,-8.921933086
37073,2012,121,109,-166,2,12,-164,10.111138965,9.1083813821,-13.8714799,0.1671262639,1.0027575834,-13.70435364
37073,2013,91,110,-181,7,-19,-174,7.7141525029,9.3247997287,-15.3435341,0.5933963464,-1.610647226,-14.75013775
37073,2014,115,86,-105,8,29,-97,9.8555941209,7.3702703861,-8.998585936,0.6856065475,2.4853237348,-8.312979389
37073,2015,101,138,-72,8,-37,-64,8.7189226519,11.912983425,-6.215469613,0.6906077348,-3.194060773,-5.524861878
37073,2016,110,103,44,9,7,53,9.5131021361,8.9077229093,3.8052408544,0.7783447202,0.6053792268,4.5835855747
37073,2017,105,120,-42,9,-15,-33,9.0763711804,10.372995635,-3.630548472,0.7779746726,-1.296624454,-2.8525738
20061,2010,249,77,569,89,172,658,NA,NA,NA,NA,NA,NA
20061,2011,1047,192,-940,94,855,-846,29.692861802,5.4451093276,-26.65834775,2.665834775,24.247752474,-23.99251297
20061,2012,969,207,1289,512,762,1801,26.489523107,5.6587526141,35.237353235,13.996528205,20.830770492,49.23388144
20061,2013,1083,215,-2231,210,868,-2021,29.010353187,5.7592113898,-59.76186331,5.6252762412,23.251141797,-54.13658706
20061,2014,1065,200,-1369,165,865,-1204,29.084057021,5.4617947458,-37.38598503,4.5059806652,23.622262275,-32.88000437
20061,2015,1091,200,-927,254,891,-673,29.832788723,5.4688888585,-25.34829986,6.9454888503,24.363899865,-18.40281101
20061,2016,1055,193,-2456,119,862,-2337,29.350396439,5.3693142301,-68.3266101,3.3106134372,23.981082209,-65.01599666
20061,2017,1017,203,-2188,16,814,-2172,29.451370488,5.878690471,-63.3624372,0.4633450618,23.572680017,-62.89909213
39055,2010,234,220,-44,13,14,-31,NA,NA,NA,NA,NA,NA
39055,2011,915,747,-307,28,168,-279,9.8024511484,8.0026568392,-3.288909839,0.2999657182,1.7997943092,-2.988944121
39055,2012,928,743,277,27,185,304,9.9215258623,7.9436354695,2.9614899395,0.2886650844,1.9778903928,3.2501550238
39055,2013,903,781,-95,38,122,-57,9.626044687,8.3255159475,-1.012706805,0.4050827222,1.3005287396,-0.607624083
39055,2014,918,761,-65,49,157,-16,9.7755249819,8.1036759382,-0.692166802,0.5217872812,1.6718490437,-0.17037952
39055,2015,906,856,-177,50,50,-127,9.6449159264,9.112635798,-1.884271654,0.5322801284,0.5322801284,-1.351991526
39055,2016,901,841,-149,45,60,-104,9.598227364,8.9590557304,-1.587276223,0.4793787252,0.6391716336,-1.107897498
39055,2017,904,819,-55,45,85,-10,9.6290063164,8.7236240853000009,-0.585835561,0.4793200047,0.9053822311,-0.106515557
16045,2010,41,32,-47,4,9,-43,NA,NA,NA,NA,NA,NA
16045,2011,177,206,14,9,-29,23,10.609284623,12.347528996,0.839152456,0.5394551503,-1.738244373,1.3786076063
16045,2012,215,175,-114,18,40,-96,12.911361999,10.509248138,-6.846024502,1.0809512371,2.4021138602,-5.765073264
16045,2013,204,198,-69,1,6,-68,12.293970531,11.932383162,-4.158254738,0.0602645614,0.3615873685,-4.097990177
16045,2014,187,211,100,13,-24,113,11.260990004,12.706250753,6.021919788,0.7828495724,-1.445260749,6.8047693605
16045,2015,190,193,26,12,-3,38,11.400456018,11.580463219,1.5600624025,0.7200288012,-0.1800072,2.2800912036
16045,2016,226,208,269,11,18,280,13.428002733,12.35851579,15.982888209,0.6535753543,1.0694869433,16.636463563
16045,2017,220,194,362,11,26,373,12.806333314,11.292857559,21.072239362,0.6403166657,1.5134757553,21.712556028
26049,2010,1314,1105,-1163,59,209,-1104,NA,NA,NA,NA,NA,NA
26049,2011,5216,4145,-4368,185,1071,-4183,12.318752443,9.7893460268,-10.31601048,0.4369189421,2.5294064161,-9.879091539
26049,2012,4968,4197,-4862,168,771,-4694,11.829205136,9.9933925032,-11.57681066,0.4000214297,1.8358126328,-11.17678923
26049,2013,4915,4227,-3436,150,688,-3286,11.793032873,10.14224821,-8.244325728,0.3599094468,1.6507846626,-7.884416281
26049,2014,5036,4440,-3603,163,596,-3440,12.161871711,10.722539793,-8.701196143,0.3936427897,1.4393319182,-8.307553353
26049,2015,4817,4696,-2715,176,121,-2539,11.707063367,11.412989323,-6.598438248,0.4277440632,0.2940740435,-6.170694185
26049,2016,4779,4453,-2141,177,326,-1964,11.672381957,10.876149164,-5.229246656,0.4323104429,0.7962327931,-4.796936213
26049,2017,4675,4444,-1624,176,231,-1448,11.458445671,10.89226365,-3.980431181,0.4313767782,0.5661820214,-3.549054402
36037,2010,159,166,-1,13,-7,12,NA,NA,NA,NA,NA,NA
36037,2011,641,621,-124,66,20,-58,10.696971973,10.363213097,-2.069305031,1.1014042905,0.3337588759,-0.96790074
36037,2012,604,594,-251,57,10,-194,10.098730135,9.9315326161,-4.196657722,0.9530258571,0.1671975188,-3.243631865
36037,2013,580,646,-530,42,-66,-488,9.7573285107,10.867645203,-8.916179501,0.706565168,-1.110316693,-8.209614333
36037,2014,574,600,-384,44,-26,-340,9.7307927036,10.171560317,-6.509798603,0.7459144233,-0.440767614,-5.76388418
36037,2015,637,604,-293,46,33,-247,10.851973628,10.289783472,-4.991567148,0.7836590061,0.5621901566,-4.207908142
36037,2016,551,621,-405,47,-70,-358,9.4386487829,10.637751169,-6.937663806,0.8051116022,-1.199102386,-6.132552204
36037,2017,559,624,-186,46,-65,-140,9.6280539791,10.747595139,-3.20361009,0.7922906673,-1.11954116,-2.411319422
01061,2010,74,117,40,-1,-43,39,NA,NA,NA,NA,NA,NA
01061,2011,320,332,4,-11,-12,-7,11.95300973,12.401247595,0.1494126216,-0.410884709,-0.448237865,-0.261472088
01061,2012,305,349,223,-10,-44,213,11.361943079,13.001043064,8.3072567427,-0.372522724,-1.639099985,7.9347340188
01061,2013,326,361,-204,-8,-35,-212,12.16145639,13.467134224,-7.610236514,-0.298440648,-1.305677833,-7.908677162
01061,2014,276,324,-29,-4,-48,-33,10.359971473,12.161705642,-1.088547727,-0.150144514,-1.801734169,-1.238692241
01061,2015,301,356,103,-5,-55,98,11.307924939,13.374157071,3.869489265,-0.187839285,-2.066232132,3.6816499803
01061,2016,285,360,-43,-4,-75,-47,10.723356222,13.54529207,-1.617909886,-0.150503245,-2.821935848,-1.768413131
01061,2017,279,359,-9,-4,-80,-13,10.540831554,13.563292215,-0.340026824,-0.151123033,-3.022460661,-0.491149857
29075,2010,28,10,-7,0,18,-7,NA,NA,NA,NA,NA,NA
29075,2011,85,88,70,1,-3,71,12.533176054,12.975523444,10.321439104,0.1474491301,-0.44234739,10.468888234
29075,2012,88,86,-57,2,2,-55,12.959281349,12.664752227,-8.394079965,0.2945291216,0.2945291216,-8.099550843
29075,2013,95,104,-26,3,-9,-23,14.079288625,15.413115969,-3.853278992,0.4446091145,-1.333827343,-3.408669878
29075,2014,85,80,15,3,5,18,12.608469925,11.866795224,2.2250241044,0.4450048209,0.7416747015,2.6700289253
29075,2015,106,83,-127,3,23,-124,15.814994405,12.383439015,-18.94815367,0.4475941813,3.4315553898,-18.50055949
29075,2016,97,82,-34,3,15,-31,14.597441685,12.340105342,-5.116629044,0.4514672686,2.2573363431,-4.665161776
29075,2017,99,88,14,3,11,17,14.884979702,13.231093069,2.1049466246,0.451059991,1.6538866336,2.5560066155
28039,2010,91,89,61,1,2,62,NA,NA,NA,NA,NA,NA
28039,2011,371,236,52,12,135,64,16.310201569,10.375222562,2.2860659882,0.5275536896,5.9349790078,2.8136196778
28039,2012,359,229,-95,28,130,-67,15.693646041,10.010710148,-4.15291469,1.2240169614,5.6829358921,-2.928897729
28039,2013,360,264,160,36,96,196,15.616527492,11.452120161,6.9406788852,1.5616527492,4.1644073311,8.5023316343
28039,2014,376,242,-87,67,134,-20,16.168913544,10.406587972,-3.741211378,2.8811627857,5.7623255714,-0.860048593
28039,2015,340,270,-36,69,70,33,14.55510606,11.558466577,-1.541128877,2.9538303474,2.9966394829,1.4127014705
28039,2016,381,252,106,72,129,178,16.170104405,10.695187166,4.4987692047,3.0557677617,5.4749172396,7.5545369663
28039,2017,377,238,170,72,139,242,15.771089125,9.9562843816,7.1116317011,3.0119851911,5.8148047439,10.123616892
45043,2010,135,118,6,4,17,10,NA,NA,NA,NA,NA,NA
45043,2011,586,669,-83,26,-83,-57,9.7501726246,11.131169771,-1.380997146,0.4326015158,-1.380997146,-0.948395631
45043,2012,591,705,167,30,-114,197,9.8393407142,11.737284608,2.7803213186,0.4994589195,-1.897943894,3.2797802381
45043,2013,602,742,370,14,-140,384,9.9961808611,12.320874085,6.1438320907,0.2324693224,-2.324693224,6.3763014131
45043,2014,592,682,438,-3,-90,435,9.7823752004,11.269560619,7.2376357057,-0.049572847,-1.487185419,7.1880628584
45043,2015,570,710,756,-2,-140,754,9.3441857034,11.639248859,12.393341038,-0.032786617,-2.295063155,12.360554422
45043,2016,557,829,340,-2,-272,338,9.0802386619,13.514394705,5.542695054,-0.032604089,-4.434156043,5.5100909654
45043,2017,554,824,506,-2,-270,504,9.009521796,13.400443971,8.2289134094,-0.032525349,-4.390922175,8.1963880599
18051,2010,109,98,33,-1,11,32,NA,NA,NA,NA,NA,NA
18051,2011,428,325,-125,0,103,-125,12.764878689,9.6929569484,-3.728060365,0,3.0719217406,-3.728060365
18051,2012,411,332,-69,1,79,-68,12.261153622,9.9043868677,-2.058441849,0.0298324906,2.3567667547,-2.028609358
18051,2013,406,362,-87,4,44,-83,12.11849862,10.805163794,-2.596821133,0.1193940751,1.3133348258,-2.477427058
18051,2014,422,348,168,4,74,172,12.558776263,10.356526397,4.9997023987,0.1190405333,2.2022498661,5.118742932
18051,2015,404,384,-124,4,20,-120,11.997921152,11.40396466,-3.682530255,0.1187912985,0.5939564927,-3.563738956
18051,2016,401,358,-89,3,43,-86,11.934346215,10.654603354,-2.648770108,0.0892843856,1.279742861,-2.559485722
18051,2017,380,381,-3,3,-1,0,11.317102226,11.346884074,-0.089345544,0.0893455439,-0.029781848,0
47053,2010,152,127,27,-2,25,25,NA,NA,NA,NA,NA,NA
47053,2011,587,711,221,-1,-124,220,11.791528982,14.28241415,4.4394001788,-0.020087784,-2.490885168,4.4193123952
47053,2012,640,653,-194,8,-13,-186,12.870271683,13.131699077,-3.901301104,0.160878396,-0.261427394,-3.740422708
47053,2013,619,669,-244,0,-50,-244,12.510737204,13.521297559,-4.931534536,0,-1.010560356,-4.931534536
47053,2014,599,631,80,0,-32,80,12.138037245,12.786479969,1.6211068107,0,-0.648442724,1.6211068107
47053,2015,634,681,-123,1,-47,-122,12.864737632,13.818432693,-2.495840266,0.0202913843,-0.953695061,-2.475548882
47053,2016,606,705,7,1,-99,8,12.329728685,14.343991292,0.1424226086,0.0203460869,-2.014262607,0.1627686955
47053,2017,608,676,80,0,-68,80,12.381126927,13.765858228,1.6290956483,0,-1.384731301,1.6290956483
04007,2010,166,200,8,6,-34,14,NA,NA,NA,NA,NA,NA
04007,2011,660,689,-125,13,-29,-112,12.3371404,12.879226873,-2.336579621,0.2430042806,-0.542086472,-2.093575341
04007,2012,591,701,-351,17,-110,-334,11.109544621,13.177310964,-6.59805442,0.3195638893,-2.067766342,-6.278490531
04007,2013,606,669,63,13,-63,76,11.438818366,12.628002454,1.1891840876,0.2453871927,-1.189184088,1.4345712803
04007,2014,622,741,135,17,-119,152,11.736956317,13.982451175,2.547410133,0.3207849797,-2.245494858,2.8681951127
04007,2015,606,784,94,20,-178,114,11.440114024,14.800411542,1.774539139,0.3775615189,-3.360297518,2.1521006579
04007,2016,610,849,577,24,-239,601,11.484298516,15.983884329,10.863016793,0.4518412531,-4.499585812,11.314858047
04007,2017,589,831,424,24,-242,448,11.030169104,15.562089178,7.9402235997,0.4494466189,-4.531920073,8.3896702185
12041,2010,49,19,32,2,30,34,NA,NA,NA,NA,NA,NA
12041,2011,179,166,-28,7,13,-21,10.531270224,9.7664293699,-1.647349532,0.4118373831,0.7648408543,-1.235512149
12041,2012,188,183,-116,6,5,-110,11.097337819,10.802195856,-6.847293548,0.3541703559,0.2951419633,-6.493123192
12041,2013,216,195,-7,2,21,-5,12.783712603,11.540851656,-0.414286983,0.1183677093,1.2428609475,-0.295919273
12041,2014,170,187,47,4,-17,51,10.047281324,11.052009456,2.7777777778,0.2364066194,-1.004728132,3.0141843972
12041,2015,195,196,225,5,-1,230,11.436950147,11.495601173,13.196480938,0.293255132,-0.058651026,13.48973607
12041,2016,182,176,34,5,6,39,10.589398964,10.2402979,1.978239367,0.290917554,0.3491010648,2.2691569209
12041,2017,194,167,498,5,27,503,11.100620834,9.5556890682,28.495408119,0.2860984751,1.5449317655,28.781506595
47055,2010,73,45,-103,4,28,-99,NA,NA,NA,NA,NA,NA
47055,2011,285,361,-38,20,-76,-18,9.7027882749,12.290198482,-1.293705103,0.6808974228,-2.587410207,-0.612807681
47055,2012,286,347,-319,19,-61,-300,9.8121622781,11.904966121,-10.94433485,0.6518569346,-2.092803843,-10.29247791
47055,2013,316,383,-118,25,-67,-93,10.938987451,13.258329727,-4.08481177,0.8654262224,-2.319342276,-3.219385547
47055,2014,301,370,57,32,-69,89,10.445948291,12.840534444,1.9781363873,1.1105327087,-2.394586153,3.088669096
47055,2015,344,332,85,34,12,119,11.908470938,11.493059162,2.9425000865,1.1770000346,0.4154117769,4.1195001212
47055,2016,342,349,163,35,-7,198,11.774832157,12.015837494,5.6119814082,1.2050266827,-0.241005337,6.8170080909
47055,2017,346,355,237,35,-9,272,11.820775183,12.128251994,8.0968893596,1.1957431544,-0.307476811,9.292632514
51071,2010,62,33,2,1,29,3,NA,NA,NA,NA,NA,NA
51071,2011,180,210,-141,5,-30,-136,10.44537937,12.186275932,-8.18221384,0.290149427,-1.740896562,-7.892064413
51071,2012,168,211,-101,11,-43,-90,9.834338231,12.351460516,-5.912310484,0.6439150032,-2.517122285,-5.268395481
51071,2013,186,234,14,6,-48,20,10.940211158,13.763491457,0.8234567538,0.3529100373,-2.823280299,1.1763667912
51071,2014,171,241,-69,6,-70,-63,10.107279014,14.244761651,-4.078375743,0.3546413689,-4.137482637,-3.723734374
51071,2015,166,220,-29,7,-54,-22,9.8738995955,13.08589103,-1.724958363,0.4163692601,-3.211991435,-1.308589103
51071,2016,192,214,128,9,-22,137,11.408199643,12.715389186,7.605466429,0.5347593583,-1.307189542,8.1402257873
51071,2017,187,202,-42,8,-15,-34,11.090024908,11.979599099,-2.490807733,0.4744395683,-0.88957419,-2.016368165
48171,2010,65,83,64,2,-18,66,NA,NA,NA,NA,NA,NA
48171,2011,252,354,226,27,-102,253,10.095547143,14.181840034,9.0539430723,1.0816657653,-4.086292891,10.135608838
48171,2012,235,338,187,31,-103,218,9.3644152222,13.46881849,7.4516836023,1.2353058378,-4.104403268,8.6869894401
48171,2013,251,353,219,50,-102,269,9.9461087336,13.987953717,8.6780789349,1.9812965605,-4.041844983,10.659375495
48171,2014,239,339,190,56,-100,246,9.4122280201,13.35039874,7.4825243674,2.205375603,-3.93817072,9.6878999705
48171,2015,258,308,472,68,-50,540,10.034225264,11.978842564,18.357187306,2.6446795271,-1.944617299,21.001866833
48171,2016,259,328,344,73,-69,417,9.9112199602,12.551660799,13.163936936,2.793509873,-2.640440839,15.957446809
48171,2017,262,366,373,74,-104,447,9.8959415308,13.824101528,14.088496912,2.7950369209,-3.928159997,16.883533833
41021,2010,6,0,3,0,6,3,NA,NA,NA,NA,NA,NA
41021,2011,17,18,68,0,-1,68,8.870336551,9.392121054,35.481346204,0,-0.521784503,35.481346204
41021,2012,19,24,5,1,-5,6,9.7361004356,12.298232129,2.5621316936,0.5124263387,-2.562131694,3.0745580323
41021,2013,23,20,-12,1,3,-11,11.810012837,10.26957638,-6.161745828,0.513478819,1.540436457,-5.648267009
41021,2014,18,15,-18,0,3,-18,9.295120062,7.745933385,-9.295120062,0,1.549186677,-9.295120062
41021,2015,17,22,-58,0,-5,-58,8.954437714,11.588095865,-30.55043455,0,-2.633658151,-30.55043455
41021,2016,16,16,-8,0,0,-8,8.5882984434,8.5882984434,-4.294149222,0,0,-4.294149222
41021,2017,18,25,2,0,-7,2,9.6930533118,13.462574044,1.0770059235,0,-3.769520732,1.0770059235
13123,2010,91,46,-9,11,45,2,NA,NA,NA,NA,NA,NA
13123,2011,318,188,-168,38,130,-130,11.226236916,6.6368947805,-5.930842144,1.3415000088,4.5893421355,-4.589342135
13123,2012,300,217,-175,59,83,-116,10.596775048,7.6650006181,-6.181452111,2.0840324261,2.93177443,-4.097419685
13123,2013,312,296,341,63,16,404,10.945064197,10.383778854,11.962393882,2.2100610398,0.5612853434,14.172454922
13123,2014,290,225,183,69,65,252,10.042246693,7.7913982963,6.3370039476,2.3893621442,2.2508483967,8.7263660918
13123,2015,344,332,475,77,12,552,11.73180547,11.322556442,16.199440693,2.6260145965,0.409249028,18.82545529
13123,2016,328,345,363,80,-17,443,10.999329309,11.569416499,12.173038229,2.6827632461,-0.57008719,14.855801476
13123,2017,337,337,559,79,0,638,11.102508772,11.102508772,18.416327606,2.602665261,0,21.018992867
54021,2010,22,6,19,3,16,22,NA,NA,NA,NA,NA,NA
54021,2011,73,63,-3,3,10,0,8.352402746,7.2082379863,-0.343249428,0.3432494279,1.1441647597,0
54021,2012,66,86,24,-8,-20,16,7.5493279954,9.8370031456,2.7452101802,-0.91507006,-2.28767515,1.8301401201
54021,2013,69,80,-114,-4,-11,-118,7.9511408159,9.2187139894,-13.13666743,-0.460935699,-1.267573174,-13.59760313
54021,2014,71,79,-118,-3,-8,-121,8.3021515435,9.2376052385,-13.797942,-0.350795136,-0.935453695,-14.14873714
54021,2015,54,74,-183,-2,-20,-185,6.4377682403,8.8221268479,-21.81688126,-0.238435861,-2.384358608,-22.05531712
54021,2016,60,70,-149,-2,-10,-151,7.3103868413,8.5287846482,-18.15412732,-0.243679561,-1.218397807,-18.39780688
54021,2017,56,79,-97,-2,-23,-99,6.9422921961,9.7935907767,-12.02504184,-0.247939007,-2.851298581,-12.27298085
08047,2010,10,0,8,0,10,8,NA,NA,NA,NA,NA,NA
08047,2011,46,28,-63,0,18,-63,8.4558823529,5.1470588235,-11.58088235,0,3.3088235294,-11.58088235
08047,2012,40,27,-11,0,13,-11,7.3814356892,4.9824690902,-2.029894815,0,2.398966599,-2.029894815
08047,2013,48,21,73,-2,27,71,8.7751371115,3.8391224863,13.345521024,-0.365630713,4.9360146252,12.979890311
08047,2014,40,30,204,-2,10,202,7.1073205402,5.3304904051,36.247334755,-0.355366027,1.776830135,35.891968728
08047,2015,38,33,50,-2,5,48,6.5932159278,5.7256875163,8.6752841156,-0.347011365,0.8675284116,8.3282727509
08047,2016,38,21,97,-2,17,95,6.4979480164,3.5909712722,16.586867305,-0.341997264,2.9069767442,16.244870041
08047,2017,42,23,91,-2,19,89,7.0481624434,3.8597080047,15.271018627,-0.335626783,3.1884544387,14.935391844
30035,2010,44,50,17,5,-6,22,NA,NA,NA,NA,NA,NA
30035,2011,275,126,-9,13,149,4,20.382448859,9.338867477,-0.667061963,0.963533946,11.043581382,0.2964719834
30035,2012,235,146,2,10,89,12,17.257205801,10.721498072,0.1468698366,0.734349183,6.535707729,0.8812190196
30035,2013,254,129,-23,4,125,-19,18.515143784,9.4033604257,-1.676568138,0.2915770675,9.1117833582,-1.38499107
30035,2014,255,145,-202,5,110,-197,18.575174825,10.562354312,-14.71445221,0.3642191142,8.0128205128,-14.3502331
30035,2015,250,125,-196,5,125,-191,18.309652849,9.1548264245,-14.35476783,0.366193057,9.1548264245,-13.98857478
30035,2016,230,154,-33,4,76,-29,16.855373566,11.285771866,-2.418379686,0.2931369316,5.5696017002,-2.125242754
30035,2017,235,160,-109,4,75,-105,17.210443444,11.717748728,-7.982716321,0.2929437182,5.492694716,-7.689772602
12043,2010,20,8,-40,16,12,-24,NA,NA,NA,NA,NA,NA
12043,2011,72,108,-72,67,-36,-5,5.6018050261,8.4027075391,-5.601805026,5.2127907881,-2.800902513,-0.389014238
12043,2012,72,106,-171,40,-34,-131,5.6461731493,8.3124215809,-13.40966123,3.1367628607,-2.666248432,-10.27289837
12043,2013,65,115,34,23,-50,57,5.1286097522,9.0736941771,2.6826574089,1.8147388354,-3.945084425,4.4973962443
12043,2014,61,96,289,28,-35,317,4.7578192029,7.4877154668,22.541143437,2.1839170112,-2.729896264,24.725060448
12043,2015,69,129,192,31,-60,223,5.2883694194,9.8869515233,14.715462732,2.375934087,-4.598582104,17.091396819
12043,2016,73,99,323,34,-26,357,5.4907860098,7.4464084242,24.294847687,2.5573523881,-1.955622414,26.852200075
12043,2017,78,126,305,34,-48,339,5.7323436467,9.2599397369,22.41493349,2.4987138973,-3.52759609,24.913647387
26051,2010,62,54,29,1,8,30,NA,NA,NA,NA,NA,NA
26051,2011,247,332,209,9,-85,218,9.5754991277,12.870711378,8.1023454158,0.3489048265,-3.29521225,8.4512502423
26051,2012,208,336,-211,7,-128,-204,8.0944875761,13.0757107,-8.211234993,0.2724106396,-4.981223124,-7.938824354
26051,2013,244,339,118,0,-95,118,9.5532672957,13.272777103,4.6200227086,0,-3.719509808,4.6200227086
26051,2014,252,324,8,0,-72,8,9.8751885887,12.696671043,0.3134980504,0,-2.821482454,0.3134980504
26051,2015,293,348,-222,0,-55,-222,11.560237518,13.730247973,-8.758951293,0,-2.170010456,-8.758951293
26051,2016,266,346,18,0,-80,18,10.566037736,13.743793446,0.7149950348,0,-3.17775571,0.7149950348
26051,2017,269,366,190,0,-97,190,10.679264758,14.53015205,7.5429751082,0,-3.850887292,7.5429751082
13125,2010,10,13,-5,0,-3,-5,NA,NA,NA,NA,NA,NA
13125,2011,31,32,19,6,-1,25,10.042112083,10.366051182,6.1548428895,1.9436345967,-0.323939099,8.0984774862
13125,2012,25,49,27,2,-24,29,8.060615831,15.798807029,8.7054650975,0.6448492665,-7.738191198,9.350314364
13125,2013,27,38,-38,1,-11,-37,8.7662337662,12.337662338,-12.33766234,0.3246753247,-3.571428571,-12.01298701
13125,2014,35,41,-47,2,-6,-45,11.547344111,13.526888816,-15.50643352,0.6598482349,-1.979544705,-14.84658529
13125,2015,21,43,34,2,-22,36,6.969797544,14.271490209,11.284434119,0.6637902423,-7.301692665,11.948224361
13125,2016,24,24,-31,2,0,-29,7.9840319361,7.9840319361,-10.31270792,0.6653359947,0,-9.647371923
13125,2017,28,34,73,2,-6,75,9.25008259,11.232243145,24.116286753,0.660720185,-1.982160555,24.777006938
48173,2010,5,2,2,1,3,3,NA,NA,NA,NA,NA,NA
48173,2011,11,8,0,2,3,2,8.910490077,6.4803564196,0,1.6200891049,2.4301336574,1.6200891049
48173,2012,16,1,18,4,15,22,12.749003984,0.796812749,14.342629482,3.187250996,11.952191235,17.529880478
48173,2013,11,12,-16,6,-1,-10,8.6716594403,9.4599921167,-12.61332282,4.7299960583,-0.788332676,-7.883326764
48173,2014,17,5,32,8,12,40,13.173188687,3.8744672608,24.796590469,6.1991476172,9.2987214258,30.995738086
48173,2015,17,9,33,10,8,43,12.658227848,6.7014147431,24.571854058,7.4460163812,5.956813105,32.017870439
48173,2016,14,3,-40,11,11,-29,10.297903641,2.2066936374,-29.42258183,8.0912100037,8.0912100037,-21.33137183
48173,2017,15,7,-22,11,8,-11,11.119347665,5.1890289103,-16.30837658,8.1541882876,5.9303187546,-8.154188288
06021,2010,107,29,-72,1,78,-71,NA,NA,NA,NA,NA,NA
06021,2011,425,234,-162,1,191,-161,15.100373068,8.3140877598,-5.755906911,0.0355302896,6.7862853082,-5.720376621
06021,2012,374,241,-406,-1,133,-407,13.344275163,8.5988511079,-14.48603133,-0.03567988,4.7454240554,-14.52171121
06021,2013,384,212,-202,-2,172,-204,13.773314204,7.6040172166,-7.245337159,-0.071736011,6.1692969871,-7.317073171
06021,2014,406,269,-90,-2,137,-92,14.558493949,9.6458987001,-3.227252353,-0.071716719,4.9125952488,-3.298969072
06021,2015,393,266,-198,3,127,-195,14.098654709,9.5426008969,-7.103139013,0.1076233184,4.5560538117,-6.995515695
06021,2016,380,231,-27,4,149,-23,13.618119266,8.2783830275,-0.967603211,0.1433486239,5.3397362385,-0.824254587
06021,2017,371,223,-23,5,148,-18,13.235582669,7.9556197713,-0.820534775,0.1783771249,5.2799628976,-0.64215765
34015,2010,862,511,19,70,351,89,NA,NA,NA,NA,NA,NA
34015,2011,3152,2399,-425,297,753,-128,10.895283262,8.2924443354,-1.469065795,1.0266177439,2.6028389264,-0.442448051
34015,2012,3132,2365,-779,330,767,-449,10.809001289,8.1619693641,-2.688445723,1.1388794462,2.6470319249,-1.549566277
34015,2013,2970,2586,-485,359,384,-126,10.240267005,8.9162728876,-1.672232154,1.2377965842,1.3239941179,-0.43443557
34015,2014,3024,2551,197,374,473,571,10.404230503,8.7768492109,0.6777888258,1.2867666032,1.6273812923,1.964555429
34015,2015,3027,2505,-403,406,522,3,10.387747468,8.5964015223,-1.382973977,1.3932690691,1.791345946,0.0102950916
34015,2016,2927,2592,-701,420,335,-281,10.035073043,8.8865423054,-2.403343424,1.4399489847,1.1485307378,-0.96339444
34015,2017,2898,2639,-164,419,259,255,9.9262042544,9.0390797196,-0.561731366,1.4351551355,0.8871245348,0.8734237698
51073,2010,101,64,47,2,37,49,NA,NA,NA,NA,NA,NA
51073,2011,362,354,-73,13,8,-60,9.8071087993,9.5903771131,-1.977676636,0.35218899,0.2167316862,-1.625487646
51073,2012,337,345,-72,30,-8,-42,9.1428261371,9.3598665202,-1.953363448,0.8139014365,-0.217040383,-1.139462011
51073,2013,341,332,-94,19,9,-75,9.2664302504,9.0218617101,-2.554382532,0.5163113629,0.2445685403,-2.038071169
51073,2014,389,337,191,18,52,209,10.544291445,9.1347717662,5.1772742058,0.4879106581,1.4095196791,5.6651848639
51073,2015,395,370,-73,30,25,-43,10.673079521,9.9975681591,-1.972493177,0.8106136345,0.6755113621,-1.161879543
51073,2016,353,397,132,15,-44,147,9.5276653171,10.715249663,3.5627530364,0.4048582996,-1.187584345,3.967611336
51073,2017,357,435,263,7,-78,270,9.5976772008,11.69464869,7.0705577138,0.188189749,-2.096971489,7.2587474628
13127,2010,261,219,69,23,42,92,NA,NA,NA,NA,NA,NA
13127,2011,1019,772,82,109,247,191,12.742358024,9.6536804657,1.0253909303,1.3630196512,3.0886775583,2.3884105815
13127,2012,973,730,408,136,243,544,12.075555997,9.0597696585,5.063542494,1.687847498,3.0157863384,6.7513899921
13127,2013,1007,834,327,134,173,461,12.388814389,10.260448064,4.0229814352,1.6485611998,2.1283663251,5.671542635
13127,2014,987,810,403,160,177,563,12.041798584,9.882327105,4.9167627448,1.9520646133,2.1594714785,6.8688273582
13127,2015,979,849,948,175,130,1123,11.800370042,10.2334159,11.426711747,2.1093613457,1.5669541425,13.536073092
13127,2016,974,855,631,185,119,816,11.586823854,10.171185211,7.5064536468,2.2007827649,1.4156386434,9.7072364117
13127,2017,953,893,509,186,60,695,11.224309522,10.517637359,5.9949355162,2.1906837053,0.706672163,8.1856192215
26053,2010,31,38,-24,3,-7,-21,NA,NA,NA,NA,NA,NA
26053,2011,141,242,-186,0,-101,-186,8.6731869349,14.885895307,-11.44122532,0,-6.212708372,-11.44122532
26053,2012,125,231,27,3,-106,30,7.7755660612,14.369246081,1.6795222692,0.1866135855,-6.59368002,1.8661358547
26053,2013,114,221,-30,5,-107,-25,7.1383844709,13.838447088,-1.878522229,0.3130870382,-6.700062617,-1.565435191
26053,2014,115,202,-67,7,-87,-60,7.2653757463,12.761790441,-4.232871087,0.4422402628,-5.496414695,-3.790630824
26053,2015,128,192,-160,7,-64,-153,8.1807432972,12.271114946,-10.22592912,0.4473843991,-4.090371649,-9.778544722
26053,2016,121,208,-110,7,-87,-103,7.8347578348,13.468013468,-7.122507123,0.4532504533,-5.633255633,-6.669256669
26053,2017,122,206,71,7,-84,78,7.9502134176,13.424130853,4.6267635463,0.4561597863,-5.473917435,5.0829233326
30037,2010,0,5,0,0,-5,0,NA,NA,NA,NA,NA,NA
30037,2011,6,10,-47,0,-4,-47,7.0216500878,11.702750146,-55.00292569,0,-4.681100059,-55.00292569
30037,2012,7,9,0,0,-2,0,8.4490042245,10.863005432,0,0,-2.414001207,0
30037,2013,9,13,23,0,-4,23,10.759115362,15.540944411,27.495517035,0,-4.78182905,27.495517035
30037,2014,6,8,-2,0,-2,-2,7.1132187315,9.484291642,-2.37107291,0,-2.37107291,-2.37107291
30037,2015,8,9,-23,0,-1,-23,9.6443640747,10.849909584,-27.72754671,0,-1.205545509,-27.72754671
30037,2016,8,5,-7,0,3,-7,9.7979179424,6.123698714,-8.5731782,0,3.6742192284,-8.5731782
30037,2017,9,8,6,0,1,6,10.995723885,9.7739767868,7.3304825901,0,1.2217470984,7.3304825901
38033,2010,5,9,6,0,-4,6,NA,NA,NA,NA,NA,NA
38033,2011,22,12,66,0,10,66,12.786980529,6.9747166521,38.360941587,0,5.8122638768,38.360941587
38033,2012,20,22,48,0,-2,48,11.217049916,12.338754907,26.920919798,0,-1.121704992,26.920919798
38033,2013,15,22,25,0,-7,25,8.2599118943,12.114537445,13.766519824,0,-3.854625551,13.766519824
38033,2014,26,25,26,0,1,26,14.141963557,13.598041882,14.141963557,0,0.5439216753,14.141963557
38033,2015,23,15,19,0,8,19,12.32913428,8.0407397481,10.184937014,0,4.2883945323,10.184937014
38033,2016,22,8,-34,0,14,-34,11.764705882,4.2780748663,-18.18181818,0,7.486631016,-18.18181818
38033,2017,24,7,-88,0,17,-88,13.150684932,3.8356164384,-48.21917808,0,9.3150684932,-48.21917808
48175,2010,20,29,19,0,-9,19,NA,NA,NA,NA,NA,NA
48175,2011,68,68,-10,-1,0,-11,9.4267692521,9.4267692521,-1.386289596,-0.13862896,0,-1.524918555
48175,2012,54,76,144,-2,-22,142,7.4277854195,10.45392022,19.807427785,-0.275103164,-3.026134801,19.532324622
48175,2013,72,59,108,-3,13,105,9.7409186227,7.9821416492,14.611377934,-0.405871609,1.7587769736,14.205506325
48175,2014,54,91,92,-3,-37,89,7.221664995,12.169842862,12.303577399,-0.401203611,-4.948177867,11.902373788
48175,2015,79,88,20,-3,-9,17,10.523511389,11.722392434,2.6641800986,-0.399627015,-1.198881044,2.2645530838
48175,2016,86,80,9,-3,6,6,11.443017763,10.644667687,1.1975251148,-0.399175038,0.7983500765,0.7983500765
48175,2017,78,78,43,-3,0,40,10.342770006,10.342770006,5.7017834648,-0.397798846,0,5.3039846184
48177,2010,55,69,0,-2,-14,-2,NA,NA,NA,NA,NA,NA
48177,2011,278,210,-118,3,68,-115,14.065266886,10.624841892,-5.970149254,0.1517834556,3.4404249937,-5.818365798
48177,2012,281,169,69,-7,112,62,14.171520791,8.5230854578,3.4798396248,-0.353027208,5.648435333,3.1268124165
48177,2013,279,181,126,0,98,126,13.93119289,9.0377989714,6.2915064663,0,4.8933939182,6.2915064663
48177,2014,298,224,136,6,74,142,14.717502963,11.062821019,6.7167127618,0.296325563,3.6546819439,7.0130383248
48177,2015,330,180,16,17,150,33,16.138892285,8.8030321555,0.7824917472,0.8313974814,7.3358601296,1.6138892285
48177,2016,324,202,186,18,122,204,15.65179585,9.7582184005,8.9852902104,0.8695442139,5.8935774498,9.8548344243
48177,2017,323,203,-107,18,120,-89,15.470830539,9.7231535588,-5.125011974,0.8621515471,5.7476769806,-4.262860427
51075,2010,38,15,32,1,23,33,NA,NA,NA,NA,NA,NA
51075,2011,174,184,-379,2,-10,-377,8.0693781014,8.5331354635,-17.57640403,0.0927514724,-0.463757362,-17.48365255
51075,2012,155,174,-88,7,-19,-81,7.2674418605,8.1582895724,-4.126031508,0.3282070518,-0.890847712,-3.797824456
51075,2013,172,196,306,3,-24,309,8.0283793876,9.1486183719,14.28304705,0.140029873,-1.120238984,14.423076923
51075,2014,173,185,292,-2,-12,290,7.9686780286,8.5214187011,13.450023031,-0.092123445,-0.552740673,13.357899585
51075,2015,170,198,333,-2,-28,331,7.725516928,8.9979550102,15.132924335,-0.090888434,-1.272438082,15.042035901
51075,2016,153,163,329,-3,-10,326,6.8557601828,7.3038490837,14.742124838,-0.13442667,-0.448088901,14.607698167
51075,2017,143,172,243,-3,-29,240,6.3330380868,7.617360496,10.76173605,-0.132860939,-1.284322409,10.628875111
27049,2010,147,118,-1,7,29,6,NA,NA,NA,NA,NA,NA
27049,2011,544,494,-168,11,50,-157,11.785733629,10.702486053,-3.639711856,0.2383144668,1.0832475762,-3.401397389
27049,2012,553,448,-63,4,105,-59,11.989029929,9.7126318414,-1.365838853,0.0867199272,2.2763980878,-1.279118926
27049,2013,486,514,-19,11,-28,-8,10.535671703,11.142665135,-0.4118884,0.2384617052,-0.606993431,-0.173426695
27049,2014,500,482,-135,13,18,-122,10.856230934,10.46540662,-2.931182352,0.2822620043,0.3908243136,-2.648920348
27049,2015,502,470,-11,16,32,5,10.908774827,10.213394759,-0.239036899,0.3476900343,0.6953800687,0.1086531357
27049,2016,510,453,133,18,57,151,11.05415452,9.8186901911,2.8827501002,0.3901466301,1.2354643287,3.2728967304
27049,2017,500,454,2,18,46,20,10.805670816,9.811549101,0.0432226833,0.3890041494,0.9941217151,0.4322268326
16047,2010,59,53,-8,1,6,-7,NA,NA,NA,NA,NA,NA
16047,2011,229,161,-223,23,68,-200,14.8715784,10.455563854,-14.48193006,1.4936519791,4.4160145469,-12.98827808
16047,2012,198,137,-209,21,61,-188,12.963629816,8.9697842669,-13.68383147,1.3749304351,3.9938455495,-12.30890104
16047,2013,205,145,-159,10,60,-149,13.514849853,9.5592840426,-10.4822494,0.6592609685,3.9555658107,-9.82298843
16047,2014,204,150,-128,-3,54,-131,13.522023001,9.9426639711,-8.484406589,-0.198853279,3.5793590296,-8.683259868
16047,2015,197,132,45,-1,65,44,13.04419798,8.7402747889,2.9796391326,-0.066214203,4.3039231915,2.9134249296
16047,2016,219,136,-144,-2,83,-146,14.478860203,8.9914382996,-9.520346435,-0.132227034,5.4874219034,-9.652573469
16047,2017,211,124,-56,-1,87,-57,13.965186313,8.2070289232,-3.706400159,-0.066185717,5.7581573896,-3.772585876
13129,2010,183,79,-94,21,104,-73,NA,NA,NA,NA,NA,NA
13129,2011,728,500,15,42,228,57,13.150764117,9.0321182124,0.2709635464,0.7586979298,4.1186459048,1.0296614762
13129,2012,725,478,-88,40,247,-48,13.041210224,8.59820481,-1.582933103,0.7195150469,4.4430054144,-0.863418056
13129,2013,684,448,-207,64,236,-143,12.272580472,8.0381813615,-3.714070406,1.1483116231,4.2343991101,-2.565758783
13129,2014,649,507,-82,42,142,-40,11.624886931,9.0813831645,-1.468783865,0.7523039308,2.543503766,-0.716479934
13129,2015,703,516,270,56,187,326,12.523938895,9.1925355186,4.8100476551,0.9976395137,3.3314033759,5.8076871688
13129,2016,725,509,326,59,216,385,12.789528463,8.9791310177,5.7508776263,1.040803006,3.8103974456,6.7916806322
13129,2017,716,519,-154,59,197,-95,12.553034819,9.0991970265,-2.699954416,1.0343981206,3.4538377923,-1.665556296
56015,2010,31,23,146,2,8,148,NA,NA,NA,NA,NA,NA
56015,2011,117,143,180,2,-26,182,8.6660247389,10.591808014,13.332345752,0.148137175,-1.925783275,13.480482927
56015,2012,134,131,57,1,3,58,9.8449783264,9.6245683638,4.1877892881,0.0734699875,0.2204099625,4.2612592756
56015,2013,145,141,-112,18,4,-94,10.664509249,10.37031589,-8.23741404,1.3238701136,0.2941933586,-6.913543927
56015,2014,153,141,-43,22,12,-21,11.293596605,10.407824322,-3.174017346,1.6239158516,0.8857722827,-1.550101495
56015,2015,147,142,-4,23,5,19,10.84470675,10.475839174,-0.295094061,1.6967908521,0.3688675765,1.4016967909
56015,2016,141,144,-233,24,-3,-209,10.475093793,10.697968129,-17.30990676,1.7829946882,-0.222874336,-15.52691208
56015,2017,133,140,7,24,-7,31,9.9502487562,10.473946059,0.523697303,1.7955336101,-0.523697303,2.3192309131
31073,2010,2,12,6,0,-10,6,NA,NA,NA,NA,NA,NA
31073,2011,23,26,-47,0,-3,-47,11.411560407,12.900024808,-23.31927561,0,-1.488464401,-23.31927561
31073,2012,26,17,80,0,9,80,12.77327438,8.3517563252,39.302382707,0,4.4215180545,39.302382707
31073,2013,22,32,-53,0,-10,-53,10.739565536,15.621186234,-25.8725897,0,-4.881620698,-25.8725897
31073,2014,22,23,-11,0,-1,-11,10.942551604,11.439940313,-5.471275802,0,-0.497388709,-5.471275802
31073,2015,21,18,19,0,3,19,10.424422934,8.9352196575,9.4316207496,0,1.4892032762,9.4316207496
31073,2016,19,21,0,0,-2,0,9.3873517787,10.375494071,0,0,-0.988142292,0
31073,2017,20,21,6,0,-1,6,9.8741051592,10.367810417,2.9622315478,0,-0.493705258,2.9622315478
20063,2010,5,12,-3,0,-7,-3,NA,NA,NA,NA,NA,NA
20063,2011,30,37,40,0,-7,40,11.055831951,13.635526073,14.741109268,0,-2.579694122,14.741109268
20063,2012,37,31,29,0,6,29,13.466787989,11.282984531,10.555050045,0,2.1838034577,10.555050045
20063,2013,32,48,48,2,-16,50,11.502516175,17.253774263,17.253774263,0.718907261,-5.751258088,17.972681524
20063,2014,29,40,-39,2,-11,-37,10.446685879,14.409221902,-14.04899135,0.7204610951,-3.962536023,-13.32853026
20063,2015,44,41,-56,2,3,-54,16.129032258,15.029325513,-20.52785924,0.7331378299,1.0997067449,-19.79472141
20063,2016,33,32,-76,2,1,-74,12.375773486,12.000750047,-28.50178136,0.7500468779,0.375023439,-27.75173448
20063,2017,33,36,3,2,-3,5,12.545143509,13.685611101,1.1404675917,0.7603117278,-1.140467592,1.9007793195
13131,2010,93,75,-7,6,18,-1,NA,NA,NA,NA,NA,NA
13131,2011,384,192,-109,9,192,-100,15.314668581,7.6573342905,-4.347132488,0.3589375449,7.6573342905,-3.988194943
13131,2012,373,249,74,-16,124,58,14.79512911,9.8766411487,2.9352266868,-0.634643608,4.9184879616,2.3005830788
13131,2013,325,264,-225,6,61,-219,12.885576084,10.467052573,-8.920783443,0.2378875585,2.4185235112,-8.682895885
13131,2014,355,258,2,26,97,28,14.084507042,10.236064273,0.0793493354,1.0315413608,3.8484427693,1.1108906963
13131,2015,317,259,-238,31,58,-207,12.583359797,10.281041601,-9.447443633,1.2305493808,2.3023181963,-8.216894252
13131,2016,357,254,-363,36,103,-327,14.277144571,10.157968406,-14.51709658,1.4397120576,4.1191761648,-13.07738452
13131,2017,335,263,-182,36,72,-146,13.477631155,10.58094625,-7.322175732,1.4483424525,2.8966849051,-5.87383328
40051,2010,150,156,17,9,-6,26,NA,NA,NA,NA,NA,NA
40051,2011,627,539,176,31,88,207,11.922872138,10.249486575,3.3467711265,0.5894880961,1.6733855632,3.9362592226
40051,2012,605,537,179,46,68,225,11.44197218,10.155932332,3.3853107772,0.8699681327,1.2860398483,4.2552789099
40051,2013,632,529,439,62,103,501,11.852629802,9.920951211,8.2330767139,1.1627579869,1.9316785912,9.3958347008
40051,2014,582,560,187,55,22,242,10.827302662,10.41802318,3.4788755976,1.0231987052,0.4092794821,4.5020743028
40051,2015,622,515,538,56,107,594,11.46945474,9.4964134904,9.9205251609,1.0326197193,1.9730412495,10.95314488
40051,2016,585,531,36,58,54,94,10.703699638,9.715665825,0.6586892085,1.0612215025,0.9880338127,1.719910711
40051,2017,585,502,79,57,83,136,10.668368743,9.1547369381,1.4406856934,1.0394820826,1.5136318045,2.4801677761
33009,2010,181,188,-30,29,-7,-1,NA,NA,NA,NA,NA,NA
33009,2011,759,754,-242,202,5,-40,8.5198093987,8.4636841721,-2.716460968,2.2674591549,0.0561252266,-0.449001813
33009,2012,796,767,-23,191,29,168,8.9279205011,8.6026570658,-0.257967552,2.1422522811,0.3252634353,1.8842847289
33009,2013,729,798,116,162,-69,278,8.1590168888,8.9312695162,1.2982797793,1.8131148642,-0.772252627,3.1113946435
33009,2014,768,840,-118,178,-72,60,8.5871461157,9.392191064,-1.319379221,1.9902500112,-0.805044948,0.6708707903
33009,2015,794,818,-770,197,-24,-573,8.9085360381,9.1778116866,-8.63926039,2.2103042815,-0.269275649,-6.428956108
33009,2016,703,794,371,199,-91,570,7.8925800766,8.914236957,4.1652165127,2.2341727386,-1.02165688,6.3993892513
33009,2017,736,783,-70,197,-47,127,8.2374074551,8.7634375507,-0.783449079,2.2048495498,-0.526030096,1.4214004712
04009,2010,125,46,-149,1,79,-148,NA,NA,NA,NA,NA,NA
04009,2011,558,282,-308,-4,276,-312,15.023828114,7.5926873267,-8.292722328,-0.107697693,7.4311407878,-8.400420021
04009,2012,528,269,-386,1,259,-385,14.244668366,7.257226876,-10.41371589,0.0269785386,6.9874414903,-10.38673735
04009,2013,594,301,98,23,293,121,15.961734831,8.0883538453,2.633417531,0.6180469716,7.8733809857,3.2514645026
04009,2014,639,274,248,31,365,279,16.930964588,7.2599128281,6.5710159904,0.8213769988,9.67105176,7.3923929891
04009,2015,577,279,-625,43,298,-582,15.214238629,7.3566249176,-16.47989453,1.1338167436,7.8576137113,-15.34607779
04009,2016,564,258,-372,48,306,-324,14.929916747,6.8296427673,-9.847391897,1.2706312125,8.1002739799,-8.576760685
04009,2017,565,276,-640,47,289,-593,15.020004519,7.3372057475,-17.01381043,1.2494517034,7.6827987718,-15.76435873
20065,2010,7,3,11,0,4,11,NA,NA,NA,NA,NA,NA
20065,2011,25,32,39,0,-7,39,9.5328884652,12.202097235,14.871306006,0,-2.66920877,14.871306006
20065,2012,29,34,-51,1,-5,-50,11.104729083,13.019337545,-19.52900632,0.3829216925,-1.914608463,-19.14608463
20065,2013,25,32,10,4,-7,14,9.6599690881,12.364760433,3.8639876352,1.5455950541,-2.704791345,5.4095826893
20065,2014,24,24,-40,5,0,-35,9.3221984851,9.3221984851,-15.53699748,1.9421246844,0,-13.59487279
20065,2015,26,39,41,5,-13,46,10.099048359,15.148572538,15.925422412,1.9421246844,-5.049524179,17.867547097
20065,2016,16,30,-14,5,-14,-9,6.2015503876,11.627906977,-5.426356589,1.9379844961,-5.426356589,-3.488372093
20065,2017,19,35,-63,5,-16,-58,7.5054315623,13.825794983,-24.88643097,1.975113569,-6.320363421,-22.9113174
37075,2010,23,35,21,0,-12,21,NA,NA,NA,NA,NA,NA
37075,2011,105,110,-52,2,-5,-50,11.87446989,12.439920837,-5.88068985,0.2261803789,-0.565450947,-5.654509471
37075,2012,90,107,-88,1,-17,-87,10.270455324,12.210430218,-10.04222298,0.1141161703,-1.939974894,-9.928106813
37075,2013,93,116,38,-1,-23,37,10.667584308,13.305804084,4.3587978894,-0.114705208,-2.638219775,4.2440926818
37075,2014,87,115,-70,-1,-28,-71,10.028240447,13.255720131,-8.06869921,-0.115267132,-3.227479684,-8.183966342
37075,2015,79,97,-14,0,-18,-14,9.1753774681,11.265969803,-1.62601626,0,-2.090592334,-1.62601626
37075,2016,85,96,-34,0,-11,-34,9.9171625248,11.200560028,-3.96686501,0,-1.283397503,-3.96686501
37075,2017,78,95,11,0,-17,11,9.1286792674,11.11826321,1.2873778454,0,-1.989583943,1.2873778454
47057,2010,71,76,67,0,-5,67,NA,NA,NA,NA,NA,NA
47057,2011,206,238,65,-3,-32,62,9.0607200194,10.468210508,2.8589650547,-0.131952233,-1.407490488,2.7270128214
47057,2012,229,238,-55,4,-9,-51,10.079447171,10.475582649,-2.420827923,0.1760602126,-0.396135478,-2.244767711
47057,2013,215,284,117,1,-69,118,9.4661529994,12.504127683,5.1513483764,0.0440286186,-3.037974684,5.195376995
47057,2014,237,301,192,1,-64,193,10.394508892,13.20146488,8.4208679634,0.0438586873,-2.806955988,8.4647266507
47057,2015,222,284,47,2,-62,49,9.7121357949,12.42453408,2.0561728935,0.0874967189,-2.712398285,2.1436696124
47057,2016,235,274,299,1,-39,300,10.225616257,11.922633423,13.010464939,0.0435132607,-1.697017166,13.0539782
47057,2017,224,276,86,1,-52,87,9.6852300242,11.933586994,3.7184365272,0.043237634,-2.24835697,3.7616741612
08049,2010,28,4,-81,3,24,-78,NA,NA,NA,NA,NA,NA
08049,2011,105,66,-303,6,39,-297,7.157952144,4.4992842048,-20.65580476,0.4090258368,2.6586679392,-20.24677892
08049,2012,109,45,-411,-3,64,-414,7.5831362182,3.1306525671,-28.59329345,-0.208710171,4.452483651,-28.80200362
08049,2013,117,61,32,2,56,34,8.2105263158,4.2807017544,2.2456140351,0.1403508772,3.9298245614,2.3859649123
08049,2014,124,67,180,-1,57,179,8.6015538291,4.6476137625,12.486126526,-0.06936737,3.9539400666,12.416759156
08049,2015,109,76,113,0,33,113,7.4603880771,5.2017384758,7.7341637863,0,2.2586496013,7.7341637863
08049,2016,125,57,377,-1,68,376,8.3853223318,3.8237069833,25.290132153,-0.067082579,4.5616153485,25.223049574
08049,2017,127,46,109,-1,81,108,8.341543514,3.0213464696,7.1592775041,-0.065681445,5.3201970443,7.0935960591
49019,2010,33,9,54,5,24,59,NA,NA,NA,NA,NA,NA
49019,2011,133,72,-77,1,61,-76,14.294926913,7.7386070507,-8.276010318,0.1074806535,6.5563198624,-8.168529665
49019,2012,124,91,24,2,33,26,13.296874162,9.7581899094,2.5735885475,0.2144657123,3.5386842529,2.7880542598
49019,2013,121,84,-26,9,37,-17,12.921138342,8.970046452,-2.776442949,0.9610764056,3.9510918896,-1.815366544
49019,2014,132,73,28,9,59,37,14.010507881,7.748235419,2.9719259141,0.955261901,6.2622724619,3.9271878151
49019,2015,130,89,27,10,41,37,13.672696676,9.3605384939,2.8397139251,1.0517458982,4.3121581826,3.8914598233
49019,2016,138,67,28,10,71,38,14.372754257,6.9780763422,2.9162110087,1.0415039317,7.3946779149,3.9577149404
49019,2017,139,71,-58,9,68,-49,14.381789964,7.3460941542,-6.001034661,0.9311950336,7.0356958096,-5.069839628
38035,2010,261,133,-77,43,128,-34,NA,NA,NA,NA,NA,NA
38035,2011,948,483,-1054,145,465,-909,14.204268772,7.2369850391,-15.7925098,2.1725938523,6.9672837333,-13.61991594
38035,2012,989,454,223,257,535,480,14.753486984,6.7725814873,3.3266204222,3.8338181547,7.9809054971,7.1604385769
38035,2013,934,505,894,193,429,1087,13.67306158,7.3928223746,13.087491491,2.8253756798,6.2802392054,15.912867171
38035,2014,1013,456,-26,219,557,193,14.586243142,6.5659692724,-0.374375441,3.1533931374,8.02027387,2.7790176964
38035,2015,1054,451,-305,250,603,-55,15.037593985000001,6.4344923029,-4.351485925,3.5667917422,8.6031016821,-0.784694183
38035,2016,1039,485,-546,226,554,-320,14.742084465,6.8815312471,-7.747043425,3.2066516739,7.8605532184,-4.540391751
38035,2017,1033,485,-552,204,548,-348,14.611962572,6.8604083711,-7.808134888,2.8856150674,7.7515542008,-4.922519821
50013,2010,13,28,-6,0,-15,-6,NA,NA,NA,NA,NA,NA
50013,2011,59,48,7,4,11,11,8.4788388302,6.8980383703,1.005963929,0.5748365309,1.5808004599,1.5808004599
50013,2012,58,64,4,1,-6,5,8.3237657865,9.1848450057,0.5740528129,0.1435132032,-0.861079219,0.7175660161
50013,2013,60,50,9,0,10,9,8.6015339402,7.1679449502,1.290230091,0,1.43358899,1.290230091
50013,2014,55,61,-14,1,-6,-13,7.8853046595,8.7455197133,-2.007168459,0.1433691756,-0.860215054,-1.863799283
50013,2015,68,66,-99,1,2,-98,9.8301409469,9.5410191543,-14.31152873,0.1445608963,0.2891217926,-14.16696784
50013,2016,54,48,57,0,6,57,7.8249529054,6.9555136937,8.2596725112,0,0.8694392117,8.2596725112
50013,2017,53,53,65,0,0,65,7.6089297251,7.6089297251,9.3317062666,0,0,9.3317062666
26055,2010,233,186,-49,-1,47,-50,NA,NA,NA,NA,NA,NA
26055,2011,870,768,1237,-9,102,1228,9.9260112837,8.7622720298,14.113190756,-0.102682875,1.163739254,14.010507881
26055,2012,925,776,677,15,149,692,10.422887534,8.7439575422,7.6284268764,0.1690197979,1.678929992,7.7974466743
26055,2013,915,817,789,3,98,792,10.210230316,9.1166755936,8.8042313873,0.033476165,1.0935547224,8.8377075522
26055,2014,990,809,559,16,181,575,10.946604894,8.9452559184,6.1809617532,0.1769148266,2.0013489756,6.3578765798
26055,2015,935,861,598,24,74,622,10.256297751,9.4445693726,6.5596428395,0.2632632578,0.8117283781,6.8229060973
26055,2016,916,853,317,25,63,342,9.987733406,9.3008041434,3.4564535914,0.2725909772,0.6869292626,3.7290445686
26055,2017,922,830,-223,24,92,-199,10.036958214,9.0354396068,-2.427594015,0.2612657236,1.001518607,-2.166328291
30039,2010,3,9,8,0,-6,8,NA,NA,NA,NA,NA,NA
30039,2011,25,35,11,2,-10,13,8.1116158339,11.356262167,3.5691109669,0.6489292667,-3.244646334,4.2180402336
30039,2012,19,33,-24,2,-14,-22,6.1969993477,10.763209393,-7.82778865,0.6523157208,-4.566210046,-7.175472929
30039,2013,15,34,38,1,-19,39,4.9043648847,11.116560405,12.424391041,0.326957659,-6.212195521,12.7513487
30039,2014,17,33,90,2,-16,92,5.4706355591,10.619469027,28.962188254,0.6436041834,-5.148833467,29.605792438
30039,2015,26,33,25,2,-7,27,8.2408874802,10.459587956,7.9239302694,0.6339144216,-2.218700475,8.557844691
30039,2016,19,25,131,2,-6,133,5.8859975217,7.7447335812,40.582403965,0.6195786865,-1.858736059,41.201982652
30039,2017,22,35,78,2,-13,80,6.6165413534,10.526315789,23.458646617,0.6015037594,-3.909774436,24.060150376
05053,2010,46,31,29,0,15,29,NA,NA,NA,NA,NA,NA
05053,2011,188,194,43,11,-6,54,10.497808303,10.832844739,2.4010944524,0.6142334646,-0.335036435,3.0153279169
05053,2012,208,192,72,4,16,76,11.570018078,10.680016688,4.0050062578,0.2225003477,0.8900013906,4.2275066055
05053,2013,217,183,-29,4,34,-25,12.036163958,10.150313384,-1.608519607,0.2218647734,1.8858505741,-1.386654834
05053,2014,166,172,44,0,-6,44,9.1956569909,9.5280301352,2.4374030578,0,-0.332373144,2.4374030578
05053,2015,197,196,-53,1,1,-52,10.918664265,10.863239573,-2.93750866,0.0554246917,0.0554246917,-2.882083968
05053,2016,189,183,71,1,6,72,10.4680144,10.135696483,3.9324286901,0.0553863196,0.3323179175,3.9878150097
05053,2017,181,166,56,1,15,57,9.9837281778,9.1563473896,3.088888276,0.0551587192,0.8273807882,3.1440469952
18053,2010,170,248,-79,3,-78,-76,NA,NA,NA,NA,NA,NA
18053,2011,783,825,-240,21,-42,-219,11.222186391,11.82414275,-3.439750618,0.3009781791,-0.601956358,-3.138772439
18053,2012,741,720,-563,15,21,-548,10.680542243,10.377854811,-8.114905915,0.2162053086,0.302687432,-7.898700606
18053,2013,812,801,-245,14,11,-231,11.767177979,11.607770395,-3.550441631,0.2028823789,0.1594075835,-3.347559253
18053,2014,770,831,-476,15,-61,-461,11.219256324,12.108054552,-6.935540273,0.2185569414,-0.888798228,-6.716983331
18053,2015,766,836,-806,16,-70,-790,11.273824417,12.304069468,-11.86253587,0.2354845831,-1.030245051,-11.62705129
18053,2016,748,837,-645,16,-89,-629,11.137498976,12.462682678,-9.603859411,0.2382352722,-1.325183702,-9.365624139
18053,2017,735,795,-265,16,-60,-249,11.028336072,11.928608404,-3.976202801,0.240072622,-0.900272332,-3.736130179
20067,2010,26,21,-10,5,5,-5,NA,NA,NA,NA,NA,NA
20067,2011,130,59,-6,4,71,-2,16.540492398,7.5068388574,-0.763407341,0.5089382276,9.0336535403,-0.254469114
20067,2012,114,45,-132,-2,69,-134,14.498283098,5.7230064861,-16.78748569,-0.254355844,8.775276612,-17.04184154
20067,2013,119,63,-35,-9,56,-44,15.179539511,8.0362268002,-4.464570445,-1.1480324,7.1433127113,-5.612602845
20067,2014,127,46,-128,-8,81,-136,16.239370884,5.8819768557,-16.36723995,-1.022952497,10.357394029,-17.39019244
20067,2015,131,58,-137,-4,73,-141,16.880355647,7.4737452484,-17.65350171,-0.515430707,9.4066103988,-18.16893241
20067,2016,116,31,-122,-5,85,-127,15.053205295,4.022839346,-15.83181936,-0.648845056,11.030365949,-16.48066442
20067,2017,121,31,-245,-5,90,-250,15.909539149,4.0759976333,-32.21352968,-0.657418973,11.833541516,-32.87094866
21081,2010,84,30,-30,-1,54,-31,NA,NA,NA,NA,NA,NA
21081,2011,347,185,-77,-8,162,-85,14.037500759,7.483970145,-3.114949736,-0.323631141,6.5535306135,-3.438580877
21081,2012,378,229,-405,-5,149,-410,15.345580026,9.2966609155,-16.44169289,-0.202983863,6.0489191109,-16.64467675
21081,2013,321,228,-40,-4,93,-44,13.086017122,9.2947411333,-1.630656339,-0.163065634,3.7912759886,-1.793721973
21081,2014,371,221,123,-4,150,119,15.028761241,8.9524426801,4.9825812201,-0.162035162,6.0763185611,4.8205460585
21081,2015,362,233,-210,-2,129,-212,14.610618933,9.4040724073,-8.475773414,-0.080721652,5.2065465259,-8.556495066
21081,2016,352,247,71,-2,105,69,14.181539825,9.9512509569,2.8604810443,-0.080576931,4.2302888683,2.7799041135
21081,2017,351,227,-45,-2,124,-47,14.070392047,9.0996552554,-1.803896416,-0.080173174,4.9707367915,-1.88406959
27051,2010,17,30,-2,0,-13,-2,NA,NA,NA,NA,NA,NA
27051,2011,72,82,0,0,-10,0,12.006003002,13.673503418,0,0,-1.667500417,0
27051,2012,58,59,-63,0,-1,-63,9.7315436242,9.8993288591,-10.5704698,0,-0.167785235,-10.5704698
27051,2013,67,80,39,0,-13,39,11.27661365,13.464613313,6.5639989902,0,-2.187999663,6.5639989902
27051,2014,79,73,-39,0,6,-39,13.301902677,12.291631588,-6.566762081,0,1.0102710894,-6.566762081
27051,2015,81,68,-70,0,13,-70,13.740458015,11.535199321,-11.87446989,0,2.2052586938,-11.87446989
27051,2016,64,65,67,0,-1,67,10.849296491,11.018816749,11.357857264,0,-0.169520258,11.357857264
27051,2017,68,59,2,0,9,2,11.455525606,9.9393530997,0.3369272237,0,1.5161725067,0.3369272237
31075,2010,2,3,0,0,-1,0,NA,NA,NA,NA,NA,NA
31075,2011,13,4,11,0,9,11,20.850040096,6.4153969527,17.64234162,0,14.434643144,17.64234162
31075,2012,5,6,-8,0,-1,-8,7.9428117554,9.5313741064,-12.70849881,0,-1.588562351,-12.70849881
31075,2013,10,7,5,0,3,5,15.898251192,11.128775835,7.9491255962,0,4.7694753577,7.9491255962
31075,2014,7,6,-10,0,1,-10,11.119936458,9.5313741064,-15.88562351,0,1.5885623511,-15.88562351
31075,2015,10,6,16,0,4,16,15.72327044,9.4339622642,25.157232704,0,6.2893081761,25.157232704
31075,2016,9,1,10,0,8,10,13.740458015,1.5267175573,15.267175573,0,12.213740458,15.267175573
31075,2017,10,3,-21,0,7,-21,15.23229246,4.569687738,-31.98781417,0,10.662604722,-31.98781417
35017,2010,92,113,-121,10,-21,-111,NA,NA,NA,NA,NA,NA
35017,2011,320,324,-99,34,-4,-65,10.904939597,11.041251342,-3.373715688,1.1586498322,-0.136311745,-2.215065856
35017,2012,327,375,-62,13,-48,-49,11.176430378,12.817007314,-2.119078543,0.4443229202,-1.640576936,-1.674755622
35017,2013,299,329,-129,1,-30,-128,10.265213286,11.295167797,-4.428804394,0.034331817,-1.02995451,-4.394472577
35017,2014,318,307,-240,4,11,-236,10.9907201,10.610537958,-8.294883094,0.1382480516,0.3801821418,-8.156635042
35017,2015,303,332,-474,5,-29,-469,10.604602327,11.619564266,-16.5893779,0.1749934377,-1.014961939,-16.41438446
35017,2016,300,352,-242,4,-52,-238,10.646225913,12.491571738,-8.58795557,0.1419496788,-1.845345825,-8.446005891
35017,2017,291,331,-308,4,-40,-304,10.445082556,11.880832735,-11.05527638,0.1435750179,-1.435750179,-10.91170136
38037,2010,3,3,0,0,0,0,NA,NA,NA,NA,NA,NA
38037,2011,34,21,-50,1,13,-49,14.30976431,8.8383838384,-21.04377104,0.4208754209,5.4713804714,-20.62289562
38037,2012,17,33,4,3,-16,7,7.2232844699,14.021669853,1.6995963459,1.2746972594,-6.798385383,2.9742936053
38037,2013,32,29,36,3,3,39,13.499261759,12.233705969,15.186669479,1.2655557899,1.2655557899,16.452225269
38037,2014,22,42,-1,3,-20,2,9.232060428,17.624842635,-0.41963911,1.2589173311,-8.392782207,0.8392782207
38037,2015,23,33,32,3,-10,35,9.6395641241,13.830678961,13.411567477,1.257334451,-4.191114837,14.668901928
38037,2016,32,19,-20,4,13,-16,13.350020859,7.9265748853,-8.343763037,1.6687526074,5.4234459741,-6.67501043
38037,2017,27,25,-27,4,2,-23,11.316010059,10.477787091,-11.31601006,1.6764459346,0.8382229673,-9.639564124
40053,2010,10,23,18,0,-13,18,NA,NA,NA,NA,NA,NA
40053,2011,47,62,34,0,-15,34,10.35014314,13.653380313,7.4873375908,0,-3.3032371720000002,7.4873375908
40053,2012,45,56,-24,0,-11,-24,9.9261056579,12.352487041,-5.293923018,0,-2.426381383,-5.293923018
40053,2013,59,78,7,0,-19,7,13.080589735,17.29298304,1.5519343753,0,-4.212393305,1.5519343753
40053,2014,48,62,-36,0,-14,-36,10.714285714,13.839285714,-8.035714286,0,-3.125,-8.035714286
40053,2015,61,57,24,0,4,24,13.648059067,12.753104374,5.3697281575,0,0.8949546929,5.3697281575
40053,2016,53,44,-38,0,9,-38,11.862130707,9.8478066249,-8.504923903,0,2.0143240824,-8.504923903
40053,2017,51,53,-56,0,-2,-56,11.528028933,11.980108499,-12.65822785,0,-0.452079566,-12.65822785
41023,2010,18,16,18,0,2,18,NA,NA,NA,NA,NA,NA
41023,2011,67,82,-44,2,-15,-42,9.009009009,11.025951324,-5.916364125,0.2689256421,-2.016942315,-5.647438483
41023,2012,60,86,-58,0,-26,-58,8.1438751272,11.672887682,-7.872412623,0,-3.529012555,-7.872412623
41023,2013,60,84,-31,0,-24,-31,8.2208673015,11.509214222,-4.247448106,0,-3.288346921,-4.247448106
41023,2014,57,75,-63,0,-18,-63,7.882727147,10.372009404,-8.712487899,0,-2.489282257,-8.712487899
41023,2015,69,81,31,0,-12,31,9.5833333333,11.25,4.3055555556,0,-1.666666667,4.3055555556
41023,2016,59,79,-4,0,-20,-4,8.1984297923,10.977558535,-0.555825749,0,-2.779128743,-0.555825749
41023,2017,59,81,28,0,-22,28,8.2092667316,11.270349242,3.8959231947,0,-3.06108251,3.8959231947
46051,2010,22,22,-8,1,0,-7,NA,NA,NA,NA,NA,NA
46051,2011,72,73,-108,16,-1,-92,9.8535650746,9.9904201451,-14.78034761,2.1896811277,-0.13685507,-12.59066648
46051,2012,72,72,-30,18,0,-12,9.9235063056,9.9235063056,-4.134794294,2.4808765764,0,-1.653917718
46051,2013,88,90,-12,9,-2,-3,12.143793556,12.419788864,-1.655971848,1.2419788864,-0.275995308,-0.413992962
46051,2014,81,92,-63,4,-11,-59,11.234396671,12.760055479,-8.737864078,0.5547850208,-1.525658807,-8.183079057
46051,2015,92,82,-101,4,10,-97,12.896894932,11.495058527,-14.1585477,0.5607345623,1.4018364057,-13.59781314
46051,2016,77,88,14,3,-11,17,10.855773298,12.406598054,1.9737769632,0.4229522064,-1.550824757,2.3967291696
46051,2017,82,76,-42,3,6,-39,11.585193558,10.737496468,-5.933879627,0.4238485448,0.8476970896,-5.510031082
53025,2010,430,201,205,14,229,219,NA,NA,NA,NA,NA,NA
53025,2011,1614,647,99,23,967,122,17.911342185,7.1800733544,1.0986511006,0.2552421749,10.731268831,1.3538932755
53025,2012,1575,680,-107,18,895,-89,17.298947785,7.4687520594,-1.175230103,0.1977022604,9.8301957252,-0.977527843
53025,2013,1526,651,-594,99,875,-495,16.653661677,7.1045437431,-6.482486918,1.0804144863,9.5491179343,-5.402072431
53025,2014,1498,671,89,117,827,206,16.224412434,7.2674103758,0.963933716,1.2671937615,8.9570020578,2.2311274775
53025,2015,1500,654,-483,179,846,-304,16.110063957,7.0239878852,-5.187440594,1.9224676322,9.0860760717,-3.264972962
53025,2016,1467,696,-437,192,771,-245,15.666047286,7.4325623118,-4.666709383,2.050362017,8.2334849747,-2.616347365
53025,2017,1486,685,267,192,801,459,15.719710994,7.2463001555,2.8244702796,2.0310797516,8.4734108388,4.8555500312
54023,2010,40,47,-17,0,-7,-17,NA,NA,NA,NA,NA,NA
54023,2011,120,125,-10,1,-5,-9,10.080645161,10.500672043,-0.840053763,0.0840053763,-0.420026882,-0.756048387
54023,2012,115,125,-72,2,-10,-70,9.6985030571,10.541851149,-6.072106262,0.1686696184,-0.843348092,-5.903436643
54023,2013,112,140,-31,-1,-28,-32,9.5023968099,11.877996012,-2.630127688,-0.084842829,-2.375599202,-2.714970517
54023,2014,112,131,-105,-2,-19,-107,9.5779706675,11.202804977,-8.979347501,-0.17103519,-1.62483431,-9.150382691
54023,2015,135,138,40,-2,-3,38,11.588977595,11.84651043,3.4337711392,-0.171688557,-0.257532835,3.2620825822
54023,2016,132,126,-26,-2,6,-28,11.326097216,10.811274615,-2.230897936,-0.171607534,0.5148226007,-2.40250547
54023,2017,132,130,27,-2,2,25,11.324153906,11.152575816,2.316304208,-0.171578089,0.1715780895,2.1447261185
55043,2010,144,107,-5,2,37,-3,NA,NA,NA,NA,NA,NA
55043,2011,530,492,-98,9,38,-89,10.350147441,9.6080613979,-1.913800848,0.1757572207,0.7420860429,-1.738043627
55043,2012,544,474,-399,21,70,-378,10.660918132,9.2891088139,-7.819313115,0.4115427956,1.3718093185,-7.40777032
55043,2013,524,472,34,31,52,65,10.288530448,9.2675312436,0.6675764031,0.6086726029,1.0209992048,1.276249006
55043,2014,534,489,595,29,45,624,10.403171604,9.5264998393,11.591548884,0.5649662481,0.8766717644,12.156515131999999
55043,2015,577,555,330,30,22,360,11.124714411,10.700548524,6.3624883113,0.5784080283,0.4241658874,6.9408963396
55043,2016,570,464,-203,33,106,-170,10.956271024,8.9187890437,-3.901970207,0.6343104277,2.0374819798,-3.267659779
55043,2017,571,472,-126,34,99,-92,10.98161397,9.0776213555,-2.423263328,0.6538964536,1.9039926148,-1.769366874
22043,2010,68,79,33,3,-11,36,NA,NA,NA,NA,NA,NA
22043,2011,238,195,-13,7,43,-6,10.647578571,8.7238563919,-0.581590426,0.3131640756,1.9237221787,-0.268426351
22043,2012,255,208,-36,2,47,-34,11.396902724,9.296297124,-1.608974502,0.0893874723,2.1006056001,-1.51958703
22043,2013,234,231,-107,6,3,-101,10.479410645,10.345059227,-4.791867261,0.2687028371,0.13435141850000001,-4.523164424
22043,2014,287,204,-32,4,83,-28,12.866781735,9.1457263904,-1.434623748,0.1793279684,3.7210553451,-1.255295779
22043,2015,239,207,-90,8,32,-82,10.715086304,9.2804303968,-4.034969738,0.3586639767,1.4346559067,-3.676305761
22043,2016,263,201,-51,8,62,-43,11.800071788,9.0183058148,-2.288226849,0.3589375449,2.7817659727,-1.929289304
22043,2017,244,179,-34,8,65,-26,10.933614142,8.0209710304,-1.523536397,0.3584791522,2.9126431116,-1.165057245
37077,2010,148,63,41,13,85,54,NA,NA,NA,NA,NA,NA
37077,2011,608,485,-302,31,123,-271,10.557938424,8.4220396965,-5.244239151,0.5383159394,2.1358987271,-4.705923212
37077,2012,542,467,-17,22,75,5,9.4178156576,8.1146123839,-0.295392742,0.3822729603,1.3032032736,0.0868802182
37077,2013,544,485,183,-13,59,170,9.4279945581,8.4054730895,3.17154964,-0.225301341,1.0225214686,2.9462482994
37077,2014,558,530,244,-10,28,234,9.6305692909,9.1473149179,4.2112166792,-0.172590848,0.483254373,4.0386258317
37077,2015,554,519,164,-7,35,157,9.5255289334,8.9237355892,2.8198316698,-0.120358669,0.6017933442,2.699473001
37077,2016,570,512,520,-6,58,514,9.7372646828,8.746455294,8.883118658,-0.102497523,0.9908093888,8.780621135
37077,2017,573,542,707,-7,31,700,9.6806075299,9.1568748363,11.944484334,-0.118262221,0.5237326936,11.826222113
26057,2010,112,122,-38,3,-10,-35,NA,NA,NA,NA,NA,NA
26057,2011,439,422,-362,14,17,-348,10.386722031,9.9845027268,-8.564905183,0.331239427,0.4022193042,-8.233665756
26057,2012,432,396,-186,5,36,-181,10.278739427,9.4221778079,-4.425568364,0.1189668915,0.8565616189,-4.306601473
26057,2013,404,467,2,9,-63,11,9.6355657317,11.138141576,0.0477008205,0.214653692,-1.502575844,0.2623545125
26057,2014,377,412,-454,15,-35,-439,9.0473847778,9.8873276617,-10.89525912,0.3599755217,-0.839942884,-10.5352836
26057,2015,420,468,-96,17,-48,-79,10.151548111,11.311725038,-2.320353854,0.410895995,-1.160176927,-1.909457859
26057,2016,385,454,-323,16,-69,-307,9.3628404669,11.040856031,-7.855058366,0.3891050584,-1.678015564,-7.465953307
26057,2017,388,434,116,16,-46,132,9.4691885296,10.591824283,2.8309945088,0.3904820012,-1.122635754,3.2214765101
21083,2010,133,89,42,21,44,63,NA,NA,NA,NA,NA,NA
21083,2011,533,434,185,60,99,245,14.252670704,11.605364138,4.9469870175,1.6044282219,2.6473065661,6.5514152394
21083,2012,497,459,-122,33,38,-89,13.238506206,12.226306537,-3.249693676,0.8790155026,1.0121996697,-2.370678174
21083,2013,489,472,-211,18,17,-193,13.065259502,12.611048026,-5.637565961,0.4809297976,0.4542114755,-5.156636163
21083,2014,502,433,98,26,69,124,13.411343539,11.567951698,2.6181507307,0.6946114183,1.843391841,3.312762149
21083,2015,463,437,-417,29,26,-388,12.398243359,11.70201371,-11.16645244,0.7765638389,0.6962296487,-10.3898886
21083,2016,514,428,-133,32,86,-101,13.833380431,11.518845962,-3.57945447,0.861222128,2.3145344691,-2.718232342
21083,2017,489,413,-134,32,76,-102,13.168347494,11.121733159,-3.608504221,0.8617323513,2.0466143344,-2.74677187
20069,2010,25,6,6,0,19,6,NA,NA,NA,NA,NA,NA
20069,2011,86,50,20,4,36,24,14.199620243,8.2555931644,3.3022372657,0.6604474531,5.9440270783,3.9626847189
20069,2012,89,40,-176,2,49,-174,14.768107525,6.6373516967,-29.20434747,0.3318675848,8.1307558284,-28.87247988
20069,2013,87,53,-21,2,34,-19,14.563106796,8.8717777034,-3.515232675,0.3347840643,5.6913290927,-3.180448611
20069,2014,90,46,27,0,44,27,14.957620076,7.6450058169,4.4872860229,0,7.3126142596,4.4872860229
20069,2015,83,48,-39,2,35,-37,13.716741035,7.9325731284,-6.445215667,0.3305238804,5.7841679061,-6.114691786
20069,2016,79,50,-102,2,29,-100,13.133832086,8.3125519534,-16.95760599,0.3325020781,4.821280133,-16.62510391
20069,2017,72,43,-54,2,29,-52,12.062321997,7.2038867482,-9.046741498,0.3350644999,4.8584352488,-8.711676998
48179,2010,83,45,-112,1,38,-111,NA,NA,NA,NA,NA,NA
48179,2011,307,248,122,2,59,124,13.608759254,10.993395097,5.4080411366,0.0886564121,2.6153641562,5.4966975487
48179,2012,342,262,163,12,80,175,15.013498979,11.501569394,7.1555565311,0.5267894379,3.5119295858,7.682345969
48179,2013,339,259,-7,9,80,2,14.773172964,11.286878459,-0.305050769,0.3922081318,3.4862945047,0.0871573626
48179,2014,330,288,383,12,42,395,14.217090666,12.407642763,16.500441591,0.5169851151,1.809447903,17.017426707
48179,2015,351,269,-292,16,82,-276,15.037916113,11.524784714,-12.51017523,0.6854890536,3.5131313997,-11.82468617
48179,2016,324,245,-604,16,79,-588,14.092164496,10.656112041,-26.27057826,0.6959093578,3.4360524542,-25.5746689
48179,2017,305,240,-419,18,65,-401,13.512914802,10.633113287,-18.56364361,0.79748349650000006,2.8798015152,-17.76616012
53027,2010,218,196,28,8,22,36,NA,NA,NA,NA,NA,NA
53027,2011,828,799,-558,40,29,-518,11.403623543,11.004221269,-7.685050648,0.5508996881,0.3994022738,-7.13415096
53027,2012,800,768,-647,36,32,-611,11.098933115,10.65497579,-8.976262157,0.4994519902,0.4439573246,-8.476810167
53027,2013,794,844,-710,28,-50,-682,11.115933304,11.815929104,-9.93994036,0.391997648,-0.6999958,-9.547942712
53027,2014,747,803,-216,29,-56,-187,10.529728511,11.319105748,-3.044740774,0.408784641,-0.789377238,-2.635956133
53027,2015,790,842,267,38,-52,305,11.135935947,11.868934263,3.7636644277,0.5356526152,-0.732998316,4.2993170429
53027,2016,761,836,594,42,-75,636,10.666479781,11.71770972,8.3257411171,0.5886887659,-1.051229939,8.914429883
53027,2017,764,817,1078,42,-53,1120,10.587436427,11.321905184,14.938817367,0.5820318455,-0.734468757,15.520849212
21085,2010,86,90,43,1,-4,44,NA,NA,NA,NA,NA,NA
21085,2011,312,312,-21,-9,0,-30,12.107571113,12.107571113,-0.814932671,-0.349256859,0,-1.16418953
21085,2012,345,336,44,-6,9,38,13.385322703,13.036140371,1.7071136201,-0.232788221,0.3491823314,1.4743253991
21085,2013,344,311,119,5,33,124,13.29468599,12.019323671,4.5990338164,0.193236715,1.2753623188,4.7922705314
21085,2014,326,320,106,4,6,110,12.534122804,12.303433427,4.0755123227,0.1537929178,0.2306893768,4.2293052405
21085,2015,351,309,21,4,42,25,13.449564134,11.84021458,0.8046747773,0.1532713861,1.6093495546,0.9579461634
21085,2016,344,301,-36,5,43,-31,13.162425866,11.517122632,-1.377463172,0.1913143294,1.6453032332,-1.186148843
21085,2017,334,290,170,5,44,175,12.724294259,11.048039925,6.4764371976,0.190483447,1.6762543335,6.6669206446
48181,2010,333,299,103,28,34,131,NA,NA,NA,NA,NA,NA
48181,2011,1550,1357,33,131,193,164,12.788462332,11.196092506,0.2722704884,1.0808313326,1.5923698258,1.3531018209
48181,2012,1437,1352,189,123,85,312,11.821225558,11.121988138,1.5547749689,1.0118376782,0.6992374199,2.5666126471
48181,2013,1532,1397,304,123,135,427,12.555061567,11.44870823,2.4913438095,1.0080108177,1.1063533365,3.4993546272
48181,2014,1543,1344,901,145,199,1046,12.553135233,10.934163158,7.3301197958,1.1796530193,1.6189720748,8.5097728151
48181,2015,1561,1402,1666,172,159,1838,12.533672703,11.257020583,13.376744858,1.3810324824,1.2766521203,14.757777341
48181,2016,1575,1405,2317,170,170,2487,12.413548502,11.073673425,18.261709129,1.3398750764,1.3398750764,19.601584205
48181,2017,1610,1353,2501,171,257,2672,12.415846013,10.433937674,19.2869757,1.3187016572,1.9819083387,20.605677358
51077,2010,37,66,-27,0,-29,-27,NA,NA,NA,NA,NA,NA
51077,2011,146,229,-45,-3,-83,-48,9.4608605495,14.839294971,-2.916018663,-0.194401244,-5.378434422,-3.110419907
51077,2012,138,224,-136,-2,-86,-138,9.0465108656,14.68419155,-8.915402013,-0.131108853,-5.637680684,-9.046510866
51077,2013,154,216,53,-2,-62,51,10.173746449,14.269670344,3.5013542974,-0.132126577,-4.095923895,3.3692277202
51077,2014,160,215,812,-2,-55,810,10.305294345,13.847739276,52.299368801,-0.128816179,-3.542444931,52.170552621
51077,2015,126,183,89,0,-57,89,7.9061303884,11.482713183,5.5844889251,0,-3.576582795,5.5844889251
51077,2016,137,207,-13,0,-70,-13,8.610395324,13.009867387,-0.817044812,0,-4.399472063,-0.817044812
51077,2017,133,188,-149,0,-55,-149,8.4353396334,11.923637978,-9.450117334,0,-3.488298345,-9.450117334
20071,2010,4,6,11,0,-2,11,NA,NA,NA,NA,NA,NA
20071,2011,15,10,-8,0,5,-8,11.933174224,7.9554494829,-6.364359586,0,3.9777247414,-6.364359586
20071,2012,18,21,16,0,-3,16,14.268727705,16.646848989,12.683313516,0,-2.378121284,12.683313516
20071,2013,23,16,6,1,7,7,18.032144257,12.544100353,4.7040376323,0.7840062721,5.4880439044,5.4880439044
20071,2014,25,19,10,2,6,12,19.349845201,14.705882353,7.7399380805,1.5479876161,4.6439628483,9.2879256966
20071,2015,16,25,6,2,-9,8,12.307692308,19.230769231,4.6153846154,1.5384615385,-6.923076923,6.1538461538
20071,2016,17,16,-22,2,1,-20,13.18340442,12.407910043,-17.06087631,1.5509887553,0.7754943777,-15.50988755
20071,2017,18,8,-43,2,10,-41,14.234875445,6.3266113088000004,-34.00553578,1.5816528272000001,7.908264136,-32.42388296
31077,2010,8,4,5,0,4,5,NA,NA,NA,NA,NA,NA
31077,2011,31,36,-8,1,-5,-7,12.202322377,14.17043889,-3.14898642,0.3936233025,-1.968116512,-2.755363117
31077,2012,29,31,-71,0,-2,-71,11.602320464,12.402480496,-28.40568114,0,-0.800160032,-28.40568114
31077,2013,25,22,16,0,3,16,10.107135638,8.8942793612,6.4685668082,0,1.2128562765,6.4685668082
31077,2014,28,28,-1,0,0,-1,11.276681434,11.276681434,-0.402738623,0,0,-0.402738623
31077,2015,32,29,-52,0,3,-52,13.016066707,11.795810454,-21.1511084,0,1.2202562538,-21.1511084
31077,2016,28,24,-32,0,4,-32,11.572638975,9.9194048357,-13.22587311,0,1.6532341393,-13.22587311
31077,2017,27,29,-29,0,-2,-29,11.299435028,12.136430216,-12.13643022,0,-0.836995187,-12.13643022
21087,2010,25,45,-6,2,-20,-4,NA,NA,NA,NA,NA,NA
21087,2011,120,125,-39,4,-5,-35,10.701863908,11.147774904,-3.47810577,0.3567287969,-0.445910996,-3.121376973
21087,2012,111,111,82,6,0,88,9.8780813384,9.8780813384,7.2973213491,0.5339503426,0,7.8312716917
21087,2013,117,160,-89,6,-43,-83,10.428736964,14.261520635,-7.932970853,0.5348070238,-3.832783671,-7.398163829
21087,2014,102,127,-111,6,-25,-105,9.1958168049,11.449693473,-10.00721241,0.5409304003,-2.253876668,-9.466282005
21087,2015,118,152,-30,6,-34,-24,10.728248023,13.819438131,-2.727520684,0.5455041367,-3.091190108,-2.182016547
21087,2016,110,133,50,6,-23,56,10.013199217,12.106868144,4.5514541896,0.5461745028,-2.093668927,5.0976286924
21087,2017,106,130,83,6,-24,89,9.6075410133,11.782833318,7.5228858878,0.5438230762,-2.175292305,8.066708964
55045,2010,110,93,-4,7,17,3,NA,NA,NA,NA,NA,NA
55045,2011,394,343,-95,36,51,-59,10.690979147,9.3071214403,-2.57777416,0.9768407343,1.3838577069,-1.600933426
55045,2012,373,341,-172,46,32,-126,10.135456435,9.2659266606,-4.673722538,1.249949051,0.8695297746,-3.423773487
55045,2013,422,319,34,30,103,64,11.456184168,8.6600065154,0.9230100988,0.8144206754,2.7961776523,1.7374307742
55045,2014,349,354,-111,41,-5,-70,9.4632519421,9.5988286175,-3.009802194,1.1117287382,-0.135576675,-1.898073455
55045,2015,400,339,-19,43,61,24,10.84554587,9.1916001247,-0.515163429,1.165896181,1.6539457452,0.6507327522
55045,2016,369,354,-169,45,15,-124,10.008951094,9.6020831638,-4.584045352,1.220603792,0.4068679307,-3.36344156
55045,2017,368,342,-29,45,26,16,9.9914475381,9.285530049,-0.787369507,1.2217802696,0.7059174891,0.4344107625
55047,2010,52,72,-9,0,-20,-9,NA,NA,NA,NA,NA,NA
55047,2011,212,194,23,2,18,25,11.134161393,10.188808067,1.2079514719,0.1050392584,0.9453533258,1.3129907303
55047,2012,191,226,-15,-3,-35,-18,10.035465651,11.874425325,-0.788125575,-0.157625115,-1.838959674,-0.94575069
55047,2013,219,240,-98,0,-21,-98,11.559473226,12.667915864,-5.172732311,0,-1.108442638,-5.172732311
55047,2014,191,217,-108,1,-26,-107,10.148508276,11.529980606,-5.738423528,0.0531335512,-1.381472331,-5.685289976
55047,2015,189,251,11,2,-62,13,10.091302259,13.401676544,0.5873244701,0.1067862673,-3.310374286,0.6941107374
55047,2016,200,204,-78,2,-4,-76,10.71639072,10.930718534,-4.179392381,0.1071639072,-0.214327814,-4.072228473
55047,2017,190,215,163,2,-25,165,10.165048284,11.502554637,8.7205414226,0.1070005083,-1.337506353,8.8275419308
54025,2010,104,89,49,3,15,52,NA,NA,NA,NA,NA,NA
54025,2011,336,516,318,13,-180,331,9.4314465762,14.484007242,8.9261905096,0.3649071592,-5.052560666,9.2910976688
54025,2012,389,489,228,16,-100,244,10.872907175,13.667998994,6.3728093468,0.447214691,-2.795091819,6.8200240378
54025,2013,385,441,-29,10,-56,-19,10.751487056,12.315339719,-0.809852272,0.2792594041,-1.563852663,-0.530592868
54025,2014,364,467,-229,87,-103,-142,10.211667672,13.101232975,-6.424373343,2.4407007897,-2.889565303,-3.983672553
54025,2015,355,479,53,95,-124,148,9.991134627,13.480995736,1.4916341838,2.6736839143,-3.489861109,4.165318098
54025,2016,366,497,-11,96,-131,85,10.304779334,13.993101992,-0.309706483,2.7028929401,-3.688322658,2.3931864574
54025,2017,373,493,-182,96,-120,-86,10.539551575,13.930292028,-5.14262302,2.7125923624,-3.390740453,-2.430030658
01063,2010,38,37,-53,0,1,-53,NA,NA,NA,NA,NA,NA
01063,2011,105,107,-89,0,-2,-89,11.72922252,11.952636282,-9.941912422,0,-0.223413762,-9.941912422
01063,2012,105,101,-58,0,4,-58,11.824990146,11.374514331,-6.531899319,0,0.4504758151,-6.531899319
01063,2013,105,134,-70,-1,-29,-71,11.929107021,15.22381277,-7.952738014,-0.113610543,-3.294705749,-8.066348557
01063,2014,101,96,-174,-1,5,-175,11.650037488,11.073302959,-20.07036161,-0.115346906,0.5767345291,-20.18570852
01063,2015,98,113,-62,-1,-15,-63,11.463999532,13.218693338,-7.252734398,-0.116979587,-1.754693806,-7.369713985
01063,2016,94,98,-15,-1,-4,-16,11.060124721,11.530768326,-1.764913519,-0.117660901,-0.470643605,-1.882574421
01063,2017,95,95,-158,-1,0,-159,11.297419432,11.297419432,-18.78939232,-0.118920205,0,-18.90831252
05055,2010,129,93,74,-1,36,73,NA,NA,NA,NA,NA,NA
05055,2011,538,456,455,9,82,464,12.666125178,10.735600523,10.712057539,0.2118868524,1.9305246554,10.923944391
05055,2012,575,457,319,19,118,338,13.378471132,10.632976186,7.4221431147,0.44207122,2.7454949453,7.8642143347
05055,2013,567,504,-143,21,63,-122,13.132143643,11.673016572,-3.311986845,0.4863756905,1.4591270714,-2.825611154
05055,2014,550,468,529,10,82,539,12.655752039,10.768894463,12.172532416,0.2301045825,1.8868575768,12.402636999
05055,2015,612,450,360,11,162,371,13.897562249,10.218795772,8.1750366174,0.2497927855,3.6787664778,8.4248294029
05055,2016,564,499,337,12,65,349,12.671879213,11.211467601,7.5716725083,0.2696144513,1.4604116114,7.8412869596
05055,2017,594,479,211,12,115,223,13.234114607,10.671954371,4.7010070404,0.2673558506,2.5621602353,4.968362891
13133,2010,41,78,20,3,-37,23,NA,NA,NA,NA,NA,NA
13133,2011,165,167,67,34,-2,101,10.292237158,10.416991548,4.1792720581,2.1208246265,-0.12475439,6.3000966847
13133,2012,182,183,53,22,-1,75,11.292774486,11.354822697,3.2885552074,1.3650606521,-0.062048211,4.6536158595
13133,2013,157,188,133,26,-31,159,9.6809002621,11.5924156,8.2010174195,1.6032064128,-1.911515338,9.8042238323
13133,2014,169,196,179,33,-27,212,10.319350308,11.968003908,10.929962753,2.0150210661,-1.6486536,12.944983819
13133,2015,163,201,219,35,-38,254,9.8311218335,12.123039807,13.208685163,2.1109770808,-2.291917973,15.319662244
13133,2016,167,171,215,41,-4,256,9.9324947215,10.170398787,12.787343504,2.4385166682,-0.237904065,15.225860172
13133,2017,158,207,349,41,-49,390,9.2343658679,12.098188194,20.397428404,2.3962594974,-2.863822326,22.793687902
17061,2010,39,22,-14,1,17,-13,NA,NA,NA,NA,NA,NA
17061,2011,152,136,-58,6,16,-52,10.957324106,9.8039215686,-4.181084198,0.4325259516,1.1534025375,-3.748558247
17061,2012,147,157,-200,5,-10,-195,10.687411393,11.414446181,-14.54069577,0.3635173943,-0.727034789,-14.17717838
17061,2013,139,130,-145,0,9,-145,10.229614366,9.567265234,-10.67118045,0,0.6623491316,-10.67118045
17061,2014,144,149,-108,0,-5,-108,10.695187166,11.066547831,-8.021390374,0,-0.371360665,-8.021390374
17061,2015,130,170,-31,0,-40,-31,9.7221702876,12.713607299,-2.318363684,0,-2.991437012,-2.318363684
17061,2016,122,166,-174,0,-44,-174,9.2232092232,12.54961255,-13.15441315,0,-3.326403326,-13.15441315
17061,2017,125,162,94,0,-37,94,9.5082341308,12.322671433,7.1501920663,0,-2.814437303,7.1501920663
18055,2010,76,99,57,0,-23,57,NA,NA,NA,NA,NA,NA
18055,2011,357,341,-198,1,16,-197,10.783218051,10.299936569,-5.980608331,0.0302050926,0.4832814813,-5.950403238
18055,2012,357,376,-69,4,-19,-65,10.827040306,11.403269342,-2.092621236,0.121311376,-0.576229036,-1.97130986
18055,2013,338,381,-157,-1,-43,-158,10.296088705,11.605946144,-4.782502742,-0.030461801,-1.309857439,-4.812964542
18055,2014,329,409,-14,1,-80,-13,10.067781569,12.515874352,-0.428416237,0.0306011598,-2.448092783,-0.397815077
18055,2015,341,378,-195,4,-37,-191,10.487789875,11.625761211,-5.997416498,0.1230239282,-1.137971335,-5.874392569
18055,2016,339,366,-152,5,-27,-147,10.491782984,11.327411717,-4.704280276,0.1547460617,-0.835628733,-4.549534214
18055,2017,330,407,27,5,-77,32,10.248447205,12.639751553,0.8385093168,0.1552795031,-2.391304348,0.9937888199
19073,2010,39,20,5,2,19,7,NA,NA,NA,NA,NA,NA
19073,2011,93,112,-15,3,-19,-12,9.9513134664,11.984377508,-1.605050559,0.3210101118,-2.033064042,-1.284040447
19073,2012,88,130,-112,5,-42,-107,9.507346586,14.04494382,-12.10025929,0.5401901469,-4.537597234,-11.56006914
19073,2013,109,123,-10,2,-14,-8,11.886586696,13.413304253,-1.090512541,0.2181025082,-1.526717557,-0.872410033
19073,2014,102,125,-10,3,-23,-7,11.155465631,13.670913764,-1.093673101,0.3281019303,-2.515448133,-0.765571171
19073,2015,105,116,-170,3,-11,-167,11.615044248,12.831858407,-18.80530973,0.3318584071,-1.216814159,-18.47345133
19073,2016,111,130,72,4,-19,76,12.360801782,14.476614699,8.0178173719,0.4454342984,-2.115812918,8.4632516704
19073,2017,115,122,-26,4,-7,-22,12.784880489,13.563090606,-2.890494719,0.4446914953,-0.778210117,-2.445803224
28041,2010,33,11,-24,0,22,-24,NA,NA,NA,NA,NA,NA
28041,2011,134,133,-66,-1,1,-67,9.3318012466,9.2621609388,-4.596260315,-0.069640308,0.0696403078,-4.665900623
28041,2012,124,124,13,-1,0,12,8.6516657945,8.6516657945,0.9070294785,-0.069771498,0,0.8372579801
28041,2013,136,120,-61,0,16,-61,9.500523926,8.3828152288,-4.261264408,0,1.1177086972,-4.261264408
28041,2014,118,121,53,0,-3,53,8.2422379772,8.4517864003,3.7020221423,0,-0.209548423,3.7020221423
28041,2015,126,136,-807,0,-10,-807,9.0374408263,9.7546980347,-57.88265672,0,-0.717257208,-57.88265672
28041,2016,125,134,-51,0,-9,-51,9.250693802,9.9167437558,-3.774283071,0,-0.666049954,-3.774283071
28041,2017,121,140,-118,0,-19,-118,9.0207626645,10.437246058,-8.797107392,0,-1.416483394,-8.797107392
29077,2010,870,662,-89,34,208,-55,NA,NA,NA,NA,NA,NA
29077,2011,3568,2544,810,191,1024,1001,12.913663401,9.207499914,2.9316332273,0.6912863536,3.7061634874,3.622919581
29077,2012,3465,2540,1886,236,925,2122,12.426793098,9.1093952294,6.7639052766,0.8463847536,3.317397869,7.6102900302
29077,2013,3631,2633,1947,259,998,2206,12.876959605,9.3376575708,6.9048307217,0.9185162593,3.539302034,7.823346981
29077,2014,3567,2663,501,314,904,815,12.540893262,9.3626012773,1.7614206684,1.1039642512,3.1782919845,2.8653849196
29077,2015,3601,2750,812,336,851,1148,12.579451234,9.6066345165,2.8365771736,1.1737560718,2.9728167176,4.0103332454
29077,2016,3549,2847,-412,346,702,-66,12.341536102,9.9003531369,-1.432717068,1.2032041396,2.4411829653,-0.229512928
29077,2017,3513,2752,827,342,761,1169,12.162316553,9.5276672795,2.8631471076,1.1840342331,2.6346492731,4.0471813407
36039,2010,117,161,-31,3,-44,-28,NA,NA,NA,NA,NA,NA
36039,2011,432,521,-228,34,-89,-194,8.8165964264,10.632978561,-4.65320367,0.6938987928,-1.816382134,-3.959304877
36039,2012,428,493,-249,63,-65,-186,8.7832707423,10.117178682,-5.109893493,1.2928646186,-1.33390794,-3.817028874
36039,2013,413,448,-293,64,-35,-229,8.5208223728,9.2429259638,-6.045038633,1.3204179948,-0.722103591,-4.724620638
36039,2014,430,493,-363,71,-63,-292,8.9283860385,10.236498412,-7.537218912,1.4742218808,-1.308112373,-6.062997031
36039,2015,366,561,-212,74,-195,-138,7.6542616043,11.732351803,-4.433616011,1.5475829473,-4.078090199,-2.886033064
36039,2016,390,546,-53,78,-156,25,8.1962906531,11.474806914,-1.113854884,1.6392581306,-3.278516261,0.525403247
36039,2017,379,526,25,78,-147,103,7.9801233866,11.075316362,0.5263933632,1.6423472933,-3.095192976,2.1687406565
37079,2010,53,24,-132,2,29,-130,NA,NA,NA,NA,NA,NA
37079,2011,262,170,177,-6,92,171,12.240130811,7.9420696099,8.2690960056,-0.280308339,4.2980612007,7.9887876664
37079,2012,223,167,-385,6,56,-379,10.429576971,7.8104903772,-18.00622033,0.2806164207,2.6190865936,-17.72560391
37079,2013,205,181,-201,13,24,-188,9.6958804332,8.5607529679,-9.506692522,0.6148607104,1.1351274654,-8.891831812
37079,2014,203,205,4,8,-2,12,9.6359234822,9.7308586889,0.1898704134,0.3797408269,-0.094935207,0.5696112403
37079,2015,211,210,-79,12,1,-67,10.029947236,9.9824119409,-3.755288302,0.5704235395,0.047535295,-3.184864762
37079,2016,212,190,103,16,22,119,10.060266692,9.0162767522,4.8877710815,0.7592654107,1.0439899397,5.6470364922
37079,2017,202,208,-138,17,-6,-121,9.5827699898,9.8674067222,-6.546644845,0.8064707417,-0.284636732,-5.740174103
39057,2010,427,286,-210,81,141,-129,NA,NA,NA,NA,NA,NA
39057,2011,1726,1254,1209,281,472,1490,10.616540521,7.7132918964,7.436499125,1.7284170836,2.9032486245,9.1649162087
39057,2012,1755,1352,-162,528,403,366,10.705560486,8.2472465969,-0.988205583,3.2208181976,2.4583138895,2.2326126143
39057,2013,1796,1364,-1501,463,432,-1038,10.950284732,8.3163632373,-9.151657785,2.8229297499,2.6339214945,-6.328728035
39057,2014,1835,1332,-217,515,503,298,11.181592722,8.1165566788,-1.322291891,3.1381581754,3.0650360431,1.815866284
39057,2015,1801,1470,-1380,581,331,-799,10.963557282,8.9486003354,-8.400726845,3.5368277516,2.0149569463,-4.863899094
39057,2016,1878,1426,93,521,452,614,11.411002686,8.6645845739,0.5650816026,3.1656722041,2.7464181118,3.7307538067
39057,2017,1842,1428,763,473,414,1236,11.101033264,8.6060127584,4.5983107385,2.8505910607,2.4950205056,7.4489017992
42059,2010,90,145,-31,0,-55,-31,NA,NA,NA,NA,NA,NA
42059,2011,382,432,-222,0,-50,-222,9.932009932,11.232011232,-5.772005772,0,-1.3000013,-5.772005772
42059,2012,379,451,-279,-7,-72,-286,9.9351202569,11.822530965,-7.313716495,-0.183498263,-1.887410708,-7.497214759
42059,2013,374,444,-135,2,-70,-133,9.8770648744,11.72571338,-3.56525069,0.0528185287,-1.848648506,-3.512432161
42059,2014,388,393,-97,4,-5,-93,10.288365926,10.420947962,-2.572091482,0.1060656281,-0.132582035,-2.466025853
42059,2015,397,410,-320,4,-13,-316,10.586948985,10.933624897,-8.533560895,0.1066695112,-0.346675911,-8.426891384
42059,2016,402,439,-145,3,-37,-142,10.792815529,11.786184122,-3.892930974,0.0805433995,-0.993368593,-3.812387575
42059,2017,387,433,-345,3,-46,-342,10.469646142,11.714100206,-9.333405476,0.0811600476,-1.244454063,-9.252245428
47059,2010,169,171,18,7,-2,25,NA,NA,NA,NA,NA,NA
47059,2011,565,854,509,30,-289,539,8.192680239,12.383272432,7.3806623746,0.4350095702,-4.190592193,7.8156719448
47059,2012,633,841,-194,11,-208,-183,9.1884280966,12.207690409,-2.816042734,0.1596725262,-3.019262313,-2.656370208
47059,2013,613,837,-172,3,-224,-169,8.9498850239,12.220316093,-2.511223857,0.0438004161,-3.270431069,-2.467423441
47059,2014,659,852,336,14,-193,350,9.6392238889,12.462243935,4.9146877491,0.2047786562,-2.823020046,5.1194664053
47059,2015,636,878,294,17,-242,311,9.288739594,12.823134219,4.2938513217,0.24828392,-3.534394625,4.5421352417
47059,2016,683,921,278,20,-238,298,9.9665107727,13.439467675,4.0566471374,0.2918451178,-3.472956902,4.3484922552
47059,2017,661,908,480,20,-247,500,9.6238543464,13.220060131,6.9885780428,0.2911907518,-3.596205785,7.2797687945
51079,2010,81,44,28,2,37,30,NA,NA,NA,NA,NA,NA
51079,2011,204,146,134,14,58,148,10.988715021,7.8644725147,7.2180775135,0.7541275014,3.1242425059,7.9722050149
51079,2012,234,131,19,30,103,49,12.485660166,6.989835392,1.0137929195,1.6007256623,5.4958247739,2.6145185818
51079,2013,215,161,-68,42,54,-26,11.418556482,8.5506399703,-3.611450422,2.2306017314,2.8679165118,-1.380848691
51079,2014,216,137,125,46,79,171,11.388200559,7.2230716508,6.5903938419,2.4252649338,4.1651289081,9.0156587758
51079,2015,203,176,25,50,27,75,10.605506504,9.1949218954,1.3060968601,2.6121937203,1.410584609,3.9182905804
51079,2016,205,153,35,54,52,89,10.643545079,7.9437190104,1.8171906233,2.8036655331,2.6998260689,4.6208561564
51079,2017,197,148,179,54,49,233,10.117351,7.6008525281,9.19292299,2.7732840305,2.5164984721,11.966207021
04011,2010,18,27,-106,2,-9,-104,NA,NA,NA,NA,NA,NA
04011,2011,114,51,156,16,63,172,13.490326016,6.0351458494,18.460446127,1.89337909,7.4551801669,20.353825217
04011,2012,125,83,117,13,42,130,14.440016173,9.5881707388,13.515855138,1.501761682,4.8518454341,15.01761682
04011,2013,105,55,78,17,50,95,11.90746201,6.237242005,8.8455432071,1.9278748015,5.6702200045,10.773418009
04011,2014,139,47,312,14,92,326,15.265498874,5.1617154467,34.265004668,1.5375322607,10.103783428,35.802536928
04011,2015,163,54,103,17,109,120,17.277930888,5.7239771041,10.917956328,1.801992792,11.553953784,12.71994912
04011,2016,137,54,-25,18,83,-7,14.29167536,5.6332151054,-2.607969956,1.8777383685,8.6584602545,-0.730231588
04011,2017,150,35,-303,18,115,-285,15.724918755,3.6691477094,-31.76433588,1.8869902506,12.055771045,-29.87734563
51081,2010,18,7,-23,1,11,-22,NA,NA,NA,NA,NA,NA
51081,2011,110,130,-258,2,-20,-256,9.0909090909,10.743801653,-21.32231405,0.1652892562,-1.652892562,-21.15702479
51081,2012,103,115,-250,6,-12,-244,8.697855092,9.7111974329,-21.11129877,0.5066711704,-1.013342341,-20.6046276
51081,2013,102,121,-110,2,-19,-108,8.7508579272,10.380919698,-9.437199725,0.1715854496,-1.630061771,-9.265614276
51081,2014,102,126,-105,5,-24,-100,8.8438028352,10.92469762,-9.103914683,0.4335197468,-2.080894785,-8.670394936
51081,2015,124,206,326,6,-82,332,10.687812446,17.755559386,28.098603689,0.5171522151,-7.06774694,28.615755904
51081,2016,148,129,-206,6,19,-200,12.713684391,11.081522206,-17.69607422,0.5154196375,1.6321621854,-17.18065458
51081,2017,141,117,99,6,24,105,12.139474817,10.073181231,8.5234610418,0.5165733965,2.0662935859,9.0400344382
21089,2010,78,108,15,0,-30,15,NA,NA,NA,NA,NA,NA
21089,2011,377,438,1,0,-61,1,10.227750573,11.882638597,0.0271293119,0,-1.654888024,0.0271293119
21089,2012,354,431,-69,-6,-77,-75,9.6323909553,11.727572039,-1.877499932,-0.163260864,-2.095181084,-2.040760796
21089,2013,407,439,-160,-8,-32,-168,11.128123804,12.003062285,-4.374692404,-0.21873462,-0.874938481,-4.593427025
21089,2014,435,460,-149,-9,-25,-158,11.956626307,12.643788739,-4.095488091,-0.247378475,-0.687162431,-4.342866567
21089,2015,383,481,-197,-9,-98,-206,10.599142106,13.311194133,-5.451778055,-0.249066002,-2.712052027,-5.700844057
21089,2016,354,460,-70,-8,-106,-78,9.863883974,12.81747635,-1.950485532,-0.222912632,-2.953592376,-2.173398164
21089,2017,352,460,-162,-8,-108,-170,9.8719728521,12.900873614,-4.543351142,-0.224363019,-3.028900761,-4.767714162
45045,2010,1538,813,598,205,725,803,NA,NA,NA,NA,NA,NA
45045,2011,6102,3781,3101,986,2321,4087,13.382385999,8.2921667425,6.8008487354,2.1624111103,5.0902192566,8.9632598457
45045,2012,6104,3766,4019,734,2338,4753,13.190436933,8.1381365483,8.6848568209,1.5861370755,5.052300385,10.270993896
45045,2013,6034,3957,4056,815,2077,4871,12.843202883,8.422365563,8.6330843375,1.7347050629,4.4208373198,10.3677894
45045,2014,6202,3965,5023,1000,2237,6023,12.988876102,8.3039170823,10.519691174,2.0943044344,4.6849590197,12.613995608
45045,2015,6417,4165,5726,1128,2252,6854,13.197295141,8.5657993238,11.776174533,2.3198611374,4.6314958168,14.09603567
45045,2016,6402,4269,4919,1158,2133,6077,12.935293226,8.6255493257,9.9388796282,2.3397484467,4.3097439006,12.278628075
45045,2017,6428,4268,4483,1152,2160,5635,12.780962966,8.486177651,8.913667856,2.2905521682,4.2947853154,11.204220024
20073,2010,8,8,-8,0,0,-8,NA,NA,NA,NA,NA,NA
20073,2011,69,110,-29,0,-41,-29,10.384528557,16.555045526,-4.364512002,0,-6.170516969,-4.364512002
20073,2012,57,95,-149,0,-38,-149,8.7456846951,14.576141158,-22.86152666,0,-5.830456463,-22.86152666
20073,2013,49,97,-19,0,-48,-19,7.6658322904,15.175219024,-2.972465582,0,-7.509386733,-2.972465582
20073,2014,75,100,-44,0,-25,-44,11.861458169,15.815277558,-6.958722126,0,-3.95381939,-6.958722126
20073,2015,68,92,-30,0,-24,-30,10.861752256,14.695311876,-4.791949525,0,-3.83355962,-4.791949525
20073,2016,64,83,-82,0,-19,-82,10.351799434,13.424989891,-13.26324302,0,-3.073190457,-13.26324302
20073,2017,61,72,3,0,-11,3,9.955120359,11.750305998,0.4895960832,0,-1.795185639,0.4895960832
45047,2010,237,137,-26,12,100,-14,NA,NA,NA,NA,NA,NA
45047,2011,921,678,-194,57,243,-137,13.196543967,9.714719663,-2.779728045,0.8167242195,3.481824304,-1.963003826
45047,2012,888,655,-181,81,233,-100,12.703226591,9.3700601544,-2.589283798,1.1587402634,3.3331664366,-1.430543535
45047,2013,891,718,-374,67,173,-307,12.747328212,10.272257751,-5.35073036,0.9585532999,2.4750704608,-4.392177061
45047,2014,874,721,-452,106,153,-346,12.533251117,10.339215166,-6.481727122,1.5200510508,2.1940359506,-4.961676071
45047,2015,876,759,52,109,117,161,12.554909815,10.878055422,0.7452686192,1.5621976825,1.6768543931,2.3074663017
45047,2016,788,746,108,117,42,225,11.250794195,10.651132575,1.5419870216,1.6704859401,0.5996616195,3.2124729617
45047,2017,806,780,45,116,26,161,11.471105197,11.101069545,0.6404463199,1.6509282914,0.3700356515,2.2913746113
40055,2010,19,31,-20,0,-12,-20,NA,NA,NA,NA,NA,NA
40055,2011,56,76,-46,-2,-20,-48,9.0724989874,12.312677197,-7.452409883,-0.324017821,-3.24017821,-7.776427704
40055,2012,54,78,-65,-2,-24,-67,8.8611749262,12.799474893,-10.66622908,-0.328191664,-3.938299967,-10.99442074
40055,2013,80,81,86,0,-1,86,13.131976362,13.296126067,14.11687459,0,-0.164149705,14.11687459
40055,2014,79,75,-19,-1,4,-20,12.895853738,12.242899119,-3.101534443,-0.163238655,0.6529546197,-3.264773098
40055,2015,70,89,-69,-1,-19,-70,11.525479542,14.653823989,-11.36082983,-0.164649708,-3.128344447,-11.52547954
40055,2016,88,74,-77,-1,14,-78,14.674003669,12.339503085,-12.83975321,-0.166750042,2.3345005836,-13.00650325
40055,2017,79,62,-138,-1,17,-139,13.380758808,10.501355014,-23.37398374,-0.169376694,2.879403794,-23.54336043
48183,2010,490,231,-61,44,259,-17,NA,NA,NA,NA,NA,NA
48183,2011,1888,1279,-152,171,609,19,15.437701352,10.458061456,-1.242865787,1.3982240102,4.979639896,0.1553582234
48183,2012,1954,1197,-502,144,757,-358,15.912181695,9.7476363814,-4.087981172,1.1726479857,6.1645453139,-2.915333187
48183,2013,1864,1267,-573,156,597,-417,15.144190732,10.293824924,-4.655376228,1.2674322716,4.8503658086,-3.387943957
48183,2014,1923,1303,-950,182,620,-768,15.621509429,10.584933326,-7.717334351,1.4784787915,5.0365761031,-6.23885556
48183,2015,1939,1276,-49,227,663,178,15.708163546,10.337089575,-0.396957202,1.8389649949,5.3710739718,1.4420077933
48183,2016,1810,1270,-1041,244,540,-797,14.629513629,10.264907353,-8.413990988,1.9721554285,4.3646062761,-6.441835559
48183,2017,1769,1265,-982,251,504,-731,14.326148663,10.244532538,-7.952672689,2.0327096181,4.0816161256,-5.919963071
46053,2010,13,14,0,0,-1,0,NA,NA,NA,NA,NA,NA
46053,2011,53,70,-32,-1,-17,-33,12.485276796,16.489988221,-7.53828033,-0.23557126,-4.004711425,-7.77385159
46053,2012,35,63,49,0,-28,49,8.2722760577,14.890096904,11.581186481,0,-6.617820846,11.581186481
46053,2013,48,65,7,0,-17,7,11.3301074,15.342853771,1.6523073292,0,-4.012746371,1.6523073292
46053,2014,52,70,13,0,-18,13,12.298959319,16.556291391,3.0747398297,0,-4.257332072,3.0747398297
46053,2015,54,70,-17,0,-16,-17,12.83269962,16.634980989,-4.039923954,0,-3.802281369,-4.039923954
46053,2016,54,46,-28,0,8,-28,12.915570438,11.002152595,-6.696962449,0,1.9134178426,-6.696962449
46053,2017,55,45,45,0,10,45,13.099916637,10.718113612,10.718113612,0,2.3818030249,10.718113612
28043,2010,56,94,-26,0,-38,-26,NA,NA,NA,NA,NA,NA
28043,2011,260,256,-242,-2,4,-244,11.967779056,11.783659379,-11.13924051,-0.092059839,0.1841196778,-11.23130035
28043,2012,295,288,9,1,7,10,13.648561118,13.324696956,0.4163967799,0.0462663089,0.3238641621,0.4626630887
28043,2013,263,303,-31,-6,-40,-37,12.18721038,14.040778499,-1.436515292,-0.278035218,-1.853568119,-1.71455051
28043,2014,284,300,81,-3,-16,78,13.166434863,13.908205841,3.7552155772,-0.139082058,-0.741770978,3.6161335188
28043,2015,273,286,-135,-3,-13,-138,12.683516075,13.287493031,-6.272068389,-0.139379298,-0.603976956,-6.411447686
28043,2016,265,290,-202,-3,-25,-205,12.421777955,13.5936438,-9.468676026,-0.140623901,-1.171865845,-9.609299927
28043,2017,276,259,-145,-3,17,-148,13.047794639,12.244126129,-6.854819647,-0.141823855,0.8036685104,-6.996643502
38039,2010,10,12,-2,0,-2,-2,NA,NA,NA,NA,NA,NA
38039,2011,20,39,-27,0,-19,-27,8.3612040134,16.304347826,-11.28762542,0,-7.943143813,-11.28762542
38039,2012,16,36,-4,0,-20,-4,6.7897305326,15.276893698,-1.697432633,0,-8.487163166,-1.697432633
38039,2013,19,45,-35,0,-26,-35,8.2126647936,19.451048195,-15.12859304,0,-11.2383834,-15.12859304
38039,2014,18,41,28,0,-23,28,7.874015748,17.935258093,12.248468941,0,-10.06124234,12.248468941
38039,2015,27,43,13,0,-16,13,11.803278689,18.797814208,5.6830601093,0,-6.994535519,5.6830601093
38039,2016,16,31,-9,0,-15,-9,7.0360598065,13.632365875,-3.957783641,0,-6.596306069,-3.957783641
38039,2017,18,32,11,0,-14,11,7.9646017699,14.159292035,4.8672566372,0,-6.194690265,4.8672566372
48185,2010,91,95,35,3,-4,38,NA,NA,NA,NA,NA,NA
48185,2011,299,298,32,0,1,32,11.228992583,11.191437424,1.2017650925,0,0.0375551591,1.2017650925
48185,2012,278,235,-20,7,43,-13,10.428780433,8.8156956897,-0.750271974,0.2625951908,1.6130847432,-0.487676783
48185,2013,319,281,63,21,38,84,11.933040307,10.511549612,2.3566819415,0.7855606472,1.4214906948,3.1422425886
48185,2014,345,291,139,25,54,164,12.824802052,10.817441731,5.1670941600999996,0.929333482,2.0073603212,6.0964276421
48185,2015,320,308,274,35,12,309,11.777912733,11.336241006,10.084837778,1.2882092052,0.4416717275,11.373046983
48185,2016,347,249,114,34,98,148,12.640244791,9.070377386,4.1527028996,1.2385254262,3.5698674049,5.3912283258
48185,2017,343,252,383,34,91,417,12.325715107,9.0556274256,13.763116286,1.2217910019,3.2700876815,14.984907288
17063,2010,179,68,-33,-2,111,-35,NA,NA,NA,NA,NA,NA
17063,2011,638,380,-320,-2,258,-322,12.729830302,7.5820305875,-6.384867863,-0.039905424,5.1477997147,-6.424773287
17063,2012,627,385,-174,-3,242,-177,12.509476876,7.6812577311,-3.471529468,-0.059853956,4.8282191453,-3.531383424
17063,2013,610,362,-218,-1,248,-219,12.158660554,7.2154674108,-4.345226231,-0.01993223,4.9431931433,-4.365158461
17063,2014,602,390,-110,-3,212,-113,11.984511711,7.7640524372,-2.189860944,-0.05972348,4.2204592736,-2.249584424
17063,2015,628,423,-136,-1,205,-137,12.482111623,8.4075369693,-2.703132453,-0.019875974,4.0745746542,-2.723008427
17063,2016,599,396,-278,-1,203,-279,11.906891685,7.8716679587,-5.526069931,-0.019877949,4.0352237263,-5.54594788
17063,2017,601,396,115,-1,205,114,11.918100243,7.8528580636,2.2805017104,-0.01983045,4.0652421794,2.2606712607
19075,2010,47,39,5,0,8,5,NA,NA,NA,NA,NA,NA
19075,2011,136,127,5,1,9,6,10.904425914,10.182809493,0.4008980115,0.0801796023,0.7216164208,0.4810776139
19075,2012,135,122,-53,1,13,-52,10.835105743,9.7917251896,-4.253782255,0.0802600425,1.043380553,-4.173522212
19075,2013,135,122,-113,1,13,-112,10.894564823,9.8454585805,-9.119154259,0.0807004802,1.0491062422,-9.038453779
19075,2014,122,119,48,1,3,49,9.8645643825,9.6219931271,3.8811400849,0.0808570851,0.2425712553,3.96199717
19075,2015,123,144,36,1,-21,37,9.9201548512,11.613839826,2.9034599564,0.0806516655,-1.693684975,2.9841116219
19075,2016,125,128,-106,1,-3,-105,10.120228312,10.363113792,-8.581953609,0.0809618265,-0.242885479,-8.500991782
19075,2017,119,130,46,1,-11,47,9.6630125863,10.556232237,3.7352821762,0.0812017864,-0.893219651,3.8164839626
29079,2010,41,57,10,1,-16,11,NA,NA,NA,NA,NA,NA
29079,2011,118,121,-13,11,-3,-2,11.510510657,11.803150758,-1.268107106,1.0730137053,-0.292640101,-0.195093401
29079,2012,140,117,53,7,23,60,13.606764506,11.37136748,5.1511322772,0.6803382253,2.235397026,5.8314705025
29079,2013,159,130,-17,5,29,-12,15.381638773,12.576182645,-1.64457773,0.4836993325,2.8054561285,-1.160878398
29079,2014,175,148,-200,3,27,-197,17.054867947,14.423545463,-19.49127765,0.2923691648,2.6313224832,-19.19890849
29079,2015,152,154,-173,3,-2,-170,15.063673753,15.261879986,-17.14483921,0.2973093504,-0.198206234,-16.84752985
29079,2016,140,140,72,3,0,75,13.941445927,13.941445927,7.1698864768,0.2987452699,0,7.4686317467
29079,2017,141,127,-149,3,14,-146,14.079584602,12.681611663,-14.87842628,0.2995656298,1.3979729392,-14.57886065
47061,2010,36,40,3,0,-4,3,NA,NA,NA,NA,NA,NA
47061,2011,157,178,-119,0,-21,-119,11.496777973,13.034563562,-8.714118336,0,-1.537785589,-8.714118336
47061,2012,165,222,63,0,-57,63,12.142173817,16.336742954,4.6361027301,0,-4.194569137,4.6361027301
47061,2013,146,212,-76,0,-66,-76,10.799215947,15.681053293,-5.621509671,0,-4.881837346,-5.621509671
47061,2014,155,203,-23,0,-48,-23,11.557676534,15.136827977,-1.715010066,0,-3.579151443,-1.715010066
47061,2015,158,205,8,0,-47,8,11.831660926,15.351205631,0.5990714393,0,-3.519544706,0.5990714393
47061,2016,156,192,-18,0,-36,-18,11.723593732,14.42903844,-1.352722354,0,-2.705444707,-1.352722354
47061,2017,153,192,121,0,-39,121,11.486486486,14.414414414,9.0840840841,0,-2.927927928,9.0840840841
35019,2010,12,16,11,0,-4,11,NA,NA,NA,NA,NA,NA
35019,2011,47,38,-80,-1,9,-81,10.08583691,8.1545064378,-17.16738197,-0.214592275,1.9313304721,-17.38197425
35019,2012,35,33,-34,-1,2,-35,7.5930144267,7.1591278881,-7.376071157,-0.216943269,0.4338865387,-7.593014427
35019,2013,49,49,-59,-1,0,-60,10.7385492,10.7385492,-12.93008985,-0.219154065,0,-13.14924392
35019,2014,40,46,-85,0,-6,-85,8.9126559715,10.249554367,-18.93939394,0,-1.336898396,-18.93939394
35019,2015,34,43,-83,0,-9,-83,7.7316657192,9.7782831154,-18.87436043,0,-2.046617396,-18.87436043
35019,2016,48,31,3,0,17,3,11.004126547,7.1068317286,0.6877579092,0,3.8972948189,0.6877579092
35019,2017,45,35,48,0,10,48,10.226110669,7.9536416316,10.907851381,0,2.2724690376,10.907851381
48187,2010,415,161,726,24,254,750,NA,NA,NA,NA,NA,NA
48187,2011,1642,864,2261,116,778,2377,12.236244472,6.4385598194,16.849055268,0.864436272,5.7976846522,17.71349154
48187,2012,1709,880,2785,127,829,2912,12.412165229,6.3912846119,20.226963232,0.9223785747,6.0208806173,21.149341807
48187,2013,1738,970,2370,82,768,2452,12.307648729,6.8690559651,16.783157358,0.5806830816,5.4385927641,17.36384044
48187,2014,1776,913,2902,103,863,3005,12.264981613,6.3051397593,20.041090451,0.7113136859,5.9598418536,20.752404137
48187,2015,1783,1055,2933,129,728,3062,11.992601312,7.0960147974,19.727593745,0.8676643686,4.8965865142,20.595258113
48187,2016,1880,1081,3078,134,799,3212,12.320557309,7.0843204525,20.171635849,0.8781673826,5.2362368562,21.049803232
48187,2017,1897,1093,4113,134,804,4247,12.072998043,6.9561343495,26.176194492,0.8528106156,5.1168636935,27.029005107
39059,2010,107,81,11,0,26,11,NA,NA,NA,NA,NA,NA
39059,2011,464,456,-227,-5,8,-232,11.595796524,11.395868997000001,-5.672943558,-0.124954704,0.1999275263,-5.797898262
39059,2012,453,431,-50,3,22,-47,11.357226129,10.805661063,-1.253556968,0.0752134181,0.5515650659,-1.17834355
39059,2013,458,446,-185,7,12,-178,11.511008344,11.209409872,-4.649643108,0.1759324419,0.3015984719,-4.473710667
39059,2014,463,472,-6,7,-9,1,11.663349875,11.890067259,-0.151144923,0.1763357433,-0.226717384,0.0251908205
39059,2015,459,468,-301,7,-9,-294,11.609378557,11.83701343,-7.613121886,0.1770493462,-0.227634874,-7.43607254
39059,2016,477,459,-210,8,18,-202,12.139721321,11.68161863,-5.344531399,0.2036011962,0.4581026914,-5.140930203
39059,2017,462,451,-126,8,11,-118,11.801821363,11.520825617,-3.218678554,0.20436054310000001,0.2809957467,-3.014318011
37081,2010,1457,787,214,300,670,514,NA,NA,NA,NA,NA,NA
37081,2011,6051,3861,2162,1352,2190,3514,12.288926867,7.8412736129,4.3907882805,2.7457658443,4.4476532536,7.1365541248
37081,2012,6068,3822,1990,1389,2246,3379,12.183858195,7.6741440378,3.9956950903,2.7889550153,4.5097141572,6.7846501056
37081,2013,6212,4053,2338,1465,2159,3803,12.330265323,8.0448431027,4.6407212372,2.9078941884,4.2854222203,7.5486154255
37081,2014,6121,3997,2178,1520,2124,3698,12.010061689,7.8425447753,4.2734707332,2.9824038175,4.1675169134,7.2558745507
37081,2015,6178,4316,1687,1683,1862,3370,11.993054201,8.3784431742,3.2748919451,3.2671269375,3.6146110265,6.5420188826
37081,2016,6081,4331,793,1738,1750,2531,11.697402565,8.3311051651,1.5254136218,3.3432142177,3.3662973999,4.8686278395
37081,2017,6122,4416,1540,1736,1706,3276,11.672636134,8.4198564468,2.9362724022,3.3099797988,3.2527796871,6.246252201
12045,2010,26,17,-52,1,9,-51,NA,NA,NA,NA,NA,NA
12045,2011,127,155,-35,0,-28,-35,8.0420466059,9.8150962513,-2.216312057,0,-1.773049645,-2.216312057
12045,2012,131,169,39,7,-38,46,8.3098100162,10.720289258,2.4739129056,0.4440356497,-2.410479241,2.9179485553
12045,2013,118,204,192,4,-86,196,7.4560849235,12.890180715,12.131934791,0.2527486415,-5.434095792,12.384683432
12045,2014,131,163,145,9,-32,154,8.2159992474,10.222960896,9.0940449685,0.5644579636,-2.006961648,9.658502932
12045,2015,112,183,-5,9,-71,4,7.0118324673,11.456833406,-0.313028235,0.5634508233,-4.445000939,0.2504225881
12045,2016,124,168,194,10,-44,204,7.7403245943,10.486891386,12.109862672,0.6242197253,-2.746566792,12.734082397
12045,2017,118,171,103,10,-53,113,7.3155610663,10.601363918,6.385616863,0.6199628022,-3.285802852,7.0055796652
08051,2010,42,29,10,3,13,13,NA,NA,NA,NA,NA,NA
08051,2011,150,54,-5,-1,96,-6,9.7405759927,3.5066073574,-0.324685866,-0.064937173,6.2339686353,-0.38962304
08051,2012,164,77,-93,-10,87,-103,10.623481781,4.987854251,-6.024291498,-0.647773279,5.6356275304,-6.672064777
08051,2013,150,68,139,-8,82,131,9.6534414519,4.3762267915,8.9455224121,-0.514850211,5.2772146604,8.4306722013
08051,2014,136,55,107,-3,81,104,8.6401321432,3.4941710873,6.7977510244,-0.19059115,5.1459610559,6.6071598742
08051,2015,140,77,264,-3,63,261,8.749726571,4.8123496141,16.499484391,-0.187494141,3.937376957,16.31199025
08051,2016,154,65,238,-3,89,235,9.4313623419,3.9807698196,14.575741801,-0.183727838,5.4505925223,14.392013963
08051,2017,158,67,354,-3,91,351,9.4525874963,4.0083757104,21.178582112,-0.179479509,5.4442117858,20.999102602
19077,2010,19,43,6,1,-24,7,NA,NA,NA,NA,NA,NA
19077,2011,101,130,-53,3,-29,-50,9.2694566814,11.930983847,-4.864170338,0.2753303965,-2.661527166,-4.588839941
19077,2012,110,111,-98,1,-1,-97,10.177646188,10.270170244,-9.067357513,0.0925240563,-0.092524056,-8.974833457
19077,2013,107,107,-93,3,0,-90,9.9869329849,9.9869329849,-8.680231473,0.2800074669,0,-8.400224006
19077,2014,109,124,24,5,-15,29,10.210772834,11.615925059,2.2482435597,0.4683840749,-1.405152225,2.7166276347
19077,2015,115,146,-10,5,-31,-5,10.785463072,13.692848769,-0.937866354,0.468933177,-2.907385698,-0.468933177
19077,2016,111,104,-5,5,7,0,10.425471964,9.768009768,-0.469615854,0.4696158542,0.6574621959,0
19077,2017,106,109,19,5,-3,24,9.9437148218,10.225140713,1.7823639775,0.469043152,-0.281425891,2.2514071295
13135,2010,2901,912,170,839,1989,1009,NA,NA,NA,NA,NA,NA
13135,2011,11720,3479,4183,3534,8241,7717,14.359049754,4.2623834552,5.1249065804,4.3297680744000004,10.096666299,9.4546746548
13135,2012,11461,3424,3728,3311,8037,7039,13.780954843,4.1170918229,4.4826280128,3.9812181734,9.6638630201,8.4638461862
13135,2013,11150,3787,6297,3000,7363,9297,13.156792386,4.4685894857,7.4303427492,3.5399441397,8.6882029002,10.970286889
13135,2014,11625,3772,7492,3353,7853,10845,13.437209222,4.3600131771,8.6599201281,3.8756957007,9.0771960445,12.535615829
13135,2015,11757,4074,6209,3832,7683,10041,13.310245787,4.6122260217,7.0292860503,4.3382548147,8.6980197656,11.367540865
13135,2016,11968,4390,3494,3902,7578,7396,13.303409554,4.8798435782,3.8838663923,4.337391718,8.4235659763,8.2212581104
13135,2017,11700,4475,2095,3881,7225,5976,12.805351542,4.8977733464,2.2929240582,4.2476554988,7.9075781961,6.5405795571
46055,2010,8,4,-11,0,4,-11,NA,NA,NA,NA,NA,NA
46055,2011,21,25,-8,0,-4,-8,10.909090909,12.987012987,-4.155844156,0,-2.077922078,-4.155844156
46055,2012,20,22,6,0,-2,6,10.413954699,11.455350169,3.1241864098,0,-1.04139547,3.1241864098
46055,2013,18,33,-27,0,-15,-27,9.4662108861,17.354719958,-14.19931633,0,-7.888509072,-14.19931633
46055,2014,19,32,-23,0,-13,-23,10.19586799,17.171988194,-12.34236651,0,-6.976120204,-12.34236651
46055,2015,23,27,8,0,-4,8,12.449255751,14.614343708,4.3301759134,0,-2.165087957,4.3301759134
46055,2016,20,17,30,0,3,30,10.718113612,9.1103965702,16.077170418,0,1.6077170418,16.077170418
46055,2017,25,11,47,0,14,47,13.068478829,5.7501306848,24.568740199,0,7.3183481443,24.568740199
13137,2010,115,79,-1,-4,36,-5,NA,NA,NA,NA,NA,NA
13137,2011,517,402,-107,-7,115,-114,12.004551048,9.3342930782,-2.484500894,-0.162537442,2.6702579701,-2.647038336
13137,2012,495,399,249,2,96,251,11.447071747,9.2270335896,5.7582239695,0.0462507949,2.2200381569,5.8044747644
13137,2013,520,449,-309,21,71,-288,12.005772006,10.366522367,-7.134199134,0.4848484848,1.6392496392,-6.649350649
13137,2014,481,390,303,19,91,322,11.079630525,8.9834842098,6.9794761938,0.437656923,2.0961463156,7.4171331168
13137,2015,463,421,131,28,42,159,10.590240053,9.629570329,2.9963746154,0.6404464827,0.960669724,3.6368210981
13137,2016,534,472,267,31,62,298,12.136915314,10.727760353,6.0684576572,0.7045774808,1.4091549616,6.773035138
13137,2017,512,459,306,31,53,337,11.538808257,10.344361309,6.8962408726,0.6986387812,1.1944469485,7.5948796538
02100,2010,2,10,1,2,-8,3,NA,NA,NA,NA,NA,NA
02100,2011,29,16,45,13,13,58,11.426319937,6.3041765169,17.730496454,5.12214342,5.12214342,22.852639874
02100,2012,24,24,-10,13,0,3,9.3167701863,9.3167701863,-3.881987578,5.0465838509,0,1.1645962733
02100,2013,13,20,-12,1,-7,-11,5.0613198365,7.7866459023,-4.671987541,0.3893322951,-2.725326066,-4.282655246
02100,2014,18,21,-2,1,-3,-1,7.0394994134,8.2127493156,-0.782166601,0.3910833007,-1.173249902,-0.391083301
02100,2015,18,17,-42,1,1,-41,7.099191481,6.7047919542,-16.564780120000002,0.3943995267,0.3943995267,-16.1703806
02100,2016,15,10,10,1,5,11,5.9441252229,3.9627501486,3.9627501486,0.3962750149,1.9813750743,4.3590251635
02100,2017,17,6,-18,1,11,-17,6.7233537671,2.3729483884,-7.118845165,0.3954913981,4.3504053787,-6.723353767
01065,2010,55,27,-55,8,28,-47,NA,NA,NA,NA,NA,NA
01065,2011,188,204,-389,8,-16,-381,12.088866026,13.117705688,-25.01366428,0.5144198309,-1.028839662,-24.49924445
01065,2012,201,154,-41,-2,47,-43,13.086789505,10.026694446,-2.669444625,-0.130216811,3.0600950583,-2.799661436
01065,2013,204,181,-138,0,23,-138,13.329848406,11.82697334,-9.017250392,0,1.5028750653,-9.017250392
01065,2014,186,181,-208,-1,5,-209,12.278848693,11.948772115,-13.73118564,-0.066015316,0.3300765778,-13.79720095
01065,2015,212,179,-62,-1,33,-63,14.102308255,11.907137631,-4.124259961,-0.066520322,2.1951706246,-4.190780283
01065,2016,198,180,-190,-1,18,-191,13.259668508,12.054244098,-12.72392433,-0.066968023,1.2054244098,-12.79089235
01065,2017,187,195,-24,-1,-8,-25,12.610000337,13.149465592,-1.618395765,-0.067433157,-0.539465255,-1.685828922
48189,2010,165,98,-6,5,67,-1,NA,NA,NA,NA,NA,NA
48189,2011,555,316,-158,26,239,-132,15.27053612,8.6945755204,-4.34728776,0.7153764669,6.5759605993,-3.631911293
48189,2012,557,273,-434,17,284,-417,15.330204907,7.5137270013,-11.94489934,0.467887762,7.8164779061,-11.47701157
48189,2013,535,304,-836,26,231,-810,14.86689268,8.4477296727,-23.2312566,0.7225031957,6.4191630078,-22.5087534
48189,2014,495,301,-1479,36,194,-1443,14.103970481,8.5763537675,-42.14095423,1.0257433077,5.5276167139,-41.11521092
48189,2015,459,321,-585,48,138,-537,13.384070332,9.360101474,-17.05812885,1.3996413419,4.023968858,-15.65848751
48189,2016,461,313,-88,49,148,-39,13.497686947,9.1643731335,-2.57656497,1.4346782222,4.3333138139,-1.141886748
48189,2017,456,294,-285,49,162,-236,13.344453711,8.6036609455,-8.34028357,1.4339434909,4.7407927659,-6.906340079
37083,2010,157,176,-144,6,-19,-138,NA,NA,NA,NA,NA,NA
37083,2011,602,648,-333,17,-46,-316,11.086249919,11.933372006,-6.132427281,0.3130668582,-0.847122087,-5.819360423
37083,2012,601,632,-359,18,-31,-341,11.142939252,11.717699845,-6.656098488,0.3337319576,-0.574760594,-6.32236653
37083,2013,559,672,-438,16,-113,-422,10.451919301,12.564740198,-8.189518165,0.2991604809,-2.112820896,-7.890357684
37083,2014,569,686,-245,23,-117,-222,10.726640337,12.932293974,-4.618676419,0.4335900312,-2.205653637,-4.185086388
37083,2015,590,665,-604,29,-75,-575,11.226975186,12.654133049,-11.49337799,0.5518343736,-1.427157863,-10.94154361
37083,2016,568,643,-312,30,-75,-282,10.912479227,12.353387576,-5.99417873,0.5763633394,-1.440908349,-5.417815391
37083,2017,553,683,-463,32,-130,-431,10.719027728,13.238871498,-8.974520503,0.6202692356,-2.51984377,-8.354251267
51083,2010,95,124,-21,0,-29,-21,NA,NA,NA,NA,NA,NA
51083,2011,339,486,-58,-2,-147,-60,9.3955267315,13.46969319,-1.607494249,-0.055430836,-4.074166459,-1.662925085
51083,2012,346,425,-177,-2,-79,-179,9.6522673064,11.856108686,-4.937720558,-0.055793453,-2.203841379,-4.993514011
51083,2013,349,468,-223,-4,-119,-227,9.8189542392,13.166964424,-6.274002279,-0.112538157,-3.348010185,-6.386540436
51083,2014,373,492,-58,-6,-119,-64,10.573911071,13.947357231,-1.644200649,-0.170089722,-3.37344616,-1.814290372
51083,2015,393,469,-26,-5,-76,-31,11.188452833,13.352123101,-0.740202986,-0.142346728,-2.163670268,-0.882549715
51083,2016,389,451,-35,-5,-62,-40,11.108889968,12.879458549,-0.999514522,-0.142787789,-1.770568581,-1.14230231
51083,2017,393,491,-298,-5,-98,-303,11.304960663,14.124009378,-8.572209358,-0.143829016,-2.819048715,-8.716038374
13139,2010,635,221,-97,54,414,-43,NA,NA,NA,NA,NA,NA
13139,2011,2612,1192,802,200,1420,1002,14.410000938,6.5760800605,4.424510242,1.1033691377,7.8339208774,5.5278793797
13139,2012,2547,1256,531,139,1291,670,13.885103089,6.8471493834,2.8947741422,0.7577657359,7.0379537054,3.6525398781
13139,2013,2470,1322,1087,140,1148,1227,13.309408728,7.1234973031,5.8572175253,0.7543794421,6.1859114251,6.6115969674
13139,2014,2433,1367,1453,182,1066,1635,12.933062233,7.2665417481,7.7236906803,0.967454717,5.6665204853,8.6911453973
13139,2015,2619,1478,1640,234,1141,1874,13.712544439,7.7385035054,8.5867021304,1.2251757918,5.9740409334,9.8118779222
13139,2016,2720,1543,2302,249,1177,2551,13.993821111,7.938406608,11.843300072,1.2810520061,6.0554145026,13.124352078
13139,2017,2700,1539,1682,247,1161,1929,13.651117875,7.7811371887,8.5041408391,1.2488244871,5.8699806862,9.7529653262
31079,2010,221,105,22,70,116,92,NA,NA,NA,NA,NA,NA
31079,2011,933,568,111,271,365,382,15.765860912,9.5980803839,1.8756812018,4.579365817,6.1677805284,6.4550470188
31079,2012,898,513,14,249,385,263,14.999665932,8.5688514732,0.2338477985,4.1591501303,6.4308144585,4.3929979288
31079,2013,905,528,-231,282,377,51,14.983443709,8.7417218543,-3.824503311,4.6688741722,6.2417218543,0.8443708609
31079,2014,1016,491,-238,310,525,72,16.681032714,8.0614045889,-3.90756475,5.0896851783,8.6196281246,1.1821204285
31079,2015,1011,557,-711,348,454,-363,16.505852966,9.093729082,-11.60797375,5.6815398932,7.4121238837,-5.926433854
31079,2016,958,547,-547,367,411,-180,15.598795083,8.9066189042,-8.906618904,5.975738826,6.6921761785,-2.930880078
31079,2017,963,539,-802,366,424,-436,15.652301116,8.7607375923,-13.03545742,5.9488496453,6.8915635235,-7.086607774
48191,2010,6,5,3,2,1,5,NA,NA,NA,NA,NA,NA
48191,2011,38,39,-51,4,-1,-47,11.396011396,11.695906433,-15.29464687,1.1995801469,-0.299895037,-14.09506673
48191,2012,38,62,-20,-1,-24,-21,11.555420404,18.85358066,-6.081800213,-0.304090011,-7.298160255,-6.385890224
48191,2013,23,58,-69,-1,-35,-70,7.1550785503,18.043241562,-21.46523565,-0.311090372,-10.88816301,-21.77632602
48191,2014,38,45,-85,-1,-7,-86,12.191209496,14.436958614,-27.26981072,-0.320821303,-2.245749118,-27.59063202
48191,2015,26,60,57,0,-34,57,8.4374492942,19.471036833,18.497484991,0,-11.03358754,18.497484991
48191,2016,22,36,33,0,-14,33,7.0921985816,11.605415861000001,10.638297872,0,-4.513217279,10.638297872
48191,2017,20,27,-33,0,-7,-33,6.4693514475,8.7336244541,-10.67442989,0,-2.264273007,-10.67442989
47063,2010,172,210,17,8,-38,25,NA,NA,NA,NA,NA,NA
47063,2011,798,676,105,69,122,174,12.735905518,10.788812193,1.6757770419,1.1012249132,1.9470933248,2.7770019551
47063,2012,762,671,-285,78,91,-207,12.144974658,10.694590545,-4.542411782,1.2431863823,1.4503841127,-3.299225399
47063,2013,803,753,167,104,50,271,12.778485041,11.982813495,2.6575429663,1.6549968173,0.7956715468,4.3125397836
47063,2014,786,794,-132,108,-8,-24,12.481242408,12.608277954,-2.096086511,1.7149798728,-0.127035546,-0.381106638
47063,2015,803,752,262,129,51,391,12.712132725,11.904761905,4.1476697062,2.0421732523,0.8073708207,6.1898429585
47063,2016,733,732,200,134,1,334,11.534134271,11.518398754,3.1471034846,2.1085593347,0.0157355174,5.2556628193
47063,2017,756,712,385,135,44,520,11.813053737,11.125521509,6.0159069956,2.1094738816,0.6875322281,8.1253808772
12047,2010,39,13,-156,1,26,-155,NA,NA,NA,NA,NA,NA
12047,2011,181,125,-162,12,56,-150,12.365921979,8.5400013664,-11.06784177,0.8198401312,3.8259206121,-10.24800164
12047,2012,149,137,103,11,12,114,10.166484716,9.3477074236,7.0278384279,0.7505458515,0.8187772926,7.7783842795
12047,2013,136,124,-410,6,12,-404,9.3596228623,8.5337737862,-28.2165101,0.412924538,0.8258490761,-27.80358556
12047,2014,158,156,-289,8,2,-281,11.122452571,10.981662032,-20.34423287,0.5631621555,0.1407905389,-19.78107071
12047,2015,154,151,183,12,3,195,10.866880711,10.65518823,12.913241365,0.8467699256,0.2116924814,13.76001129
12047,2016,162,130,8,12,32,20,11.33025598,9.0921807246,0.5595188138,0.8392782207,2.2380752553,1.3987970346
12047,2017,161,109,-204,12,52,-192,11.295075067,7.6469762874,-14.31177213,0.8418689491,3.6480987793,-13.46990319
17065,2010,25,41,6,0,-16,6,NA,NA,NA,NA,NA,NA
17065,2011,91,112,0,0,-21,0,10.789021282,13.278795424,0,0,-2.489774142,0
17065,2012,97,116,-19,1,-19,-18,11.540749554,13.801308745,-2.260559191,0.1189767995,-2.260559191,-2.141582391
17065,2013,79,109,-7,0,-30,-7,9.4424191717,13.028147971,-0.836670053,0,-3.585728799,-0.836670053
17065,2014,73,111,5,0,-38,5,8.7645575699,13.326930004,0.6003121623,0,-4.562372434,0.6003121623
17065,2015,90,99,-56,0,-9,-56,10.870878125,11.957965938,-6.764101945,0,-1.087087813,-6.764101945
17065,2016,90,86,-51,0,4,-51,10.945576163,10.459106111,-6.202493159,0,0.4864700517,-6.202493159
17065,2017,90,100,5,0,-10,5,10.980296468,12.200329409,0.6100164704,0,-1.220032941,0.6100164704
18057,2010,1008,345,1010,156,663,1166,NA,NA,NA,NA,NA,NA
18057,2011,3842,1265,3568,594,2577,4162,13.72758147,4.519883019,12.748571235,2.1223798524,9.2076984506,14.870951087
18057,2012,3809,1387,3248,618,2422,3866,13.297909481,4.8422684299,11.339356785,2.1575500286,8.4556410507,13.496906813
18057,2013,3695,1431,4204,673,2264,4877,12.602577133,4.8807274364,14.338629031,2.2954085009,7.7218496968,16.634037531
18057,2014,4016,1481,2785,712,2535,3497,13.39521728,4.9398199184,9.2892629795,2.3748492788,8.455397362,11.664112258
18057,2015,3831,1596,2935,775,2235,3710,12.527754978,5.2190803823,9.5977449387,2.5343278799,7.3086745956,12.132072819
18057,2016,3922,1602,4400,796,2320,5196,12.548994513,5.1258259075,14.078423217,2.5469147455,7.4231686051,16.625337962
18057,2017,3901,1744,4493,792,2157,5285,12.189805997,5.4496338527,14.039681709,2.4748337221,6.7401721447,16.514515431
19079,2010,38,53,-26,0,-15,-26,NA,NA,NA,NA,NA,NA
19079,2011,160,158,-168,-6,2,-174,10.291705529,10.163059209,-10.80629081,-0.385938957,0.1286463191,-11.19222976
19079,2012,172,170,-158,8,2,-150,11.176814608,11.046851647,-10.26707388,0.5198518422,0.1299629606,-9.747222042
19079,2013,160,172,18,18,-12,36,10.438413361,11.221294363,1.1743215031,1.1743215031,-0.782881002,2.3486430063
19079,2014,212,179,-180,24,33,-156,13.875253616,11.715426402,-11.78087571,1.5707834282,2.1598272138,-10.21009228
19079,2015,193,167,-36,25,26,-11,12.676518883,10.968801314,-2.36453202,1.6420361248,1.7077175698,-0.722495895
19079,2016,191,169,-183,28,22,-155,12.593960174,11.14334696,-12.06646446,1.8462349993,1.4506132138,-10.22022946
19079,2017,189,167,-35,29,22,-6,12.510342545,11.054112196,-2.316730101,1.9195763694,1.4562303492,-0.397153732
20075,2010,19,1,1,1,18,2,NA,NA,NA,NA,NA,NA
20075,2011,46,35,-86,8,11,-78,17.180205415,13.071895425,-32.11951447,2.9878618114,4.1083099907,-29.13165266
20075,2012,50,31,-10,8,19,-2,18.839487566,11.680482291,-3.767897513,3.0143180106,7.1590052751,-0.753579503
20075,2013,26,33,-36,9,-7,-27,9.8261526833,12.471655329,-13.60544218,3.4013605442,-2.645502646,-10.20408163
20075,2014,45,24,-20,16,21,-4,17.058377559,9.0978013647,-7.581501137,6.0652009098,7.9605761941,-1.516300227
20075,2015,41,26,-128,25,15,-103,15.74500768,9.9846390169,-49.15514593,9.6006144393,5.7603686636,-39.55453149
20075,2016,31,20,32,25,11,57,11.946050096,7.7071290944,12.331406551,9.633911368,4.2389210019,21.965317919
20075,2017,35,14,-36,25,21,-11,13.285253369,5.3141013475,-13.66483204,9.489466692,7.9711520213,-4.175365344
31081,2010,22,16,6,0,6,6,NA,NA,NA,NA,NA,NA
31081,2011,89,81,-58,1,8,-57,9.7791451489,8.9001208658,-6.372926052,0.1098780354,0.879024283,-6.263048017
31081,2012,99,75,-62,0,24,-62,10.929565025,8.2799735041,-6.844778097,0,2.6495915213,-6.844778097
31081,2013,111,79,51,1,32,52,12.222650443,8.6990034686,5.6158123658,0.110113968,3.5236469746,5.7259263338
31081,2014,96,100,-16,0,-4,-16,10.534401405,10.973334796,-1.755733567,0,-0.438933392,-1.755733567
31081,2015,92,91,38,0,1,38,10.084954782,9.9753357084,4.1655248013,0,0.1096190737,4.1655248013
31081,2016,107,62,-16,0,45,-16,11.686325907,6.7715159458,-1.747487986,0,4.9148099607,-1.747487986
31081,2017,111,67,-7,0,44,-7,12.080317789,7.2917233498,-0.761821843,0,4.7885944387,-0.761821843
36041,2010,10,4,5,0,6,5,NA,NA,NA,NA,NA,NA
36041,2011,37,49,-14,0,-12,-14,7.6438384464,10.122921186,-2.892263196,0,-2.479082739,-2.892263196
36041,2012,36,67,7,0,-31,7,7.4750830565,13.911960133,1.4534883721,0,-6.436877076,1.4534883721
36041,2013,35,58,-12,0,-23,-12,7.312996239,12.118679482,-2.507312996,0,-4.805683243,-2.507312996
36041,2014,22,72,-15,0,-50,-15,4.6457607433,15.204307887,-3.167564143,0,-10.55854714,-3.167564143
36041,2015,30,54,26,0,-24,26,6.3782289784,11.480812161,5.527798448,0,-5.102583183,5.527798448
36041,2016,35,57,-116,0,-22,-116,7.5512405609,12.297734628,-25.02696872,0,-4.746494067,-25.02696872
36041,2017,29,67,-43,0,-38,-43,6.4081316982,14.804993923,-9.501712518,0,-8.396862225,-9.501712518
39061,2010,2658,1737,-1323,316,921,-1007,NA,NA,NA,NA,NA,NA
39061,2011,10919,7687,-6490,1533,3232,-4957,13.624090396,9.5913895849,-8.097842904,1.912787854,4.0327008115,-6.18505505
39061,2012,11072,7595,-3332,1609,3477,-1723,13.814658735,9.4763667897,-4.157373817,2.0075673686,4.3382919457,-2.149806449
39061,2013,10970,7618,-2940,1730,3352,-1210,13.655088886,9.4826314613,-3.659613612,2.153446105,4.1724574243,-1.506167507
39061,2014,10935,7772,-2749,2060,3163,-689,13.573742288,9.6474737137,-3.412365574,2.557101885,3.9262685739,-0.855263689
39061,2015,11099,8152,-3495,2228,2947,-1267,13.743232241,10.09413724,-4.327650841,2.7588000211,3.6490950009,-1.56885082
39061,2016,10647,7828,-3430,2299,2819,-1131,13.156691538,9.6732019683,-4.238513382,2.840916112,3.4834895693,-1.39759727
39061,2017,10787,7768,-1533,2288,3019,755,13.285227189,9.5670385471,-1.88803683,2.8178918893,3.7181886423,0.9298550596
47065,2010,1076,836,455,79,240,534,NA,NA,NA,NA,NA,NA
47065,2011,4051,3191,2380,500,860,2880,11.94462013,9.4088577717,7.0175748971,1.4742804406,2.5357623578,8.4918553377
47065,2012,4120,3327,3420,377,793,3797,11.998928251,9.6894257989,9.9602753929,1.0979601822,2.3095024522,11.058235575
47065,2013,4216,3320,1951,374,896,2325,12.139151066,9.5592935337,5.6175246037,1.0768601752,2.579857532,6.6943847788
47065,2014,4098,3358,562,421,740,983,11.716588923,9.6008554425,1.6068138054,1.2036808044,2.1157334805,2.8104946099
47065,2015,4223,3480,1919,492,743,2411,11.991197558,9.8814509832,5.4489955278,1.3970327252,2.1097465749,6.846028253
47065,2016,4352,3451,2890,521,901,3411,12.227999365,9.6964213715,8.1201558283,1.4638758431,2.5315779935,9.5840316714
47065,2017,4335,3553,2246,517,782,2763,12.047121335,9.8739151338,6.2417149987,1.4367616449,2.1732062017,7.6784766436
48193,2010,21,54,-15,0,-33,-15,NA,NA,NA,NA,NA,NA
48193,2011,98,144,-31,-1,-46,-32,11.6334283,17.094017094,-3.679962013,-0.118708452,-5.460588794,-3.798670465
48193,2012,84,117,-113,0,-33,-113,10.106478975,14.076881429,-13.59562053,0,-3.970402454,-13.59562053
48193,2013,101,125,7,8,-24,15,12.266958159,15.181878909,0.8501852189,0.9716402502,-2.914920751,1.8218254691
48193,2014,75,149,-16,10,-74,-6,9.158627427,18.195139822,-1.953840518,1.2211503236,-9.036512395,-0.732690194
48193,2015,86,145,-31,11,-59,-20,10.604192355,17.879161529,-3.82244143,1.356350185,-7.274969174,-2.466091245
48193,2016,91,141,201,11,-50,212,11.164959205,17.299552175,24.661063738,1.3496104533,-6.13459297,26.010674192
48193,2017,93,122,209,11,-29,220,11.16915871,14.652014652,25.100582478,1.3210832883,-3.482855942,26.421665766
46057,2010,29,16,6,0,13,6,NA,NA,NA,NA,NA,NA
46057,2011,113,79,-25,6,34,-19,19.055649241,13.322091062,-4.215851602,1.0118043845,5.7335581788,-3.204047218
46057,2012,114,75,-82,5,39,-77,19.260010137,12.671059301,-13.8536915,0.8447372867,6.5889508363,-13.00895422
46057,2013,114,75,-60,3,39,-57,19.344985576,12.726964195,-10.18157136,0.5090785678,6.6180213813,-9.672492788
46057,2014,126,59,-41,0,67,-41,21.363173957,10.00339098,-6.951508986,0,11.359782977,-6.951508986
46057,2015,118,64,-31,0,54,-31,19.925700777,10.807159743,-5.234718001,0,9.1185410334,-5.234718001
46057,2016,115,61,-109,0,54,-109,19.47337228,10.329353992,-18.45737025,0,9.144018288,-18.45737025
46057,2017,110,65,24,0,45,24,18.603077964,10.992727888,4.0588533739,0,7.6103500761,4.0588533739
25013,2010,1328,1063,-144,483,265,339,NA,NA,NA,NA,NA,NA
25013,2011,5535,4236,-2159,2759,1299,600,11.900321104,9.107454417,-4.641877735,5.931885443,2.7928666874,1.2900077078
25013,2012,5428,4202,-3196,2676,1226,-520,11.637455111,9.0089510639,-6.852119848,5.7372567937,2.6285040467,-1.114863054
25013,2013,5362,4444,-2501,2476,918,-25,11.476109809,9.5113450185,-5.352806906,5.2993002398,1.96476479,-0.053506666
25013,2014,5330,4358,-1915,2927,972,1012,11.373250669,9.2991794402,-4.086261732,6.2456856865,2.074071229,2.1594239545
25013,2015,5176,4455,-3517,3010,721,-507,11.019283747,9.4843332865,-7.487407445,6.40804561,1.5349504601,-1.079361835
25013,2016,4985,4441,-4491,3114,544,-1377,10.619544435,9.4606613516,-9.567176341,6.633753535,1.1588830838,-2.933422806
25013,2017,5004,4345,-2952,3101,659,149,10.660179097,9.2562906028,-6.288738748,6.6061581494,1.4038884942,0.3174194016
25015,2010,301,272,922,138,29,1060,NA,NA,NA,NA,NA,NA
25015,2011,1125,1202,233,665,-77,898,7.0447892043,7.5269658876,1.4590541196,4.1642531741,-0.482176683,5.6233072937
25015,2012,1121,1150,-374,644,-29,270,6.9970226763,7.1780339677,-2.334421482,4.0196990219,-0.181011291,1.6852775402
25015,2013,1085,1278,-71,711,-193,640,6.7582508277,7.9604097306,-0.442244985,4.428678653,-1.202158903,3.9864336679
25015,2014,1110,1238,-541,788,-128,247,6.9023626601,7.6983107867,-3.364124504,4.9000556542,-0.795948127,1.5359311505
25015,2015,1048,1264,-618,832,-216,214,6.5147592243,7.8574958583,-3.841718703,5.1720225903,-1.342736634,1.3303038874
25015,2016,1011,1203,139,848,-192,987,6.269339766,7.45995622,0.8619567037,5.2585560055,-1.190616454,6.1205127092
25015,2017,1016,1231,-456,847,-215,391,6.2814536372,7.6106982553,-2.819235097,5.236605542,-1.329244618,2.417370445
54027,2010,64,81,11,0,-17,11,NA,NA,NA,NA,NA,NA
54027,2011,201,254,-114,-7,-53,-121,8.4192008042,10.639189076,-4.775069113,-0.293205998,-2.219988272,-5.068275111
54027,2012,231,257,-70,-8,-26,-78,9.7330777172,10.828575642,-2.94941749,-0.337076285,-1.095497925,-3.286493775
54027,2013,223,263,-142,-8,-40,-150,9.4551621794,11.151155395,-6.020775917,-0.339198643,-1.695993216,-6.35997456
54027,2014,244,256,-30,-7,-12,-37,10.398687379,10.910098234,-1.278527137,-0.298322999,-0.511410855,-1.576850135
54027,2015,229,255,-88,-7,-26,-95,9.7953247642,10.907457707,-3.764142267,-0.299420408,-1.112132943,-4.063562675
54027,2016,249,270,55,-7,-21,48,10.672724545,11.572833844,2.3574291164,-0.300036433,-0.900109299,2.0573926834
54027,2017,235,254,155,-7,-19,148,10.039731704,10.851454693,6.6219506985,-0.299055838,-0.811722989,6.3228948605
51650,2010,480,206,-400,68,274,-332,NA,NA,NA,NA,NA,NA
51650,2011,1825,1165,-1583,118,660,-1465,13.325544887,8.5064437224,-11.55854113,0.8615968749,4.8191011646,-10.69694425
51650,2012,1868,1111,-668,448,757,-220,13.651677592,8.1193864053,-4.881863293,3.274064005,5.5322911871,-1.607799288
51650,2013,1896,1181,-860,354,715,-506,13.819241983,8.6078717201,-6.268221574,2.5801749271,5.2113702624,-3.688046647
51650,2014,1860,1269,-520,327,591,-193,13.528453392,9.2298964273,-3.78214826,2.3783893867,4.298556965,-1.403758874
51650,2015,1745,1294,-2251,401,451,-1850,12.738574521,9.4462552606,-16.43239613,2.9273171248,3.2923192601,-13.505079
51650,2016,1605,1249,-1652,334,356,-1318,11.817632939,9.1964009601,-12.16369446,2.4592457331,2.621231979,-9.704448731
51650,2017,1595,1258,-1258,261,337,-997,11.814771056,9.3184840056,-9.318484006,1.9333261729,2.4962870508,-7.385157833
45049,2010,64,28,-57,1,36,-56,NA,NA,NA,NA,NA,NA
45049,2011,242,205,-325,4,37,-321,11.560693642,9.7931495724,-15.52572493,0.1910858453,1.7675440692,-15.33463909
45049,2012,224,197,-79,1,27,-78,10.786084026,9.4859756832,-3.804020705,0.0481521608,1.3001083424,-3.755868545
45049,2013,215,253,-318,-2,-38,-320,10.454401789,12.302156524,-15.46278962,-0.097250249,-1.847754735,-15.56003987
45049,2014,220,189,11,5,31,16,10.778501788,9.2597128999,0.5389250894,0.2449659497,1.5187888883,0.7838910391
45049,2015,220,226,-406,5,-6,-401,10.874131923,11.170699157,-20.06771619,0.2471393619,-0.296567234,-19.82057682
45049,2016,214,234,-141,5,-20,-136,10.725472998,11.727853652,-7.066783611,0.2505951635,-1.002380654,-6.816188448
45049,2017,203,234,-247,5,-31,-242,10.284729963,11.855304489,-12.51393252,0.253318472,-1.570574526,-12.26061404
13141,2010,25,4,9,0,21,9,NA,NA,NA,NA,NA,NA
13141,2011,96,88,-47,2,8,-45,10.196494955,9.346787042,-4.992033988,0.2124269782,0.8497079129,-4.77960701
13141,2012,90,92,-329,5,-2,-324,9.741841208,9.9583265682,-35.61184175,0.5412134004,-0.21648536,-35.07062835
13141,2013,79,86,-128,9,-7,-119,8.7592859519,9.5354252134,-14.19226078,0.9978933363,-0.776139262,-13.19436745
13141,2014,62,85,-380,8,-23,-372,7.0727812001,9.6965548711,-43.34930413,0.912616929,-2.623773671,-42.4366872
13141,2015,65,105,44,8,-40,52,7.5748747232,12.236336091,5.127607505,0.9322922736,-4.661461368,6.0598997786
13141,2016,70,100,92,8,-30,100,8.1187659476,11.598237068,10.670378103,0.9278589654,-3.47947112,11.598237068
13141,2017,66,115,-53,8,-49,-45,7.6663956325,13.358113602,-6.156348008,0.9292600767,-5.69171797,-5.227087931
17067,2010,44,60,6,0,-16,6,NA,NA,NA,NA,NA,NA
17067,2011,185,171,-112,1,14,-111,9.7146007824,8.9794418043,-5.881271825,0.0525113556,0.7351589781,-5.828760469
17067,2012,189,211,-151,2,-22,-149,9.9941832796,11.157527365,-7.984770768,0.1057585532,-1.163344085,-7.879012215
17067,2013,189,211,-269,6,-22,-263,10.115606936,11.293084993,-14.39734532,0.3211303789,-1.177478056,-14.07621494
17067,2014,194,208,-212,5,-14,-207,10.524602615,11.28411002,-11.50111214,0.2712526447,-0.759507405,-11.22985949
17067,2015,219,199,-132,5,20,-127,11.986535672,10.89187488,-7.224761227,0.273665198,1.094660792,-6.951096029
17067,2016,204,201,-5,6,3,1,11.197716544,11.033044242,-0.274453837,0.3293446042,0.1646723021,0.0548907674
17067,2017,216,218,-204,6,-2,-198,11.920858743,12.031237065,-11.25858881,0.3311349651,-0.110378322,-10.92745385
18059,2010,204,118,103,1,86,104,NA,NA,NA,NA,NA,NA
18059,2011,783,618,-30,-15,165,-45,11.140436369,8.7928348356,-0.426836643,-0.213418321,2.3476015338,-0.640254964
18059,2012,747,608,102,-2,139,100,10.60266273,8.6297442303,1.4477531439,-0.028387317,1.9729185,1.4193658273
18059,2013,777,615,258,-8,162,250,10.979538775,8.6903685281,3.6457155777,-0.113045444,2.2891702464,3.5326701334
18059,2014,753,581,609,-6,172,603,10.552277919,8.1419302401,8.5343124203,-0.084081896,2.4103476786,8.4502305245
18059,2015,782,621,499,-6,161,493,10.850035034,8.6162042915,6.9234878284,-0.083248351,2.2338307422,6.8402394778
18059,2016,820,653,1224,-7,167,1217,11.219121762,8.9342518419,16.746591508,-0.095772991,2.2848699198,16.650818517
18059,2017,847,606,972,-7,241,965,11.387010473,8.1470228412,13.067501983,-0.094107525,3.2399876316,12.973394458
19081,2010,29,47,-24,0,-18,-24,NA,NA,NA,NA,NA,NA
19081,2011,101,107,0,1,-6,1,8.9404266619,9.4715411171,0,0.0885190759,-0.531114455,0.0885190759
19081,2012,103,130,-91,3,-27,-88,9.1665554221,11.569438882,-8.098607218,0.2669870511,-2.40288346,-7.831620166
19081,2013,120,142,-26,2,-22,-24,10.756543564,12.728576551,-2.330584439,0.1792757261,-1.972032987,-2.151308713
19081,2014,102,128,-73,2,-26,-71,9.201623816,11.547135769,-6.585475868,0.1804239964,-2.345511953,-6.405051872
19081,2015,120,115,-21,3,5,-18,10.879419764,10.426110607,-1.903898459,0.2719854941,0.4533091568,-1.631912965
19081,2016,121,110,-144,3,11,-141,11.042160978,10.038328162000001,-13.14108414,0.2737725862,1.0038328162,-12.86731155
19081,2017,115,123,-118,3,-8,-115,10.616691285,11.355243722,-10.89364845,0.276957164,-0.738552437,-10.61669129
21091,2010,25,31,-7,0,-6,-7,NA,NA,NA,NA,NA,NA
21091,2011,104,83,21,-2,21,19,12.135355893,9.6849474912,2.4504084014,-0.233372229,2.4504084014,2.2170361727
21091,2012,114,65,7,-1,49,6,13.231197772,7.5441039926,0.8124419684,-0.116063138,5.687093779,0.6963788301
21091,2013,105,95,-22,-1,10,-23,12.157702773,10.999826319,-2.5473282,-0.115787645,1.1578764546,-2.663115846
21091,2014,104,82,36,-1,22,35,12.012705746,9.4715564539,4.1582442969,-0.115506786,2.5411492925,4.0427375108
21091,2015,124,75,-89,-1,49,-90,14.310444316,8.6555106751,-10.271206,-0.115406809,5.6549336411,-10.38661281
21091,2016,140,91,44,-1,49,43,16.108618111,10.470601772,5.0627085491,-0.115061558,5.6380163387,4.9476469911
21091,2017,129,78,15,-1,51,14,14.710913445,8.8949709203,1.7105713308,-0.114038089,5.8159425248,1.5965332421
23009,2010,132,137,-76,20,-5,-56,NA,NA,NA,NA,NA,NA
23009,2011,453,529,176,67,-76,243,8.321011012,9.7170305196,3.2328872806,1.230701408,-1.396019508,4.4635886886
23009,2012,445,538,14,77,-93,91,8.1626663487,9.8685719003,0.2568029863,1.4124164244,-1.705905552,1.6692194106
23009,2013,488,573,136,68,-85,204,8.9432980244,10.501044607,2.4923945314,1.2461972657,-1.557746582,3.7385917971
23009,2014,471,601,-28,69,-130,41,8.6310369155,11.013276404,-0.513097736,1.2644194207,-2.382239488,0.7513216848
23009,2015,481,611,-152,72,-130,-80,8.8400430056,11.229243818,-2.793527104,1.3232496807,-2.389200812,-1.470277423
23009,2016,454,630,201,72,-176,273,8.3531121782,11.591323067,3.6981840261,1.3247226362,-3.238210888,5.0229066623
23009,2017,458,624,196,72,-166,268,8.4117728087,11.460581294,3.5997979705,1.3223747647,-3.048808485,4.9221727352
28045,2010,120,134,58,19,-14,77,NA,NA,NA,NA,NA,NA
28045,2011,430,419,606,8,11,614,9.6866481945,9.4388502174,13.651415828,0.1802167106,0.2477979771,13.831632538
28045,2012,479,391,396,37,88,433,10.651782339,8.6948786942,8.8060664013,0.8227890324,1.9569036446999999,9.6288554337
28045,2013,476,463,223,23,13,246,10.49382716,10.207231041,4.9162257496,0.5070546737,0.2865961199,5.4232804233
28045,2014,519,485,394,18,34,412,11.353195957,10.609441309,8.6188038675,0.393752461,0.7437546485,9.0125563285
28045,2015,522,515,276,32,7,308,11.323947328,11.172093629,5.9873744495,0.694188342,0.1518536998,6.6815627915
28045,2016,478,483,383,14,-5,397,10.290413554,10.398053863,8.2452476804,0.3013928656,-0.107640309,8.546640546
28045,2017,473,484,416,0,-11,416,10.096051227,10.330843116,8.8794023479,0,-0.234791889,8.8794023479
39063,2010,217,173,-164,16,44,-148,NA,NA,NA,NA,NA,NA
39063,2011,876,715,33,35,161,68,11.712012835,9.5594625309,0.441205963,0.4679457183,2.1525503042,0.9091516813
39063,2012,885,659,244,81,226,325,11.772843973,8.7664453993,3.245846248,1.0775145331,3.006398574,4.3233607811
39063,2013,922,736,-209,104,186,-105,12.21523725,9.7509919912,-2.768963758,1.377857564,2.4642452586,-1.391106194
39063,2014,953,688,-718,114,265,-604,12.647224711,9.1304203577,-9.528549152,1.5128894197,3.5168043529,-8.015659733
39063,2015,939,747,2,121,192,123,12.463333378,9.914920163,0.026545971,1.6060312446,2.5484132146,1.6325772156
39063,2016,906,746,-191,129,160,-62,11.993407597,9.8753665204,-2.528411535,1.7076706181,2.1180410768,-0.820740917
39063,2017,895,699,-157,127,196,-30,11.827360186,9.23723438,-2.07474363,1.6782958029,2.5901258061,-0.396447827
47067,2010,13,37,12,0,-24,12,NA,NA,NA,NA,NA,NA
47067,2011,64,104,-63,0,-40,-63,9.4807792015,15.406266203,-9.332642027,0,-5.925487001,-9.332642027
47067,2012,69,90,-18,-1,-21,-19,10.33011453,13.47406243,-2.694812486,-0.149711805,-3.1439479,-2.844524291
47067,2013,75,105,-5,1,-30,-4,11.290079783,15.806111697,-0.752671986,0.1505343971,-4.516031913,-0.602137588
47067,2014,61,86,23,1,-25,24,9.2075471698,12.981132075,3.4716981132,0.1509433962,-3.773584906,3.6226415094
47067,2015,67,123,12,1,-56,13,10.149208513,18.632129062,1.8177686889,0.1514807241,-8.482920548,1.969249413
47067,2016,76,87,28,1,-11,29,11.53612629,13.20582878,4.2501517911,0.1517911354,-1.669702489,4.4019429265
47067,2017,68,86,22,1,-18,23,10.305372433,13.033265136,3.3340910813,0.1515495946,-2.727892703,3.4856406759
54029,2010,70,77,4,-1,-7,3,NA,NA,NA,NA,NA,NA
54029,2011,303,378,16,1,-75,17,9.8908093816,12.339029526,0.522286964,0.0326429353,-2.448220144,0.5549298993
54029,2012,295,412,-55,8,-117,-47,9.6661096366,13.499787018,-1.802156034,0.2621317868,-3.833677381,-1.540024247
54029,2013,291,388,14,9,-97,23,9.5734706298,12.764627506,0.460579343,0.2960867205,-3.191156877,0.7566660635
54029,2014,274,404,-6,13,-130,7,9.044993893,13.336414353,-0.19806556,0.429142046,-4.29142046,0.2310764863
54029,2015,290,438,-142,15,-148,-127,9.6380737146,14.556814783,-4.719332646,0.4985210542,-4.918741068,-4.220811592
54029,2016,251,405,-190,15,-154,-175,8.4269191385,13.597220124,-6.378942774,0.5036007453,-5.170300985,-5.875342029
54029,2017,261,420,-27,15,-159,-12,8.837122687,14.220657198,-0.914185106,0.5078806142,-5.38353451,-0.406304491
46059,2010,12,15,7,0,-3,7,NA,NA,NA,NA,NA,NA
46059,2011,45,48,-2,0,-3,-2,13.11379863,13.988051872,-0.582835495,0,-0.874253242,-0.582835495
46059,2012,31,38,-55,0,-7,-55,9.1189880865,11.178114429,-16.17884983,0,-2.059126342,-16.17884983
46059,2013,34,50,15,0,-16,15,10.090517881,14.838996884,4.4516990651,0,-4.748479003,4.4516990651
46059,2014,38,42,-33,0,-4,-33,11.339898538,12.533572068,-9.847806625,0,-1.19367353,-9.847806625
46059,2015,31,43,-22,0,-12,-22,9.3486127865,12.967430639,-6.634499397,0,-3.618817853,-6.634499397
46059,2016,33,45,-5,0,-12,-5,10.028870992,13.675733171,-1.519525908,0,-3.646862179,-1.519525908
46059,2017,29,29,-5,0,0,-5,8.8428114042,8.8428114042,-1.524622656,0,0,-1.524622656
51085,2010,235,225,35,14,10,49,NA,NA,NA,NA,NA,NA
51085,2011,890,756,-180,47,134,-133,8.9086413821,7.5673403201,-1.801747695,0.4704563427,1.341301062,-1.331291353
51085,2012,860,845,399,37,15,436,8.5892634207,8.4394506866,3.9850187266,0.3695380774,0.1498127341,4.354556804
51085,2013,918,859,609,66,59,675,9.1157340748,8.5298644556,6.0473660692,0.655379574,0.5858696192,6.7027456432
51085,2014,894,854,541,77,40,618,8.8176550364,8.423129084,5.3359635063,0.7594624584,0.3945259524,6.0954259647
51085,2015,952,924,1223,85,28,1308,9.2989636344,9.025464704,11.946042568,0.8302646102,0.2734989304,12.776307178
51085,2016,964,851,1104,87,113,1191,9.2964048758,8.2066810677,10.646505169,0.8389908965,1.0897238081,11.485496065
51085,2017,988,821,1332,83,167,1415,9.3974413849,7.8090074666,12.669425025,0.789461169,1.5884339183,13.458886194
48195,2010,18,16,-17,1,2,-16,NA,NA,NA,NA,NA,NA
48195,2011,88,59,-72,14,29,-58,15.750850188,10.560229103,-12.88705924,2.5058170754,5.1906210847,-10.38124217
48195,2012,76,50,-91,12,26,-79,13.697395693,9.0114445346,-16.40082905,2.1627466883,4.685951158,-14.23808236
48195,2013,82,53,-32,16,29,-16,14.829550592,9.5849534316,-5.787141695,2.8935708473,5.2445971607,-2.893570847
48195,2014,74,48,-44,17,26,-27,13.368259416,8.6713034053,-7.948694788,3.0710866227,4.6969560112,-4.877608165
48195,2015,95,56,14,22,39,36,17.049533381,10.050251256,2.5125628141,3.9483129935,6.9992821249,6.4608758076
48195,2016,62,41,-123,23,21,-100,11.130060138,7.3602010592,-22.08060318,4.1288932771,3.7698590791,-17.9517099
48195,2017,70,34,-142,22,36,-120,12.751616723,6.1936424082,-25.86756535,4.00765097,6.5579743146,-21.85991438
46061,2010,8,11,3,0,-3,3,NA,NA,NA,NA,NA,NA
46061,2011,51,20,12,0,31,12,15.214797136,5.9665871122,3.5799522673,0,9.2482100239,3.5799522673
46061,2012,45,19,-21,-1,26,-22,13.329383886,5.6279620853,-6.220379147,-0.296208531,7.7014218009,-6.516587678
46061,2013,49,14,-9,-1,35,-10,14.454277286,4.1297935103,-2.654867257,-0.294985251,10.324483776,-2.949852507
46061,2014,62,26,-16,-1,36,-17,18.173823831,7.6212809615,-4.690019053,-0.293126191,10.55254287,-4.983145244
46061,2015,37,33,-38,-1,4,-39,10.871162039,9.6959012781,-11.16497723,-0.29381519,1.175260761,-11.45879242
46061,2016,38,11,-21,-1,27,-22,11.216056671,3.2467532468,-6.198347107,-0.295159386,7.9693034238,-6.493506494
46061,2017,37,10,6,-1,27,5,10.86158814,2.9355643622,1.7613386173,-0.293556436,7.9260237781,1.4677821811
13143,2010,87,100,-1,0,-13,-1,NA,NA,NA,NA,NA,NA
13143,2011,377,385,-285,-4,-8,-289,13.176059415,13.455657492,-9.96068152,-0.13979903900000001,-0.27959807800000003,-10.10048056
13143,2012,335,327,-162,-4,8,-166,11.800345204,11.518545916,-5.706435591,-0.140899644,0.2817992885,-5.847335235
13143,2013,338,315,10,-7,23,3,11.93355341,11.121506876,0.3530637103,-0.247144597,0.8120465338,0.1059191131
13143,2014,330,318,143,-7,12,136,11.616037171,11.19363582,5.0336161076,-0.246400788,0.4224013517,4.7872153191
13143,2015,355,358,228,-7,-3,221,12.416060436,12.520984891,7.9742585339,-0.244823727,-0.104924454,7.7294348069
13143,2016,339,375,177,-7,-36,170,11.784336219,13.035770153,6.1528835124,-0.243334376,-1.251433935,5.9095491362
13143,2017,342,355,443,-7,-13,436,11.77503486,12.222623905,15.252457436,-0.241009485,-0.447589044,15.011447951
12049,2010,88,74,-45,25,14,-20,NA,NA,NA,NA,NA,NA
12049,2011,408,199,-385,103,209,-282,14.734029107,7.1864504713,-13.90343433,3.7196200932,7.5475786357,-10.18381424
12049,2012,408,195,-552,84,213,-468,14.817774065,7.0820243694,-20.04757668,3.0507181899,7.7357496958,-16.99685849
12049,2013,382,209,-349,44,173,-305,13.967603934,7.6419613149,-12.76097846,1.608833961,6.3256426195,-11.1521445
12049,2014,392,184,-243,52,208,-191,14.361867776,6.7412848742,-8.902892524,1.9051457253,7.6205829013,-6.997746799
12049,2015,401,238,-281,70,163,-211,14.69941349,8.724340176,-10.30058651,2.5659824047,5.9750733138,-7.734604106
12049,2016,392,196,-156,75,196,-81,14.351614557,7.1758072783,-5.711356813,2.7458446218,7.1758072783,-2.965512192
12049,2017,379,191,-226,75,188,-151,13.836661677,6.9730933518,-8.250885327,2.7381256617,6.8635683254,-5.512759666
47069,2010,58,44,-96,0,14,-96,NA,NA,NA,NA,NA,NA
47069,2011,289,279,-336,-1,10,-337,10.69993891,10.32969881,-12.44006738,-0.03702401,0.3702401007,-12.47709139
47069,2012,278,298,-286,-1,-20,-287,10.413155036,11.16230288,-10.71281417,-0.037457392,-0.749147844,-10.75027157
47069,2013,265,264,-268,-1,1,-269,10.032558492,9.9946997804,-10.14613463,-0.037858711,0.0378587113,-10.18399334
47069,2014,265,304,-315,-1,-39,-316,10.150728746,11.64460958,-12.06596058,-0.038304637,-1.493880834,-12.10426522
47069,2015,289,287,-149,-1,2,-150,11.176857331,11.099508837,-5.762462776,-0.038674247,0.0773484936,-5.801137023
47069,2016,253,290,-269,-1,-37,-270,9.871437211,11.315086131,-10.49571783,-0.039017538,-1.44364892,-10.53473536
47069,2017,252,305,26,-1,-53,25,9.8972959174,11.978870059,1.0211495788,-0.039274984,-2.081574141,0.981874595
48197,2010,14,10,14,0,4,14,NA,NA,NA,NA,NA,NA
48197,2011,46,28,-17,1,18,-16,11.060351046,6.7323875932,-4.087521039,0.240442414,4.3279634528,-3.847078625
48197,2012,30,45,-51,1,-15,-50,7.268322229,10.902483343,-12.35614779,0.2422774076,-3.634161114,-12.11387038
48197,2013,41,39,-39,5,2,-34,10.049019608,9.5588235294,-9.558823529,1.2254901961,0.4901960784,-8.333333333
48197,2014,45,71,-56,5,-26,-51,11.177347243,17.635370094,-13.90958768,1.2419274714,-6.458022851,-12.66766021
48197,2015,44,57,-73,7,-13,-66,11.139240506,14.430379747,-18.48101266,1.7721518987,-3.291139241,-16.70886076
48197,2016,48,26,51,8,22,59,12.147285841,6.5797798304,12.906491206,2.0245476401,5.5675060104,14.931038846
48197,2017,46,38,-13,9,8,-4,11.521603006,9.5178459612,-3.256105197,2.254226675,2.0037570445,-1.001878522
17069,2010,10,11,-3,0,-1,-3,NA,NA,NA,NA,NA,NA
17069,2011,40,58,-7,0,-18,-7,9.2969203951,13.480534573,-1.626961069,0,-4.183614178,-1.626961069
17069,2012,41,52,-1,0,-11,-1,9.5716119995,12.139605463,-0.233453951,0,-2.567993463,-0.233453951
17069,2013,25,60,26,0,-35,26,5.8520599251,14.04494382,6.0861423221,0,-8.192883895,6.0861423221
17069,2014,35,70,6,0,-35,6,8.2304526749,16.46090535,1.4109347443,0,-8.230452675,1.4109347443
17069,2015,22,65,-38,0,-43,-38,5.2418394091,15.4872528,-9.054086252,0,-10.24541339,-9.054086252
17069,2016,37,48,-46,0,-11,-46,8.9642640824,11.629315566,-11.14476075,0,-2.665051484,-11.14476075
17069,2017,34,60,-26,0,-26,-26,8.3486801719,14.732965009,-6.384284837,0,-6.384284837,-6.384284837
19083,2010,54,38,-5,1,16,-4,NA,NA,NA,NA,NA,NA
19083,2011,184,227,-142,13,-43,-129,10.539882572,13.003007303,-8.134039811,0.7446656165,-2.463124731,-7.389374194
19083,2012,166,207,22,8,-41,30,9.5594586813,11.920529801,1.2669162108,0.4606968039,-2.36107112,1.7276130147
19083,2013,199,240,44,18,-41,62,11.458183389,13.818914639,2.5334676839,1.036418598,-2.360731251,3.5698862818
19083,2014,188,213,-39,17,-25,-22,10.834485938,12.275242047,-2.24757953,0.979714154,-1.440756109,-1.267865376
19083,2015,185,225,-52,18,-40,-34,10.700135921,13.013678822,-3.007605772,1.0410943058,-2.313542902,-1.966511466
19083,2016,193,211,-58,19,-18,-39,11.206270867,12.2514153,-3.367687618,1.1032080128,-1.045144433,-2.264479605
19083,2017,192,216,-141,19,-24,-122,11.214625741,12.616453959,-8.235740779,1.1097806723,-1.401828218,-7.125960106
21093,2010,420,239,1039,110,181,1149,NA,NA,NA,NA,NA,NA
21093,2011,1826,850,-526,79,976,-447,17.031119568,7.9279581777,-4.906007061,0.73683376,9.1031613899,-4.169173301
21093,2012,1514,825,-459,479,689,20,14.041010137,7.6511448895,-4.256818793,4.4423010934,6.3898652471,0.1854823004
21093,2013,1633,837,-385,302,796,-83,15.046600233,7.7121888519,-3.54742259,2.7826535642,7.3344113812,-0.764769026
21093,2014,1613,858,-1520,270,755,-1250,14.8452204,7.8965896488,-13.98929635,2.4849407986,6.9486307516,-11.50435555
21093,2015,1520,933,-3147,304,587,-2843,14.162656243,8.6932620231,-29.32228895,2.8325312487,5.4693942203,-26.4897577
21093,2016,1415,948,13,191,467,204,13.279090828,8.896521629,0.1219987143,1.7924426489,4.3825691991,1.9144413632
21093,2017,1443,944,551,132,499,683,13.425503805,8.7828659683,5.126439776,1.2281126142,4.642637837,6.3545523902
39065,2010,107,54,10,5,53,15,NA,NA,NA,NA,NA,NA
39065,2011,373,318,-411,21,55,-390,11.670108254,9.9493148113,-12.85902009,0.6570302234,1.7207934422,-12.20198986
39065,2012,370,310,-253,17,60,-236,11.667139659,9.7751710655,-7.977800902,0.5360577681,1.8919685933,-7.441743134
39065,2013,402,336,28,14,66,42,12.689994791,10.606562811,0.8838802342,0.4419401171,2.0834319807,1.3258203513
39065,2014,401,319,-65,17,82,-48,12.631114751,10.04819353,-2.047437553,0.5354836677,2.5829212209,-1.511953885
39065,2015,358,309,-218,20,49,-198,11.297652108,9.7513254229,-6.879575865,0.6311537491,1.5463266852,-6.248422116
39065,2016,359,310,-276,19,49,-257,11.393208505,9.8381466201,-8.759124088,0.6029831799,1.5550618851,-8.156140908
39065,2017,360,328,-94,19,32,-75,11.470264931000001,10.450685826,-2.995013621,0.6053750936,1.019579105,-2.389638527
47071,2010,65,43,20,1,22,21,NA,NA,NA,NA,NA,NA
47071,2011,285,336,-131,-1,-51,-132,10.977794041,12.942241396,-5.045933401,-0.038518576,-1.964447355,-5.084451977
47071,2012,300,350,148,0,-50,148,11.575860472,13.505170551,5.710757833,0,-1.929310079,5.710757833
47071,2013,269,397,99,-7,-128,92,10.368685798,15.302484245,3.8159847361,-0.269817103,-4.933798447,3.5461676335
47071,2014,260,382,-19,14,-122,-5,10.05452647,14.77241966,-0.734753857,0.5413975792,-4.71789319,-0.193356278
47071,2015,284,389,38,17,-105,55,11.021635782,15.096536335,1.4747259144,0.6597458038,-4.074900553,2.1344717182
47071,2016,301,349,49,18,-48,67,11.689320388,13.553398058,1.9029126214,0.6990291262,-1.86407767,2.6019417476
47071,2017,308,348,109,18,-40,127,11.936827827,13.487065207,4.2243968608,0.697606821,-1.55023738,4.9220036818
48199,2010,175,103,75,2,72,77,NA,NA,NA,NA,NA,NA
48199,2011,657,510,140,-2,147,138,11.962419431,9.2858963621,2.5490695896,-0.03641528,2.6765230691,2.5126543097
48199,2012,683,543,-76,-3,140,-79,12.398119407,9.8567772151,-1.379585761,-0.054457333,2.5413421917,-1.434043094
48199,2013,694,553,48,4,141,52,12.570414244,10.01648282,0.8694234636,0.0724519553,2.5539314242,0.9418754189
48199,2014,730,588,65,5,142,70,13.176181795,10.613143693,1.1732216667,0.0902478205,2.5630381026,1.2634694872
48199,2015,686,548,114,9,138,123,12.331143327,9.8505343196,2.0491987453,0.1617788483,2.4806090075,2.2109775936
48199,2016,703,585,379,8,118,387,12.551442166,10.44465671,6.766709219,0.1428329123,2.106785456,6.9095421312
48199,2017,696,577,753,8,119,761,12.275132275,10.176366843,13.28042328,0.1410934744,2.0987654321,13.421516755
35021,2010,1,3,-3,0,-2,-3,NA,NA,NA,NA,NA,NA
35021,2011,5,14,31,0,-9,31,7.0871722183,19.844082211,43.940467753,0,-12.75690999,43.940467753
35021,2012,5,8,-10,0,-3,-10,7.0372976777,11.259676284,-14.07459536,0,-4.222378607,-14.07459536
35021,2013,9,6,-13,0,3,-13,12.875536481,8.5836909871,-18.59799714,0,4.2918454936,-18.59799714
35021,2014,5,5,2,0,0,2,7.1890726096,7.1890726096,2.8756290439,0,0,2.8756290439
35021,2015,3,7,30,0,-4,30,4.2253521127,9.8591549296,42.253521127,0,-5.633802817,42.253521127
35021,2016,6,8,-28,0,-2,-28,8.480565371,11.307420495,-39.57597173,0,-2.826855124,-39.57597173
35021,2017,4,6,1,0,-2,1,5.7803468208,8.6705202312,1.4450867052,0,-2.89017341,1.4450867052
46063,2010,3,4,-10,1,-1,-9,NA,NA,NA,NA,NA,NA
46063,2011,14,15,24,6,-1,30,11.102299762,11.895321174,19.032513878,4.7581284695,-0.793021412,23.790642347
46063,2012,10,8,21,5,2,26,7.7519379845,6.2015503876,16.279069767,3.8759689922,1.5503875969,20.15503876
46063,2013,18,6,-58,1,12,-57,14.040561622,4.6801872075,-45.24180967,0.7800312012,9.360374415,-44.46177847
46063,2014,18,7,-26,0,11,-26,14.365522745,5.5865921788,-20.75019952,0,8.7789305666,-20.75019952
46063,2015,23,7,8,0,16,8,18.290258449,5.5666003976,6.3618290258,0,12.723658052,6.3618290258
46063,2016,17,4,-19,0,13,-19,13.417521705,3.1570639305,-14.99605367,0,10.260457774,-14.99605367
46063,2017,16,7,-31,0,9,-31,12.764260072,5.5843637814,-24.73075389,0,7.1798962904,-24.73075389
54031,2010,38,56,31,3,-18,34,NA,NA,NA,NA,NA,NA
54031,2011,153,136,-134,20,17,-114,10.932475884,9.7177563416,-9.57484816,1.4290818149,1.2147195427,-8.145766345
54031,2012,135,134,-147,32,1,-115,9.7188726108,9.6468809618,-10.5827724,2.303732767,0.071991649,-8.279039631
54031,2013,139,139,76,26,0,102,10.011884611,10.011884611,5.4741239601,1.8727266179,0,7.346850578
54031,2014,154,137,-67,32,17,-35,11.060040218,9.8391266877,-4.811835679,2.2981901752,1.2209135306,-2.513645504
54031,2015,138,166,-159,35,-28,-124,9.9714585064,11.994652986,-11.48885437,2.5289930995,-2.02319448,-8.959861267
54031,2016,151,167,-55,37,-16,-18,10.983815239,12.147663211,-4.000727405,2.6913984361,-1.163847972,-1.309328969
54031,2017,139,163,-26,37,-24,11,10.128242495,11.877003789,-1.894491402,2.696006995,-1.748761294,0.8015155931
24025,2010,683,468,102,109,215,211,NA,NA,NA,NA,NA,NA
24025,2011,2776,1840,328,274,936,602,11.285608004,7.4803741813,1.3334580062,1.1139252857,3.8052338227,2.4473832919
24025,2012,2611,1845,770,347,766,1117,10.542785904,7.4498046698,3.1091325722,1.4011285747,3.0929812342,4.5102611469
24025,2013,2651,2019,-486,254,632,-232,10.656129787,8.1157020143,-1.9535568,1.0209947061,2.5404277727,-0.932562094
24025,2014,2658,1924,-528,274,734,-254,10.666153022,7.720721751,-2.118784347,1.0995206652,2.9454312709,-1.019263682
24025,2015,2820,2006,-888,313,814,-575,11.30054439,8.0386142006,-3.558469297,1.2542802816,3.2619301891,-2.304189016
24025,2016,2676,2089,-99,294,587,195,10.701859628,8.3543291342,-0.395920816,1.175764847,2.3475304939,0.7798440312
24025,2017,2713,2130,885,271,583,1156,10.795883,8.4759420532,3.5216942334,1.0783945054,2.319940947,4.6000887387
21095,2010,92,119,-30,1,-27,-29,NA,NA,NA,NA,NA,NA
21095,2011,427,382,-147,4,45,-143,14.638577967,13.095870687,-5.039510448,0.137129536,1.5427072799,-4.902380912
21095,2012,399,425,-437,7,-26,-430,13.807900611,14.707663558,-15.12293876,0.2422438704,-0.899762947,-14.88069489
21095,2013,399,453,-133,1,-54,-132,13.961056002,15.850522227,-4.653685334,0.0349901153,-1.889466226,-4.618695219
21095,2014,381,420,-440,3,-39,-437,13.486248274,14.866730381,-15.57466992,0.1061909313,-1.380482107,-15.46847899
21095,2015,339,391,-463,3,-52,-460,12.211155737,14.084253372,-16.67777318,0.1080633251,-1.873097635,-16.56970985
21095,2016,336,419,-412,3,-83,-409,12.325073822,15.36966051,-15.11288814,0.110045302,-3.044586688,-15.00284284
21095,2017,326,388,-245,3,-62,-242,12.134973664,14.442852091,-9.119842171,0.1116715368,-2.307878427,-9.008170634
31083,2010,5,2,2,0,3,2,NA,NA,NA,NA,NA,NA
31083,2011,48,49,13,1,-1,14,13.975833455,14.266996652,3.7851215606,0.291163197,-0.291163197,4.0762847576
31083,2012,29,51,-1,1,-22,0,8.456043155,14.870972445,-0.291587695,0.291587695,-6.41492929,0
31083,2013,41,56,97,0,-15,97,11.849710983,16.184971098,28.034682081,0,-4.335260116,28.034682081
31083,2014,41,30,-31,0,11,-31,11.741122566,8.5910652921,-8.877434135,0,3.1500572738,-8.877434135
31083,2015,43,36,-34,0,7,-34,12.399077278,10.380622837,-9.803921569,0,2.0184544406,-9.803921569
31083,2016,33,37,13,0,-4,13,9.5430884905,10.699826489,3.7593984962,0,-1.156737999,3.7593984962
31083,2017,37,38,-18,0,-1,-18,10.716871832,11.006517017,-5.213613324,0,-0.289645185,-5.213613324
40057,2010,7,23,10,0,-16,10,NA,NA,NA,NA,NA,NA
40057,2011,32,30,1,3,2,4,10.960780956,10.275732146,0.3425244049,1.0275732146,0.6850488097,1.3700976195
40057,2012,32,19,-46,3,13,-43,11.004126547,6.5337001376,-15.81843191,1.0316368638,4.4704264099,-14.78679505
40057,2013,42,36,-35,5,6,-30,14.570685169,12.489158716,-12.14223764,1.7346053773,2.0815264527,-10.40763226
40057,2014,34,40,-90,4,-6,-86,12.033268448,14.156786409,-31.85276942,1.4156786409,-2.123517961,-30.43709078
40057,2015,32,22,-37,4,10,-33,11.556518599,7.9451065367,-13.36222463,1.4445648248,3.6114120621,-11.9176598
40057,2016,35,32,-71,4,3,-67,12.841680426,11.740964961,-26.05026601,1.4676206201,1.1007154651,-24.58264539
40057,2017,31,36,-5,4,-5,-1,11.519881085,13.377926421,-1.858045336,1.486436269,-1.858045336,-0.371609067
37085,2010,433,248,757,64,185,821,NA,NA,NA,NA,NA,NA
37085,2011,1735,781,2346,94,954,2440,14.767591308,6.6475439836,19.968166691,0.8000885204,8.1200473244,20.768255211
37085,2012,1776,833,1646,422,943,2068,14.709780016,6.8993506494,13.633050623,3.4952292605,7.8104293666,17.128279883
37085,2013,1787,913,1660,288,874,1948,14.448460151999999,7.3818937428,13.421624987,2.3285710821,7.0665664087,15.750196069
37085,2014,1969,950,403,283,1019,686,15.632877474,7.5425259522,3.199618904,2.2468787837,8.0903515214,5.4464976876
37085,2015,1901,975,115,371,926,486,14.909453111,7.646878897,0.9019395622,2.9097354572,7.2625742139,3.8116750194
37085,2016,1811,1003,1614,270,808,1884,13.978942818,7.7420649623,12.458317896,2.0841052242,6.236877856,14.54242312
37085,2017,1849,1023,853,171,826,1024,14.026011462,7.7601999598,6.4706261639,1.2971595241,6.2658115022,7.767785688
41025,2010,28,33,-16,-1,-5,-17,NA,NA,NA,NA,NA,NA
41025,2011,77,95,-21,-3,-18,-24,10.435725418,12.875245646,-2.846106932,-0.406586705,-2.439520228,-3.252693637
41025,2012,77,65,-129,4,12,-125,10.545056149,8.9016707751,-17.66639277,0.5477951246,1.6433853739,-17.11859764
41025,2013,75,86,-83,7,-11,-76,10.41160547,11.938640938,-11.52217672,0.9717498438,-1.527035469,-10.55042688
41025,2014,79,77,-50,6,2,-44,11.065200644,10.785068982,-7.003291547,0.8403949856,0.2801316619,-6.162896561
41025,2015,94,99,27,7,-5,34,13.178185897,13.879153231,3.7852236086,0.9813542689,-0.700967335,4.7665778775
41025,2016,84,76,98,7,8,105,11.660188784,10.549694614,13.603553581,0.9716823987,1.1104941699,14.57523598
41025,2017,83,77,17,7,6,24,11.408934708,10.58419244,2.3367697595,0.9621993127,0.824742268,3.2989690722
20077,2010,13,34,-5,1,-21,-4,NA,NA,NA,NA,NA,NA
20077,2011,67,98,-47,7,-31,-40,11.217143814,16.407165578,-7.868742675,1.1719403985,-5.190021765,-6.696802277
20077,2012,62,86,-54,2,-24,-52,10.507584103,14.575036014,-9.151766799,0.3389543259,-4.067451911,-8.812812474
20077,2013,81,86,-15,1,-5,-14,13.839056894,14.693319665,-2.562788314,0.1708525542,-0.854262771,-2.391935759
20077,2014,87,79,-24,4,8,-20,14.903640257,13.533190578,-4.111349036,0.6852248394,1.3704496788,-3.426124197
20077,2015,78,92,-39,4,-14,-35,13.430908308,15.841584158,-6.715454154,0.6887645286,-2.41067585,-6.026689625
20077,2016,78,93,-91,4,-15,-87,13.609002879,16.226118817,-15.87717003,0.6978975835,-2.617115938,-15.17927244
20077,2017,76,97,-72,4,-21,-68,13.487133984,17.213842059,-12.77728483,0.7098491571,-3.726708075,-12.06743567
40059,2010,18,2,-4,1,16,-3,NA,NA,NA,NA,NA,NA
40059,2011,43,36,-9,15,7,6,11.610638585,9.7205346294,-2.430133657,4.0502227623,1.8901039557,1.6200891049
40059,2012,44,49,-24,25,-5,1,11.866235167,13.214670982,-6.472491909,6.7421790723,-1.348435814,0.2696871629
40059,2013,61,46,115,36,15,151,16.097110437,12.138804592,30.347011479,9.4999340282,3.9583058451,39.846945507
40059,2014,64,42,-45,43,22,-2,16.4799794,10.814986481,-11.58748552,11.072486159,5.6649929188,-0.514999356
40059,2015,56,38,-117,45,18,-72,14.477766287,9.8241985522,-30.24819028,11.633919338,4.6535677353,-18.61427094
40059,2016,48,55,-87,48,-7,-39,12.572027239,14.405447878,-22.78679937,12.572027239,-1.833420639,-10.21477213
40059,2017,53,69,-19,48,-16,29,13.943699027,18.153117601,-4.998684557,12.628255722,-4.209418574,7.6295711655
13145,2010,73,33,109,0,40,109,NA,NA,NA,NA,NA,NA
13145,2011,313,231,73,7,82,80,9.7102438419,7.1663460942,2.2646894583,0.2171620029,2.5438977477,2.4818514612
13145,2012,299,206,161,19,93,180,9.2151695869,6.3489128257,4.9620143929,0.5855793383,2.8662567611,5.5475937312
13145,2013,272,256,-61,8,16,-53,8.3532952521,7.8619249432,-1.873349303,0.2456851545,0.4913703089,-1.627664148
13145,2014,281,241,167,3,40,170,8.6074863689,7.3822214054,5.1154812228,0.0918948723,1.2252649635,5.2073760951
13145,2015,294,259,380,4,35,384,8.9208502116,7.8588442341,11.530350614,0.1213721117,1.0620059776,11.651722725
13145,2016,283,279,450,-1,4,449,8.4753376658,8.3555449073,13.476685334,-0.02994819,0.1197927585,13.446737145
13145,2017,295,307,313,-1,-12,312,8.7365989457,9.0919860214,9.2696795593,-0.02961559,-0.355387076,9.2400639697
48201,2010,16101,5379,-138,4429,10722,4291,NA,NA,NA,NA,NA,NA
48201,2011,66922,21856,5936,22340,45066,28276,16.147825888,5.273704949,1.4323166443,5.3904908749,10.874120939,6.8228075192
48201,2012,66377,22709,15394,22909,43668,38303,15.722617562,5.3790457873,3.6463530252,5.4264194786,10.343571775,9.0727725038
48201,2013,67610,23931,21334,25785,43679,47119,15.693682347,5.5548811159,4.9520635881,5.9852329436,10.138801231,10.937296532
48201,2014,70224,24173,22944,30172,46051,53116,15.948741638,5.4899882038,5.2108670561,6.8524355307,10.458753435,12.063302587
48201,2015,72306,25082,17914,33696,47224,51610,16.060760166,5.5712663747,3.9790952012,7.4846260969,10.489493792,11.463721298
48201,2016,73713,26547,-16411,34886,47166,18475,16.079790559,5.7909758112,-3.579903719,7.6100494274,10.288814748,4.030145708
48201,2017,73172,27050,-45113,34791,46122,-10322,15.786803503,5.8360169842,-9.733095535,7.5061318631,9.9507865193,-2.226963671
18061,2010,94,118,-10,2,-24,-8,NA,NA,NA,NA,NA,NA
18061,2011,401,369,-194,10,32,-184,10.216300222,9.4010343686,-4.942549234,0.2547705791,0.8152658531,-4.687778655
18061,2012,415,363,-238,8,52,-230,10.617476622,9.2870940094,-6.089058882,0.2046742481,1.3303826129,-5.884384634
18061,2013,413,385,-51,13,28,-38,10.591644654,9.8735670505,-1.307927064,0.3333931731,0.7180776037,-0.974533891
18061,2014,402,390,157,15,12,172,10.287381324,9.9802953144,4.0177086266,0.3838575121,0.3070860097,4.4015661386
18061,2015,471,382,252,17,89,269,11.971481947,9.7093547854,6.4051240993,0.4320917051,2.262127162,6.8372158044
18061,2016,450,370,59,20,80,79,11.363636364,9.3434343434,1.4898989899,0.5050505051,2.0202020202,1.9949494949
18061,2017,446,348,103,20,98,123,11.20926901,8.7462457745,2.5886876861,0.5026578031,2.4630232354,3.0913454893
19085,2010,44,61,-10,0,-17,-10,NA,NA,NA,NA,NA,NA
19085,2011,142,200,-88,0,-58,-88,9.5709904627,13.480268257,-5.931318033,0,-3.909277795,-5.931318033
19085,2012,146,176,-264,0,-30,-264,9.9866616505,12.038715414,-18.05807312,0,-2.052053764,-18.05807312
19085,2013,147,189,-75,0,-42,-75,10.19700333,13.110432852,-5.202552719,0,-2.913429523,-5.202552719
19085,2014,181,160,-112,0,21,-112,12.645846433000001,11.178648781,-7.825054147,0,1.4671976525,-7.825054147
19085,2015,151,188,-87,0,-37,-87,10.628937458,13.233379087,-6.123957343,0,-2.604441629,-6.123957343
19085,2016,165,168,-69,0,-3,-69,11.695491919,11.908137227,-4.890842075,0,-0.212645308,-4.890842075
19085,2017,161,171,76,0,-10,76,11.415201361,12.124220079,5.3885422575,0,-0.709018718,5.3885422575
21097,2010,39,57,-22,0,-18,-22,NA,NA,NA,NA,NA,NA
21097,2011,202,221,-115,12,-19,-103,10.775057343,11.788552835,-6.134314824,0.6401024164,-1.013495493,-5.494212407
21097,2012,205,225,-77,10,-20,-67,10.996084321,12.068873035,-4.13023655,0.5363943571,-1.072788714,-3.593842193
21097,2013,210,223,-64,15,-13,-49,11.310084826,12.010232934,-3.446882994,0.8078632018,-0.700148108,-2.639019793
21097,2014,224,234,73,13,-10,86,12.060842644,12.599273119,3.9305424687,0.6999596177,-0.538430475,4.6305020864
21097,2015,206,220,23,19,-14,42,11.061590506,11.813349084,1.2350319497,1.0202437846,-0.751758578,2.2552757343
21097,2016,226,213,-82,21,13,-61,12.142703632,11.444229529,-4.405759725,1.1283043198,0.6984741027,-3.277455405
21097,2017,218,202,157,21,16,178,11.667424871,10.81110011,8.4026867189,1.123926249,0.8563247612,9.526612968
28047,2010,670,437,389,101,233,490,NA,NA,NA,NA,NA,NA
28047,2011,2777,1677,1798,180,1100,1978,14.663406958,8.8550714689,9.4939883728,0.9504548983,5.8083354895,10.444443271
28047,2012,2794,1750,818,676,1044,1494,14.537886179,9.1056910569,4.2562601626,3.517398374,5.432195122,7.7736585366
28047,2013,2745,1919,1399,367,826,1766,14.095065957,9.8537091333,7.1836055641,1.8844769421,4.2413568234,9.0680825062
28047,2014,2828,1907,900,368,921,1268,14.345535662,9.6735984823,4.565410925,1.8667458005,4.6719371799,6.4321567255
28047,2015,2748,1986,1019,536,762,1555,13.783452333,9.961403324,5.111112783,2.6884754188,3.8220490095,7.7995882018
28047,2016,2803,1958,887,384,845,1271,13.90514932,9.7132652049,4.4002381189,1.904950888,4.1918841155,6.3051890068
28047,2017,2724,1894,1294,258,830,1552,13.363881216,9.2919203466,6.3483341755,1.2657420535,4.0719608699,7.6140762291
29081,2010,27,13,-7,0,14,-7,NA,NA,NA,NA,NA,NA
29081,2011,104,95,-92,0,9,-92,11.656579242,10.647836808,-10.31158933,0,1.0087424344,-10.31158933
29081,2012,111,127,-142,-2,-16,-144,12.611486678,14.429358632,-16.13361359,-0.227233994,-1.817871954,-16.36084758
29081,2013,115,120,-5,-3,-5,-8,13.19488268,13.768573232,-0.573690551,-0.344214331,-0.573690551,-0.917904882
29081,2014,119,126,-70,-2,-7,-72,13.726281792,14.533710133,-8.074283407,-0.230693812,-0.807428341,-8.304977219
29081,2015,115,115,-4,-2,0,-6,13.331787619,13.331787619,-0.463714352,-0.231857176,0,-0.695571528
29081,2016,104,106,-28,-2,-2,-30,12.084592145,12.316988148,-3.253544039,-0.232396003,-0.232396003,-3.485940042
29081,2017,105,119,-49,-2,-14,-51,12.270655604,13.906743017,-5.726305948,-0.233726773,-1.636087414,-5.960032722
39067,2010,45,65,-13,0,-20,-13,NA,NA,NA,NA,NA,NA
39067,2011,151,197,8,2,-46,10,9.5524276451,12.462438716,0.5060888819,0.1265222205,-2.910011071,0.6326111023
39067,2012,163,206,-61,1,-43,-60,10.358084708,13.090585581,-3.876338449,0.0635465319,-2.732500874,-3.812791917
39067,2013,159,186,-53,1,-27,-52,10.163965864,11.889922332,-3.387988621,0.0639243136,-1.725956468,-3.324064308
39067,2014,160,201,-43,0,-41,-43,10.282445937,12.917322708,-2.763407346,0,-2.634876771,-2.763407346
39067,2015,175,230,-69,0,-55,-69,11.32283006,14.881433794,-4.464430138,0,-3.558603733,-4.464430138
39067,2016,148,178,-106,0,-30,-106,9.6574225122,11.615008157,-6.91680261,0,-1.957585644,-6.91680261
39067,2017,149,186,-3,0,-37,-3,9.7791487546,12.207527976,-0.196895613,0,-2.428379221,-0.196895613
48203,2010,206,100,21,3,106,24,NA,NA,NA,NA,NA,NA
48203,2011,869,619,294,34,250,328,13.159090221,9.3733910779,4.4519821921,0.5148550834,3.7856991429,4.9668372755
48203,2012,864,550,-454,49,314,-405,13.03501652,8.2977535718,-6.849418403,0.7392544091,4.7372629483,-6.110163994
48203,2013,824,663,-224,82,161,-142,12.438111339,10.007849294,-3.38123415,1.2377732158,2.4302620456,-2.143460935
48203,2014,883,616,21,97,267,118,13.290186635,9.2715231788,0.3160746538,1.4599638772,4.0186634557,1.776038531
48203,2015,813,646,-137,108,167,-29,12.190184877,9.6861739613,-2.054188596,1.6193603527,2.5040109157,-0.434828243
48203,2016,856,707,-301,122,149,-179,12.824930706,10.592553749,-4.509701101,1.8278522736,2.2323769571,-2.681848828
48203,2017,837,682,-348,122,155,-226,12.54957231,10.225577438,-5.217743326,1.8292088672,2.3239948722,-3.388534459
54033,2010,209,161,105,4,48,109,NA,NA,NA,NA,NA,NA
54033,2011,797,903,154,1,-106,155,11.502879328,13.032747846,2.2226391675,0.0144327219,-1.529868518,2.2370718894
54033,2012,818,886,-129,6,-68,-123,11.819784412,12.802358177,-1.864000231,0.0866976852,-0.982573765,-1.777302546
54033,2013,792,868,-94,-8,-76,-102,11.476514443,12.577796132,-1.362111563,-0.115924388,-1.101281689,-1.478035951
54033,2014,824,806,-246,-12,18,-258,11.977875817,11.71622319,-3.575919237,-0.174435085,0.2616526271,-3.750354321
54033,2015,804,850,-88,-12,-46,-100,11.721398112,12.392025367,-1.282939097,-0.17494624,-0.670627255,-1.457885337
54033,2016,774,877,-115,-14,-103,-129,11.316285802,12.822199804,-1.681360294,-0.20468734,-1.505914002,-1.886047634
54033,2017,779,874,-357,-15,-95,-372,11.448222145,12.844346797,-5.246489481,-0.220440735,-1.396124652,-5.466930216
51660,2010,125,46,-44,73,79,29,NA,NA,NA,NA,NA,NA
51660,2011,530,271,359,355,259,714,10.705664913,5.4740286629,7.2515730258,7.1707755547,5.2316362498,14.42234858
51660,2012,489,258,786,316,231,1102,9.6494430357,5.0911171845,15.510147702,6.2356319004,4.5583258512,21.745779602
51660,2013,554,241,-470,431,313,-39,10.758326051,4.6800660258,-9.127099718,8.3697446354,6.0782600252,-0.757355083
51660,2014,564,208,192,475,356,667,10.81568274,3.9887624289,3.6819345498,9.1089526622,6.826920311,12.790887212
51660,2015,585,313,-575,511,272,-64,11.087209908,5.9321311134,-10.89768495,9.6847252362,5.155078795,-1.212959716
51660,2016,721,283,99,534,438,633,13.500355765,5.2990300715,1.8537243006,9.9988765307,8.2013256937,11.852600831
51660,2017,700,247,-715,532,453,-183,12.944026332,4.5673921485,-13.22139832,9.8374600122,8.3766341833,-3.383938312
13147,2010,71,38,0,0,33,0,NA,NA,NA,NA,NA,NA
13147,2011,281,284,175,17,-3,192,11.090500059,11.208903974,6.9068950547,0.6709555196,-0.118403915,7.5778505743
13147,2012,248,290,134,8,-42,142,9.7327420431,11.381029002,5.2588202975,0.3139594207,-1.648286959,5.5727797182
13147,2013,286,273,-72,10,13,-62,11.212608304,10.70294429,-2.822754538,0.3920492414,0.5096640138,-2.430705297
13147,2014,290,281,-106,13,9,-93,11.399819175,11.046031684,-4.166830457,0.5110263768,0.3537874916,-3.65580408
13147,2015,256,285,73,16,-29,89,10.069225928,11.209880428,2.8713027061,0.6293266205,-1.1406545,3.5006293266
13147,2016,290,321,110,18,-31,128,11.372326033,12.587988471,4.313640909,0.7058685124,-1.215662438,5.0195094214
13147,2017,267,300,261,18,-33,279,10.400841416,11.68633867,10.167114643,0.7011803202,-1.285497254,10.868294963
21099,2010,54,69,10,0,-15,10,NA,NA,NA,NA,NA,NA
21099,2011,258,168,9,3,90,12,14.14279841,9.2092640811,0.4933534329,0.1644511443,4.9335343292,0.6578045772
21099,2012,257,198,52,3,59,55,14.006594545,10.79107284,2.8340191296,0.1635011036,3.2155217048,2.9975202333
21099,2013,209,229,74,3,-20,77,11.338360549,12.423371128,4.0145391418,0.1627515868,-1.085010579,4.1772907286
21099,2014,257,197,-16,1,60,-15,13.904669155,10.658442893,-0.865660337,0.054103771,3.246226262,-0.811556565
21099,2015,259,234,-126,1,25,-125,14.034897583,12.680177739,-6.827788013,0.0541887938,1.3547198439,-6.77359922
21099,2016,265,206,62,2,59,64,14.351087163,11.155939455,3.3576128456,0.1083100918,3.1951477079,3.4659229374
21099,2017,263,202,169,2,61,171,14.107928334,10.835747237,9.0655509066,0.1072846261,3.2721810964,9.1728355327
09003,2010,2454,1814,-39,968,640,929,NA,NA,NA,NA,NA,NA
09003,2011,9732,7930,-4016,4491,1802,475,10.853842285,8.8441193298,-4.478938616,5.0086935574,2.0097229549,0.5297549409
09003,2012,9480,7744,-5335,4376,1736,-959,10.554735992,8.621927798,-5.939822418,4.8721017619,1.9328081944,-1.067720656
09003,2013,9391,7865,-4711,4385,1526,-326,10.444093627,8.7469701174,-5.239284962,4.8767277768,1.6971235091,-0.362557185
09003,2014,9355,7749,-7283,4644,1606,-2639,10.402679899,8.6168216505,-8.098633641,5.1640882365,1.7858582489,-2.934545404
09003,2015,9588,8028,-7779,4997,1560,-2782,10.674468782,8.9376966393,-8.660481086,5.5632374323,1.7367721422,-3.097243654
09003,2016,9091,8082,-8228,5073,1009,-3155,10.139850975,9.0144401695,-9.177284548,5.6582844568,1.1254108056,-3.519000091
09003,2017,9107,8063,-6226,5049,1044,-1177,10.170390617,9.0044866086,-6.952986931,5.6385530059,1.1659040084,-1.314433925
48205,2010,9,5,-4,1,4,-3,NA,NA,NA,NA,NA,NA
48205,2011,55,34,-71,14,21,-57,9.0969235858,5.6235527622,-11.74330136,2.3155805491,3.4733708237,-9.427720807
48205,2012,58,37,23,7,21,30,9.5796514989,6.1111569907,3.7988273185,1.1561648361,3.4684945082,4.9549921546
48205,2013,66,35,-129,7,31,-122,10.932582408,5.7975815803,-21.36822925,1.1595163161,5.1350008282,-20.20871294
48205,2014,68,44,15,8,24,23,11.303191489,7.3138297872,2.4933510638,1.329787234,3.9893617021,3.8231382979
48205,2015,61,43,-407,11,18,-396,10.415777341,7.3422692735,-69.49543243,1.8782549304,3.073508068,-67.6171775
48205,2016,51,45,14,12,6,26,8.9630931459,7.9086115993,2.460456942,2.1089630931,1.0544815466,4.5694200351
48205,2017,54,33,-48,12,21,-36,9.4761779416,5.790997631,-8.423269281,2.1058173203,3.6851803106,-6.317451961
20079,2010,98,66,20,9,32,29,NA,NA,NA,NA,NA,NA
20079,2011,458,396,-141,39,62,-102,13.19124424,11.405529954,-4.061059908,1.1232718894,1.7857142857,-2.937788018
20079,2012,421,378,11,27,43,38,12.118246452,10.880515817,0.3166287672,0.7771797012,1.2377306353,1.0938084684
20079,2013,451,407,-127,31,44,-96,12.976363453,11.710376775,-3.654097913,0.8919451598,1.2659866784,-2.762152753
20079,2014,431,419,-203,45,12,-158,12.436339503,12.090084111,-5.857487051,1.2984577208,0.3462553922,-4.559029331
20079,2015,424,410,140,50,14,190,12.224833134,11.821182983,4.0365015065,1.4416076809,0.4036501506,5.4781091874
20079,2016,411,350,-122,53,61,-69,11.817645959,10.063688773,-3.507914372,1.5239300142,1.7539571862,-1.983984358
20079,2017,402,339,-347,53,63,-294,11.598718947,9.7810092617,-10.01182954,1.5291843388,1.8177096858,-8.4826452
20081,2010,9,2,9,1,7,10,NA,NA,NA,NA,NA,NA
20081,2011,55,31,-72,6,24,-66,12.932047966,7.28897249,-16.92922643,1.410768869,5.6430754761,-15.51845756
20081,2012,53,20,-60,5,33,-55,12.548833906,4.735409021,-14.20622706,1.1838522552,7.8134248846,-13.02237481
20081,2013,50,26,-126,7,24,-119,11.99760048,6.2387522496,-30.23395321,1.6796640672,5.7588482304,-28.55428914
20081,2014,57,24,-61,5,33,-56,13.868613139,5.8394160584,-14.84184915,1.2165450122,8.0291970803,-13.62530414
20081,2015,52,36,-28,5,16,-23,12.69686241,8.7901355146,-6.836772067,1.2208521548,3.9067268954,-5.615919912
20081,2016,49,19,-91,6,30,-85,12.054120541,4.6740467405,-22.38622386,1.4760147601,7.3800738007,-20.9102091
20081,2017,53,20,-23,6,33,-17,13.100976394,4.9437646768,-5.685329378,1.483129403,8.1572117167,-4.202199975
40061,2010,29,20,-17,3,9,-14,NA,NA,NA,NA,NA,NA
40061,2011,117,156,-13,10,-39,-3,9.1833130568,12.244417409,-1.020368117,0.7848985519,-3.061104352,-0.235469566
40061,2012,143,127,20,7,16,27,11.225370908,9.9693853521,1.5699819452,0.5494936808,1.2559855562,2.119475626
40061,2013,159,179,108,11,-20,119,12.412662477,13.974003669,8.4312424373,0.8587376556,-1.561341192,9.2899800929
40061,2014,179,166,-111,9,13,-102,13.968551251,12.954075461,-8.662062507,0.7023293925,1.0144757891,-7.959733115
40061,2015,168,142,-112,9,26,-103,13.195098963,11.153000314,-8.796732642,0.7068803016,2.0420986491,-8.089852341
40061,2016,162,159,-60,9,3,-51,12.786108919,12.549329124,-4.735595896,0.7103393844,0.2367797948,-4.025256511
40061,2017,155,141,96,9,14,105,12.200401433,11.09842969,7.5563776615,0.7084104058,1.1019717423,8.2647880672
48207,2010,16,35,-8,2,-19,-6,NA,NA,NA,NA,NA,NA
48207,2011,38,78,100,18,-40,118,6.4210882055,13.180128422,16.897600541,3.0415680973,-6.759040216,19.939168638
48207,2012,49,92,-56,27,-43,-29,8.2735331363,15.533980583,-9.455466442,4.5588856057,-7.260447446,-4.896580836
48207,2013,44,92,24,41,-48,65,7.4626865672,15.603799186,4.0705563094,6.9538670285,-8.141112619,11.024423338
48207,2014,46,91,-103,42,-45,-61,7.8605604921,15.550239234,-17.60082023,7.1770334928,-7.689678742,-10.42378674
48207,2015,59,84,-6,48,-25,42,10.158402204,14.462809917,-1.033057851,8.2644628099,-4.304407713,7.2314049587
48207,2016,43,59,-86,51,-16,-35,7.4253151442,10.188223105,-14.85063029,8.8067691245,-2.762907961,-6.043861164
48207,2017,50,67,-54,51,-17,-3,8.6873425419,11.641039006,-9.382329945,8.8610893928,-2.953696464,-0.521240553
15001,2010,594,360,-97,156,234,59,NA,NA,NA,NA,NA,NA
15001,2011,2453,1401,58,613,1052,671,13.17414795,7.5242483808,0.3114963641,3.2921943308,5.6498995693,3.6036906949
15001,2012,2470,1525,494,649,945,1143,13.132465102,8.1081009233,2.6264930204,3.4505950814,5.0243641787,6.0770881018
15001,2013,2391,1478,924,630,913,1554,12.561038715,7.7646236811,4.8542031673,3.3096839777,4.7964150344,8.163887145
15001,2014,2470,1579,1157,603,891,1760,12.803798633,8.1851004217,5.9975688334,3.1257856582,4.6186982114,9.1233544916
15001,2015,2374,1630,1114,642,744,1756,12.143843675,8.3380224052,5.6985012021,3.2840554504,3.8058212696,8.9825566525
15001,2016,2378,1973,884,657,405,1541,12.027686946,9.9792373192,4.4711838774,3.3230405062,2.0484496271,7.7942243836
15001,2017,2347,1930,638,652,417,1290,11.762583258,9.6726824403,3.1974981331,3.267662669,2.0899008174000002,6.4651608021
47073,2010,130,125,43,1,5,44,NA,NA,NA,NA,NA,NA
47073,2011,550,638,-231,-22,-88,-253,9.7001763668,11.252204586,-4.074074074,-0.388007055,-1.552028219,-4.462081129
47073,2012,532,684,58,-14,-152,44,9.4208480534,12.112518926,1.0270849382,-0.247917054,-2.691670872,0.7791678841
47073,2013,568,642,248,-5,-74,243,10.053987079,11.363837508,4.3897690061,-0.088503407,-1.309850429,4.3012655987
47073,2014,523,705,-10,-6,-182,-16,9.261144805,12.483952366,-0.177077339,-0.106246403,-3.222807561,-0.283323742
47073,2015,558,731,58,-5,-173,53,9.9103099192,12.982861202,1.0301038984,-0.08880206,-3.072551283,0.9413018382
47073,2016,550,733,314,-4,-183,310,9.7684001137,13.018613242,5.5768684285,-0.07104291,-3.250213129,5.5058255186
47073,2017,541,719,274,-4,-178,270,9.5900731221,12.745402172,4.857079548,-0.070906271,-3.155329049,4.7861732772
31085,2010,2,0,-7,0,2,-7,NA,NA,NA,NA,NA,NA
31085,2011,15,8,-10,0,7,-10,15.72327044,8.3857442348,-10.48218029,0,7.3375262055,-10.48218029
31085,2012,8,7,-36,0,1,-36,8.551576697,7.4826296098,-38.48209514,0,1.0689470871,-38.48209514
31085,2013,13,2,14,1,11,15,13.948497854,2.1459227468,15.021459227,1.0729613734,11.802575107,16.094420601
31085,2014,10,5,-43,1,5,-42,10.781671159,5.3908355795,-46.36118598,1.0781671159,5.3908355795,-45.28301887
31085,2015,12,5,-3,1,7,-2,13.157894737,5.4824561404,-3.289473684,1.0964912281,7.6754385965,-2.192982456
31085,2016,14,3,-36,2,11,-34,15.512465374,3.324099723,-39.88919668,2.216066482,12.188365651,-37.67313019
31085,2017,14,5,-9,2,9,-7,15.695067265,5.6053811659,-10.0896861,2.2421524664,10.089686099,-7.847533632
48209,2010,500,237,756,30,263,786,NA,NA,NA,NA,NA,NA
48209,2011,2106,843,3605,72,1263,3677,13.103656393,5.2451957926,22.430522933,0.4479882528,7.8584606004,22.878511186
48209,2012,2023,772,3776,119,1251,3895,12.197327802,4.6546401698,22.766737411,0.7174898707,7.5426876326,23.484227281
48209,2013,2090,869,5999,166,1221,6165,12.133632513,5.0450366767,34.82758921,0.9637239221,7.0885958368,35.791313132
48209,2014,2246,884,7038,236,1362,7274,12.447006013,4.8989996952,39.003574496,1.3078777467,7.5480063177,40.311452243
48209,2015,2449,887,7626,291,1562,7917,12.910946627,4.6761983088,40.203707218,1.5341304485,8.2347483183,41.737837667
48209,2016,2516,1111,8137,287,1405,8424,12.616524839,5.5711284168,40.803125047,1.4391663867,7.0453964226,42.242291434
48209,2017,2637,1066,8236,284,1571,8520,12.592221188,5.0903707948,39.328605878,1.3561588234,7.5018503928,40.684764702
37087,2010,131,193,-24,0,-62,-24,NA,NA,NA,NA,NA,NA
37087,2011,530,653,-60,-10,-123,-70,9.0074779062,11.09789259,-1.01971448,-0.169952413,-2.090414684,-1.189666893
37087,2012,580,702,77,-22,-122,55,9.8803287765,11.958604829,1.3116988203,-0.374771092,-2.078276053,0.9369277288
37087,2013,552,718,514,-30,-166,484,9.3837654059,12.205694858,8.7377815555,-0.50998725,-2.821929452,8.2277943051
37087,2014,540,714,362,-21,-174,341,9.141928439,12.087660936,6.1284779536,-0.355519439,-2.945732497,5.7729585143
37087,2015,610,786,696,-16,-176,680,10.268236641,13.230875409,11.715889675,-0.269330797,-2.962638768,11.446558878
37087,2016,581,765,928,-16,-184,912,9.6793809195,12.744795875,15.460353689,-0.266557822,-3.065414956,15.193795867
37087,2017,615,752,846,-15,-137,831,10.125790306,12.381454162,13.929135933,-0.246970495,-2.255663857,13.682165437
47075,2010,65,22,-38,0,43,-38,NA,NA,NA,NA,NA,NA
47075,2011,219,188,-314,-1,31,-315,11.727849626,10.067743058,-16.81527298,-0.053551825,1.6601065681,-16.86882481
47075,2012,215,199,-306,-3,16,-309,11.690818629,10.82080422,-16.63902558,-0.163127702,0.8700144096,-16.80215329
47075,2013,236,190,-91,5,46,-86,12.94853506,10.424668057,-4.992867332,0.2743333699,2.5238670032,-4.718533962
47075,2014,238,182,-100,2,56,-98,13.087709651,10.008248557,-5.499037668,0.1099807534,3.0794610943,-5.389056915
47075,2015,207,188,-216,5,19,-211,11.456402026,10.404848217,-11.95450646,0.2767246866,1.0515538091,-11.67778177
47075,2016,187,202,-161,5,-15,-156,10.453935599,11.292486583,-9.000447227,0.2795169946,-0.838550984,-8.720930233
47075,2017,189,216,-208,5,-27,-203,10.685210312,12.211668928,-11.75938489,0.2826775215,-1.526458616,-11.47670737
13149,2010,35,39,16,0,-4,16,NA,NA,NA,NA,NA,NA
13149,2011,128,124,-115,-1,4,-116,10.864952041,10.52542229,-9.76148035,-0.084882438,0.3395297513,-9.846362788
13149,2012,132,119,-90,-2,13,-92,11.294600839,10.182253786,-7.700864208,-0.171130316,1.1123470523,-7.871994524
13149,2013,130,109,-108,-1,21,-109,11.202068074,9.3925032314,-9.306333477,-0.086169754,1.8095648427,-9.392503231
13149,2014,140,116,36,-1,24,35,12.078857685,10.008196368,3.1059919762,-0.086277555,2.0706613175,3.0197144213
13149,2015,109,126,-47,-1,-17,-48,9.4079060936,10.8751942,-4.056620059,-0.086311065,-1.467288106,-4.142931124
13149,2016,127,148,44,-1,-21,43,10.98330883,12.79944651,3.8052408544,-0.086482747,-1.816137681,3.7187581078
13149,2017,115,130,173,-1,-15,172,9.8695502918,11.156882939,14.847236526,-0.085822176,-1.287332647,14.761414349
48211,2010,15,12,-21,4,3,-17,NA,NA,NA,NA,NA,NA
48211,2011,72,33,108,5,39,113,18.590240124,8.5205267235,27.885360186,1.2909888975,10.0697134,29.176349083
48211,2012,67,36,92,7,31,99,16.681190091,8.9630275115,22.905514752,1.742810905,7.7181625794,24.648325657
48211,2013,66,37,27,5,29,32,16.048632219,8.9969604863,6.5653495441,1.2158054711,7.0516717325,7.7811550152
48211,2014,61,35,-4,9,26,5,14.666987257,8.4154844915000009,-0.961769656,2.1639817264,6.2515027651,1.2022120702
48211,2015,80,25,47,15,55,62,18.896893823,5.9052793197,11.101925121,3.5431675918,12.991614503,14.645092713
48211,2016,53,32,-205,18,21,-187,12.592064623,7.602755999,-48.70515562,4.2765502495,4.9893086244,-44.42860537
48211,2017,60,28,-152,18,32,-134,14.72392638,6.8711656442,-37.3006135,4.4171779141,7.8527607362,-32.88343558
05057,2010,103,55,-47,0,48,-47,NA,NA,NA,NA,NA,NA
05057,2011,319,253,-162,-15,66,-177,14.149792632,11.222249329,-7.185788108,-0.665350751,2.9275433032,-7.851138859
05057,2012,340,246,-223,-16,94,-239,15.165369433,10.972590825,-9.946698187,-0.713664444,4.1927786079,-10.66036263
05057,2013,312,225,3,-7,87,-4,13.935103508,10.049353492,0.1339913799,-0.312646553,3.8857500167,-0.178655173
05057,2014,324,233,-167,-6,91,-173,14.471392202,10.406896244,-7.459020054,-0.267988744,4.0644959578,-7.727008799
05057,2015,331,247,-327,-3,84,-330,14.892803312,11.113360779,-14.71282986,-0.13498009,3.7794425322,-14.84780995
05057,2016,307,242,-138,-5,65,-143,13.913752861,10.967844275,-6.254390537,-0.226608353,2.9459085862,-6.48099889
05057,2017,297,231,-224,-6,66,-230,13.534759724,10.527035341,-10.20803427,-0.273429489,3.0077243831,-10.48146376
17071,2010,17,8,7,0,9,7,NA,NA,NA,NA,NA,NA
17071,2011,63,91,-95,-6,-28,-101,8.6550350323,12.501717269,-13.0512433,-0.824289051,-3.846682237,-13.87553235
17071,2012,55,82,-149,-2,-27,-151,7.7155081714,11.503121274,-20.90201305,-0.280563934,-3.787613102,-21.18257698
17071,2013,58,92,-50,2,-34,-48,8.2827561585,13.138164941,-7.140307033,0.2856122813,-4.855408783,-6.854694752
17071,2014,74,67,43,0,7,43,10.591855722,9.5899234237,6.1547269734,0,1.001932298,6.1547269734
17071,2015,74,92,3,0,-18,3,10.568409026,13.139103112999999,0.4284490146,0,-2.570694087,0.4284490146
17071,2016,52,79,-93,-1,-27,-94,7.4992789155,11.393135275,-13.41217191,-0.144216902,-3.89385636,-13.55638881
17071,2017,51,83,-46,-1,-32,-47,7.4621406101,12.144268052,-6.730558197,-0.146316483,-4.682127442,-6.87687468
21101,2010,136,141,19,1,-5,20,NA,NA,NA,NA,NA,NA
21101,2011,595,512,1,-11,83,-10,12.852776308,11.059868016,0.0216013047,-0.237614352,1.7929082917,-0.216013047
21101,2012,554,439,0,-11,115,-11,11.946220444,9.4664093413,0,-0.237199323,2.4798111031,-0.237199323
21101,2013,563,477,-158,-4,86,-162,12.138067827,10.283940237,-3.406420456,-0.086238493,1.8541275898,-3.492658948
21101,2014,552,517,10,-2,35,8,11.906174171,11.151253707,0.2156915611,-0.043138312,0.7549204637,0.1725532489
21101,2015,573,524,-58,-1,49,-59,12.356328036,11.299678692,-1.250727794,-0.021564272,1.0566493434,-1.272292067
21101,2016,557,508,-172,2,49,-170,12.029068449,10.970855964,-3.714541783,0.0431923463,1.0582124847,-3.671349437
21101,2017,551,529,-340,2,22,-338,11.955908519,11.478540121,-7.377511609,0.0433971271,0.4773683982,-7.334114482
37089,2010,289,280,155,17,9,172,NA,NA,NA,NA,NA,NA
37089,2011,1076,1270,675,42,-194,717,10.042184642,11.852764401,6.2996976145,0.3919811849,-1.810579759,6.6916787994
37089,2012,1078,1249,597,1,-171,598,10.016260163,11.605110337,5.5470383275,0.0092915215,-1.588850174,5.556329849
37089,2013,1021,1337,1431,-3,-316,1428,9.4183847609,12.333379457,13.200498132,-0.027674,-2.914994696,13.172824132
37089,2014,1042,1318,1631,2,-276,1633,9.5012742832,12.017926589,14.871956196,0.0182366109,-2.516652305,14.890192807
37089,2015,1134,1419,1837,34,-285,1871,10.200547807,12.764177547,16.524167832,0.3058365304,-2.56362974,16.830004363
37089,2016,1077,1412,2081,37,-335,2118,9.5422468137,12.510355154,18.43771181,0.3278209212,-2.96810834,18.765532731
37089,2017,1089,1368,2182,38,-279,2220,9.4916022417,11.923335047,19.018068036,0.3312037513,-2.431732806,19.349271788
47077,2010,93,61,-23,-1,32,-24,NA,NA,NA,NA,NA,NA
47077,2011,336,279,169,-3,57,166,12.043010753,10,6.0573476703,-0.107526882,2.0430107527,5.9498207885
47077,2012,321,316,7,-5,5,2,11.459170013,11.280678269,0.2498884427,-0.178491745,0.1784917448,0.0713966979
47077,2013,305,322,-42,-5,-17,-47,10.900253744,11.50780887,-1.501018548,-0.178692684,-0.607555127,-1.679711233
47077,2014,333,312,31,-5,21,26,11.906677393,11.155805846,1.108429427,-0.17877894,0.7508715473,0.9296504872
47077,2015,316,342,12,-5,-26,7,11.295597934,12.224982574,0.428946757,-0.178727815,-0.92938464,0.2502189416
47077,2016,330,349,-147,-5,-19,-152,11.837078752,12.518607529,-5.272880535,-0.179349678,-0.681528777,-5.452230213
47077,2017,317,312,-42,-5,5,-47,11.41437419,11.234336742,-1.512314561,-0.180037448,0.1800374478,-1.692352009
48213,2010,223,269,128,7,-46,135,NA,NA,NA,NA,NA,NA
48213,2011,932,930,173,2,2,175,11.841311184,11.815900645,2.1980116253,0.025410539,0.025410539,2.2234221643
48213,2012,922,943,184,-4,-21,180,11.690864135,11.957141951,2.3331008686,-0.050719584,-0.26627781700000003,2.2823812845
48213,2013,884,1047,-160,26,-163,-134,11.22069482,13.289669091,-2.03089499,0.3300204359,-2.068974271,-1.700874554
48213,2014,891,1000,695,46,-109,741,11.28633859,12.667046678,8.8035974413,0.5826841472,-1.380708088,9.3862815884
48213,2015,888,1075,320,57,-187,377,11.190291666,13.546805789,4.0325375373,0.7182957488,-2.356514123,4.7508332861
48213,2016,904,1088,711,60,-184,771,11.33677366,13.644258564,8.916422646,0.7524407296,-2.307484904,9.6688633756
48213,2017,912,1081,1135,61,-169,1196,11.322300711,13.420402488,14.090801872,0.7573030081,-2.098101777,14.84810488
18063,2010,434,211,188,64,223,252,NA,NA,NA,NA,NA,NA
18063,2011,1777,983,1624,207,794,1831,12.071395819,6.677648897,11.032046601,1.4061783537,5.3937469219,12.438224955
18063,2012,1749,965,981,268,784,1249,11.695554486,6.4529503023,6.5599422244,1.7921146953,5.2426041834,8.3520569197
18063,2013,1641,1056,2051,189,585,2240,10.797402307,6.9482369507,13.495107941,1.2435764997,3.8491653562,14.738684441
18063,2014,1811,1047,1355,201,764,1556,11.717056696,6.7740244952,8.7667652254,1.3004574246,4.9430322009,10.06722265
18063,2015,1724,1112,1174,220,612,1394,11.001001831,7.0957738031,7.4914014791,1.4038401409,3.9052280283,8.89524162
18063,2016,1804,1099,1701,223,705,1924,11.344306623,6.9109717178,10.696599538,1.4023172821,4.4333349054,12.09891682
18063,2017,1784,1061,2406,220,723,2626,11.011631962,6.5489582465,14.850889294,1.3579366769,4.4626737156,16.208825971
12051,2010,156,97,-251,47,59,-204,NA,NA,NA,NA,NA,NA
12051,2011,618,275,-617,188,343,-429,15.855097747,7.0552619426,-15.82944225,4.823233619,8.7998358048,-11.00620863
12051,2012,577,248,-1631,148,329,-1483,15.028585568,6.4594267259,-42.48114915,3.8548191751,8.569158842,-38.62632998
12051,2013,604,253,-595,156,351,-439,15.976088768,6.6919709574,-15.73803446,4.1262745824,9.2841178104,-11.61175988
12051,2014,554,298,226,221,256,447,14.533053515,7.8174186779,5.9286463799,5.7974816369,6.7156348374,11.726128017
12051,2015,580,276,55,265,304,320,14.954813258,7.116428378,1.4181288435,6.8328026094,7.8383848802,8.2509314528
12051,2016,625,286,-77,285,339,208,15.876241522,7.2649681205,-1.955952956,7.2395661341,8.6112734016,5.2836131786
12051,2017,596,313,141,285,283,426,14.902421644,7.8262717692,3.5255729056,7.1261580007,7.0761498744,10.651730906
27053,2010,4035,1840,-1551,1219,2195,-332,NA,NA,NA,NA,NA,NA
27053,2011,15916,7799,1989,5212,8117,7201,13.699042806,6.7126686882,1.7119499963,4.4860147715,6.9863741175,6.1979647677
27053,2012,16027,7742,2160,4939,8285,7099,13.615503681,6.5771029824,1.8349964404,4.1958552867,7.0384006987,6.0308517272
27053,2013,16497,8237,1197,5133,8260,6330,13.839440013,6.9100725822,1.004171043,4.3061069035,6.929367431,5.3102779465
27053,2014,16711,8066,-1689,6051,8645,4362,13.860119044,6.6899479509,-1.400858181,5.0187050646,7.170171093,3.6178468835
27053,2015,16751,8508,-3400,6621,8243,3221,13.755821239,6.9867188289,-2.792059711,5.4371256895,6.7691024103,2.6450659788
27053,2016,16666,8521,-1289,6791,8145,5502,13.547324594000001,6.9264822314,-1.047791996,5.5202136878,6.620842363,4.472421692
27053,2017,16588,8526,210,6752,8062,6962,13.328774702,6.8508037802,0.1687390094,5.4253609106,6.4779709214,5.59409992
51087,2010,998,626,-107,325,372,218,NA,NA,NA,NA,NA,NA
51087,2011,3931,2474,416,1554,1457,1970,12.716703168,8.0033384985,1.3457513401,5.0271576502,4.7133646695,6.3729089903
51087,2012,4080,2414,1811,1551,1666,3362,13.021789156,7.7045585837,5.7800147453,4.9501948481,5.3172305718,10.730209593
51087,2013,4032,2545,392,1532,1487,1924,12.698672655,8.0154072189,1.2345931748,4.8249916933,4.683265436,6.059584868
51087,2014,4094,2646,172,1622,1448,1794,12.762084079,8.2482839455,0.5361696291,5.0562042931,4.5138001334,5.5923739222
51087,2015,4077,2791,-661,1751,1286,1090,12.600386634,8.6258717431,-2.042888292,5.4116450814,3.9745148913,3.3687567897
51087,2016,3985,2731,-1620,1779,1254,159,12.244979482,8.3917287238,-4.977883754,5.4664538263,3.8532507578,0.4885700722
51087,2017,3915,2693,-1234,1771,1222,537,11.971653327,8.234907384,-3.773440665,5.4155295125,3.7367459426,1.6420888471
01067,2010,40,59,13,5,-19,18,NA,NA,NA,NA,NA,NA
01067,2011,188,229,104,17,-41,121,10.844172699,13.209125256,5.9989040464,0.9805900845,-2.364952557,6.9794941309
01067,2012,184,233,-173,2,-49,-171,10.656473518,13.494338748,-10.01940173,0.1158312339,-2.83786523,-9.903570498
01067,2013,170,211,11,5,-41,16,9.9162948056,12.307871788,0.6416426051,0.2916557296,-2.391576983,0.9332983346
01067,2014,174,191,-31,1,-17,-30,10.172464192,11.166325636,-1.812335574,0.0584624379,-0.993861444,-1.753873137
01067,2015,162,211,71,3,-49,74,9.4786729858,12.345679012,4.1542332222,0.1755309812,-2.867006027,4.3297642034
01067,2016,185,222,22,4,-37,26,10.820611803,12.984734164,1.2867754577,0.2339591741,-2.164122361,1.5207346318
01067,2017,175,202,78,4,-27,82,10.222261164,11.799410029,4.5562078332,0.2336516838,-1.577148865,4.7898595169
13151,2010,575,211,788,73,364,861,NA,NA,NA,NA,NA,NA
13151,2011,2448,1166,426,262,1282,688,11.877527553,5.6573517674,2.0669226869,1.2712059718,6.2201757855,3.3381286587
13151,2012,2415,1303,-208,223,1112,15,11.630034866,6.2749215033,-1.001675881,1.0739121222,5.3551133627,0.0722362414
13151,2013,2355,1354,876,170,1001,1046,11.255125742,6.4710998958,4.1866200212,0.8124719219,4.7840258462,4.9990919431
13151,2014,2450,1274,1645,232,1176,1877,11.56931911,6.0160459373,7.7679714025,1.0955436872,5.5532731729,8.8635150897
13151,2015,2358,1415,2353,259,943,2612,10.964662446,6.5797274644,10.941412526,1.2043458751,4.3849349816,12.145758401
13151,2016,2432,1493,3343,251,939,3594,11.100410332,6.814519994,15.258499893,1.1456426782,4.2858903378,16.404142571
13151,2017,2512,1526,3228,250,986,3478,11.235150995,6.8251753256,14.437526836,1.1181479891,4.4099756691,15.555674825
17073,2010,139,108,-60,-3,31,-63,NA,NA,NA,NA,NA,NA
17073,2011,554,525,-205,2,29,-203,10.999265392,10.423491572,-4.07012528,0.0397085393,0.5757738202,-4.030416741
17073,2012,537,531,-27,-3,6,-30,10.683165559,10.563800581,-0.537142402,-0.059682489,0.1193649783,-0.596824892
17073,2013,548,515,-380,11,33,-369,10.941181168,10.282314419,-7.586950445,0.2196222497,0.6588667492,-7.367328196
17073,2014,515,509,-103,8,6,-95,10.325814536,10.205513784,-2.065162907,0.1604010025,0.1203007519,-1.904761905
17073,2015,579,561,-208,9,18,-199,11.641232885,11.279329272,-4.181997306,0.1809518065,0.361903613,-4.001045499
17073,2016,561,533,-158,9,28,-149,11.314019502,10.749326907,-3.186479646,0.1815083343,0.5646925955,-3.004971312
17073,2017,570,540,-234,9,30,-225,11.532391859,10.925423866,-4.734350342,0.1820903978,0.6069679926,-4.552259944
18065,2010,129,100,36,0,29,36,NA,NA,NA,NA,NA,NA
18065,2011,439,548,-211,5,-109,-206,8.8916794945,11.099408572,-4.273677388,0.101271976,-2.207729077,-4.172405412
18065,2012,468,589,19,2,-121,21,9.5191603612,11.980310797,0.3864616386,0.0406801725,-2.461150435,0.4271418111
18065,2013,487,578,-173,3,-91,-170,9.9425293223,11.80037361,-3.531945735,0.0612476139,-1.857844288,-3.470698121
18065,2014,504,579,124,4,-75,128,10.31286448,11.847516932,2.5372920546,0.0818481308,-1.534652452,2.6191401854
18065,2015,464,577,-118,6,-113,-112,9.5124851367,11.829103284,-2.419123375,0.1230062733,-2.316618148,-2.296117102
18065,2016,483,592,-197,7,-109,-190,9.9558890217,12.202663149,-4.060683514,0.1442882467,-2.246774127,-3.916395267
18065,2017,466,548,190,7,-82,197,9.6241222635,11.31763734,3.9239983478,0.1445683602,-1.693515076,4.068566708
19087,2010,55,71,-35,8,-16,-27,NA,NA,NA,NA,NA,NA
19087,2011,228,232,125,9,-4,134,11.305037683,11.503371678,6.1979373265,0.4462514875,-0.198333994,6.644188814
19087,2012,230,215,-270,4,15,-266,11.436527274,10.690666799,-13.42548854,0.1988961265,0.7458604744,-13.22659241
19087,2013,230,201,-3,6,29,3,11.497413082,10.047739259,-0.149966258,0.2999325152,1.4496738234,0.1499662576
19087,2014,236,228,-223,11,8,-212,11.847389558,11.445783133,-11.19477912,0.5522088353,0.4016064257,-10.64257028
19087,2015,236,213,-28,11,23,-17,11.906263401,10.745907222,-1.412607522,0.5549529551,1.1603561789,-0.857654567
19087,2016,224,205,-54,12,19,-42,11.306279023,10.347264284,-2.725620836,0.6056935191,0.9590147385,-2.119927317
19087,2017,225,193,19,12,32,31,11.345300524,9.731746672,0.9580475998,0.6050826946,1.6135538524,1.5631302945
21103,2010,39,49,-28,0,-10,-28,NA,NA,NA,NA,NA,NA
21103,2011,194,182,-24,7,12,-17,12.619938201,11.839323467,-1.561229468,0.4553585949,0.7806147341,-1.105870873
21103,2012,170,152,-64,3,18,-61,11.076361741,9.9035704978,-4.16992442,0.1954652072,1.1727912432,-3.974459213
21103,2013,179,179,83,10,0,93,11.64454853,11.64454853,5.3994275306,0.6505334374,0,6.049960968
21103,2014,158,162,120,10,-4,130,10.206388683,10.464778269,7.751687607,0.6459739672,-0.258389587,8.3976615742
21103,2015,172,164,7,10,8,17,11.057893214,10.5435726,0.4500305378,0.6429007683,0.5143206146,1.0929313061000001
21103,2016,173,169,275,9,4,284,11.012444699,10.7578217,17.505331169,0.5729017474,0.2546229988,18.078232916
21103,2017,180,160,123,9,20,132,11.299789698,10.04425751,7.7215229605,0.5649894849,1.2555321887,8.2865124455
29083,2010,63,97,6,0,-34,6,NA,NA,NA,NA,NA,NA
29083,2011,280,318,26,-2,-38,24,12.592759163,14.301776479,1.1693276366,-0.08994828,-1.709017315,1.0793793569
29083,2012,261,313,32,-1,-52,31,11.749347258,14.090213379,1.4405329972,-0.045016656,-2.34086612,1.395516341
29083,2013,265,325,-43,-2,-60,-45,11.965233096,14.674342477,-1.941528389,-0.090303646,-2.70910938,-2.031832035
29083,2014,263,287,-34,-1,-24,-35,11.92095005,13.0087934,-1.541111413,-0.045326806,-1.087843351,-1.58643822
29083,2015,245,328,-237,-1,-83,-238,11.202560585,14.997713763,-10.83676269,-0.045724737,-3.795153178,-10.88248743
29083,2016,247,297,-40,-2,-50,-42,11.401666397,13.709696032,-1.846423708,-0.092321185,-2.308029635,-1.938744893
29083,2017,245,281,140,-2,-36,138,11.307257413,12.968731972,6.4612899504,-0.092304142,-1.661474559,6.3689858082
39069,2010,91,82,-58,-1,9,-59,NA,NA,NA,NA,NA,NA
39069,2011,325,282,-220,-5,43,-225,11.574486271,10.043092703,-7.83503686,-0.17806902,1.5313935681,-8.01310588
39069,2012,344,292,-237,1,52,-236,12.329970071,10.466137386,-8.494775892,0.0358429363,1.8638326852,-8.458932956
39069,2013,356,250,-111,2,106,-109,12.802761944,8.9907036125,-3.991872404,0.0719256289,3.8120583317,-3.919946775
39069,2014,296,266,-257,4,30,-253,10.68765684,9.6044483761,-9.279485837,0.1444277951,1.0832084635,-9.135058042
39069,2015,312,294,-137,6,18,-131,11.333502852,10.679646918,-4.976570162,0.2179519779,0.6538559337,-4.758618184
39069,2016,280,292,-196,5,-12,-191,10.229992145,10.66842038,-7.160994501,0.1826784312,-0.438428235,-6.97831607
39069,2017,291,249,-131,5,42,-126,10.687920079,9.1453336761,-4.811400448,0.1836412385,1.5425864032,-4.62775921
47079,2010,102,85,30,3,17,33,NA,NA,NA,NA,NA,NA
47079,2011,322,426,104,12,-104,116,9.936431525,13.145713757,3.2092822317,0.370301796,-3.209282232,3.5795840276
47079,2012,333,456,88,4,-123,92,10.279998765,14.077115426,2.7166363103,0.1234834687,-3.797116661,2.840119779
47079,2013,372,492,-33,10,-120,-23,11.516136522,15.231019271,-1.021592756,0.3095735624,-3.714882749,-0.712019194
47079,2014,303,440,148,10,-137,158,9.3989918573,13.648701047,4.5909267158,0.3101977511,-4.24970919,4.9011244668
47079,2015,341,453,6,11,-112,17,10.591542296,14.070289326,0.186361448,0.3416626547,-3.47874703,0.5280241027
47079,2016,329,501,261,12,-172,273,10.218978102,15.561422581,8.1068488896,0.3727286846,-5.342444479,8.4795775742
47079,2017,364,491,320,13,-127,333,11.252801608,15.178916454,9.8925728418,0.4018857717,-3.926114847,10.294458613
51089,2010,131,141,-46,12,-10,-34,NA,NA,NA,NA,NA,NA
51089,2011,558,724,-467,40,-166,-427,10.36317544,13.446127274,-8.673123532,0.7428799599,-3.082951834,-7.930243572
51089,2012,515,656,-316,24,-141,-292,9.6557672116,12.299385031,-5.924703765,0.4499775011,-2.643617819,-5.474726264
51089,2013,520,723,-149,0,-203,-149,9.8224404987,13.656970155,-2.814506989,0,-3.834529656,-2.814506989
51089,2014,478,717,-277,10,-239,-267,9.1035480983,13.655322148,-5.275487078,0.190450797,-4.551774049,-5.085036281
51089,2015,431,678,-75,12,-247,-63,8.2734261774,13.014809625,-1.43969133,0.2303506128,-4.741383447,-1.209340717
51089,2016,423,644,-118,10,-221,-108,8.1707552637,12.439636855,-2.279312343,0.193162063,-4.268881592,-2.08615028
51089,2017,417,708,-94,10,-291,-84,8.1103947253,13.770166584,-1.828242456,0.1944938783,-5.659771859,-1.633748578
36043,2010,173,179,2,11,-6,13,NA,NA,NA,NA,NA,NA
36043,2011,658,643,-145,55,15,-90,10.213743539,9.9809074399,-2.250748956,0.8537323627,0.2328360989,-1.397016593
36043,2012,649,645,-180,29,4,-151,10.092135443,10.0299343,-2.799051433,0.4509582864,0.0622011429,-2.348093146
36043,2013,666,701,-324,30,-35,-294,10.395448479,10.941755832,-5.057245206,0.468263445,-0.546307353,-4.588981761
36043,2014,673,708,-495,32,-35,-463,10.572784114,11.122631728,-7.77641625,0.5027178182,-0.549847614,-7.273698432
36043,2015,636,721,-674,34,-85,-640,10.087632341,11.435822198,-10.69035251,0.5392759427,-1.348189857,-10.15107657
36043,2016,609,703,-150,37,-94,-113,9.7309993848,11.232992722,-2.396797878,0.5912101432,-1.501993337,-1.805587735
36043,2017,599,656,-217,37,-57,-180,9.6055933739,10.519648169,-3.479822641,0.5933338144,-0.914054795,-2.886488827
12053,2010,368,637,407,43,-269,450,NA,NA,NA,NA,NA,NA
12053,2011,1519,2483,712,146,-964,858,8.7854505074,14.360943785,4.1179991845,0.8444211811,-5.575493278,4.9624203656
12053,2012,1437,2468,834,120,-1031,954,8.3162128534,14.282820683,4.8265285454,0.6944645389,-5.96660783,5.5209930843
12053,2013,1437,2512,1890,121,-1075,2011,8.2953299082,14.500952491,10.910350401,0.6984933326,-6.205622583,11.608843734
12053,2014,1496,2416,2325,199,-920,2524,8.5717641733,13.843169948,13.32175916,1.1402279883,-5.271405775,14.461987148
12053,2015,1517,2542,3316,210,-1025,3526,8.5893044192,14.392888486,18.775302211,1.1890269796,-5.803584067,19.964329191
12053,2016,1621,2750,5261,219,-1129,5480,9.0027046991,15.272941346,29.218525245,1.2162815109,-6.270236647,30.434806756
12053,2017,1640,2761,5201,221,-1121,5422,8.8940951885,14.973534644,28.206212851,1.1985335589,-6.079439455,29.40474641
37091,2010,59,76,78,16,-17,94,NA,NA,NA,NA,NA,NA
37091,2011,233,268,-138,52,-35,-86,9.4333893399,10.850422073,-5.587157635,2.1053057754,-1.417032733,-3.481851859
37091,2012,248,254,-134,25,-6,-109,10.088887985,10.332973985,-5.451253992,1.0170249985,-0.244086,-4.434228993
37091,2013,251,265,-31,31,-14,0,10.238838239,10.809928818,-1.264557711,1.2645577107,-0.571090579,0
37091,2014,226,259,11,31,-33,42,9.2216668367,10.56819341,0.4488421912,1.2649189024,-1.346526573,1.7137610935
37091,2015,221,271,-208,35,-50,-173,9.058119518,11.107467825,-8.525288958,1.4345438151,-2.049348307,-7.090745143
37091,2016,233,250,-213,39,-17,-174,9.6314821322,10.334208296,-8.804745468,1.6121364942,-0.702726164,-7.192608974
37091,2017,227,273,-183,39,-46,-144,9.4579392525,11.374526061,-7.624682305,1.6249322945,-1.916586809,-5.99975001
38041,2010,9,12,0,0,-3,0,NA,NA,NA,NA,NA,NA
38041,2011,26,44,44,0,-18,44,10.452261307,17.688442211,17.688442211,0,-7.236180905,17.688442211
38041,2012,28,39,50,0,-11,50,11.108906963,15.473120413,19.837333862,0,-4.36421345,19.837333862
38041,2013,31,37,106,0,-6,106,11.966801776,14.282956958,40.918741556,0,-2.316155182,40.918741556
38041,2014,37,41,-11,0,-4,-11,14.049743687,15.568634897,-4.176950826,0,-1.518891209,-4.176950826
38041,2015,30,25,23,0,5,23,11.361484567,9.4679038061,8.7104715016,0,1.8935807612,8.7104715016
38041,2016,34,26,-63,0,8,-63,12.942519985,9.8972211648,-23.98172821,0,3.0452988199,-23.98172821
38041,2017,35,21,-131,0,14,-131,13.774104683,8.2644628099,-51.5545061,0,5.5096418733,-51.5545061
21105,2010,7,33,-17,0,-26,-17,NA,NA,NA,NA,NA,NA
21105,2011,40,63,-55,-1,-23,-56,8.2987551867,13.070539419,-11.41078838,-0.20746888,-4.771784232,-11.61825726
21105,2012,44,52,-37,0,-8,-37,9.2475830181,10.928961749,-7.776376629,0,-1.681378731,-7.776376629
21105,2013,35,54,-7,-1,-19,-8,7.4136835416,11.438254607,-1.482736708,-0.21181953,-4.024571065,-1.694556238
21105,2014,34,63,0,-1,-29,-1,7.2463768116,13.427109974,0,-0.21312873,-6.180733163,-0.21312873
21105,2015,44,74,-39,-1,-30,-40,9.4776521271,15.939687668,-8.400646204,-0.215401185,-6.462035541,-8.616047388
21105,2016,49,52,9,-1,-3,8,10.629067245,11.279826464,1.9522776573,-0.21691974,-0.650759219,1.7353579176
21105,2017,41,67,-66,-1,-26,-67,8.979413053,14.673674989,-14.45466491,-0.219010074,-5.694261936,-14.67367499
47081,2010,57,71,-30,4,-14,-26,NA,NA,NA,NA,NA,NA
47081,2011,266,274,-286,1,-8,-285,10.855592058,11.18207603,-11.67180199,0.0408104965,-0.326483972,-11.63099149
47081,2012,253,276,-143,-3,-23,-146,10.422030442,11.369487755,-5.890712859,-0.123581389,-0.947457313,-6.014294247
47081,2013,258,249,6,-2,9,4,10.662699151,10.290744529,0.2479697477,-0.082656583,0.3719546215,0.1653131651
47081,2014,304,269,196,-3,35,193,12.50179919,11.062447309,8.0603705303,-0.123373018,1.4393518804,7.936997512
47081,2015,298,294,-66,-1,4,-67,12.213865606,12.049921102,-2.705084329,-0.040986126,0.1639445048,-2.746070455
47081,2016,267,263,280,-1,4,279,10.894624095,10.731408752,11.425073957,-0.040803836,0.1632153422,11.384270121
47081,2017,278,260,198,-1,18,197,11.229374104,10.502292327,7.9978995415,-0.040393432,0.7270817765,7.9575061095
29085,2010,21,30,25,0,-9,25,NA,NA,NA,NA,NA,NA
29085,2011,83,152,38,1,-69,39,8.6211373669,15.788106985,3.9470267463,0.1038691249,-7.166969618,4.0508958712
29085,2012,77,157,-89,1,-80,-88,8.081868276,16.478614537,-9.341380215,0.1049593283,-8.396746261,-9.236420887
29085,2013,62,136,-21,0,-74,-21,6.5992549228,14.475784992,-2.235231506,0,-7.876530069,-2.235231506
29085,2014,65,137,15,1,-72,16,6.974248927,14.699570815,1.6094420601,0.1072961373,-7.725321888,1.7167381974
29085,2015,75,156,56,1,-81,57,8.0810257515,16.808533563,6.0338325611,0.10774701,-8.727507812,6.1415795712
29085,2016,79,155,181,1,-76,182,8.4750308427,16.628225071,19.417475728,0.1072788714,-8.153194228,19.5247546
29085,2017,88,136,147,1,-48,148,9.3373653775,14.430473765,15.597644437,0.1061064247,-5.093108388,15.703750862
35023,2010,11,1,-46,0,10,-46,NA,NA,NA,NA,NA,NA
35023,2011,53,35,-38,-1,18,-39,10.922205049,7.2127769191,-7.831014941,-0.206079341,3.7094281298,-8.037094281
35023,2012,62,53,-75,-1,9,-76,12.893833836,11.022148279,-15.59737964,-0.207965062,1.8716855568,-15.8053447
35023,2013,60,50,-174,1,10,-173,12.772751464,10.643959553,-37.04097924,0.2128791911,2.1287919106,-36.82810005
35023,2014,48,50,-74,1,-2,-73,10.475774771,10.912265386,-16.15015277,0.2182453077,-0.436490615,-15.93190746
35023,2015,58,51,-121,1,7,-120,12.920472266,11.361104923,-26.95477835,0.2227667632,1.5593673424,-26.732011580000002
35023,2016,54,39,-119,1,15,-118,12.324546388,8.9010612804,-27.15964852,0.2282323405,3.4234851078,-26.93141618
35023,2017,53,45,-35,1,8,-34,12.275622467,10.422698321,-8.106543138,0.2316155182,1.8529241459,-7.87492762
48215,2010,3769,904,1208,146,2865,1354,NA,NA,NA,NA,NA,NA
48215,2011,16377,3557,1319,1607,12820,2926,20.813978168,4.5206887918,1.6763532517,2.0423803454,16.293289376,3.7187335971
48215,2012,16132,3688,-1518,1235,12444,-283,20.14782398,4.6060733225,-1.895883759,1.5424350741,15.541750658,-0.353448685
48215,2013,16312,3850,-3387,1736,12462,-1651,20.085565593,4.7406466119,-4.170537682,2.1376006541,15.344918981,-2.032937028
48215,2014,16172,4079,-2399,2059,12093,-340,19.641278262,4.9540424209,-2.913642503,2.5007044238,14.687235841,-0.412938079
48215,2015,16331,4148,-3988,2748,12183,-1240,19.566015684,4.9696793251,-4.777984848,3.2923526483,14.596336359,-1.485632199
48215,2016,15496,4291,-4071,2948,11205,-1123,18.335206768,5.0772052298,-4.816896409,3.4881382003,13.258001538,-1.328758209
48215,2017,15574,4475,-3610,2989,11099,-621,18.206176119,5.2313238815,-4.220129433,3.4941736496,12.974852237,-0.725955783
39071,2010,134,98,-19,0,36,-19,NA,NA,NA,NA,NA,NA
39071,2011,546,481,-312,-3,65,-315,12.55489894,11.060268114,-7.174227966,-0.068982961,1.4946308262,-7.243210927
39071,2012,494,437,-478,3,57,-475,11.446180938,10.125467753,-11.07545443,0.0695112203,1.3207131851,-11.00594321
39071,2013,544,512,190,7,32,197,12.631774486,11.888728928,4.4118330005,0.1625412158,0.743045558,4.5743742163
39071,2014,581,473,-219,10,108,-209,13.47215137,10.967861615,-5.078143116,0.2318786811,2.5042897556,-4.846264434
39071,2015,516,499,-160,11,17,-149,11.998325815,11.603032135,-3.720411105,0.2557782635,0.39529368,-3.464632842
39071,2016,563,486,-32,11,77,-21,13.103384071,11.311269376,-0.744774938,0.256016385,1.7921146953,-0.488758553
39071,2017,559,466,-125,11,93,-114,13.005444139,10.841747708,-2.908194128,0.2559210832,2.1636964311,-2.652273045
51091,2010,0,14,-8,0,-14,-8,NA,NA,NA,NA,NA,NA
51091,2011,21,23,-36,0,-2,-36,9.2186128183,10.096575944,-15.80333626,0,-0.877963126,-15.80333626
51091,2012,18,28,-14,0,-10,-14,8.0124638326,12.463832629,-6.231916314,0,-4.451368796,-6.231916314
51091,2013,12,23,-18,0,-11,-18,5.4066231133,10.362694301,-8.10993467,0,-4.956071187,-8.10993467
51091,2014,19,36,49,0,-17,49,8.5527796534,16.205266712,22.05716858,0,-7.652487058,22.05716858
51091,2015,10,29,-22,0,-19,-22,4.5105999098,13.080739738,-9.923319802,0,-8.570139829,-9.923319802
51091,2016,22,22,16,0,0,16,9.9818511797,9.9818511797,7.2595281307,0,0,7.2595281307
51091,2017,17,26,9,0,-9,9,7.6853526221,11.754068716,4.068716094,0,-4.068716094,4.068716094
12055,2010,217,414,35,31,-197,66,NA,NA,NA,NA,NA,NA
12055,2011,914,1392,125,185,-478,310,9.2751387719,14.125813097,1.2684817795,1.8773530337,-4.850674325,3.1458348132
12055,2012,901,1447,110,211,-546,321,9.163208852,14.716052396,1.1187047433,2.1458790985,-5.552843544,3.2645838418
12055,2013,881,1491,275,211,-610,486,8.977154619,15.192891642,2.8021765269,2.1500336261,-6.215737023,4.952210153
12055,2014,894,1425,665,278,-531,943,9.096783056,14.499905878,6.766622743,2.8287535677,-5.403122822,9.5953763107
12055,2015,938,1453,1598,309,-515,1907,9.456932143,14.649171006,16.111063502,3.1153433179,-5.192238863,19.226406819
12055,2016,927,1511,1929,326,-584,2255,9.2033219326,15.001315469,19.1512492,3.2365511867,-5.797993537,22.387800386
12055,2017,935,1536,1601,325,-601,1926,9.1468932357,15.026340118,15.662220396,3.1794013921,-5.879446882,18.841621788
30041,2010,72,36,11,2,36,13,NA,NA,NA,NA,NA,NA
30041,2011,271,144,103,10,127,113,16.661543191,8.8533661236,6.3326160467,0.6148170919,7.8081770673,6.9474331386
30041,2012,302,141,-168,11,161,-157,18.428680397,8.6041189931,-10.25171625,0.6712433257,9.8245614035,-9.580472921
30041,2013,303,166,-7,3,137,-4,18.413855971,10.088119113,-0.425402613,0.1823154057,8.3257368581,-0.243087208
30041,2014,302,126,-217,5,176,-212,18.299703084,7.634975459,-13.1491244,0.3029752166,10.664727625,-12.84614918
30041,2015,316,163,-224,5,153,-219,19.204472941,9.906104713,-13.61329727,0.3038682427,9.2983682275,-13.30942903
30041,2016,302,142,-141,5,160,-136,18.375977365,8.6403602178,-8.579512611,0.3042380358,9.7356171469,-8.275274575
30041,2017,302,149,-142,5,153,-137,18.353641861,9.0552736334,-8.629858094,0.3038682427,9.2983682275,-8.325989851
48217,2010,108,61,4,7,47,11,NA,NA,NA,NA,NA,NA
48217,2011,431,388,-5,18,43,13,12.258596661,11.035581217,-0.142211098,0.5119599534,1.2230154441,0.3697488552
48217,2012,416,400,-71,12,16,-59,11.831963366,11.376887852,-2.019397594,0.3413066356,0.4550755141,-1.678090958
48217,2013,413,431,-299,27,-18,-272,11.80286641,12.317277053,-8.544932341,0.7716159639,-0.514410643,-7.7733163770000004
48217,2014,400,407,-92,27,-7,-65,11.49045574,11.691538716,-2.64280482,0.7756057625,-0.201082975,-1.867199058
48217,2015,399,437,78,35,-38,113,11.462388141,12.554044155,2.2407676065,1.005472644,-1.091656013,3.2462402505
48217,2016,407,434,317,38,-27,355,11.625914077,12.397166362,9.0550731261,1.0854661792,-0.771252285,10.140539305
48217,2017,405,410,648,38,-5,686,11.404756206,11.545555665,18.247609929,1.0700758909,-0.140799459,19.31768582
12057,2010,3761,2134,1230,1499,1627,2729,NA,NA,NA,NA,NA,NA
12057,2011,16540,9105,22724,6740,7435,29464,13.206664335,7.2700531301,18.144391799,5.3816757932,5.9366112051,23.526067592
12057,2012,16446,9254,-3428,7338,7192,3910,12.880553348,7.2477587673,-2.684819219,5.7471421909,5.6327945812,3.0623229717
12057,2013,16411,9914,-1061,7053,6497,5992,12.735497279,7.6936030725,-0.823372288,5.4733692223,5.0418942064,4.6499969347
12057,2014,16783,9634,9110,8397,7149,17507,12.839191857,7.3701230024,6.9692568561,6.423803493,5.4690688545,13.393060349
12057,2015,17289,10384,15226,9124,6905,24350,12.948549196,7.7770683583,11.403470996,6.8333948094,5.1714808372,18.236865806
12057,2016,17407,10877,14829,9344,6530,24173,12.740569091,7.961117367,10.853673755,6.8390806911,4.7794517244,17.692754446
12057,2017,17606,11302,11347,9256,6304,20603,12.61991554,8.1012317069,8.1334875401,6.6346664908,4.518683833,14.768154031
33011,2010,1127,630,-405,243,497,-162,NA,NA,NA,NA,NA,NA
33011,2011,4548,2944,-1661,852,1604,-809,11.329398269,7.3337177889,-4.137671619,2.122393871,3.9956804801,-2.015277748
33011,2012,4308,2972,-1377,953,1336,-424,10.709171904,7.3880359558,-3.423057036,2.369043831,3.3211359478,-1.054013205
33011,2013,4365,3026,-1611,946,1339,-665,10.830109939,7.5078837742,-3.997092122,2.3471441012,3.3222261645,-1.64994802
33011,2014,4126,3032,-430,1080,1094,650,10.207401232,7.5009308131,-1.063786362,2.6718355139,2.7064704187,1.6080491519
33011,2015,4230,3409,-1007,1172,821,165,10.430652804,8.406169127,-2.483136495,2.8900059304,2.0244836765,0.4068694356
33011,2016,4239,3189,-523,1183,1050,660,10.418727657,7.8380095536,-1.285443398,2.907609063,2.5807181032,1.6221656649
33011,2017,4261,3262,-180,1175,999,995,10.425548834,7.9812579901,-0.440412765,2.874916658,2.4442908437,2.4345038934
26059,2010,139,114,-69,0,25,-69,NA,NA,NA,NA,NA,NA
26059,2011,568,478,-134,-6,90,-140,12.184526938,10.253880064,-2.874518679,-0.128709792,1.930646874,-3.003228471
26059,2012,493,447,-384,2,46,-382,10.619850288,9.6289514783,-8.271850934,0.0430825569,0.9908988098,-8.228768377
26059,2013,544,468,-206,-1,76,-207,11.777823484,10.132392262,-4.459984628,-0.021650411,1.6454312221,-4.481635039
26059,2014,579,444,-340,-1,135,-341,12.581759708,9.6481887916,-7.388252678,-0.021730155,2.9335709164,-7.409982833
26059,2015,543,494,-101,0,49,-101,11.833158996,10.765341702,-2.201011158,0,1.0678172943,-2.201011158
26059,2016,521,444,-168,0,77,-168,11.372193786,9.6914664891,-3.667041374,0,1.6807272965,-3.667041374
26059,2017,525,453,42,0,72,42,11.457128516,9.8858651769,0.9165702813,0,1.5712633394,0.9165702813
28049,2010,823,401,-105,51,422,-54,NA,NA,NA,NA,NA,NA
28049,2011,3453,1994,704,166,1459,870,13.986523845,8.0767820869,2.8515820407,0.6723900835,5.9097417577,3.5239721242
28049,2012,3438,2009,-1798,189,1429,-1609,13.864692218,8.1018518519,-7.250935605,0.762195122,5.7628403665,-6.488740483
28049,2013,3307,2102,-3244,219,1205,-3025,13.388447151,8.509983644,-13.13339055,0.8866253178,4.8784635067,-12.24676523
28049,2014,3382,2210,-2459,270,1172,-2189,13.768592383,8.9972173764,-10.01093101,1.0992075528,4.7713750069,-8.911723456
28049,2015,3293,2100,-2994,298,1193,-2696,13.473785856,8.5924537798,-12.2503841,1.2193101078,4.8813320758,-11.031074
28049,2016,3216,2188,-3179,299,1028,-2880,13.248661642,9.0137038784,-13.09623612,1.2317630071,4.2349577637,-11.86447311
28049,2017,3137,2150,-3620,298,987,-3322,13.035122529,8.9338582841,-15.04212418,1.238274311,4.1012642448,-13.80384987
08053,2010,0,0,0,0,0,0,NA,NA,NA,NA,NA,NA
08053,2011,5,7,-17,0,-2,-17,5.9916117436,8.388256441,-20.37147993,0,-2.396644697,-20.37147993
08053,2012,6,3,-27,0,3,-27,7.3755377996,3.6877688998,-33.1899201,0,3.6877688998,-33.1899201
08053,2013,9,5,-1,0,4,-1,11.207970112,6.2266500623,-1.245330012,0,4.9813200498,-1.245330012
08053,2014,7,3,-36,0,4,-36,8.8776157261,3.804692454,-45.65630945,0,5.072923272,-45.65630945
08053,2015,7,7,-9,0,0,-9,9.1086532206,9.1086532206,-11.71112557,0,0,-11.71112557
08053,2016,2,3,25,0,-1,25,2.5789813024,3.8684719536,32.23726628,0,-1.289490651,32.23726628
08053,2017,2,0,5,0,2,5,2.5300442758,0,6.3251106894,0,2.5300442758,6.3251106894
31087,2010,9,14,-2,0,-5,-2,NA,NA,NA,NA,NA,NA
31087,2011,37,36,-43,1,1,-42,12.844992189,12.497830238,-14.9279639,0.3471619511,0.3471619511,-14.58080194
31087,2012,30,34,19,2,-4,21,10.454783063,11.848754138,6.6213626067,0.6969855376,-1.393971075,7.3183481443
31087,2013,33,41,-17,2,-8,-15,11.512297227,14.30315716,-5.930577359,0.6977149834,-2.790859934,-5.232862376
31087,2014,23,38,40,2,-15,42,8.0181279414,13.247341816,13.944570333,0.6972285166,-5.229213875,14.64179885
31087,2015,47,36,-9,3,11,-6,16.296809986,12.482662968,-3.120665742,1.040221914,3.814147018,-2.080443828
31087,2016,28,30,-44,4,-2,-40,9.7731239092,10.471204188,-15.35776614,1.3961605585,-0.698080279,-13.96160558
31087,2017,31,38,-7,4,-7,-3,10.919337795,13.384994716,-2.465656921,1.4089468123,-2.465656921,-1.056710109
39073,2010,83,42,66,0,41,66,NA,NA,NA,NA,NA,NA
39073,2011,315,311,-21,3,4,-18,10.688654756,10.552925807,-0.712576984,0.101796712,0.1357289493,-0.610780272
39073,2012,306,299,-175,4,7,-171,10.414539514,10.176298414,-5.9560275,0.1361377714,0.2382411,-5.819889728
39073,2013,334,318,-680,1,16,-679,11.527377522,10.97516782,-23.46891232,0.0345131064,0.5522097016,-23.43439921
39073,2014,318,309,85,3,9,88,11.082842505,10.769177151,2.9623950092,0.104555118,0.3136653539,3.0669501272
39073,2015,312,289,-275,3,23,-272,10.903372357,10.099598113,-9.610344225,0.1048401188,0.8037742443,-9.505504106
39073,2016,305,269,-144,3,36,-141,10.724897586,9.4590080349,-5.063558205,0.1054907959,1.2658895511,-4.958067409
39073,2017,309,294,73,3,15,76,10.868800563,10.341188885,2.5677101653,0.1055223356,0.5276116778,2.6732325009
48219,2010,98,73,-116,8,25,-108,NA,NA,NA,NA,NA,NA
48219,2011,321,215,-50,21,106,-29,14.024203766,9.3931582856,-2.184455415,0.9174712744,4.6310454804,-1.266984141
48219,2012,342,185,-33,16,157,-17,14.872798434,8.0452272233,-1.435094586,0.6958034355,6.8275712111,-0.73929115
48219,2013,329,175,177,5,154,182,14.161806168,7.5328756215,7.6189656286,0.2152250178,6.6289305469,7.8341906463
48219,2014,321,249,-17,11,72,-6,13.700091761,10.627173983,-0.725550031,0.4694735494,3.0729177781,-0.256076482
48219,2015,305,209,-261,20,96,-241,13.040875663,8.9362066017,-11.15956901,0.8551393877,4.1046690611,-10.30442962
48219,2016,317,198,-351,20,119,-331,13.65849455,8.5311732518,-15.12344349,0.8617346719,5.1273212978,-14.26170882
48219,2017,294,207,-122,21,87,-101,12.729752549,8.9627849581,-5.282414323,0.9092680392,3.7669675911,-4.373146284
20083,2010,10,4,-5,0,6,-5,NA,NA,NA,NA,NA,NA
20083,2011,19,20,38,0,-1,38,9.8039215686,10.319917441,19.607843137,0,-0.515995872,19.607843137
20083,2012,21,17,-34,1,4,-33,10.808028821,8.749356665,-17.49871333,0.5146680391,2.0586721565,-16.98404529
20083,2013,29,17,-26,9,12,-17,15.049299429,8.8220031136,-13.49247535,4.6704722366,6.2272963155,-8.822003114
20083,2014,21,15,-53,8,6,-45,11.014948859,7.8678206137,-27.79963284,4.196170994,3.1471282455,-23.60346184
20083,2015,24,25,-28,8,-1,-20,12.786361215,13.319126265,-14.91742142,4.2621204049,-0.532765051,-10.65530101
20083,2016,11,20,-32,7,-9,-25,5.9475533928,10.813733441,-17.30197351,3.7848067045,-4.866180049,-13.5171668
20083,2017,14,25,14,7,-11,21,7.619047619,13.605442177,7.619047619,3.8095238095,-5.986394558,11.428571429
37093,2010,222,79,374,49,143,423,NA,NA,NA,NA,NA,NA
37093,2011,987,309,1202,70,678,1272,20.353662938,6.3721193999,24.787338248,1.4435221942,13.981543538,26.230860442
37093,2012,962,298,93,266,664,359,19.239038048,5.9597020149,1.8599070046,5.3197340133,13.279336033,7.1796410179
37093,2013,909,293,-120,173,616,53,17.874875869,5.7616486574,-2.359719587,3.4019290708,12.113227211,1.0422094841
37093,2014,901,295,-311,160,606,-151,17.524068852,5.7376252067,-6.048818438,3.1119323155,11.786443645,-2.936886123
37093,2015,949,310,302,215,639,517,18.172939746,5.9363659865,5.7831694449,4.1171570552,12.236573759,9.9003265001
37093,2016,972,310,-492,138,662,-354,18.355207251,5.8540270041,-9.290907374,2.6059862147,12.501180247,-6.684921159
37093,2017,931,338,333,77,593,410,17.365515183,6.3045586809,6.2112959785,1.4362456167,11.060956502,7.6475415952
12059,2010,49,83,-46,1,-34,-45,NA,NA,NA,NA,NA,NA
12059,2011,200,263,52,7,-63,59,10.07962907,13.254712227,2.6207035581,0.3527870174,-3.175083157,2.9734905755
12059,2012,189,236,-97,2,-47,-95,9.5613901958,11.939090403,-4.907168513,0.1011787322,-2.377700207,-4.805989781
12059,2013,191,266,-21,0,-75,-21,9.7218334054,13.539307256,-1.068892678,0,-3.81747385,-1.068892678
12059,2014,183,250,44,-1,-67,43,9.3443627451,12.765522876,2.2467320261,-0.051062092,-3.421160131,2.1956699346
12059,2015,207,249,-246,0,-42,-246,10.655273588,12.817213157,-12.6627889,0,-2.161939569,-12.6627889
12059,2016,206,263,179,1,-57,180,10.648471221,13.594892869,9.2527978083,0.0516916079,-2.946421648,9.3044894161
12059,2017,200,237,188,1,-37,189,10.265622995,12.164763249,9.6496856153,0.051328115,-1.899140254,9.7010137303
28051,2010,81,69,-95,0,12,-95,NA,NA,NA,NA,NA,NA
28051,2011,305,216,-421,-1,89,-422,15.854038881,11.227778355,-21.8837717,-0.051980455,4.626260526,-21.93575216
28051,2012,279,190,-248,-1,89,-249,14.685756395,10.001052742,-13.05400568,-0.05263712,4.684703653,-13.1066428
28051,2013,258,198,-177,0,60,-177,13.678657583,10.497574424,-9.384195319,0,3.1810831588,-9.384195319
28051,2014,266,219,-345,-1,47,-346,14.258147513,11.738850772,-18.49271012,-0.053602058,2.519296741,-18.54631218
28051,2015,277,237,-224,-1,40,-225,15.040451757,12.868545366,-12.16267579,-0.05429766,2.1719063908,-12.21697345
28051,2016,232,207,-389,-1,25,-390,12.7876533,11.409673419,-21.44136696,-0.055119195,1.3779798815,-21.49648615
28051,2017,230,227,-224,-1,3,-225,12.885515,12.717443066,-12.54937113,-0.056023978,0.1680719348,-12.60539511
39075,2010,213,50,-55,1,163,-54,NA,NA,NA,NA,NA,NA
39075,2011,783,284,-187,3,499,-184,18.367131514,6.6618969986,-4.38653077,0.0703721514,11.705234515,-4.316158619
39075,2012,794,287,-169,-3,507,-172,18.483815022,6.6811774702,-3.934212517,-0.069838092,11.802637552,-4.004050609
39075,2013,808,298,-24,-4,510,-28,18.633182285,6.8721390109,-0.55346086,-0.092243477,11.761043274,-0.645704337
39075,2014,784,300,-300,-4,484,-304,17.943993683,6.8663241134,-6.866324113,-0.091550988,11.07766957,-6.957875102
39075,2015,736,331,-315,-3,405,-318,16.794258919,7.5528528563,-7.187760271,-0.06845486,9.2414060628,-7.256215131
39075,2016,712,315,-429,-3,397,-432,16.237172178,7.1835803877,-9.783352338,-0.068415051,9.0535917902,-9.851767389
39075,2017,771,326,-316,-3,445,-319,17.564842976,7.4268985864,-7.199079611,-0.068345693,10.137944389,-7.267425304
29087,2010,15,8,-3,0,7,-3,NA,NA,NA,NA,NA,NA
29087,2011,63,69,-72,0,-6,-72,12.919101815,14.149492464,-14.76468779,0,-1.230390649,-14.76468779
29087,2012,41,55,-148,0,-14,-148,8.6161605548,11.558264159,-31.1022381,0,-2.942103604,-31.1022381
29087,2013,56,80,-67,0,-24,-67,12.083288381,17.261840544,-14.45679146,0,-5.178552163,-14.45679146
29087,2014,51,66,-45,0,-15,-45,11.184210526,14.473684211,-9.868421053,0,-3.289473684,-9.868421053
29087,2015,44,65,-26,0,-21,-26,9.7636746921,14.423610341,-5.769444136,0,-4.659935649,-5.769444136
29087,2016,51,51,-3,0,0,-3,11.381388083,11.381388083,-0.669493417,0,0,-0.669493417
29087,2017,47,54,-59,0,-7,-59,10.571300045,12.145748988,-13.27035538,0,-1.574448943,-13.27035538
31089,2010,24,23,-2,1,1,-1,NA,NA,NA,NA,NA,NA
31089,2011,152,131,-21,8,21,-13,14.562176662,12.550296992,-2.01187967,0.7664303506,2.0118796704,-1.24544932
31089,2012,134,118,-85,3,16,-82,12.873474878,11.336343549,-8.166010183,0.2882121241,1.5371313287,-7.877798059
31089,2013,138,119,-11,2,19,-9,13.294797688,11.464354528,-1.05973025,0.1926782274,1.8304431599,-0.867052023
31089,2014,145,117,-55,9,28,-46,13.975230109,11.276564985,-5.300949352,0.8674280758,2.6986651246,-4.433521276
31089,2015,143,149,-94,10,-6,-84,13.85256224,14.433788627,-9.105880074,0.9687106461,-0.581226388,-8.137169427
31089,2016,132,114,-72,11,18,-61,12.869260018,11.114360924,-7.019596373,1.0724383348,1.7548990933,-5.947158038
31089,2017,140,119,-67,12,21,-55,13.700640994,11.645544845,-6.556735333,1.1743406567,2.0550961491,-5.382394676
15003,2010,3379,1747,-61,1467,1632,1406,NA,NA,NA,NA,NA,NA
15003,2011,13775,7075,-1192,4952,6700,3760,14.32875628,7.3594156572,-1.239918511,5.15107086,6.9693406224,3.9111523493
15003,2012,13516,7134,-3703,7226,6382,3523,13.913845543,7.3439903892,-3.811998376,7.4386984234,6.5698551533,3.6267000478
15003,2013,13762,7229,-2752,5795,6533,3043,14.028306354,7.3688872715,-2.80525353,5.9071381572,6.6594190821,3.1018846268
15003,2014,13548,7465,-7782,5476,6083,-2306,13.718298963,7.5588353824,-7.879820087,5.5448335639,6.1594635809,-2.334986523
15003,2015,12996,7681,-7452,6472,5315,-980,13.106395166,7.7462466354,-7.515301384,6.526976725,5.3601485311,-0.988324659
15003,2016,13237,8207,-11616,5648,5030,-5968,13.327111263,8.2628693914,-11.69507626,5.6864489244,5.0642418714,-6.008627334
15003,2017,12927,8401,-13473,4839,4526,-8634,13.048277213,8.4798156465,-13.59939962,4.8843980376,4.568461566,-8.715001582
48221,2010,129,109,70,7,20,77,NA,NA,NA,NA,NA,NA
48221,2011,567,572,236,55,-5,291,11.030484602,11.127755189,4.5911717215,1.0699764605,-0.097270587,5.661148182
48221,2012,525,623,642,59,-98,701,10.125654551,12.015776734,12.382228994,1.1379307019,-1.890122183,13.520159696
48221,2013,601,616,673,75,-15,748,11.442932894,11.728530221,12.813800063,1.427986634,-0.285597327,14.241786697
48221,2014,583,646,918,77,-63,995,10.924661064,12.105199052,17.202124968,1.4428797631,-1.180537988,18.645004732
48221,2015,634,765,1504,96,-131,1600,11.61469974,14.014582494,27.55285238,1.7586927051,-2.399882754,29.311545085
48221,2016,645,701,1382,103,-56,1485,11.508814503,12.508029405,24.659196346,1.8378416958,-0.999214903,26.497038042
48221,2017,664,663,1404,105,1,1509,11.544714034,11.527327416,24.410810999,1.8255948397,0.0173866175,26.236405838
41027,2010,66,19,45,5,47,50,NA,NA,NA,NA,NA,NA
41027,2011,291,168,-135,6,123,-129,12.967625499,7.4864642053,-6.015908736,0.2673737216,5.4811612932,-5.748535015
41027,2012,284,189,67,-14,95,53,12.616334599,8.3960818285,2.9763887963,-0.621931987,4.2202527709,2.354456809
41027,2013,293,169,-80,-18,124,-98,12.967470679,7.4795308697,-3.540606329,-0.796636424,5.4879398097,-4.337242753
41027,2014,268,203,27,-12,65,15,11.834319527,8.9640554623,1.1922635344,-0.52989490400000006,2.8702640643,0.6623686302
41027,2015,295,184,169,-9,111,160,12.927256792,8.0631025416,7.4057843996,-0.394390885,4.8641542507,7.0113935145
41027,2016,292,172,-1,-9,120,-10,12.690410483,7.475173298,-0.04346031,-0.391142789,5.2152371846,-0.434603099
41027,2017,281,163,203,-10,118,193,12.101375939,7.0196593527,8.7422751448,-0.430653948,5.0817165866,8.3116211968000009
31091,2010,2,1,0,0,1,0,NA,NA,NA,NA,NA,NA
31091,2011,5,5,5,0,0,5,6.7567567568,6.7567567568,6.7567567568,0,0,6.7567567568
31091,2012,7,16,-16,0,-9,-16,9.582477755,21.902806297,-21.9028063,0,-12.32032854,-21.9028063
31091,2013,6,9,16,0,-3,16,8.281573499,12.422360248,22.084195997,0,-4.140786749,22.084195997
31091,2014,10,13,-7,0,-3,-7,13.764624914,17.894012388,-9.63523744,0,-4.129387474,-9.63523744
31091,2015,6,16,2,0,-10,2,8.356545961,22.284122563,2.7855153203,0,-13.9275766,2.7855153203
31091,2016,9,18,-15,0,-9,-15,12.8113879,25.622775801,-21.35231317,0,-12.8113879,-21.35231317
31091,2017,6,9,-13,0,-3,-13,8.7912087912,13.186813187,-19.04761905,0,-4.395604396,-19.04761905
02105,2010,3,0,1,0,3,1,NA,NA,NA,NA,NA,NA
02105,2011,31,17,-39,2,14,-37,14.567669173,7.9887218045,-18.32706767,0.9398496241,6.5789473684,-17.38721805
02105,2012,18,12,21,3,6,24,8.4427767355,5.6285178236,9.8499061914,1.4071294559,2.8142589118,11.257035647
02105,2013,19,8,-11,1,11,-10,8.8454376164,3.7243947858,-5.121042831,0.4655493482,5.1210428305,-4.655493482
02105,2014,27,11,-37,2,16,-35,12.619770975,5.1413881748,-17.29376022,0.93479785,7.4783827997,-16.35896237
02105,2015,18,23,32,2,-5,34,8.3935649336,10.725110748,14.921893215,0.932618326,-2.331545815,15.854511541
02105,2016,15,5,-26,3,10,-23,6.970260223,2.3234200743,-12.08178439,1.3940520446,4.6468401487,-10.68773234
02105,2017,16,12,-8,3,4,-5,7.4592074592,5.5944055944,-3.72960373,1.3986013986,1.8648018648,-2.331002331
51670,2010,87,38,0,4,49,4,NA,NA,NA,NA,NA,NA
51670,2011,332,292,-214,27,40,-187,14.704254047,12.932657174,-9.478043271,1.1958278894,1.7715968731,-8.282215382
51670,2012,333,267,-290,33,66,-257,14.858111726,11.913260753,-12.9394967,1.4724254863,2.9448509727,-11.46707121
51670,2013,361,275,-271,38,86,-233,16.226906999,12.361217243,-12.18141772,1.7080954735,3.8656897559,-10.47332225
51670,2014,351,306,-146,42,45,-104,15.849363316,13.81739366,-6.592612661,1.8965050122,2.0319696559,-4.696107649
51670,2015,328,306,53,45,22,98,14.791431793,13.799323563,2.3900789177,2.0293122886,0.99210823,4.4193912063
51670,2016,373,283,249,47,90,296,16.632480157,12.619281191,11.103183805,2.095781682,4.0131989655,13.198965486
51670,2017,359,267,-136,47,92,-89,15.870910698,11.803713528,-6.012378426,2.0778072502,4.0671971706,-3.934571176
21107,2010,123,178,-21,2,-55,-19,NA,NA,NA,NA,NA,NA
21107,2011,571,511,-58,7,60,-51,12.189915034,10.909013279,-1.23820503,0.1494385381,1.2809017548,-1.088766492
21107,2012,562,605,-198,15,-43,-183,12.026149385,12.946299605,-4.23697078,0.3209826348,-0.92015022,-3.915988145
21107,2013,526,612,-120,25,-86,-95,11.305749597,13.154218162,-2.579258463,0.5373455132,-1.848468565,-2.04191295
21107,2014,538,585,-239,26,-47,-213,11.619493969,12.634579873,-5.161819811,0.5615368833,-1.015085904,-4.600282928
21107,2015,584,640,-73,30,-56,-43,12.662756535,13.876993463,-1.582844567,0.6504840686,-1.214236928,-0.932360498
21107,2016,559,558,-390,29,1,-361,12.181966767,12.160174339,-8.499046581,0.6319803868,0.0217924271,-7.867066194
21107,2017,537,534,-190,29,3,-161,11.769218125,11.703468303,-4.164155389,0.635581612,0.0657498219,-3.528573777
48223,2010,122,125,46,1,-3,47,NA,NA,NA,NA,NA,NA
48223,2011,497,367,-74,-5,130,-79,14.107895596,10.417701577,-2.10057198,-0.141930539,3.690194019,-2.242502519
48223,2012,462,361,-25,-14,101,-39,13.094124649,10.231556274,-0.708556529,-0.396791656,2.8625683757,-1.105348185
48223,2013,427,392,-35,-10,35,-45,12.093747787,11.102456985,-0.991290802,-0.283225943,0.9912908022,-1.274516746
48223,2014,474,370,289,-11,104,278,13.354934141,10.424737621,8.1425653307,-0.309924632,2.9301965204,7.8326406987
48223,2015,451,397,234,-11,54,223,12.590379945,11.082884342,6.5324809469,-0.307082438,1.5074956031,6.2253985093
48223,2016,466,361,150,-10,105,140,12.915384829,10.005265929,4.1573127131,-0.277154181,2.9101188991,3.8801585322
48223,2017,464,362,203,-9,102,194,12.764962379,9.9588715113,5.5846710409,-0.247596253,2.8060908678,5.3370747878
45051,2010,703,585,914,57,118,971,NA,NA,NA,NA,NA,NA
45051,2011,3100,2701,4471,288,399,4759,11.352545992,9.8913634591,16.373301009,1.0546881437,1.4611825325,17.427989153
45051,2012,3080,2768,5232,200,312,5432,11.054046391,9.9342858476,18.77752296,0.7177952202,1.1197605435,19.495318181
45051,2013,2993,2928,7015,268,65,7283,10.490307068,10.262485498,24.58720484,0.9393258584,0.2278215701,25.526530698
45051,2014,3189,3007,8189,296,182,8485,10.865084205,10.245001005,27.900336957,1.0084869629,0.6200832002,28.90882392
45051,2015,3092,3203,10789,358,-111,11147,10.184989986,10.550621904,35.538763571,1.179245283,-0.365631917,36.718008854
45051,2016,3148,3460,12149,367,-312,12516,9.9834296633,10.972892832,38.528807808,1.1638877657,-0.989463169,39.692695574
45051,2017,3202,3443,11613,369,-241,11982,9.7814598264,10.517665891,35.475356953,1.1272200737,-0.736206064,36.602577027
05059,2010,75,57,177,2,18,179,NA,NA,NA,NA,NA,NA
05059,2011,382,356,-125,1,26,-124,11.513653626,10.730001808,-3.767556815,0.0301404545,0.7836518175,-3.73741636
05059,2012,331,382,399,0,-51,399,9.9368067126,11.467855481,11.97820507,0,-1.531048768,11.97820507
05059,2013,358,390,45,6,-32,51,10.686886176,11.642138571,1.3433236813,0.1791098242,-0.955252396,1.5224335055
05059,2014,337,414,-30,5,-77,-25,10.074437237,12.37631162,-0.896834175,0.1494723626,-2.301874383,-0.747361813
05059,2015,371,424,130,6,-53,136,11.095493017,12.680563448,3.8879086042,0.1794419356,-1.585070431,4.0673505398
05059,2016,326,353,-12,7,-27,-5,9.7423943578,10.54927978,-0.358615743,0.2091925169,-0.806885422,-0.149423226
05059,2017,325,359,156,8,-34,164,9.6985974336,10.713219934,4.6553267681,0.2387347061,-1.014622501,4.8940614742
56017,2010,15,19,-1,2,-4,1,NA,NA,NA,NA,NA,NA
56017,2011,55,72,12,4,-17,16,11.438078403,14.973484455,2.4955807424,0.8318602475,-3.535406052,3.3274409899
56017,2012,55,57,32,-5,-2,27,11.409604813,11.824499533,6.6383155274,-1.037236801,-0.41489472,5.6010787263
56017,2013,48,65,21,-2,-17,19,9.9306920451,13.447812144,4.3446777697,-0.413778835,-3.517120099,3.9308989345
56017,2014,52,76,-21,-2,-24,-23,10.807440507,15.795489972,-4.364543282,-0.415670789,-4.988049465,-4.78021407
56017,2015,45,78,-37,-2,-33,-39,9.4677046076,16.410687987,-7.784557122,-0.420786871,-6.942983379,-8.205343993
56017,2016,51,62,-33,-2,-11,-35,10.867249094,13.211165566,-7.031749414,-0.426166631,-2.343916471,-7.457916045
56017,2017,45,69,52,-2,-24,50,9.6102509343,14.735718099,11.105178857,-0.427122264,-5.125467165,10.678056594
26061,2010,110,64,22,32,46,54,NA,NA,NA,NA,NA,NA
26061,2011,403,363,-187,151,40,-36,10.973003145,9.8838713191,-5.091691286,4.1114726424,1.0891318258,-0.980218643
26061,2012,374,348,-260,154,26,-106,10.192957593,9.4843562629,-7.0860133,4.1971001853,0.70860133,-2.888913115
26061,2013,378,367,-267,156,11,-111,10.326176037,10.02567885,-7.293886248,4.2615964596,0.3004971863,-3.032289789
26061,2014,364,342,-403,161,22,-242,9.9857346648,9.382201251,-11.05563481,4.4167672556,0.6035334138,-6.638867552
26061,2015,363,350,-364,170,13,-194,10.011583651,9.6530420873,-10.03916377,4.6886204424,0.3585415632,-5.350543328
26061,2016,372,358,-67,171,14,104,10.268300762,9.8818593353,-1.849398255,4.7201059954,0.3864414265,2.8707077399
26061,2017,368,348,-171,169,20,-2,10.138858276,9.5878333701,-4.711262949,4.6561604585,0.5510249063,-0.055102491
01069,2010,323,235,145,5,88,150,NA,NA,NA,NA,NA,NA
01069,2011,1330,912,247,25,418,272,13.022745743,8.9298827953,2.4185099237,0.2447884538,4.0928629478,2.6632983775
01069,2012,1335,1003,526,39,332,565,12.97186999,9.7459068163,5.1110139435,0.3789535053,3.2259631735,5.4899674489
01069,2013,1251,1095,99,24,156,123,12.087715654,10.580374613,0.9565818143,0.2318986217,1.5073410407,1.188480436
01069,2014,1282,1058,284,28,224,312,12.340390715,10.184191401,2.7337527013,0.2695249142,2.1561993137,3.0032776155
01069,2015,1268,1093,-90,30,175,-60,12.169081129,10.48959438,-0.863736042,0.2879120141,1.6794867488,-0.575824028
01069,2016,1312,1106,-310,32,206,-278,12.589841763,10.613083072,-2.974733953,0.3070693113,1.9767586915,-2.667664642
01069,2017,1286,1116,-25,33,170,8,12.334607398,10.704060541,-0.239786302,0.3165179192,1.6305468566,0.0767316168
13153,2010,502,258,487,89,244,576,NA,NA,NA,NA,NA,NA
13153,2011,2086,1016,1870,237,1070,2107,14.65263217,7.1366607312,13.135389338,1.6647525524,7.5159714393,14.80014189
13153,2012,2105,993,530,463,1112,993,14.515639654,6.8475202736,3.6547691289,3.1927511447,7.6681193799,6.8475202736
13153,2013,2025,998,319,366,1027,685,13.78432467,6.7934597634,2.1714565777,2.4913890515,6.9908649068,4.6628456292
13153,2014,1999,1029,-158,376,970,218,13.475935108,6.9368370315,-1.065131439,2.5347431719,6.5390980764,1.4696117326
13153,2015,2026,1125,-572,428,901,-144,13.569493421,7.5348865246,-3.831071193,2.8666057178,6.0346068966,-0.964465475
13153,2016,2025,1226,1023,358,799,1381,13.43074214,8.1314024016,6.785011955,2.374422561,5.2993397381,9.159434516
13153,2017,2018,1234,538,301,784,839,13.218008718,8.0827664808,3.5239289843,1.9715662161,5.1352422374,5.4954952004
27055,2010,36,26,-6,1,10,-5,NA,NA,NA,NA,NA,NA
27055,2011,166,172,-150,0,-6,-150,8.7578147669,9.0743622886,-7.913688042,0,-0.316547522,-7.913688042
27055,2012,201,175,-136,-2,26,-138,10.678708992,9.2973834507,-7.225395139,-0.106255811,1.3813255412,-7.33165095
27055,2013,181,146,-28,5,35,-23,9.6415064188,7.7771267246,-1.491503755,0.2663399563,1.8643796942,-1.225163799
27055,2014,194,175,-100,5,19,-95,10.351359283,9.3375663634,-5.335752208,0.2667876104,1.0137929195,-5.068964597
27055,2015,208,212,-18,5,-4,-13,11.126267084,11.340233759,-0.962850036,0.2674583434,-0.213966675,-0.695391693
27055,2016,196,169,2,6,27,8,10.480162549,9.0364666881,0.1069404342,0.3208213025,1.4436958614,0.4277617367
27055,2017,188,169,-83,6,19,-77,10.059124107,9.0425105005,-4.440996281,0.3210358758,1.0166136066,-4.119960406
47083,2010,23,9,8,0,14,8,NA,NA,NA,NA,NA,NA
47083,2011,97,109,-96,2,-12,-94,11.554496724,12.983918999,-11.4353782,0.2382370459,-1.429422275,-11.19714116
47083,2012,67,111,98,2,-44,100,8.0033446814,13.259272532,11.706384758,0.2389058114,-5.25592785,11.945290569
47083,2013,77,106,-103,1,-29,-102,9.2375982245,12.71669366,-12.35678724,0.1199688081,-3.479095435,-12.23681843
47083,2014,67,116,-5,1,-49,-4,8.1276156972,14.071692849,-0.606538485,0.121307697,-5.944077152,-0.485230788
47083,2015,101,97,-101,2,4,-99,12.36381442,11.874158404,-12.36381442,0.2448280083,0.4896560166,-12.11898641
47083,2016,92,102,4,2,-10,6,11.330049261,12.561576355,0.4926108374,0.2463054187,-1.231527094,0.7389162562
47083,2017,86,97,104,2,-11,106,10.532116833,11.879248056,12.736513379,0.2449329496,-1.347131223,12.981446329
48225,2010,60,113,1,5,-53,6,NA,NA,NA,NA,NA,NA
48225,2011,230,281,-216,10,-51,-206,9.7650030781,11.930286369,-9.170611586,0.4245653512,-2.165283291,-8.746046235
48225,2012,227,277,-181,14,-50,-167,9.7358037399,11.880253903,-7.76290959,0.6004460456,-2.144450163,-7.162463544
48225,2013,236,325,-325,8,-89,-317,10.257970574,14.126442527,-14.12644253,0.3477278161,-3.868471954,-13.77871471
48225,2014,245,320,56,11,-75,67,10.745378391,14.034779939,2.4560864893,0.4824455604,-3.289401548,2.9385320497
48225,2015,219,280,-9,14,-61,5,9.6198194637,12.299312556,-0.395335046,0.6149656278,-2.679493093,0.2196305814
48225,2016,234,270,174,15,-36,189,10.257759074,11.835875855,7.6275644398,0.6575486586,-1.578116781,8.2851130984
48225,2017,243,302,179,15,-59,194,10.586159577,13.156461696,7.7980352436,0.6534666405,-2.570302119,8.4515018842
05061,2010,48,27,1,2,21,3,NA,NA,NA,NA,NA,NA
05061,2011,188,162,-17,6,26,-11,13.608889211,11.726808788,-1.230591046,0.4343262514,1.8820804227,-0.796264794
05061,2012,192,161,-181,11,31,-170,13.960590417,11.706536756,-13.16076492,0.7998254926,2.254053661,-12.36093943
05061,2013,187,176,-160,17,11,-143,13.729809104,12.922173275,-11.74743025,1.248164464,0.8076358297,-10.49926579
05061,2014,189,156,-86,15,33,-71,13.963281741,11.525248421,-6.353662591,1.1081969635,2.4380333198,-5.245465627
05061,2015,180,177,-164,19,3,-145,13.387378677,13.164255699,-12.19738946,1.4131121937,0.2231229779,-10.78427727
05061,2016,206,153,-11,20,53,9,15.365680826,11.412374594,-0.82049752,1.4918136725,3.9533062321,0.6713161526
05061,2017,204,164,-19,20,40,1,15.158270174,12.186060336,-1.411799673,1.486104919,2.972209838,0.074305246
18067,2010,224,173,-68,19,51,-49,NA,NA,NA,NA,NA,NA
18067,2011,999,867,-171,72,132,-99,12.070684187,10.475758949,-2.066153149,0.8699592207,1.5949252379,-1.196193928
18067,2012,987,897,-88,40,90,-48,11.92158568,10.834510998,-1.062917467,0.4831443031,1.087074682,-0.579773164
18067,2013,1054,989,-177,19,65,-158,12.736082748,11.9506507,-2.138791885,0.2295878294,0.785432048,-1.909204055
18067,2014,951,942,-166,22,9,-144,11.508440733,11.399528045,-2.008834029,0.2662310159,0.1089126883,-1.742603013
18067,2015,989,1076,-178,24,-87,-154,11.996821873,13.05215403,-2.159185332,0.2911261122,-1.055332157,-1.86805922
18067,2016,985,954,-32,28,31,-4,11.964555763,11.588006292,-0.388696228,0.3401091993,0.3765494707,-0.048587028
18067,2017,964,936,-25,26,28,1,11.705990213,11.365982198,-0.303578584,0.3157217277,0.3400080145,0.0121431434
19089,2010,28,13,-13,2,15,-11,NA,NA,NA,NA,NA,NA
19089,2011,114,118,-30,6,-4,-24,11.929053524,12.347616805,-3.139224612,0.6278449223,-0.418563282,-2.511379689
19089,2012,118,105,-11,1,13,-10,12.363141076,11.00110011,-1.152496202,0.104772382,1.362040966,-1.04772382
19089,2013,120,114,-117,1,6,-116,12.643557054,12.011379201,-12.32746813,0.1053629755,0.6321778527,-12.22210515
19089,2014,112,106,-91,0,6,-91,11.922503726,11.283798169,-9.687034277,0,0.6387055567,-9.687034277
19089,2015,128,105,-58,0,23,-58,13.714040821,11.249799111,-6.214174747,0,2.46424171,-6.214174747
19089,2016,113,101,-56,1,12,-55,12.159035885,10.867810836,-6.025716899,0.1076020875,1.2912250498,-5.918114811
19089,2017,115,109,-51,1,6,-50,12.432432432,11.783783784,-5.513513514,0.1081081081,0.6486486486,-5.405405405
24027,2010,912,394,569,387,518,956,NA,NA,NA,NA,NA,NA
24027,2011,3313,1417,1851,1519,1896,3370,11.375829881,4.8655451076,6.3557685209,5.2157819467,6.5102847735,11.571550468
24027,2012,3390,1471,2229,1556,1919,3785,11.425489965,4.9577863534,7.5125124282,5.2442661903,6.4677036113,12.756778618
24027,2013,3452,1505,1209,1538,1947,2747,11.434969408,4.9854081575,4.0048893438,5.094722755,6.449561251,9.0996120988
24027,2014,3454,1542,43,1630,1912,1673,11.287692363,5.0392650908,0.1405242535,5.3268496096,6.2484272722,5.4673738631
24027,2015,3646,1623,867,1760,2023,2627,11.757800911,5.2339305754,2.7959444294,5.6757349432,6.5238703353,8.4716793726
24027,2016,3549,1749,1012,1763,1800,2775,11.278016289,5.5579742153,3.2159347661,5.6024634315,5.7200420741,8.8183981976
24027,2017,3584,1811,657,1733,1773,2390,11.233718709,5.6764131087,2.0593061361,5.4319292752,5.5573056001,7.4912354113
29089,2010,41,15,-31,4,26,-27,NA,NA,NA,NA,NA,NA
29089,2011,119,125,66,16,-6,82,11.682128307,12.27114318,6.4791635989,1.570706327,-0.589014873,8.0498699259
29089,2012,121,82,-69,6,39,-63,11.848225214,8.029375765,-6.756425949,0.5875152999,3.8188494492,-6.168910649
29089,2013,101,95,36,2,6,38,9.8806495793,9.2936802974,3.5218156916,0.1956564273,0.5869692819,3.717472119
29089,2014,129,104,-138,4,25,-134,12.660712533,10.207086073,-13.54401806,0.3925802336,2.4536264599,-13.15143783
29089,2015,118,106,-12,4,12,-8,11.64052481,10.456742626,-1.183782184,0.3945940614,1.1837821841,-0.789188123
29089,2016,123,88,-117,4,35,-113,12.17761497,8.7124399782,-11.58358497,0.396019999,3.4651749913,-11.18756497
29089,2017,114,77,36,4,37,40,11.286569972,7.6233849809,3.5641799911,0.396019999,3.6631849908,3.9601999901
31093,2010,20,3,-12,0,17,-12,NA,NA,NA,NA,NA,NA
31093,2011,63,60,12,1,3,13,10.020677589,9.5435024654,1.9087004931,0.1590583744,0.4771751233,2.0677588675
31093,2012,73,65,-4,1,8,-3,11.593742555,10.323195426,-0.635273565,0.1588183912,1.2705471294,-0.476455174
31093,2013,81,77,34,1,4,35,12.821527503,12.188365651,5.381875742,0.158290463,0.633161852,5.540166205
31093,2014,77,71,10,1,6,11,12.136496178,11.190795177,1.5761683348,0.1576168335,0.9457010009,1.7337851683
31093,2015,81,49,-3,1,32,-2,12.721847024,7.6959321501,-0.471179519,0.1570598398,5.0259148736,-0.31411968
31093,2016,90,69,16,1,21,17,14.061401453,10.780407781,2.4998047028,0.1562377939,3.2809936724,2.6560424967
31093,2017,84,61,-7,1,23,-6,13.067828251,9.4897324207,-1.088985688,0.1555693839,3.5780958307,-0.933416304
48227,2010,105,118,-26,13,-13,-13,NA,NA,NA,NA,NA,NA
48227,2011,407,390,-83,77,17,-6,11.633390976,11.147475383,-2.372411428,2.2009118063,0.4859155936,-0.171499621
48227,2012,425,365,380,48,60,428,12.061699139,10.358871025,10.784578053,1.362262491,1.7028281137,12.146840544
48227,2013,454,374,540,44,80,584,12.6741297,10.440802881,15.074956031,1.2283297507,2.2333268195,16.303285782
48227,2014,492,424,207,63,68,270,13.542340458,11.670634866,5.6976920219,1.7340801806,1.8717055917,7.4317722024
48227,2015,507,392,440,74,115,514,13.770625382,10.647110749,11.950838596,2.0099137638,3.123514633,13.96075236
48227,2016,479,363,-712,79,116,-633,12.989478251,9.8438008461,-19.30795097,2.1423147847,3.1456774054,-17.16563619
48227,2017,464,349,-779,83,115,-696,12.772165488,9.6066503344,-21.44292439,2.284676154,3.1655151532,-19.15824823
29091,2010,124,87,118,7,37,125,NA,NA,NA,NA,NA,NA
29091,2011,559,495,-43,10,64,-33,13.775767956,12.198578065,-1.059674458,0.2464359205,1.5771898912,-0.813238538
29091,2012,507,468,-89,11,39,-78,12.497380973,11.536043975,-2.193820329,0.2711463327,0.9613369979,-1.922673996
29091,2013,485,522,-268,7,-37,-261,12.005693422,12.921591683,-6.634073891,0.1732780494,-0.915898261,-6.460795841
29091,2014,549,520,-149,12,29,-137,13.659944514,12.938380961,-3.707343775,0.2985780222,0.7215635536,-3.408765753
29091,2015,480,550,4,13,-70,17,11.969179363,13.714684687,0.0997431614,0.3241652744,-1.745505324,0.4239084358
29091,2016,508,492,41,11,16,52,12.66627604,12.267338212,1.0222781843,0.2742697568,0.398937828,1.2965479411
29091,2017,491,491,-45,11,0,-34,12.237827599,12.237827599,-1.121593161,0.2741672171,0,-0.847425944
27057,2010,60,57,0,0,3,0,NA,NA,NA,NA,NA,NA
27057,2011,233,178,25,9,55,34,11.382232969,8.6954397792000009,1.2212696319,0.4396570675,2.6867931902,1.6609266994
27057,2012,209,193,-81,8,16,-73,10.203334391,9.4222178827,-3.954402324,0.3905582542,0.7811165084,-3.56384407
27057,2013,212,188,209,11,24,220,10.302765223,9.1364144433,10.156971376,0.5345774408,1.16635078,10.691548817
27057,2014,232,223,-85,10,9,-75,11.225625393,10.790148546,-4.11283689,0.4838631635,0.4354768471,-3.628973726
27057,2015,211,217,9,10,-6,19,10.222868217,10.513565891,0.4360465116,0.484496124,-0.290697674,0.9205426357
27057,2016,223,190,33,9,33,42,10.78206213,9.1865103348,1.595551795,0.4351504895,1.595551795,2.0307022845
27057,2017,204,185,270,9,19,279,9.7754989578,8.8650358195,12.938160385,0.4312720128,0.9104631382,13.369432398
34017,2010,2429,892,-1574,2116,1537,542,NA,NA,NA,NA,NA,NA
34017,2011,10350,3878,-3533,9395,6472,5862,16.10940073,6.0359667664,-5.498986742,14.622977764,10.073433964,9.1239910223
34017,2012,10286,3677,-5696,9390,6609,3694,15.733506281,5.6243537423,-8.712624127,14.362981137,10.109152538,5.6503570096
34017,2013,10363,3881,-7892,9527,6482,1635,15.630762269,5.8538056902,-11.90369351,14.369803352,9.7769565791,2.4661098437
34017,2014,10278,3748,-10225,10272,6530,47,15.330699659,5.5905295117,-15.25164468,15.321750039,9.7401701472,0.0701053594
34017,2015,10210,3701,-11580,11117,6509,-463,15.084805863,5.4680574434,-17.10891791,16.424856687,9.6167484191,-0.684061226
34017,2016,10350,4014,-11303,11440,6336,137,15.150428384,5.8757313558,-16.54543884,16.745980745,9.274697028,0.2005419023
34017,2017,10345,4155,-12324,11383,6190,-941,15.014143338,6.030330166,-17.88635114,16.520637372,8.9838131715,-1.365713763
48229,2010,11,0,-14,0,11,-14,NA,NA,NA,NA,NA,NA
48229,2011,55,19,-103,4,36,-99,15.981403458,5.5208484672000004,-29.92881011,1.1622838878,10.460554991,-28.76652622
48229,2012,49,16,-104,11,33,-93,14.490610676,4.7316279758,-30.75558184,3.2529942333,9.7589827,-27.50258761
48229,2013,45,18,-59,16,27,-43,13.454925998,5.3819703992,-17.64090298,4.7839736881,8.0729555987,-12.85692929
48229,2014,39,19,-118,15,20,-103,11.827141774,5.7619408643,-35.78468537,4.5489006823,6.0652009098,-31.23578469
48229,2015,43,14,126,22,29,148,12.847325964,4.1828503137,37.645652823,6.573050493,8.6644756498,44.218703316
48229,2016,32,12,587,27,20,614,8.5231056066,3.1961646025,156.34571847,7.1913703556,5.3269410041,163.53708883
48229,2017,59,15,262,27,44,289,13.913453602,3.5373187124,61.785166844,6.3671736823,10.37613489,68.152340526
08055,2010,10,13,-32,3,-3,-29,NA,NA,NA,NA,NA,NA
08055,2011,46,107,-115,13,-61,-102,6.9707531444,16.214577966,-17.42688286,1.9699954539,-9.243824822,-15.45688741
08055,2012,58,105,84,0,-47,84,8.8712144387,16.059957173,12.847965739,0,-7.188742735,12.847965739
08055,2013,48,93,-54,-2,-45,-56,7.377805103,14.294497387,-8.300030741,-0.307408546,-6.916692284,-8.607439287
08055,2014,44,96,-13,0,-52,-13,6.851448147,14.948614139,-2.024291498,0,-8.097165992,-2.024291498
08055,2015,56,103,59,0,-47,59,8.7575259989,16.107592462,9.2266791774,0,-7.350066463,9.2266791774
08055,2016,39,100,242,0,-61,242,6.0083192112,15.405946695,37.282391003,0,-9.397627484,37.282391003
08055,2017,44,85,121,0,-41,121,6.6445182724,12.836001208,18.272425249,0,-6.191482936,18.272425249
40063,2010,36,31,23,-1,5,22,NA,NA,NA,NA,NA,NA
40063,2011,140,173,-257,-5,-33,-262,10.08282319,12.459488657,-18.50918257,-0.360100828,-2.376665466,-18.8692834
40063,2012,154,190,-61,3,-36,-58,11.247033047,13.876209604,-4.45499361,0.2190980464,-2.629176557,-4.235895563
40063,2013,141,235,76,3,-94,79,10.339517489,17.232529149,5.5730732566,0.2199897338,-6.893011659,5.7930629904
40063,2014,132,171,77,3,-39,80,9.6717467761000009,12.529308324,5.641852286,0.2198124267,-2.857561547,5.8616647128
40063,2015,156,207,-45,3,-51,-42,11.452903605,15.197122091,-3.303722194,0.2202481462,-3.744218486,-3.083474047
40063,2016,161,176,-141,3,-15,-138,11.927692992,13.038968736,-10.445992,0.2222551489,-1.111275745,-10.22373685
40063,2017,154,175,-101,3,-21,-98,11.525220775,13.09684179,-7.55874869,0.2245172878,-1.571621015,-7.334231402
46065,2010,50,22,23,0,28,23,NA,NA,NA,NA,NA,NA
46065,2011,250,139,125,-1,111,124,14.541647278,8.0851558865,7.2708236389,-0.058166589,6.4564913913,7.2126570498
46065,2012,230,147,55,-12,83,43,13.238933978,8.4614056294,3.1658320382,-0.69072699,4.7775283486,2.4751050481
46065,2013,240,132,-107,-8,108,-115,13.76659879,7.5716293343,-6.137608627,-0.458886626,6.1949694554,-6.596495253
46065,2014,254,127,82,-7,127,75,14.489033399,7.2445166995,4.6775619634,-0.39930407,7.2445166995,4.2782578934
46065,2015,234,142,-162,-7,92,-169,13.301500682,8.0718508413,-9.208731241,-0.39790814,5.2296498408,-9.606639382
46065,2016,236,155,-50,-7,81,-57,13.4354274,8.8241154536,-2.846488856,-0.39850844,4.6113119467,-3.244997296
46065,2017,240,162,18,-7,78,11,13.619725903,9.1933149845,1.0214794427,-0.397242006,4.4264109185,0.6242374372
06023,2010,383,290,252,23,93,275,NA,NA,NA,NA,NA,NA
06023,2011,1548,1191,-192,72,357,-120,11.45572009,8.8138001465,-1.420864507,0.5328241902,2.6419199432,-0.888040317
06023,2012,1437,1287,-859,66,150,-793,10.65095336,9.5391628217,-6.366853818,0.489187837,1.1117905387,-5.877665981
06023,2013,1541,1292,-431,43,249,-388,11.455545644,9.604519774,-3.203984538,0.3196550699,1.8510258698,-2.884329468
06023,2014,1485,1353,-16,47,132,31,11.039743075,10.05843258,-0.118946727,0.3494060098,0.9813104956,0.230459283
06023,2015,1447,1300,434,65,147,499,10.726344777,9.6366608229,3.2171621516,0.4818330411,1.0896839546,3.6989951928
06023,2016,1471,1340,1036,60,131,1096,10.829394702,9.8649822578,7.6269564321,0.4417156235,0.9644124446,8.0686720556
06023,2017,1446,1332,136,59,114,195,10.585535298,9.7509910213,0.9955966809,0.431913266,0.8345442766,1.4275099468
19091,2010,26,31,-19,0,-5,-19,NA,NA,NA,NA,NA,NA
19091,2011,106,119,2,1,-13,3,10.832353993,12.160850238,0.2043840376,0.1021920188,-1.328496244,0.3065760564
19091,2012,108,125,-45,2,-17,-43,11.078059288,12.82182788,-4.615858037,0.2051492461,-1.743768592,-4.410708791
19091,2013,106,115,-44,0,-9,-44,10.936290947,11.864843952,-4.539592468,0,-0.928553005,-4.539592468
19091,2014,103,117,-34,6,-14,-28,10.679108346,12.130637636,-3.525142561,0.6220839813,-1.45152929,-2.90305858
19091,2015,110,127,-71,8,-17,-63,11.477462437,13.251252087,-7.408180301,0.8347245409,-1.773789649,-6.57345576
19091,2016,103,98,-23,7,5,-16,10.799475754,10.275229358,-2.411533421,0.7339449541,0.5242463958,-1.677588467
19091,2017,105,109,30,7,-4,37,10.997643362,11.416601205,3.1421838178,0.7331762241,-0.418957842,3.8753600419
32013,2010,60,15,19,1,45,20,NA,NA,NA,NA,NA,NA
32013,2011,264,124,-71,7,140,-64,15.875402147,7.4566282811,-4.269521032,0.4209386933,8.4187738657,-3.848582339
32013,2012,276,138,295,-2,138,293,16.343933203,8.1719666015,17.469059039,-0.118434299,8.1719666015,17.350624741
32013,2013,263,112,129,8,151,137,15.245051155,6.492189085,7.4776106426,0.4637277918,8.75286207,7.9413384343
32013,2014,259,128,-276,16,131,-260,14.941302028,7.3841183766,-15.92200525,0.9230147971,7.5571836511,-14.99899045
32013,2015,268,146,-347,17,122,-330,15.606347358,8.5019653516000009,-20.20672587,0.9899548697,7.1043820061,-19.216771
32013,2016,225,96,-347,19,129,-328,13.256738842,5.6562085727,-20.44483724,1.1194579467,7.6005302696,-19.32537929
32013,2017,232,104,-195,19,128,-176,13.768954568,6.1722899789,-11.57304371,1.1276299,7.5966645895,-10.44541381
28053,2010,36,14,-67,0,22,-67,NA,NA,NA,NA,NA,NA
28053,2011,138,92,-67,1,46,-66,14.798134148,9.8654227655,-7.184601362,0.1072328561,4.9327113828,-7.077368506
28053,2012,135,79,-164,4,56,-160,14.571752388,8.5271736197,-17.70198068,0.4317556263,6.0445787684,-17.27022505
28053,2013,140,115,-287,4,25,-283,15.404929577,12.654049296,-31.58010563,0.4401408451,2.7508802817,-31.13996479
28053,2014,111,100,-195,7,11,-188,12.504928744,11.265701572,-21.96811806,0.78859911,1.2392271729,-21.17951895
28053,2015,115,98,-112,8,17,-104,13.148116389,11.204481793,-12.80512205,0.9146515749,1.9436345967,-11.89047047
28053,2016,96,76,-137,8,20,-129,11.100190785,8.7876510378,-15.84089727,0.9250158987,2.3125397468,-14.91588137
28053,2017,100,100,-262,8,0,-254,11.809163911,11.809163911,-30.94000945,0.9447331129,0,-29.99527633
47085,2010,53,65,36,0,-12,36,NA,NA,NA,NA,NA,NA
47085,2011,215,232,-151,5,-17,-146,11.635143545,12.555131639,-8.171658955,0.2705847336,-0.919988094,-7.901074221
47085,2012,204,221,-99,3,-17,-96,11.12231824,12.049178093,-5.397595616,0.1635635035,-0.926859853,-5.234032113
47085,2013,216,264,6,2,-48,8,11.826220263,14.454269211,0.3285061184,0.1095020395,-2.628048947,0.4380081579
47085,2014,186,234,-50,2,-48,-48,10.22174594,12.85961586,-2.747781167,0.1099112467,-2.63786992,-2.63786992
47085,2015,203,232,30,2,-29,32,11.186421998,12.784482284,1.6531658125,0.1102110542,-1.598060285,1.7633768667
47085,2016,196,231,267,2,-35,269,10.731787445,12.64817806,14.619322693,0.1095080352,-1.916390615,14.728830728
47085,2017,197,232,138,2,-35,140,10.687644107,12.586464126,7.4867760749,0.1085040011,-1.898820019,7.595280076
48231,2010,284,243,145,25,41,170,NA,NA,NA,NA,NA,NA
48231,2011,1092,822,-30,97,270,67,12.618004922,9.4981685405,-0.346648487,1.1208301076,3.1198363819,0.7741816207
48231,2012,1050,816,-3,89,234,86,12.088766082,9.3946982126,-0.034539332,1.0246668394,2.6940678698,0.9901275077
48231,2013,1061,854,189,77,207,266,12.161782658,9.7890314705,2.1664249976,0.8826175916,2.3727511878,3.0490425892
48231,2014,1075,900,910,86,175,996,12.207100558,10.219898142,10.333452565,0.9765680446,1.9872024164,11.31002061
48231,2015,1162,921,679,102,241,781,13.032092369,10.329222953,7.6151383118,1.1439530306,2.7028694155,8.7590913424
48231,2016,1124,935,1969,107,189,2076,12.377968537,10.296619735,21.683469796,1.1783297451,2.0813488021,22.861799541
48231,2017,1154,944,1614,108,210,1722,12.421223717,10.160862382,17.372491403,1.1624715437,2.2603613349,18.534962946
34019,2010,244,231,-75,36,13,-39,NA,NA,NA,NA,NA,NA
34019,2011,985,838,-338,204,147,-134,7.7345897134,6.5802905379,-2.654102866,1.6018845701,1.1542991755,-1.052218296
34019,2012,928,815,-913,151,113,-762,7.3043259241,6.4148983062,-7.186260311,1.1885271708,0.8894276179,-5.99773314
34019,2013,838,869,-287,179,-31,-108,6.6161115739,6.8608603314,-2.265899787,1.4132266966,-0.244748758,-0.852673091
34019,2014,920,895,-633,134,25,-499,7.2808138684,7.0829656654,-5.009516499,1.0604663678,0.1978482029,-3.949050131
34019,2015,909,911,-534,148,-2,-386,7.2178373485,7.2337181788,-4.240181677,1.1751814385,-0.01588083,-3.065000238
34019,2016,928,931,-839,156,-3,-683,7.400082932,7.4240056139,-6.690376702,1.2439794584,-0.023922682,-5.446397244
34019,2017,915,963,-104,154,-48,50,7.3164880857,7.7003038542,-0.831600832,1.2314089237,-0.383815768,0.3998080921
42061,2010,110,115,9,0,-5,9,NA,NA,NA,NA,NA,NA
42061,2011,426,424,8,7,2,15,9.2538286087,9.2103834039,0.1737808189,0.1520582166,0.0434452047,0.3258390355
42061,2012,424,447,-47,24,-23,-23,9.2142864904,9.7141180689,-1.021394965,0.5215633863,-0.499831578,-0.499831578
42061,2013,456,471,-71,31,-15,-40,9.9218868992,10.248264758,-1.544855197,0.674514241,-0.326377859,-0.870340956
42061,2014,440,430,-87,24,10,-63,9.5863699249,9.3684978812,-1.895486781,0.522892905,0.2178720437,-1.372593876
42061,2015,430,453,-231,26,-23,-205,9.3979827121,9.9006655083,-5.048683736,0.5682501175,-0.502682796,-4.480433619
42061,2016,407,485,-86,27,-78,-59,8.9310204843,10.642616548,-1.887144378,0.5924755604,-1.711596063,-1.294668817
42061,2017,393,511,84,26,-118,110,8.6379321714,11.23150977,1.8462755786,0.5714662505,-2.593577599,2.4177418291
18069,2010,121,101,-29,3,20,-26,NA,NA,NA,NA,NA,NA
18069,2011,391,381,32,6,10,38,10.527874635,10.258619529,0.8616163384,0.1615530634,0.2692551057,1.0231694018
18069,2012,431,416,-208,5,15,-203,11.627279594000001,11.222617891,-5.611308946,0.1348872343,0.4046617028,-5.476421711
18069,2013,414,417,-206,8,-3,-198,11.227270878,11.308627914,-5.586516427,0.2169520943,-0.081357035,-5.369564333
18069,2014,424,427,-176,11,-3,-165,11.556754841,11.638524333,-4.797143519,0.2998214699,-0.081769492,-4.497322049
18069,2015,443,389,-151,14,54,-137,12.116902121,10.639898251,-4.130140452,0.3829269293,1.4770038703,-3.747213523
18069,2016,428,398,-198,17,30,-181,11.744367917,10.921164558,-5.433142167,0.4664819032,0.8232033587,-4.966660264
18069,2017,420,386,-81,17,34,-64,11.553538271,10.61825184,-2.228182381,0.4676432157,0.9352864315,-1.760539165
26063,2010,92,85,-38,0,7,-38,NA,NA,NA,NA,NA,NA
26063,2011,318,414,-244,12,-96,-232,9.6596345742,12.575750672,-7.411795082,0.3645145122,-2.916116098,-7.04728057
26063,2012,269,454,-143,11,-185,-132,8.2520400025,13.9272348,-4.386772195,0.337444015,-5.675194797,-4.04932818
26063,2013,298,426,-82,11,-128,-71,9.2154497944,13.1737638,-2.53579491,0.3401676099,-3.958314006,-2.1956273
26063,2014,287,440,-71,16,-153,-55,8.9321838723,13.693940431,-2.209704024,0.4979614702,-4.761756559,-1.711742554
26063,2015,296,487,-93,16,-191,-77,9.281761026,15.271005472,-2.916228971,0.5017168122,-5.989244446,-2.414512159
26063,2016,310,460,-168,17,-150,-151,9.8091953296,14.555580166,-5.315951017,0.5379236148,-4.746384837,-4.778027402
26063,2017,313,449,-50,17,-136,-33,9.9791171829,14.315091422,-1.594108176,0.5419967799,-4.335974239,-1.052111396
39077,2010,169,150,-94,7,19,-87,NA,NA,NA,NA,NA,NA
39077,2011,734,523,-415,30,211,-385,12.341631147,8.7938325473,-6.9778977190000004,0.5044263411,3.5477985994,-6.473471378
39077,2012,711,602,-345,4,109,-341,11.994938844,10.156052299,-5.820328975,0.0674820751,1.8388865458,-5.7528469
39077,2013,733,583,-579,22,150,-557,12.431946541,9.8878919964,-9.820050542,0.3731279999,2.5440545445,-9.446922542
39077,2014,751,604,-370,22,147,-348,12.802154717,10.296273567,-6.3073199,0.3750298319,2.5058811496,-5.9322900690000004
39077,2015,724,577,-465,32,147,-433,12.39312216,9.8768390691,-7.959671,0.5477623054,2.5162830904,-7.411908695
39077,2016,787,560,-148,35,227,-113,13.491274385,9.599890287,-2.537113862,0.5999931429,3.8913840985,-1.937120719
39077,2017,760,559,-132,37,201,-95,13.004234932,9.564957009,-2.258630278,0.6331009112,3.4392779227,-1.625529366
46067,2010,24,38,8,0,-14,8,NA,NA,NA,NA,NA,NA
46067,2011,67,112,-48,1,-45,-47,9.1887814579,15.360351094,-6.583007612,0.13714599190000001,-6.171569636,-6.44586162
46067,2012,96,102,9,4,-6,13,13.243205959,14.070906332,1.2415505587,0.5518002483,-0.827700372,1.793350807
46067,2013,82,113,-34,5,-31,-29,11.353409484,15.645552094,-4.70751125,0.6922810661,-4.29214261,-4.015230183
46067,2014,106,108,35,3,-2,38,14.701803051,14.979195562,4.854368932,0.4160887656,-0.27739251,5.2704576976
46067,2015,115,119,42,3,-4,45,15.867540531,16.419454984,5.7951017592,0.4139358399,-0.551914453,6.2090375992
46067,2016,123,111,55,3,12,58,16.842393537,15.199233192,7.5311515815,0.4107900863,1.6431603451,7.9419416678
46067,2017,121,99,-5,3,22,-2,16.467065868,13.473053892,-0.680457267,0.4082743604,2.994011976,-0.272182907
48233,2010,63,49,-57,1,14,-56,NA,NA,NA,NA,NA,NA
48233,2011,285,237,-262,11,48,-251,12.889220541,10.71840445,-11.84903783,0.4974786876,2.1708160912,-11.35155914
48233,2012,312,224,-111,13,88,-98,14.176340959,10.177885817,-5.043505918,0.5906808733,3.9984551423,-4.452825045
48233,2013,300,260,-164,14,40,-150,13.668048658,11.84564217,-7.4718666,0.6378422707,1.8224064878,-6.834024329
48233,2014,317,231,-97,16,86,-81,14.477530142,10.549872123,-4.430032883,0.7307270734,3.9276580197,-3.699305809
48233,2015,284,274,-146,20,10,-126,13.003960713,12.546074773,-6.685134733,0.9157718812,0.4578859406,-5.769362852
48233,2016,310,245,-300,23,65,-277,14.301861549,11.303084127,-13.84051118,1.0611058568,2.9987774215,-12.77940532
48233,2017,286,220,-285,23,66,-262,13.319361975,10.245663057,-13.27279078,1.0711375015,3.0736989172,-12.20165328
37095,2010,19,21,-6,5,-2,-1,NA,NA,NA,NA,NA,NA
37095,2011,43,52,-4,0,-9,-4,7.4054938431,8.9554809265,-0.688883148,0,-1.549987083,-0.688883148
37095,2012,60,64,-118,9,-4,-109,10.442046641,11.138183084,-20.53602506,1.5663069962,-0.696136443,-18.96971806
37095,2013,48,54,-37,7,-6,-30,8.4603860051,9.5179342558,-6.521547546,1.2338062924,-1.057548251,-5.287741253
37095,2014,50,53,-52,3,-3,-49,8.8817834621,9.4146904698,-9.237054801,0.5329070077,-0.532907008,-8.704147793
37095,2015,42,61,-154,4,-19,-150,7.6080065211,11.049723757,-27.89602391,0.7245720496,-3.441717236,-27.17145186
37095,2016,42,48,41,4,-6,45,7.6972418217,8.7968477962,7.5139741593,0.7330706497,-1.099605975,8.2470448089
37095,2017,42,49,-111,4,-7,-107,7.7497924163,9.0414244857,-20.48159424,0.7380754682,-1.291632069,-19.74351877
46069,2010,3,2,1,0,1,1,NA,NA,NA,NA,NA,NA
46069,2011,13,19,-18,0,-6,-18,9.219858156,13.475177305,-12.76595745,0,-4.255319149,-12.76595745
46069,2012,15,16,31,0,-1,31,10.615711253,11.323425336,21.939136589,0,-0.707714084,21.939136589
46069,2013,10,23,-39,2,-13,-37,7.1225071225,16.381766382,-27.77777778,1.4245014245,-9.259259259,-26.35327635
46069,2014,18,13,9,0,5,9,12.977649603,9.3727469358,6.4888248017,0,3.6049026676000002,6.4888248017
46069,2015,17,20,-3,0,-3,-3,12.221423436,14.378145219,-2.156721783,0,-2.156721783,-2.156721783
46069,2016,14,16,-48,1,-2,-47,10.267693436,11.734506784,-35.20352035,0.733406674,-1.466813348,-34.47011368
46069,2017,16,13,-25,1,3,-24,12.043658261,9.7854723372,-18.81821603,0.7527286413,2.258185924,-18.06548739
22045,2010,253,138,-102,16,115,-86,NA,NA,NA,NA,NA,NA
22045,2011,1089,655,-328,127,434,-201,14.839140447,8.9252864949,-4.469456443,1.7305517326,5.9138539523,-2.738904711
22045,2012,984,673,-100,80,311,-20,13.361668036,9.1386205164,-1.357893093,1.0863144745,4.2230475195,-0.271578619
22045,2013,1088,755,-302,72,333,-230,14.735658804,10.225572056,-4.090228823,0.9751538915,4.5100867481,-3.115074931
22045,2014,1071,744,-530,72,327,-458,14.507870283,10.078296443,-7.179431606,0.9753190106,4.4295738398,-6.204112595
22045,2015,1160,732,-440,88,428,-352,15.719115664,9.9193040226,-5.962423183,1.1924846366,5.7998116416,-4.769938546
22045,2016,1076,746,-1181,95,330,-1086,14.648424205,10.155877748,-16.07787081,1.2933088285,4.492546457,-14.78456198
22045,2017,1054,763,-1292,97,291,-1195,14.512609034,10.505807109,-17.78964978,1.3356006416,4.0068019249,-16.45404914
22047,2010,86,43,-62,4,43,-58,NA,NA,NA,NA,NA,NA
22047,2011,423,284,-196,19,139,-177,12.675296656,8.5101282512,-5.873187103,0.5693395661,4.1651684047,-5.303847537
22047,2012,450,282,-203,13,168,-190,13.496490912,8.4578009717,-6.088417012,0.3898986264,5.0386899406,-5.698518385
22047,2013,431,336,-52,6,95,-46,12.92218208,10.073905287,-1.559056771,0.1798911658,2.8482767925,-1.379165605
22047,2014,374,355,-267,6,19,-261,11.246090931,10.674765456,-8.028626413,0.1804185711,0.5713254751,-7.848207842
22047,2015,397,353,-32,9,44,-23,11.97803524,10.650494811,-0.965483949,0.2715423606,1.3275404296,-0.693941588
22047,2016,383,328,-301,10,55,-291,11.593939669,9.929013607,-9.111686267,0.3027138295,1.6649260621,-8.808972438
22047,2017,378,298,22,10,80,32,11.464272716,9.0379716123,0.6672328036,0.303287638,2.426301104,0.9705204416
19093,2010,23,38,-8,0,-15,-8,NA,NA,NA,NA,NA,NA
19093,2011,71,106,13,0,-35,13,10.063071363,15.023740344,1.8425341932,0,-4.960668982,1.8425341932
19093,2012,73,88,15,0,-15,15,10.364165543,12.493788599,2.1296230567,0,-2.129623057,2.1296230567
19093,2013,91,95,33,2,-4,35,12.89317087,13.459903655,4.6755454803,0.2833663927,-0.566732785,4.9589118731
19093,2014,84,85,-105,2,-1,-103,11.963255715,12.105675425,-14.95406964,0.2848394218,-0.142419711,-14.66923022
19093,2015,73,76,-8,2,-3,-6,10.47947172,10.910134941,-1.148435257,0.2871088142,-0.430663221,-0.861326443
19093,2016,79,85,1,2,-6,3,11.351390186,12.213521086,0.1436884834,0.2873769667,-0.8621309,0.4310654501
19093,2017,80,105,-70,2,-25,-68,11.575748806,15.193170308,-10.12878021,0.2893937202,-3.617421502,-9.839386485
16049,2010,40,22,26,-1,18,25,NA,NA,NA,NA,NA,NA
16049,2011,166,170,133,-4,-4,129,10.139262155,10.383581725,8.1236257024,-0.24431957,-0.24431957,7.8793061324
16049,2012,155,163,14,-1,-8,13,9.430231497,9.9169531226,0.8517628449,-0.060840203,-0.486721626,0.7909226417
16049,2013,158,178,-173,1,-20,-172,9.6683392486,10.89217966,-10.58621956,0.0611920206,-1.223840411,-10.52502754
16049,2014,156,200,70,0,-44,70,9.595866396,12.302392815,4.3058374854,0,-2.706526419,4.3058374854
16049,2015,150,203,49,0,-53,49,9.2222563787,12.480786966,3.0126037504,0,-3.258530587,3.0126037504
16049,2016,159,184,-8,0,-25,-8,9.7876269621,11.326562019,-0.492459218,0,-1.538935057,-0.492459218
16049,2017,160,171,154,0,-11,154,9.8168543117,10.491763046,9.4487222751,0,-0.674908734,9.4487222751
06025,2010,687,180,-268,-5,507,-273,NA,NA,NA,NA,NA,NA
06025,2011,3127,981,-1025,252,2146,-773,17.820963996,5.5907789192,-5.841537607,1.4361633921,12.230185077,-4.405374215
06025,2012,3017,952,-1236,244,2065,-992,17.074233584,5.3876931958,-6.994946208,1.3808793485,11.686540388,-5.614066859
06025,2013,3016,972,-2450,375,2044,-2075,17.015130829,5.4836562221,-13.82197299,2.1156081104,11.531474607,-11.70636488
06025,2014,3167,984,-967,385,2183,-582,17.785390372,5.5259943561,-5.430524941,2.1621014503,12.259396016,-3.268423491
06025,2015,3269,980,-1878,547,2289,-1331,18.226574893,5.464069561,-10.47094146,3.049842908,12.762505332,-7.421098557
06025,2016,3142,1027,-1535,562,2115,-973,17.415934305,5.6926048795,-8.50842112,3.1151352894,11.723329426,-5.39328583
06025,2017,3106,1030,-778,558,2076,-220,17.074846761,5.6622962535,-4.276957753,3.0675352519,11.412550507,-1.209422501
05063,2010,119,98,129,1,21,130,NA,NA,NA,NA,NA,NA
05063,2011,450,388,-66,49,62,-17,12.219959267,10.536320434,-1.792260692,1.3306177868,1.6836388323,-0.461642906
05063,2012,481,405,-15,15,76,0,13.041768909,10.981115193,-0.40670797,0.4067079701,2.0606537153,0
05063,2013,472,419,-153,21,53,-132,12.799826443,11.362557796,-4.149096283,0.5694838036,1.4372686472,-3.57961248
05063,2014,461,394,134,12,67,146,12.480203582,10.666377898,3.6276513665,0.3248643015,1.8138256832,3.9525156679
05063,2015,455,475,-29,21,-20,-8,12.288496077,12.828649751,-0.783222827,0.5671613574,-0.540153674,-0.216061469
05063,2016,485,427,5,22,58,27,13.089711756,11.524344165,0.134945482,0.5937601209,1.5653675915,0.7287056029
05063,2017,494,421,316,23,73,339,13.244322904,11.287165876,8.4720769994,0.6166385158,1.9571570283,9.0887155152
12061,2010,316,407,307,33,-91,340,NA,NA,NA,NA,NA,NA
12061,2011,1323,1741,1029,205,-418,1234,9.5399136865,12.554036076,7.4199328673,1.4782179182,-3.014122389,8.8981507854
12061,2012,1246,1714,1642,225,-468,1867,8.9132106515,12.261029741,11.74598065,1.6095284082,-3.347819089,13.355509058
12061,2013,1225,1851,1817,253,-626,2070,8.6743780117,13.107162204,12.866403957,1.7915246016,-4.432784192,14.657928559
12061,2014,1263,1894,2873,324,-631,3197,8.8163538827,13.221040581,20.054936425,2.2616774806,-4.404686698,22.316613906
12061,2015,1233,2058,3478,364,-825,3842,8.4394250513,14.0862423,23.805612594,2.4914442163,-5.646817248,26.29705681
12061,2016,1275,2038,4122,389,-763,4511,8.5281143503,13.631605526,27.570892041,2.6019109665,-5.103491176,30.172803007
12061,2017,1260,2112,3444,391,-852,3835,8.241623469,13.814530767,22.527104149,2.5575196638,-5.572907298,25.084623812
42063,2010,237,231,-30,8,6,-22,NA,NA,NA,NA,NA,NA
42063,2011,839,896,-253,55,-57,-198,9.4547462488,10.097083002,-2.85107366,0.6197986218,-0.642336753,-2.231275038
42063,2012,848,880,-391,65,-32,-326,9.5898311602,9.9517115813,-4.421726396,0.7350696054,-0.361880421,-3.68665679
42063,2013,904,884,-146,82,20,-64,10.247051422,10.020346745,-1.654944146,0.9294891777,0.2267046775,-0.725454968
42063,2014,877,895,-800,99,-18,-701,9.9840051002,10.188921967,-9.107416283,1.127042765,-0.204916866,-7.980373518
42063,2015,807,927,-603,103,-120,-500,9.2570818971,10.633599651,-6.917001715,1.1815110724,-1.376517754,-5.735490643
42063,2016,764,872,-1615,107,-108,-1508,8.8773725766,10.132289119,-18.76565015,1.2432969446,-1.254916542,-17.5223532
42063,2017,749,889,-266,104,-140,-162,8.8009447209,10.445981117,-3.125569153,1.2220270373,-1.645036396,-1.903542116
26065,2010,825,374,-693,362,451,-331,NA,NA,NA,NA,NA,NA
26065,2011,3285,2008,-1766,1699,1277,-67,11.663722627,7.1296057946,-6.270360475,6.0324702415,4.5341168325,-0.237890233
26065,2012,3267,1930,-2650,1656,1337,-994,11.56705849,6.8333097295,-9.382523722,5.8631921824,4.7337487608,-3.519331539
26065,2013,3248,2063,-2633,1708,1185,-925,11.486021745,7.2954627031,-9.311174647,6.040063159,4.1905590418,-3.271111488
26065,2014,3311,2087,-1743,1796,1224,53,11.676335232,7.3598645813,-6.146738843,6.3336448433,4.3164706505,0.1869060004
26065,2015,3340,2202,-1568,1908,1138,340,11.721807124,7.7279698462,-5.502932207,6.6961700575,3.9938372775,1.1932378509
26065,2016,3305,2142,-859,1952,1163,1093,11.523569273,7.4685281037,-2.995081999,6.8060536221,4.0550411693,3.8109716234
26065,2017,3315,2174,-811,1927,1141,1116,11.46822713,7.5209429201,-2.80565074,6.6664475653,3.9472842097,3.8607968256
06027,2010,39,35,-34,0,4,-34,NA,NA,NA,NA,NA,NA
06027,2011,193,199,-116,5,-6,-111,10.455604312,10.780649006,-6.28419741,0.270870578,-0.325044694,-6.013326832
06027,2012,229,203,-68,14,26,-54,12.455467624,11.041309728,-3.698566805,0.7614696364,1.4141578962,-2.937097169
06027,2013,212,197,-20,12,15,-8,11.538356873,10.721963698,-1.088524233,0.65311454,0.816393175,-0.435409693
06027,2014,241,182,-105,11,59,-94,13.127434159,9.9136639704,-5.719421521,0.5991774927,3.2137701882,-5.120244029
06027,2015,196,147,-210,16,49,-194,10.728850207,8.046637655,-11.49519665,0.8758245067,2.6822125517,-10.61937214
06027,2016,212,182,-210,17,30,-193,11.702685546,10.046645138,-11.59228285,0.9384228975,1.6560404074,-10.65385995
06027,2017,194,195,-23,17,-1,-6,10.759844703,10.81530782,-1.275651692,0.9428729895,-0.055463117,-0.332778702
26067,2010,201,169,-91,0,32,-91,NA,NA,NA,NA,NA,NA
26067,2011,747,459,-286,1,288,-285,11.699386839,7.1887798652,-4.479283315,0.0156618298,4.5106069742,-4.463621485
26067,2012,733,447,-272,7,286,-265,11.47769444,6.9993580007,-4.259117173,0.1096096331,4.4783364389,-4.14950754
26067,2013,754,505,-140,4,249,-136,11.794611083,7.8995737359,-2.189980838,0.0625708811,3.895037347,-2.127409957
26067,2014,717,526,63,4,191,67,11.184687741,8.2052242007,0.9827549898,0.0623971422,2.9794635406,1.045152132
26067,2015,738,522,-399,6,216,-393,11.506080449,8.1384471469,-6.220767072,0.0935453695,3.3676333022,-6.127221703
26067,2016,732,523,-81,4,209,-77,11.416718006,8.1570266624,-1.263325353,0.0623864372,3.2596913431,-1.200938916
26067,2017,725,528,-88,4,197,-84,11.286418158,8.2196259136,-1.369937652,0.0622698933,3.0667922443,-1.307667759
26069,2010,59,69,-44,3,-10,-41,NA,NA,NA,NA,NA,NA
26069,2011,201,369,-82,8,-168,-74,7.8185778746,14.353508635,-3.189668586,0.3111871791,-6.534930761,-2.878481407
26069,2012,229,403,17,14,-174,31,8.9754644509,15.795249667,0.6663008544,0.5487183507,-6.819785216,1.2150192051
26069,2013,231,422,157,4,-191,161,9.0844738084,16.595878559,6.1742960516,0.1573069058,-7.511404751,6.3316029574
26069,2014,231,383,141,7,-152,148,9.089657072,15.070730124,5.5482322388,0.2754441537,-5.981073052,5.8236763925
26069,2015,255,437,87,7,-182,94,10.051637826,17.22574796,3.429382317,0.2759273129,-7.174110134,3.7053096299
26069,2016,213,399,123,10,-186,133,8.419637916,15.771997786,4.8620444304,0.3952881651,-7.35235987,5.2573325955
26069,2017,222,386,46,10,-164,56,8.8037594432,15.30743759,1.8242024072,0.3965657407,-6.503678147,2.2207681478
19095,2010,56,48,-29,0,8,-29,NA,NA,NA,NA,NA,NA
19095,2011,170,154,-25,-4,16,-29,10.412200649,9.4322288234,-1.531205978,-0.244992956,0.9799718258,-1.776198934
19095,2012,187,166,-165,-2,21,-167,11.509108813,10.216642048,-10.15509601,-0.123092073,1.2924667651,-10.27818808
19095,2013,204,207,112,-5,-3,107,12.570865171,12.755730836,6.9016514666,-0.30810944,-0.184865664,6.5935420261
19095,2014,192,180,28,-5,12,23,11.782393912,11.045994293,1.7182657789,-0.306833175,0.7363996195,1.4114326041
19095,2015,188,168,-52,-5,20,-57,11.538343511,10.310860159,-3.191456716,-0.306870838,1.2274833523,-3.498327554
19095,2016,181,185,-80,-6,-4,-86,11.152530885,11.398995656,-4.929295419,-0.369697156,-0.246464771,-5.298992575
19095,2017,185,185,-74,-6,0,-80,11.459720631,11.459720631,-4.583888252,-0.371666615,0,-4.955554867
55049,2010,71,59,-8,1,12,-7,NA,NA,NA,NA,NA,NA
55049,2011,290,221,-185,2,69,-183,12.271236644,9.3515286153,-7.828202687,0.0846292182,2.9197080292,-7.743573469
55049,2012,279,206,-78,5,73,-73,11.83457052,8.7380699894,-3.308589608,0.2120890774,3.0965005302,-3.09650053
55049,2013,256,194,-88,5,62,-83,10.864721485,8.2334217507,-3.734748011,0.2122015915,2.6312997347,-3.522546419
55049,2014,256,207,-31,5,49,-26,10.865643768,8.7858916407,-1.31576155,0.2122196048,2.0797521275,-1.103541945
55049,2015,228,195,-37,6,33,-31,9.6729031437,8.2728776887,-1.56972551,0.2545500827,1.400025455,-1.315175427
55049,2016,300,222,-185,7,78,-178,12.754559755,9.4383742188,-7.865311849,0.2976063943,3.3161855363,-7.567705455
55049,2017,279,204,163,7,75,170,11.825792095,8.6468157253,6.90897531,0.2967044612,3.1789763696,7.2056797711
37097,2010,438,291,144,32,147,176,NA,NA,NA,NA,NA,NA
37097,2011,1814,1391,732,179,423,911,11.306618797,8.6700698717,4.5625385665,1.1157027369,2.6365489257,5.6782413034
37097,2012,1689,1433,1167,223,256,1390,10.430948234,8.8499400946,7.2071738244,1.3772063092,1.5810081397,8.5843801336
37097,2013,1769,1465,1388,181,304,1569,10.807376386,8.9501449435,8.479727769,1.1057858258,1.8572314422,9.5855135948
37097,2014,1757,1485,1466,200,272,1666,10.61031985,8.9677432991,8.8530044959,1.2077768753,1.6425765504,10.060781371
37097,2015,1876,1483,2370,219,393,2589,11.162447527,8.8240456732,14.101812708,1.3030788958,2.3384018541,15.404891603
37097,2016,1911,1568,2394,230,343,2624,11.172400488,9.167097836,13.996194017,1.3446635856,2.0053026516,15.340857603
37097,2017,1941,1587,2602,226,354,2828,11.147484493,9.1144038594,14.943716977,1.297955433,2.033080634,16.24167241
48235,2010,5,4,9,0,1,9,NA,NA,NA,NA,NA,NA
48235,2011,12,22,-5,0,-10,-5,7.5023444827,13.754298218,-3.125976868,0,-6.251953736,-3.125976868
48235,2012,21,9,-30,0,12,-30,13.27014218,5.6872037915,-18.95734597,0,7.5829383886,-18.95734597
48235,2013,9,13,41,0,-4,41,5.6532663317,8.1658291457,25.753768844,0,-2.512562814,25.753768844
48235,2014,18,16,-40,0,2,-40,11.302982732,10.047095761,-25.1177394,0,1.2558869702,-25.1177394
48235,2015,11,15,-28,0,-4,-28,7.0580686558,9.624639076,-17.96599294,0,-2.56657042,-17.96599294
48235,2016,16,7,19,0,9,19,10.279473177,4.4972695149,12.206874398,0,5.7822036621,12.206874398
48235,2017,14,8,-60,0,6,-60,9.0732339598,5.1847051199,-38.8852884,0,3.8885288399,-38.8852884
26071,2010,19,25,0,0,-6,0,NA,NA,NA,NA,NA,NA
26071,2011,85,191,59,0,-106,59,7.2125583369,16.207042851,5.0063640221,0,-8.994484514,5.0063640221
26071,2012,102,210,-90,0,-108,-90,8.746730695,18.00797496,-7.717703554,0,-9.261244265,-7.717703554
26071,2013,82,178,32,0,-96,32,7.1128073904,15.43999653,2.7757297133,0,-8.32718914,2.7757297133
26071,2014,90,196,-48,1,-106,-47,7.8822911193,17.165878438,-4.203888597,0.0875810124,-9.283587318,-4.116307585
26071,2015,97,172,50,1,-75,51,8.5628531073,15.183615819,4.4138418079,0.0882768362,-6.620762712,4.5021186441
26071,2016,87,179,-41,1,-92,-40,7.7343645819,15.913232875,-3.644930435,0.0889007423,-8.178868294,-3.556029693
26071,2017,86,184,40,1,-98,41,7.7109297947,16.497803282,3.5864789743,0.0896619744,-8.786873487,3.6761409486
29093,2010,32,18,-40,1,14,-39,NA,NA,NA,NA,NA,NA
29093,2011,101,133,49,6,-32,55,9.5134931475,12.527669194,4.6154570715,0.5651580088,-3.014176047,5.1806150803
29093,2012,122,142,-57,5,-20,-52,11.518126888,13.406344411,-5.38141994,0.4720543807,-1.888217523,-4.909365559
29093,2013,105,116,-79,3,-11,-76,9.9876343575,11.033957957,-7.51450585,0.2853609816,-1.046323599,-7.229144868
29093,2014,92,152,-38,2,-60,-36,8.8274803301,14.584532719,-3.64613318,0.1919017463,-5.757052389,-3.454231434
29093,2015,98,167,-94,2,-69,-92,9.5214962351,16.22540685,-9.132863736,0.1943162497,-6.703910615,-8.938547486
29093,2016,110,143,-33,2,-33,-31,10.806562531,14.04853129,-3.241968759,0.1964829551,-3.241968759,-3.045485804
29093,2017,105,147,118,2,-42,120,10.307760271,14.430864379,11.583959162,0.1963382909,-4.123104108,11.780297453
49021,2010,240,81,-71,10,159,-61,NA,NA,NA,NA,NA,NA
49021,2011,875,263,-276,23,612,-253,18.841313078,5.663160388,-5.943088468,0.4952573723,13.17815269,-5.447831096
49021,2012,831,292,-528,7,539,-521,17.820763012,6.2619287598,-11.32293968,0.1501147305,11.558834252,-11.17282494
49021,2013,837,290,-664,-2,547,-666,17.966385472,6.2249125292,-14.25290317,-0.042930431,11.741472943,-14.2958336
49021,2014,829,312,27,-19,517,8,17.717082345,6.6679489645,0.577034045,-0.406060995,11.04913338,0.1709730504
49021,2015,860,286,529,-17,574,512,18.069314732,6.0090976899,11.114729643,-0.357184128,12.060217042,10.757545515
49021,2016,893,299,1078,-16,594,1062,18.23658549,6.1060907745,22.014601521,-0.326747332,12.130494716,21.687854189
49021,2017,920,294,594,-16,626,578,18.254511543,5.8335069496,11.786065061,-0.317469766,12.421004593,11.468595295
55051,2010,10,10,8,0,0,8,NA,NA,NA,NA,NA,NA
55051,2011,41,79,73,0,-38,73,6.901195085,13.297424676,12.287493688,0,-6.396229591,12.287493688
55051,2012,34,90,-13,0,-56,-13,5.7403342901,15.195002533,-2.194833699,0,-9.454668242,-2.194833699
55051,2013,39,93,-3,-1,-54,-4,6.6569941111,15.874370573,-0.51207647,-0.170692157,-9.217376462,-0.682768627
55051,2014,40,97,87,-1,-57,86,6.8452126294,16.599640626,14.888337469,-0.171130316,-9.754427997,14.717207153
55051,2015,35,73,-103,-1,-38,-104,6.046471452,12.611211886,-17.7939017,-0.172756327,-6.564740434,-17.96665803
55051,2016,30,73,-10,-1,-43,-11,5.2705551651,12.825017569,-1.756851722,-0.175685172,-7.554462403,-1.932536894
55051,2017,32,83,59,-1,-51,58,5.6457304164,14.643613267,10.409315455,-0.176429076,-8.997882851,10.23288638
17075,2010,79,63,-35,3,16,-32,NA,NA,NA,NA,NA,NA
17075,2011,313,387,-142,10,-74,-132,10.575396155,13.075649559,-4.797783559,0.3378720816,-2.500253404,-4.459911478
17075,2012,315,384,-173,11,-69,-162,10.721761773,13.070338161,-5.88845964,0.3744107286,-2.348576388,-5.514048912
17075,2013,282,382,-243,12,-100,-231,9.6907216495,13.127147766,-8.350515464,0.412371134,-3.436426117,-7.93814433
17075,2014,306,341,-195,16,-35,-179,10.61412789,11.828162126,-6.763905028,0.5549870792,-1.214034236,-6.208917949
17075,2015,302,406,-99,16,-104,-83,10.548928515,14.18167211,-3.45809246,0.5588836299,-3.632743595,-2.89920883
17075,2016,286,349,-274,17,-63,-257,10.079650384,12.299992951,-9.65672799,0.5991400578,-2.220342567,-9.057587933
17075,2017,283,327,-312,17,-44,-295,10.090925299,11.659832412,-11.12497771,0.6061686575,-1.568907114,-10.51880906
13155,2010,25,16,50,0,9,50,NA,NA,NA,NA,NA,NA
13155,2011,112,101,87,0,11,87,11.609826889,10.469576034,9.0183476729,0,1.1402508552,9.0183476729
13155,2012,101,88,-94,1,13,-93,10.458734597,9.1125608367,-9.733871803,0.1035518277,1.34617376,-9.630319975
13155,2013,104,103,-262,2,1,-260,10.957172207,10.851814782,-27.60364537,0.2107148501,0.1053574251,-27.39293052
13155,2014,93,102,-268,2,-9,-266,10.073656846,11.048526863,-29.02946274,0.2166377816,-0.974870017,-28.81282496
13155,2015,97,117,79,2,-20,81,10.626061237,12.817001698,8.6542148217,0.2190940461,-2.190940461,8.8733088678
13155,2016,100,84,180,2,16,182,10.800302408,9.0722540231,19.440544335,0.2160060482,1.7280483854,19.656550383
13155,2017,91,106,64,2,-15,66,9.6968405349,11.295220843,6.8197559806,0.2131173744,-1.598380308,7.032873355
26073,2010,176,135,-91,27,41,-64,NA,NA,NA,NA,NA,NA
26073,2011,648,465,-69,166,183,97,9.2018005993,6.6031439485,-0.97982136,2.3572513881,2.5986566507,1.377430028
26073,2012,628,434,-377,200,194,-177,8.8997852998,6.150488567,-5.342705506,2.8343265286,2.7492967327,-2.508378978
26073,2013,650,451,-888,191,199,-697,9.2418813627,6.4124438378,-12.62583177,2.7156912927,2.8294375249,-9.910140477
26073,2014,682,454,-618,217,228,-401,9.7410480911,6.4845100196,-8.826932141,3.0994243926,3.2565380715,-5.727507749
26073,2015,720,478,229,233,242,462,10.244006545,6.8008821228,3.2581631927,3.3150743402,3.443124422,6.5732375329
26073,2016,631,494,116,241,137,357,8.9017422586,6.9690343514,1.6364534105,3.3998730338,1.9327079072,5.0363264442
26073,2017,650,453,-509,239,197,-270,9.1423106135,6.371487243,-7.159132465,3.3615572871,2.7708233706,-3.797575178
27059,2010,124,82,6,1,42,7,NA,NA,NA,NA,NA,NA
27059,2011,502,268,90,12,234,102,13.202882542,7.048550839,2.3670506549,0.315606754,6.1543317027,2.6826574089
27059,2012,445,308,-210,22,137,-188,11.659897812,8.070221407,-5.502423687,0.5764443862,3.5896764051,-4.9259793
27059,2013,446,284,-265,20,162,-245,11.706343999,7.4542638914,-6.955563138,0.5249481614,4.2520801071,-6.430614977
27059,2014,425,322,84,19,103,103,11.137754367,8.4384868378,2.2013443925,0.4979231364,2.6992675289,2.6992675289
27059,2015,455,310,-162,19,145,-143,11.892626572,8.1026686531,-4.234297812,0.4966151755,3.7899579184,-3.737682637
27059,2016,443,287,325,23,156,348,11.503057528,7.4523194371,8.43903769,0.5972242058,4.0507380912,9.0362618958
27059,2017,446,315,663,23,131,686,11.385393,8.0412529038,16.924922778,0.5871391009,3.3441400965,17.512061879
53029,2010,242,114,-35,82,128,47,NA,NA,NA,NA,NA,NA
53029,2011,912,677,-53,57,235,4,11.575734114,8.5929517487,-0.672712618,0.7234833821,2.9827823648,0.0507707637
53029,2012,895,642,-527,372,253,-155,11.336647772,8.1319864467,-6.675322208,4.7119921467,3.2046613256,-1.963330061
53029,2013,894,625,-1285,174,269,-1111,11.376940697,7.9536777806,-16.35276152,2.2143038941,3.4232629168,-14.13845762
53029,2014,884,683,96,196,201,292,11.274000293,8.7105680999,1.2243258237,2.4996652234,2.5634321934,3.7239910471
53029,2015,876,667,783,341,209,1124,11.042898383,8.4082342708,9.8705358831,4.2986624983,2.6346641118,14.169198381
53029,2016,971,753,1202,218,218,1420,12.014575871,9.3171736669,14.872832334,2.6974022037,2.6974022037,17.570234538
53029,2017,970,738,1221,60,232,1281,11.772058957,8.9564737222,14.818230914,0.7281685953,2.8155852352,15.54639951
51093,2010,95,74,18,4,21,22,NA,NA,NA,NA,NA,NA
51093,2011,335,323,-36,4,12,-32,9.4898161525,9.1498824396,-1.019801139,0.1133112376,0.3399337129,-0.906489901
51093,2012,330,327,8,41,3,49,9.3447357988,9.2597836552,0.2265390497,1.1610126296,0.0849521436,1.3875516792
51093,2013,291,384,248,34,-93,282,8.2124513179,10.837049162,6.9989275837,0.9595303945,-2.624597844,7.9584579782
51093,2014,360,341,294,37,19,331,10.083609932,9.5514194081,8.2349481114,1.0363710208,0.5321905242,9.2713191322
51093,2015,342,328,244,43,14,287,9.4940662086,9.1054202235,6.7735443126,1.193698383,0.3886459851,7.9672426955
51093,2016,381,341,79,34,40,113,10.511069729,9.407545348,2.1794606525,0.9379957238,1.103524381,3.1174563763
51093,2017,359,381,220,34,-22,254,9.8523519403,10.45611724,6.0376529996,0.9330918272,-0.6037653,6.9707448268
28055,2010,6,10,-10,0,-4,-10,NA,NA,NA,NA,NA,NA
28055,2011,14,9,-3,0,5,-3,10.046645138,6.4585575888,-2.15285253,0,3.5880875493,-2.15285253
28055,2012,12,10,4,0,2,4,8.5806220951,7.1505184126,2.860207365,0,1.4301036825,2.860207365
28055,2013,17,12,5,0,5,5,12.073863636,8.5227272727,3.5511363636,0,3.5511363636,3.5511363636
28055,2014,8,18,-8,0,-10,-8,5.7020669993,12.829650748,-5.702066999,0,-7.127583749,-5.702066999
28055,2015,12,12,-49,0,0,-49,8.7623220153,8.7623220153,-35.77948156,0,0,-35.77948156
28055,2016,8,4,-28,0,4,-28,5.9970014993,2.9985007496,-20.98950525,0,2.9985007496,-20.98950525
28055,2017,10,2,10,0,8,10,7.5159714393,1.5031942879,7.5159714393,0,6.0127771514,7.5159714393
27061,2010,101,91,-29,1,10,-28,NA,NA,NA,NA,NA,NA
27061,2011,475,512,103,5,-37,108,10.540096747,11.361114809,2.2855367683,0.1109483868,-0.821018062,2.3964851551
27061,2012,468,491,77,1,-23,78,10.371995612,10.881730439,1.7065035515,0.0221623838,-0.509734827,1.7286659353
27061,2013,459,557,285,1,-98,286,10.14633715,12.3126575,6.3000132632,0.0221053097,-2.16632035,6.3221185729
27061,2014,446,508,63,1,-62,64,9.839718487,11.20757173,1.3899153917,0.0220621491,-1.367853243,1.4119775407
27061,2015,506,590,12,1,-84,13,11.173924565,13.028884374,0.2649942585,0.0220828549,-1.854959809,0.2870771133
27061,2016,475,519,-51,1,-44,-50,10.509430831,11.482936003,-1.128380995,0.0221251175,-0.973505172,-1.106255877
27061,2017,463,475,2,1,-12,3,10.256296657,10.522118601,0.0443036573,0.0221518286,-0.265821944,0.0664554859
28057,2010,61,56,16,-1,5,15,NA,NA,NA,NA,NA,NA
28057,2011,250,283,-116,-2,-33,-118,10.70961938,12.123289138,-4.969263392,-0.085676955,-1.413669758,-5.054940347
28057,2012,311,237,-38,-1,74,-39,13.356811544,10.17866346,-1.632021989,-0.042947947,3.1781480845,-1.674969936
28057,2013,252,270,89,2,-18,91,10.799228627,11.5706021,3.8140132848,0.0857081637,-0.771373473,3.8997214485
28057,2014,265,268,19,9,-3,28,11.333504405,11.461808229,0.8125908819,0.3849114704,-0.128303823,1.1975023522
28057,2015,253,290,151,12,-37,163,10.786152797,12.363574352,6.437585266,0.5115961801,-1.577421555,6.9491814461
28057,2016,264,301,-91,12,-37,-79,11.252957098,12.830076085,-3.878860212,0.5114980499,-1.577118987,-3.367362162
28057,2017,258,266,103,12,-8,115,10.999552344,11.340623734,4.3912941528,0.5116070858,-0.341071391,4.9029012385
05065,2010,35,22,10,1,13,11,NA,NA,NA,NA,NA,NA
05065,2011,114,196,-77,4,-82,-73,8.3547086845,14.364235984,-5.643092708,0.2931476731,-6.009527299,-5.349945035
05065,2012,121,182,16,8,-61,24,8.9312075583,13.433717154,1.1809861234,0.5904930617,-4.502509596,1.7714791851
05065,2013,123,199,-59,8,-76,-51,9.1351331279,14.77960563,-4.381893126,0.5941550002,-5.644472502,-3.787738126
05065,2014,120,196,207,10,-76,217,8.9063717668,14.547073886,15.363491298,0.7421976472,-5.640702119,16.105688945
05065,2015,99,204,27,11,-105,38,7.326007326,15.096015096,1.998001998,0.814000814,-7.77000777,2.812002812
05065,2016,105,164,59,12,-59,71,7.786429366,12.161661105,4.375231739,0.8898776418,-4.375231739,5.2651093808
05065,2017,104,187,268,12,-83,280,7.6538121872,13.762143067,19.723285252,0.8831321754,-6.10833088,20.606417427
48237,2010,23,35,-27,2,-12,-25,NA,NA,NA,NA,NA,NA
48237,2011,101,82,-5,11,19,6,11.196718585,9.0904051882,-0.554292999,1.2194445984,2.1063133973,0.6651515991
48237,2012,98,80,-50,1,18,-49,10.866552087,8.8706547652,-5.544159228,0.1108831846,1.9958973222,-5.433276044
48237,2013,96,85,-119,2,11,-117,10.725058653,9.496145682,-13.29460395,0.2234387219,1.2289129706,-13.07116523
48237,2014,97,102,-34,1,-5,-33,10.923423423,11.486486486,-3.828828829,0.1126126126,-0.563063063,-3.716216216
48237,2015,101,91,-32,1,10,-31,11.412429379,10.282485876,-3.615819209,0.1129943503,1.1299435028,-3.502824859
48237,2016,97,90,-83,2,7,-81,11.019596705,10.224368077,-9.429139449,0.2272081795,0.7952286282,-9.20193127
48237,2017,93,71,44,2,22,46,10.569382884,8.0690987612,5.0005682464,0.2272985567,2.5002841232,5.227866803
01071,2010,144,131,-57,6,13,-51,NA,NA,NA,NA,NA,NA
01071,2011,573,647,74,36,-74,110,10.77108162,12.162111358,1.391029738,0.6767171698,-1.391029738,2.0677469078
01071,2012,601,693,-103,42,-92,-61,11.311237837,13.042741799,-1.938531609,0.7904691999,-1.731503962,-1.148062409
01071,2013,556,691,-28,42,-135,14,10.492842787,13.040565406,-0.528416543,0.7926248148,-2.547722619,0.2642082716
01071,2014,552,646,-311,26,-94,-285,10.468027004,12.250625806,-5.897747099,0.493059243,-1.782598801,-5.404687856
01071,2015,524,716,-164,28,-192,-136,10.004964295,13.670905411,-3.131324703,0.5346164127,-3.665941116,-2.59670829
01071,2016,565,732,-16,27,-167,11,10.838704727,14.042357274,-0.306936771,0.5179558011,-3.203652548,0.2110190301
01071,2017,554,686,-29,25,-132,-4,10.658150407,13.197637507,-0.557917621,0.480963466,-2.539487101,-0.076954155
05067,2010,44,36,43,0,8,43,NA,NA,NA,NA,NA,NA
05067,2011,184,235,-121,-2,-51,-123,10.239287702,13.077351141,-6.73344463,-0.111296605,-2.838063439,-6.844741235
05067,2012,211,237,-183,1,-26,-182,11.866265501,13.328459354,-10.2915952,0.0562382251,-1.462193853,-10.23535697
05067,2013,208,242,82,3,-34,85,11.748425542,13.668841255,4.6315908385,0.1694484453,-1.920415714,4.8010392838
05067,2014,203,211,-128,2,-8,-126,11.493276716,11.94621373,-7.246992215,0.1132342534,-0.452937013,-7.133757962
05067,2015,172,241,-151,2,-69,-149,9.8367218553,13.782848646,-8.635726745,0.1143804867,-3.946126791,-8.521346258
05067,2016,204,205,-68,2,-1,-66,11.763009947,11.82067176,-3.921003316,0.1153236269,-0.057661813,-3.805679689
05067,2017,203,207,-173,2,-4,-171,11.787248868,12.019509929,-10.04529091,0.1161305307,-0.232261061,-9.929160376
08057,2010,4,0,-9,0,4,-9,NA,NA,NA,NA,NA,NA
08057,2011,11,10,-35,0,1,-35,8.0058224163,7.2780203785,-25.47307132,0,0.7278020378,-25.47307132
08057,2012,9,15,-26,0,-6,-26,6.7064083458,11.177347243,-19.37406855,0,-4.470938897,-19.37406855
08057,2013,5,10,16,0,-5,16,3.7551633496,7.5103266992,12.016522719,0,-3.75516335,12.016522719
08057,2014,17,12,41,0,5,41,12.490815577,8.8170462895,30.124908156,0,3.6737692873,30.124908156
08057,2015,12,10,-34,0,2,-34,8.7719298246,7.3099415205,-24.85380117,0,1.4619883041,-24.85380117
08057,2016,13,10,6,0,3,6,9.59055699,7.3773515308,4.4264109185,0,2.2132054592,4.4264109185
08057,2017,16,8,16,0,8,16,11.657559199,5.8287795993,11.657559199,0,5.8287795993,11.657559199
12063,2010,120,98,-143,1,22,-142,NA,NA,NA,NA,NA,NA
12063,2011,462,539,-405,15,-77,-390,9.3493878377,10.907619144,-8.195891936,0.3035515532,-1.558231306,-7.892340382
12063,2012,490,551,-33,13,-61,-20,9.9707998006,11.212062633,-0.671502844,0.2645314233,-1.241262832,-0.40697142
12063,2013,506,538,-231,36,-32,-195,10.328849334,10.982057197,-4.715344261,0.7348588459,-0.653207863,-3.980485415
12063,2014,500,577,-111,48,-77,-63,10.245481743,11.823285931,-2.274496947,0.9835662473,-1.577804188,-1.2909307
12063,2015,518,594,-75,52,-76,-23,10.641357492,12.202637742,-1.540737089,1.0682443814,-1.56128025,-0.472492707
12063,2016,504,667,-224,53,-163,-171,10.400437479,13.764071028,-4.622416657,1.0936967984,-3.36363355,-3.528719859
12063,2017,497,607,98,53,-110,151,10.287512161,12.564426321,2.0285235247,1.0970586409,-2.27691416,3.1255821656
13157,2010,201,92,125,3,109,128,NA,NA,NA,NA,NA,NA
13157,2011,802,493,-50,25,309,-25,13.182658722,8.1035545511,-0.821861516,0.4109307582,5.0791041709,-0.410930758
13157,2012,783,535,-373,2,248,-371,12.853660338,8.7825137688,-6.123135768,0.0328318272,4.0711465695,-6.090303941
13157,2013,702,575,312,-7,127,305,11.494817507,9.4152707504,5.1088077811,-0.114620687,2.0795467571,4.9941870937
13157,2014,786,508,538,-6,278,532,12.740815185,8.2345217737,8.7208124296,-0.097258131,4.5062934116,8.6235542984
13157,2015,798,569,1044,-4,229,1040,12.719868019,9.0696803296,16.641030341,-0.063758737,3.6501876898,16.577271604
13157,2016,830,583,1359,-3,247,1356,12.933082982,9.0843221428,21.17597563,-0.046746083,3.8487608392,21.129229547
13157,2017,850,579,2264,-3,271,2261,12.830479181,8.7398205242,34.174358665,-0.045284044,4.0906586564,34.129074621
17077,2010,165,74,29,54,91,83,NA,NA,NA,NA,NA,NA
17077,2011,661,484,-433,200,177,-233,10.951505211,8.018953891,-7.173981477,3.3136173103,2.9325513196,-3.860364167
17077,2012,673,483,-1809,221,190,-1588,11.280306395,8.095673089,-30.32106132,3.704231372,3.1846333062,-26.61682995
17077,2013,680,494,259,203,186,462,11.46363667,8.3279948751,4.3662969082,3.4222327118,3.1356417951,7.78852962
17077,2014,695,476,-802,245,219,-557,11.683715926,8.0020845767,-13.48250385,4.1187200027,3.6816313493,-9.363783843
17077,2015,729,468,-557,257,261,-300,12.291868651,7.8910761708,-9.391729545,4.3333473844,4.4007924799,-5.058382161
17077,2016,720,432,-801,253,288,-548,12.170282536,7.3021695219,-13.53943932,4.276502058,4.8681130146,-9.262937264
17077,2017,705,455,-1257,249,250,-1008,12.018820962,7.7568277132,-21.42930206,4.244945276,4.261993249,-17.18435678
18071,2010,129,86,140,16,43,156,NA,NA,NA,NA,NA,NA
18071,2011,580,449,146,82,131,228,13.563602774,10.500099388,3.4142862154,1.9176128059,3.0635033851,5.3318990213
18071,2012,520,447,-87,82,73,-5,12.101888593,10.402969617,-2.024739053,1.9083747396,1.6989189755,-0.116364313
18071,2013,597,430,219,75,167,294,13.810812687,9.9474865246,5.0662780207,1.7350267194,3.8633261619,6.8013047401
18071,2014,596,491,87,79,105,166,13.673801822,11.264826669,1.996007984,1.81246702,2.4089751531,3.808475004
18071,2015,618,496,-28,92,122,64,14.106207416,11.321486858,-0.639116194,2.0999532076,2.7847205579,1.460837014
18071,2016,566,450,-178,92,116,-86,12.88780099,10.246484886,-4.053054022,2.0948369101,2.6413161041,-1.958217112
18071,2017,574,447,-263,89,127,-174,13.072639694,10.180261225,-5.98972864,2.0269423916,2.8923784689,-3.962786249
19097,2010,41,64,0,1,-23,1,NA,NA,NA,NA,NA,NA
19097,2011,210,242,-67,1,-32,-66,10.620006069,12.238292708,-3.38828765,0.0505714575,-1.618286639,-3.337716193
19097,2012,196,230,-13,1,-34,-12,9.9487335668,11.674534288,-0.659864981,0.0507588447,-1.725800721,-0.609106137
19097,2013,203,230,-142,0,-27,-142,10.360578763,11.738586776,-7.247301401,0,-1.378008013,-7.247301401
19097,2014,214,219,-85,2,-5,-83,10.993527176,11.250385287,-4.366587897,0.1027432446,-0.256858112,-4.263844652
19097,2015,207,241,-30,2,-34,-28,10.675881276,12.429407669,-1.54722917,0.1031486114,-1.753526393,-1.444080559
19097,2016,223,193,2,2,30,4,11.51056856,9.962061579,0.1032337987,0.1032337987,1.5485069812,0.2064675975
19097,2017,224,206,-43,2,18,-41,11.559500464,10.630612034,-2.21901125,0.1032098256,0.9288884302,-2.115801424
20085,2010,36,48,15,1,-12,16,NA,NA,NA,NA,NA,NA
20085,2011,158,117,-82,-1,41,-83,11.752454627,8.7027670336,-6.099375186,-0.074382624,3.049687593,-6.17375781
20085,2012,169,126,-67,-3,43,-70,12.601125899,9.3949222682,-4.995712635,-0.223688625,3.2062036312,-5.21940126
20085,2013,172,130,-132,-3,42,-135,12.880035944,9.7349108881,-9.884678748,-0.22465179,3.1451250562,-10.10933054
20085,2014,155,125,99,0,30,99,11.590084869,9.3468426366,7.4026993682,0,2.2432422328,7.4026993682
20085,2015,171,143,-184,0,28,-184,12.79844323,10.702791707,-13.77142429,0,2.0956515231,-13.77142429
20085,2016,181,157,-48,0,24,-48,13.638247372,11.82986098,-3.616772784,0,1.8083863919,-3.616772784
20085,2017,171,135,22,0,36,22,12.868269556,10.159160176,1.6555668435,0,2.7091093803,1.6555668435
21109,2010,34,67,23,0,-33,23,NA,NA,NA,NA,NA,NA
21109,2011,155,170,-81,0,-15,-81,11.53617148,12.652575171,-6.028579935,0,-1.116403692,-6.028579935
21109,2012,156,169,-63,-1,-13,-64,11.685393258,12.65917603,-4.719101124,-0.074906367,-0.973782772,-4.794007491
21109,2013,172,157,70,0,15,70,12.879553708,11.756336815,5.2416788348,0,1.1232168932,5.2416788348
21109,2014,159,136,-108,0,23,-108,11.905653313,10.183451891,-8.086858854,0,1.7222014227,-8.086858854
21109,2015,174,161,7,0,13,7,13.061592163,12.085726082,0.5254663514,0,0.9758660811,0.5254663514
21109,2016,165,147,24,0,18,24,12.358162004,11.009998877,1.797550837,0,1.3481631277,1.797550837
21109,2017,166,151,44,0,15,44,12.386211013,11.266975078,3.2830920758,0,1.1192359349,3.2830920758
26075,2010,483,422,-213,25,61,-188,NA,NA,NA,NA,NA,NA
26075,2011,1831,1504,-903,76,327,-827,11.45291233,9.4075260208,-5.648268615,0.4753803042,2.045386309,-5.172888311
26075,2012,1797,1582,46,44,215,90,11.24766456,9.9019506592,0.2879201835,0.2754019147,1.3457139012,0.5633220982
26075,2013,1787,1651,-536,57,136,-479,11.187419005,10.335998197,-3.355599657,0.3568454859,0.8514208085,-2.998754171
26075,2014,1764,1587,-440,65,177,-375,11.062994472,9.9529321012,-2.759477079,0.407650023,1.1100623705,-2.351827056
26075,2015,1826,1638,-396,72,188,-324,11.465024142,10.284616399,-2.486390778,0.4520710505,1.180407743,-2.034319727
26075,2016,1737,1688,-1097,72,49,-1025,10.944972685,10.636219857,-6.912282692,0.4536776242,0.3087528276,-6.458605067
26075,2017,1711,1599,251,72,112,323,10.799892695,10.092944722,1.5843209039,0.4544665541,0.706947973,2.038787458
27063,2010,22,20,3,0,2,3,NA,NA,NA,NA,NA,NA
27063,2011,96,131,-42,0,-35,-42,9.3818714879,12.802345468,-4.104568776,0,-3.42047398,-4.104568776
27063,2012,105,101,113,-2,4,111,10.242903131,9.8526972978,11.023314799,-0.195102917,0.3902058336,10.828211882
27063,2013,132,95,-65,-1,37,-66,12.82362656,9.2291251761,-6.314664594,-0.097148686,3.5945013844,-6.41181328
27063,2014,110,112,-6,0,-2,-6,10.705596107,10.900243309,-0.583941606,0,-0.194647202,-0.583941606
27063,2015,123,111,-203,0,12,-203,12.08667027,10.907482926,-19.94791923,0,1.1791873434,-19.94791923
27063,2016,107,97,-150,0,10,-150,10.68717539,9.6883739513,-14.98202157,0,0.9988014383,-14.98202157
27063,2017,107,106,4,0,1,4,10.760257442,10.659694288,0.4022526146,0,0.1005631537,0.4022526146
28059,2010,389,350,-311,51,39,-260,NA,NA,NA,NA,NA,NA
28059,2011,1665,1261,-112,202,404,90,11.91882315,9.026808404,-0.801746662,1.4460073732,2.8920147464,0.6442607108
28059,2012,1620,1261,-716,305,359,-411,11.578623859,9.0127436335,-5.117465854,2.1799260969,2.5658802256,-2.937539757
28059,2013,1536,1315,-42,210,221,168,10.965554167,9.3878279493,-0.299839372,1.4991968588,1.5777262181,1.1993574871
28059,2014,1631,1219,430,295,412,725,11.582408374,8.6566252654,3.0536085842,2.0949175171,2.9257831086,5.1485261013
28059,2015,1647,1413,-684,317,234,-367,11.655638512,9.9996461555,-4.840593043,2.2433742613,1.655992357,-2.597218782
28059,2016,1666,1336,-328,312,330,-16,11.782761523,9.4488411732,-2.319775378,2.2066156033,2.3339203497,-0.113159775
28059,2017,1611,1336,31,303,275,334,11.356987261,9.4183333216,0.2185391714,2.136044159,1.9386539397,2.3545833304
29095,2010,2445,1440,-420,168,1005,-252,NA,NA,NA,NA,NA,NA
29095,2011,9583,6120,-3737,784,3463,-2953,14.196048571,9.066035402,-5.535910833,1.1614006136,5.1300131695,-4.374510219
29095,2012,9674,6044,-2285,825,3630,-1460,14.303604881,8.9364262871,-3.378513247,1.2198133168,5.367178594,-2.15869993
29095,2013,9472,6153,-1308,762,3319,-546,13.955701844,9.0656074163,-1.927159841,1.12270321,4.8900944279,-0.804456631
29095,2014,9657,6100,-765,789,3557,24,14.164206228,8.9470496004,-1.122048024,1.1572495303,5.2171566276,0.0352015066
29095,2015,9402,6223,-329,914,3179,585,13.71855799,9.0800453492,-0.480047392,1.3336271009,4.638512641,0.853579709
29095,2016,9333,6288,1936,952,3045,2888,13.523176534,9.1110826148,2.805193375,1.3794132712,4.4120939189,4.1846066463
29095,2017,9329,6360,1854,958,2969,2812,13.403639342,9.1378653889,2.6637739671,1.3764268935,4.2657739528,4.0402008606
37099,2010,103,55,35,13,48,48,NA,NA,NA,NA,NA,NA
37099,2011,432,331,-287,88,101,-199,10.713754278,8.2089182084,-7.117702495,2.182431427,2.5048360696,-4.935271068
37099,2012,365,329,303,64,36,367,9.0175781009,8.1281731375,7.4858251084,1.5811643793,0.8894049634,9.0669894877
37099,2013,391,377,324,32,14,356,9.5676217975,9.225047104,7.9281571928,0.7830278709,0.3425746935,8.7111850637
37099,2014,369,328,-150,52,41,-98,8.9951733216,7.9957096192,-3.656574521,1.2676125006,0.9994637024,-2.38896202
37099,2015,384,351,250,65,33,315,9.3286528113,8.5269717104,6.0733416741,1.5790688353,0.801681101,7.6524105093
37099,2016,410,383,835,67,27,902,9.8079085233,9.1620218645,19.974642968,1.6027557831,0.6458866589,21.577398751
37099,2017,403,372,605,67,31,672,9.4555436938,8.7281941789,14.195046984,1.5720134677,0.7273495149,15.767060452
39079,2010,127,132,34,1,-5,35,NA,NA,NA,NA,NA,NA
39079,2011,401,388,-138,-3,13,-141,12.081406384,11.689739843,-4.157690975,-0.090384586,0.3916665411,-4.248075562
39079,2012,392,383,-261,-2,9,-263,11.878067996,11.605357251,-7.908611599,-0.060602388,0.2727107448,-7.969213987
39079,2013,472,411,-150,16,61,-134,14.373153872,12.515606444,-4.567739578,0.487225555,1.8575474284,-4.080514023
39079,2014,435,405,-80,22,30,-58,13.267655895,12.352645144,-2.44002867,0.6710078843,0.9150107514,-1.769020786
39079,2015,408,391,-246,23,17,-223,12.489477309,11.969082421,-7.530420142,0.7040636718,0.5203948879,-6.82635647
39079,2016,427,411,-71,25,16,-46,13.118682602,12.62711604,-2.181326615,0.7680727519,0.4915665612,-1.413253863
39079,2017,415,385,-139,24,30,-115,12.772571288,11.849252882,-4.278041949,0.7386547251,0.9233184064,-3.539387224
40065,2010,103,46,-44,24,57,-20,NA,NA,NA,NA,NA,NA
40065,2011,436,259,-284,30,177,-254,16.486113474,9.7933563988,-10.73866107,1.134365606,6.6927570756,-9.604295464
40065,2012,471,273,-517,116,198,-401,17.899897389,10.375099761,-19.6480827,4.4084672975,7.5247976285,-15.2396154
40065,2013,447,274,-330,74,173,-256,17.076385307,10.467403969,-12.60672741,2.8269631158,6.6089813382000004,-9.779764292
40065,2014,409,259,-565,77,150,-488,15.747122011,9.9718938898,-21.75335926,2.9646171024,5.7752281215,-18.78874216
40065,2015,405,274,-637,93,131,-544,15.816296643,10.7004081,-24.8764962,3.6318903403,5.1158885439,-21.24460586
40065,2016,398,234,-243,71,164,-172,15.668982894,9.2124170784,-9.566740812,2.7952205665,6.4565658156,-6.771520246
40065,2017,380,197,-506,48,183,-458,15.042951585,7.7985827956,-20.03087764,1.9001623055,7.2443687898,-18.13071533
41029,2010,573,540,122,-2,33,120,NA,NA,NA,NA,NA,NA
41029,2011,2409,2186,1051,7,223,1058,11.810531425,10.717236071,5.152705906,0.0343186882,1.093295354,5.1870245942
41029,2012,2254,2210,1171,-46,44,1125,10.985074627,10.770636613,5.7069753274,-0.224185196,0.214438014,5.482790131
41029,2013,2283,2254,1433,-73,29,1360,11.057751687,10.917289664,6.9407613526,-0.353576817,0.1404620232,6.5871845356
41029,2014,2346,2314,1994,-63,32,1931,11.270853601,11.117116468,9.5797451327,-0.302669982,0.1537371335,9.277075151
41029,2015,2323,2289,2712,-41,34,2671,11.035419754,10.873902634,12.883365637,-0.194770646,0.1615171208,12.688594991
41029,2016,2388,2373,2869,-43,15,2826,11.196181671,11.125853896,13.451358967000001,-0.201606286,0.0703277743,13.249752681
41029,2017,2389,2307,2731,-44,82,2687,11.055450791,10.675983664,12.638106366,-0.203616507,0.3794671263,12.43448986
46071,2010,18,3,3,0,15,3,NA,NA,NA,NA,NA,NA
46071,2011,70,29,63,3,41,66,22.555179636,9.3442887063,20.299661672,0.9666505558,13.21089093,21.266312228
46071,2012,73,43,-23,5,30,-18,23.086654016,13.598987982,-7.273877293,1.5812776724,9.4876660342,-5.69259962
46071,2013,71,30,21,7,41,28,22.180568572,9.3720712277,6.5604498594,2.1868166198,12.808497345,8.7472664792
46071,2014,75,35,-11,4,40,-7,23.059185242,10.760953113,-3.382013836,1.2298232129,12.298232129,-2.152190623
46071,2015,73,46,-17,4,27,-13,22.283272283,14.041514042,-5.189255189,1.221001221,8.2417582418,-3.968253968
46071,2016,69,22,-37,5,47,-32,20.975832193,6.6879464964,-11.24791002,1.5199878401,14.287885697,-9.727922177
46071,2017,70,28,-56,5,42,-51,21.257212268,8.5028849074,-17.00576981,1.5183723049,12.754327361,-15.48739751
47087,2010,23,20,-13,0,3,-13,NA,NA,NA,NA,NA,NA
47087,2011,93,132,-47,-3,-39,-50,8.0328222846,11.401425178,-4.059598359,-0.2591233,-3.368602894,-4.318721658
47087,2012,110,147,40,-1,-37,39,9.5378479147,12.746033122,3.4683083326,-0.086707708,-3.208185208,3.3816006243
47087,2013,105,154,60,-1,-49,59,9.0991810737,13.345465575,5.1995320421,-0.086658867,-4.246284501,5.1128731747
47087,2014,83,145,37,-1,-62,36,7.1970518101,12.573162801,3.2083243009,-0.086711468,-5.376110991,3.1216128333
47087,2015,102,179,82,-1,-77,81,8.8530139305,15.536171505,7.1171288461,-0.086794254,-6.683157575,7.0303345919
47087,2016,105,153,129,-1,-48,128,9.0810810811,13.232432432,11.156756757,-0.086486486,-4.151351351,11.07027027
47087,2017,104,149,120,-1,-45,119,8.9350917136,12.801237167,10.309721208,-0.085914343,-3.866145453,10.223806865
48239,2010,54,20,-17,0,34,-17,NA,NA,NA,NA,NA,NA
48239,2011,176,133,-89,-1,43,-90,12.511551859,9.4547522570999991,-6.326864292,-0.071088363,3.0567996019,-6.397952655
48239,2012,183,137,171,6,46,177,12.927837236,9.6782169475,12.080110205,0.4238635159,3.2496202889,12.50397372
48239,2013,199,173,301,9,26,310,13.783072448,11.982269012,20.847762848,0.6233550353,1.8008034354,21.471117883
48239,2014,201,155,60,7,46,67,13.706102966,10.569382884,4.0913740198,0.477326969,3.1367200818,4.5687009887
48239,2015,210,161,10,12,49,22,14.23101684,10.910446244,0.6776674686,0.8132009623,3.320570596,1.4908684309
48239,2016,199,130,-23,12,69,-11,13.426441318,8.7710420673,-1.55179975,0.8096346524,4.6553992511,-0.742165098
48239,2017,202,126,-133,12,76,-121,13.622875641,8.4974372808,-8.96951713,0.809279741,5.1254383599,-8.160237389
54035,2010,94,107,33,4,-13,37,NA,NA,NA,NA,NA,NA
54035,2011,321,322,74,3,-1,77,10.967609676,11.001776684,2.5283586169,0.102501025,-0.034167008,2.6308596419
54035,2012,316,336,-23,7,-20,-16,10.791059812,11.474038281,-0.785425239,0.2390424642,-0.682978469,-0.546382775
54035,2013,333,333,-84,-2,0,-86,11.396303901,11.396303901,-2.874743326,-0.06844627,0,-2.943189596
54035,2014,316,345,-37,19,-29,-18,10.840108401,11.834928476,-1.269253199,0.6517786697,-0.994820075,-0.617474529
54035,2015,347,359,32,21,-12,53,11.905987305,12.317721736,1.0979584834,0.7205352548,-0.411734431,1.8184937382
54035,2016,327,357,20,19,-30,39,11.210916072,12.239440483,0.6856829402,0.6513987932,-1.02852441,1.3370817334
54035,2017,327,349,-191,19,-22,-172,11.247162413,12.003852239,-6.569443489,0.6535048497,-0.756689826,-5.915938639
55053,2010,57,30,-1,0,27,-1,NA,NA,NA,NA,NA,NA
55053,2011,238,197,11,2,41,13,11.615138723,9.6142114638,0.5368341427,0.0976062078,2.000927259,0.6344403504
55053,2012,246,198,-79,3,48,-76,11.997951569,9.6568878484,-3.853000707,0.1463164826,2.3410637208,-3.706684225
55053,2013,239,212,46,-1,27,45,11.645187224,10.32962214,2.241333106,-0.048724633,1.3155650839,2.1926084732
55053,2014,245,218,-8,3,27,-5,11.911997083,10.599246384,-0.38896317,0.1458611888,1.3127506989,-0.243101981
55053,2015,277,233,-102,3,44,-99,13.480302698,11.33902718,-4.963865976,0.1459960581,2.1412755189,-4.817869918
55053,2016,243,194,-101,5,49,-96,11.855971897,9.4652615144,-4.927790788,0.243950039,2.3907103825,-4.683840749
55053,2017,239,171,-16,5,68,-11,11.658252238,8.3412599693,-0.780468769,0.2438964903,3.3169922685,-0.536572279
22049,2010,47,23,13,0,24,13,NA,NA,NA,NA,NA,NA
22049,2011,201,180,28,-6,21,22,12.309011299,11.022995193,1.7146881411,-0.367433173,1.2860161058,1.347254968
22049,2012,174,157,-95,-6,17,-101,10.669937145,9.6274720221,-5.825540396,-0.367928867,1.0424651234,-6.193469263
22049,2013,168,200,-95,-6,-32,-101,10.371330679,12.346822237,-5.864740562,-0.370404667,-1.975491558,-6.235145229
22049,2014,165,213,-90,-1,-48,-91,10.273013106,13.261526009,-5.603461694,-0.062260685,-2.988512904,-5.66572238
22049,2015,199,177,-65,0,22,-65,12.462034631,11.084322259,-4.070513824,0,1.3777123712,-4.070513824
22049,2016,149,212,-35,0,-63,-35,9.3731324505,13.33626899,-2.201742522,0,-3.963136539,-2.201742522
22049,2017,159,203,44,0,-44,44,10.033761398,12.810399773,2.7766383744,0,-2.776638374,2.7766383744
51095,2010,160,185,263,42,-25,305,NA,NA,NA,NA,NA,NA
51095,2011,656,589,492,90,67,582,9.6477682183,8.6624016472,7.2358261637,1.3236267373,0.9853665711,8.5594529009
51095,2012,668,602,893,136,66,1029,9.6998562446,8.7414872145,12.967023393,1.9748210318,0.9583690302,14.941844425
51095,2013,614,641,1134,88,-27,1222,8.7685474773,9.1541350699,16.194678891,1.2567299316,-0.385587593,17.451408823
51095,2014,677,652,1297,114,25,1411,9.4877724056,9.1374115339,18.176722024,1.5976455749,0.3503608717,19.774367599
51095,2015,695,748,679,132,-53,811,9.5914987579,10.322936793,9.3706872757,1.8216947281,-0.731438035,11.192382004
51095,2016,705,676,1084,121,29,1205,9.5979088811,9.2031012818,14.757635783,1.6473006732,0.3948075994,16.404936456
51095,2017,696,669,1319,109,27,1428,9.3052482402,8.9442687826,17.634514984,1.4572874399,0.3609794576,19.091802424
13159,2010,41,46,1,2,-5,3,NA,NA,NA,NA,NA,NA
13159,2011,198,122,-140,3,76,-137,14.278502921,8.7978654359,-10.09591116,0.2163409533,5.4806374847,-9.879570203
13159,2012,178,131,-245,3,47,-242,12.952048316,9.5321254457,-17.82725751,0.2182929491,3.4199228698,-17.60896456
13159,2013,173,124,-98,6,49,-92,12.695384164,9.0995817128,-7.191604902,0.4403023409,3.595802451,-6.751302561
13159,2014,173,137,-101,12,36,-89,12.739322533,10.088365243,-7.437407953,0.88365243,2.6509572901,-6.553755523
13159,2015,157,140,133,14,17,147,11.514062557,10.26731693,9.7539510836,1.026731693,1.2467456272,10.780682777
13159,2016,164,126,52,14,38,66,11.910814148,9.1509913574,3.7765996078,1.0167768175,2.7598227903,4.7933764253
13159,2017,150,118,97,14,32,111,10.79719273,8.4937916142,6.982184632,1.0077379881,2.3034011157,7.9899226201
17079,2010,37,9,-3,0,28,-3,NA,NA,NA,NA,NA,NA
17079,2011,124,108,11,1,16,12,12.736890761,11.093420985,1.1298854707,0.102716861,1.6434697756,1.2326023317
17079,2012,103,107,-86,5,-4,-81,10.611445938,11.023540926,-8.86004224,0.5151187349,-0.412094988,-8.344923505
17079,2013,112,118,-69,12,-6,-57,11.626699886,12.249558808,-7.162877608,1.2457178449,-0.622858922,-5.917159763
17079,2014,112,103,8,12,9,20,11.647860226,10.711871458,0.8319900161,1.2479850242,0.9359887681,2.0799750403
17079,2015,125,95,-40,15,30,-25,12.97892223,9.863980895,-4.153255114,1.5574706676,3.1149413353,-2.595784446
17079,2016,104,95,-65,15,9,-50,10.818683033,9.8824508478,-6.761676896,1.560386976,0.9362321856,-5.20128992
17079,2017,115,92,-54,15,23,-39,11.99728757,9.5978300558,-5.633508946,1.5648635961,2.399457514,-4.06864535
18073,2010,111,111,18,0,0,18,NA,NA,NA,NA,NA,NA
18073,2011,376,276,-177,0,100,-177,11.238641798,8.2496413199,-5.290530846,0,2.9890004782,-5.290530846
18073,2012,405,302,-36,6,103,-30,12.106175644,9.0273210976,-1.076104502,0.1793507503,3.0788545465,-0.896753751
18073,2013,405,345,-129,1,60,-128,12.10581378,10.312359886,-3.855925871,0.0298908982,1.7934538933,-3.826034972
18073,2014,346,294,25,9,52,34,10.34024177,8.7862169957,0.7471272955,0.2689658264,1.5540247747,1.0160931219
18073,2015,402,364,-66,9,38,-57,12.003045549,10.868429303,-1.970649269,0.2687249003,1.1346162459,-1.701924369
18073,2016,368,317,-151,9,51,-142,11.006430387,9.4810826978,-4.516225512,0.269179004,1.5253476895,-4.247046508
18073,2017,382,320,-11,9,62,-2,11.430965348,9.5756777784,-0.329163924,0.2693159375,1.8552875696,-0.059847986
19099,2010,116,122,-24,3,-6,-21,NA,NA,NA,NA,NA,NA
19099,2011,370,333,-246,8,37,-238,10.078173944,9.0703565495,-6.700623757,0.2179064637,1.0078173944,-6.482717294
19099,2012,453,376,-171,3,77,-168,12.387710735,10.282073369,-4.676155708,0.0820378194,2.1056373655,-4.594117888
19099,2013,434,355,117,3,79,120,11.851123672,9.693891483,3.1948881789,0.0819202097,2.1572321892,3.2768083886
19099,2014,416,388,129,-2,28,127,11.306191227,10.545197587,3.5060064141,-0.054356689,0.7609936403,3.4516497255
19099,2015,416,385,-167,-2,31,-169,11.30450142,10.46209867,-4.538105137,-0.054348565,0.84240275,-4.592453702
19099,2016,401,361,-106,-1,40,-107,10.927919335,9.8378525685,-2.888676931,-0.027251669,1.0900667666,-2.915928601
19099,2017,407,361,262,-1,46,261,11.055726839,9.806185231,7.1169543781,-0.027163948,1.2495416084,7.0897904301
28061,2010,55,22,-91,0,33,-91,NA,NA,NA,NA,NA,NA
28061,2011,217,186,-193,-1,31,-194,12.818619488,10.987388132,-11.40089199,-0.059071979,1.8312313554,-11.45996397
28061,2012,232,215,-320,-1,17,-321,13.890967877,12.873095231,-19.15995569,-0.059874862,1.0178726462,-19.21983055
28061,2013,254,207,-111,-1,47,-112,15.375302663,12.530266344,-6.719128329,-0.060532688,2.8450363196,-6.779661017
28061,2014,206,198,36,0,8,36,12.478798158,11.994184638,2.1807608432,0,0.4846135207,2.1807608432
28061,2015,224,211,9,0,13,9,13.544154548,12.758109865,0.544184781,0,0.7860446836,0.544184781
28061,2016,215,185,14,0,30,14,12.975648028,11.165092489,0.8449259181,0,1.8105555388,0.8449259181
28061,2017,210,193,-23,0,17,-23,12.660898924,11.635969011,-1.386669882,0,1.0249299129,-1.386669882
29097,2010,416,297,130,17,119,147,NA,NA,NA,NA,NA,NA
29097,2011,1753,1223,-207,128,530,-79,14.870739932,10.374737556,-1.755985833,1.0858269887,4.4960023752,-0.670158845
29097,2012,1684,1085,-3160,140,599,-3020,14.403072199,9.2798891545,-27.02714261,1.1974050522,5.1231830447,-25.82973755
29097,2013,1745,1182,346,117,563,463,15.010623565,10.167654472,2.9763184833,1.0064429553,4.8429690927,3.9827614386
29097,2014,1727,1148,326,116,579,442,14.727703774,9.7900428101,2.7800992649,0.9892377752,4.9376609643,3.7693370401
29097,2015,1617,1153,221,134,464,355,13.684139262,9.7574598446,1.8702503258,1.1339979351,3.9266794171,3.0042482609
29097,2016,1680,1148,61,137,532,198,14.125540743,9.6524528413,0.5128916579,1.1519042154,4.4730879021,1.6647958733
29097,2017,1647,1140,280,137,507,417,13.752792101,9.519236791,2.3380581592,1.1439784565,4.2335553097,3.4820366157
45053,2010,72,73,118,22,-1,140,NA,NA,NA,NA,NA,NA
45053,2011,325,219,183,71,106,254,12.94098909,8.7202357251,7.2867723182,2.8271083858,4.2207533647,10.113880704
45053,2012,325,191,315,44,134,359,12.721650292,7.4764160175,12.330214898,1.7223157318,5.2452342741,14.05253063
45053,2013,323,224,504,18,99,522,12.369554811,8.5782671135,19.301101005,0.6893250359,3.7912876975,19.990426041
45053,2014,333,215,189,21,118,210,12.521150592,8.0842263583,7.1065989848,0.7896221094,4.4369242339,7.8962210942
45053,2015,377,243,667,29,134,696,13.86870712,8.9392462339,24.536943366,1.0668236246,4.9294608862,25.603766991
45053,2016,352,275,366,22,77,388,12.644586536,9.8785832316,13.147496228,0.7902866585,2.7660033048,13.937782887
45053,2017,351,272,282,24,79,306,12.418404713,9.6233791505,9.9771798546,0.8491216898,2.7950255621,10.826301544
48241,2010,109,133,81,5,-24,86,NA,NA,NA,NA,NA,NA
48241,2011,470,412,325,35,58,360,13.061723592,11.449851319,9.0320429092,0.9726815441,1.611872273,10.004724453
48241,2012,447,343,-504,34,104,-470,12.411667523,9.5239417457,-13.99436338,0.9440641964,2.8877257771,-13.05029919
48241,2013,455,437,-247,-7,18,-254,12.738496857,12.234556322,-6.915184008,-0.195976875,0.503940535,-7.111160883
48241,2014,409,402,-189,-8,7,-197,11.519666521,11.322508414,-5.323268881,-0.225323551,0.1971581067,-5.548592432
48241,2015,430,456,-124,-6,-26,-130,12.171131774,12.907060672,-3.509814744,-0.169829746,-0.735928898,-3.67964449
48241,2016,451,420,129,-6,31,123,12.766981359,11.889428317,3.651752983,-0.169848976,0.8775530424,3.481904007
48241,2017,446,411,132,-6,35,126,12.570107945,11.583664496,3.7203010062,-0.169104591,0.9864434486,3.551196415
18075,2010,65,69,-73,0,-4,-73,NA,NA,NA,NA,NA,NA
18075,2011,324,201,29,3,123,32,15.243113547,9.4563759968,1.3643527558,0.1411399403,5.7867375503,1.505492696
18075,2012,288,223,-50,2,65,-48,13.496415015,10.450349126,-2.343127607,0.0937251043,3.0460658887,-2.249402502
18075,2013,292,237,-136,4,55,-132,13.704416389,11.123105083,-6.382878866,0.1877317314,2.5813113061,-6.195147135
18075,2014,312,251,-195,2,61,-193,14.714204867,11.837389172,-9.196378042,0.0943218261,2.8768156952,-9.102056216
18075,2015,330,246,-85,3,84,-82,15.609848395,11.63643244,-4.020718526,0.1419077127,3.9734159552,-3.878810813
18075,2016,299,217,-186,3,82,-183,14.176999123,10.288992674,-8.819136578,0.1422441384,3.8880064484,-8.67689244
18075,2017,292,217,-174,3,75,-171,13.909729665,10.337025128,-8.288674527,0.1429081815,3.5727045373,-8.145766345
13161,2010,63,12,-10,0,51,-10,NA,NA,NA,NA,NA,NA
13161,2011,184,144,12,-2,40,10,12.159259871,9.5159425078,0.792995209,-0.132165868,2.6433173633,0.6608293408
13161,2012,228,146,-45,4,82,-41,15.021741995,9.6191856635,-2.964817499,0.2635393332,5.4025563315,-2.701278166
13161,2013,198,169,-176,-1,29,-177,13.091774663,11.174292515,-11.63713303,-0.066120074,1.9174821476,-11.70325311
13161,2014,218,176,-158,-1,42,-159,14.539633841,11.738419982,-10.53789976,-0.066695568,2.8012138593,-10.60459532
13161,2015,203,156,33,0,47,33,13.555021368,10.416666667,2.203525641,0,3.1383547009,2.203525641
13161,2016,214,169,-89,0,45,-89,14.273803568,11.272302818,-5.936301484,0,3.0015007504,-5.936301484
13161,2017,212,164,7,1,48,8,14.135689282,10.935155859,0.4667444574,0.0666777796,3.2005334222,0.533422237
48243,2010,4,1,-2,0,3,-2,NA,NA,NA,NA,NA,NA
48243,2011,14,23,-53,-2,-9,-55,6.0527453524,9.943795936,-22.91396455,-0.864677907,-3.891050584,-23.77864246
48243,2012,21,13,6,1,8,7,9.1743119266,5.6793359546,2.621231979,0.4368719965,3.494975972,3.0581039755
48243,2013,10,22,-58,3,-12,-55,4.4179368235,9.7194610117,-25.62403358,1.3253810471,-5.301524188,-24.29865253
48243,2014,11,22,-7,6,-11,-1,4.9427095035,9.885419007,-3.145360593,2.6960233655,-4.942709503,-0.449337228
48243,2015,13,13,-22,8,0,-14,5.877034358,5.877034358,-9.945750452,3.616636528,0,-6.329113924
48243,2016,14,13,31,8,1,39,6.2935491122,5.8440098899,13.935715891,3.5963137784,0.4495392223,17.53202967
48243,2017,15,18,29,8,-3,37,6.6298342541,7.955801105,12.817679558,3.5359116022,-1.325966851,16.35359116
01073,2010,2104,1582,-967,146,522,-821,NA,NA,NA,NA,NA,NA
01073,2011,8832,6903,-2885,713,1929,-2172,13.42415512,10.492181022,-4.385041612,1.083720856,2.9319740971,-3.301320756
01073,2012,9008,6742,-2906,570,2266,-2336,13.695620609,10.250430079,-4.4182364,0.8666189773,3.4451905307,-3.551617423
01073,2013,8839,7063,-1215,588,1776,-627,13.429099928,10.730821676,-1.845950494,0.8933488808,2.6982782523,-0.952601613
01073,2014,8656,6859,-1497,630,1797,-867,13.132352908,10.406054597,-2.271156689,0.9557974043,2.7262983104,-1.315359285
01073,2015,8993,7217,-1908,752,1776,-1156,13.629567659,10.937906127,-2.891717457,1.1397125409,2.6916615327,-1.752004917
01073,2016,8644,7114,-2614,753,1530,-1861,13.098616947,10.780143564,-3.961104199,1.1410525869,2.3184733838,-2.820051613
01073,2017,8532,7192,-2603,741,1340,-1862,12.937622826,10.905694252,-3.947097072,1.1236261737,2.0319285732,-2.823470898
05069,2010,251,205,-168,0,46,-168,NA,NA,NA,NA,NA,NA
05069,2011,976,782,-1551,2,194,-1549,12.730379433,10.199955652,-20.23034682,0.0260868431,2.5304237808,-20.20425998
05069,2012,902,852,-1503,9,50,-1494,11.977797254,11.313839535,-19.95856904,0.1195123895,0.6639577192,-19.83905665
05069,2013,945,860,-1570,13,85,-1557,12.790406518,11.639946673,-21.24967009,0.1759526823,1.1504598456,-21.07371741
05069,2014,957,820,-902,13,137,-889,13.146958821,11.264896796,-12.39138648,0.1785898272,1.8820620256,-12.21279665
05069,2015,949,884,-682,20,65,-662,13.158259616,12.257008957,-9.456199218,0.277307895,0.9012506586,-9.178891323
05069,2016,874,867,-1509,22,7,-1487,12.295658535,12.197180721,-21.22900312,0.3095017023,0.0984778144,-20.91950142
05069,2017,831,822,-1264,21,9,-1243,11.917652036,11.788579992,-18.12745147,0.301168102,0.1290720437,-17.82628337
08059,2010,1482,919,357,85,563,442,NA,NA,NA,NA,NA,NA
08059,2011,5553,3743,2436,468,1810,2904,10.319969224,6.9561759059,4.5271826094,0.8697542944,3.3637933181,5.3969369038
08059,2012,5556,3904,3747,480,1652,4227,10.224869843,7.1846457642,6.895714057,0.8833580858,3.0402240785,7.7790721428
08059,2013,5625,4005,3435,403,1620,3838,10.244576749,7.2941386451,6.2560215346,0.7339670097,2.9504381036,6.9899885443
08059,2014,5938,4112,4412,398,1826,4810,10.695938497,7.406820327,7.9472011874,0.7169052748,3.2891181705,8.6641064622
08059,2015,5844,4404,3916,468,1440,4384,10.408911339,7.8440871898,6.9748967836,0.8335678485,2.5648241492,7.8084646321
08059,2016,5963,4362,4403,461,1601,4864,10.505600755,7.6849623504,7.7571960634,0.8121888224,2.8206384051,8.5693848859
08059,2017,6073,4418,1653,464,1655,2117,10.603674357,7.7139853962,2.88619689,0.8101605305,2.8896889612,3.6963574205
12065,2010,32,14,-24,0,18,-24,NA,NA,NA,NA,NA,NA
12065,2011,129,174,-188,0,-45,-188,8.8153893464,11.890525165,-12.84723409,0,-3.075135818,-12.84723409
12065,2012,125,151,-286,-3,-26,-289,8.7023113338999991,10.512392091,-19.91088833,-0.208855472,-1.810080757,-20.1197438
12065,2013,144,158,6,-2,-14,4,10.137275607,11.122844069,0.4223864836,-0.140795495,-0.985568462,0.2815909891
12065,2014,128,153,-129,1,-25,-128,9.0629093355,10.833008815,-9.133713315,0.0708039792,-1.77009948,-9.062909336
12065,2015,128,153,76,1,-25,77,9.0957541304,10.872268609,5.4006040149,0.0710605791,-1.776514479,5.4716645941
12065,2016,117,164,-117,-1,-47,-118,8.3476027397,11.700913242,-8.34760274,-0.071347032,-3.353310502,-8.418949772
12065,2017,120,160,250,-1,-40,249,8.5479217865,11.397229049,17.808170389,-0.071232682,-2.849307262,17.736937707
13163,2010,50,75,-17,-2,-25,-19,NA,NA,NA,NA,NA,NA
13163,2011,235,199,-138,-3,36,-141,13.961916644,11.823069839,-8.198912753,-0.178237234,2.1388468051,-8.377149987
13163,2012,220,216,-435,4,4,-431,13.276205419,13.034819866,-26.2506789,0.2413855531,0.2413855531,-26.00929334
13163,2013,213,223,-101,8,-10,-93,13.058672062,13.671755257,-6.192140273,0.4904665563,-0.613083195,-5.701673717
13163,2014,182,223,-86,6,-41,-80,11.234914658,13.765856971,-5.308805827,0.3703818019,-2.530942313,-4.938424025
13163,2015,205,229,-188,8,-24,-180,12.78254092,14.279033515,-11.72252533,0.4988308652,-1.496492595,-11.22369447
13163,2016,218,208,-165,8,10,-157,13.743971251,13.113513854,-10.40254705,0.5043659175,0.6304573968,-9.89818113
13163,2017,210,222,-137,8,-12,-129,13.360478432,14.123934343,-8.716121644,0.5089706069,-0.76345591,-8.207151037
16051,2010,135,41,-14,-1,94,-15,NA,NA,NA,NA,NA,NA
16051,2011,498,143,-270,0,355,-270,18.961676852,5.4448188551,-10.28042721,0,13.516857997,-10.28042721
16051,2012,501,141,-40,4,360,-36,18.927802335,5.3269862858,-1.511201783,0.1511201783,13.600816049,-1.360081605
16051,2013,481,141,-192,4,340,-188,18.010259483,5.279514734,-7.189126446,0.1497734676,12.730744749,-7.039352979
16051,2014,475,145,-196,0,330,-196,17.689557575,5.3999702071,-7.299270073,0,12.289587368,-7.299270073
16051,2015,465,171,-121,1,294,-120,17.217120853,6.331457346,-4.480154028,0.0370260664,10.885663507,-4.443127962
16051,2016,462,144,395,2,318,397,16.829987979,5.2457105388,14.389275436,0.0728570908,11.58427744,14.462132527
16051,2017,477,154,314,2,323,316,16.959095515,5.4752635415,11.163849039,0.0711073187,11.483831973,11.234956358
17081,2010,102,140,-34,9,-38,-25,NA,NA,NA,NA,NA,NA
17081,2011,450,446,-42,28,4,-14,11.613053072,11.509825933,-1.083884953,0.7225899689,0.1032271384,-0.361294984
17081,2012,459,418,-160,29,41,-131,11.861691131,10.802150093,-4.134794294,0.7494314658,1.0595410378,-3.385362828
17081,2013,479,464,-73,44,15,-29,12.396640743,12.008436962,-1.889258401,1.1387310912,0.3882037811,-0.75052731
17081,2014,489,466,-324,44,23,-280,12.700473995,12.103110188,-8.415037985,1.1427829362,0.5973638075,-7.272255048
17081,2015,523,438,-208,49,85,-159,13.641817518,11.424696124,-5.42542647,1.2781052741,2.2171213939,-4.147321196
17081,2016,494,440,-94,49,54,-45,12.896825397,11.487050961,-2.454051796,1.2792397661,1.4097744361,-1.17481203
17081,2017,485,432,-230,49,53,-181,12.681893655,11.296037235,-6.014093898,1.2812634827,1.38585642,-4.732830416
18077,2010,92,99,5,1,-7,6,NA,NA,NA,NA,NA,NA
18077,2011,331,367,-94,13,-36,-81,10.23421195,11.347298446,-2.906392518,0.4019479014,-1.113086496,-2.504444616
18077,2012,373,340,130,9,33,139,11.524261196,10.50468849,4.0164985402,0.2780652835,1.0195727063,4.2945638237
18077,2013,353,384,-16,4,-31,-12,10.88599007,11.841983532,-0.493415981,0.1233539951,-0.955993462,-0.370061985
18077,2014,355,395,36,14,-40,50,10.954423427,12.188724658,1.1108711081,0.4320054309,-1.234301231,1.542876539
18077,2015,371,374,-106,14,-3,-92,11.464239915,11.556942663,-3.275497118,0.432612827,-0.092702749,-2.842884292
18077,2016,382,372,-87,14,10,-73,11.83358632,11.523806574,-2.695083795,0.4336916452,0.3097797466,-2.26139215
18077,2017,361,341,-194,14,20,-180,11.221983898,10.600267338,-6.030650626,0.4352015916,0.6217165594,-5.595449035
19101,2010,34,48,-32,32,-14,0,NA,NA,NA,NA,NA,NA
19101,2011,129,163,63,160,-34,223,7.6234376385,9.6327157758,3.7230741956,9.4554265284,-2.009278137,13.178500724
19101,2012,146,142,-57,254,4,197,8.5307779953,8.2970580502,-3.330509217,14.841216512,0.2337199451,11.510707295
19101,2013,148,159,5,303,-11,308,8.5243635526,9.1579311139,0.2879852552,17.451906462,-0.633567561,17.739891718
19101,2014,152,170,-124,325,-18,201,8.6358729618,9.6585421283,-7.045054258,18.464859951,-1.022669167,11.419805693
19101,2015,171,128,-151,340,43,189,9.6013475576,7.1869736103,-8.478382931,19.090398652,2.4143739472,10.612015722
19101,2016,151,169,-80,343,-18,263,8.3658827114,9.3631402532,-4.432255741,19.00329649,-0.997257542,14.571040749
19101,2017,159,174,-73,340,-15,267,8.689949172,9.5097556977,-3.989725092,18.582281248,-0.819806526,14.592556157
20087,2010,55,50,11,0,5,11,NA,NA,NA,NA,NA,NA
20087,2011,192,187,-191,0,5,-191,10.080592235,9.818076812,-10.02808915,0,0.2625154228,-10.02808915
20087,2012,178,188,-72,1,-10,-71,9.4097745355,9.9384135543,-3.806200936,0.0528639019,-0.528639019,-3.753337034
20087,2013,189,175,-103,0,14,-103,10.035575851,9.2921998619,-5.469123347,0,0.743375989,-5.469123347
20087,2014,203,186,14,1,17,15,10.795001329,9.8909864398,0.7444828503,0.0531773465,0.9040148897,0.7976601968
20087,2015,159,187,21,1,-28,22,8.4495815066,9.9375581241,1.1159824631,0.0531420221,-1.487976618,1.1691244852
20087,2016,193,172,21,1,21,22,10.246880807,9.131935227,1.11494558,0.0530926467,1.11494558,1.1680382267
20087,2017,182,144,104,1,38,105,9.6158926401,7.6081787922,5.4947957944,0.0528345749,2.0077138479,5.5476303693
21111,2010,2555,1780,-149,378,775,229,NA,NA,NA,NA,NA,NA
21111,2011,10237,7255,-326,1758,2982,1432,13.756126731,9.7490182114,-0.438067531,2.36233963,4.0071085191,1.9242720991
21111,2012,10093,7250,205,2086,2843,2291,13.477873613,9.6814211525,0.2737505291,2.7855785551,3.7964524602,3.0593290842
21111,2013,10024,7514,1836,2256,2510,4092,13.282697246,9.9567225766,2.43286434,2.9894019341,3.3259746696,5.4222662741
21111,2014,9967,7350,-1691,2382,2617,691,13.122640801,9.6770753377,-2.226385632,3.1361623747,3.4455654638,0.9097767426
21111,2015,10051,7723,-1605,2641,2328,1036,13.177837214,10.125603105,-2.104310887,3.4626075100000002,3.0522341095,1.3582966226
21111,2016,10039,7683,-2017,2672,2356,655,13.108516423,10.032147791,-2.633716269,3.4889885328,3.0763686315,0.8552722638
21111,2017,9998,7440,-1341,2651,2558,1310,12.997134209,9.6718022116,-1.74326435,3.4462295246,3.325331997,1.7029651744
28063,2010,21,5,-30,0,16,-30,NA,NA,NA,NA,NA,NA
28063,2011,110,93,-148,0,17,-148,14.365939663,12.145748988,-19.32871882,0,2.2201906752,-19.32871882
28063,2012,115,67,37,0,48,37,15.060240964,8.7742273442,4.8454688318,0,6.2860136197,4.8454688318
28063,2013,128,82,-73,0,46,-73,16.697104096,10.696582312,-9.52256718,0,6.0005217845,-9.52256718
28063,2014,101,80,-98,-1,21,-99,13.263296126,10.50558109,-12.86933684,-0.131319764,2.7577150361,-13.0006566
28063,2015,116,102,-93,-1,14,-94,15.388697267,13.5314407,-12.33749005,-0.132661183,1.8572565667,-12.47015123
28063,2016,95,80,-193,-1,15,-194,12.819647797,10.795492882,-26.04412658,-0.134943661,2.0241549153,-26.17907024
28063,2017,92,82,-68,-1,10,-69,12.6165661,11.245200219000001,-9.325287987,-0.137136588,1.3713658804,-9.462424575
29099,2010,711,403,100,17,308,117,NA,NA,NA,NA,NA,NA
29099,2011,2729,1883,-484,62,846,-422,12.442183058,8.5850607178,-2.206675192,0.2826732685,3.8571223405,-1.924001924
29099,2012,2596,1782,-566,45,814,-521,11.817134846,8.111762055,-2.576463144,0.2048424761,3.7053727905,-2.371620668
29099,2013,2722,1917,224,41,805,265,12.353607258,8.7001708719,1.0166083857,0.186075642,3.653436386,1.2026840277
29099,2014,2610,1847,368,60,763,428,11.786834422,8.3411046657,1.6618984932,0.2709617109,3.4457297563,1.9328602041
29099,2015,2523,1962,496,72,561,568,11.336421681,8.8157191191,2.22864255,0.3235126282,2.5207025616,2.5521551782
29099,2016,2617,2027,-354,72,590,-282,11.721785635,9.0791209333,-1.585598821,0.3224946755,2.6426647018,-1.263104146
29099,2017,2546,2087,-126,73,459,-53,11.385818708,9.3331514703,-0.563477281,0.3264590596,2.0526672376,-0.237018221
30043,2010,22,31,12,1,-9,13,NA,NA,NA,NA,NA,NA
30043,2011,87,89,-35,3,-2,-32,7.6392852439,7.8149009966,-3.073275673,0.2634236291,-0.175615753,-2.809852044
30043,2012,73,98,-34,6,-25,-28,6.4351198872,8.6389280677,-2.997179126,0.5289139633,-2.203808181,-2.468265162
30043,2013,103,110,119,5,-7,124,9.0541490858,9.6694796062,10.460618847,0.4395218003,-0.61533052,10.900140647
30043,2014,82,103,63,5,-21,68,7.1575088378,8.9905293938,5.499061668,0.4364334657,-1.833020556,5.9354951338
30043,2015,83,114,99,6,-31,105,7.2076766098,9.8997004038,8.5971082454,0.5210368634,-2.692023794,9.1181451088
30043,2016,88,72,196,6,16,202,7.546199031,6.1741628435,16.807443296,0.5145135703,1.3720361875,17.321956867
30043,2017,87,112,141,6,-25,147,7.3538734627,9.4670554922,11.918346646,0.5071636871,-2.11318203,12.425510333
31095,2010,10,18,-17,0,-8,-17,NA,NA,NA,NA,NA,NA
31095,2011,80,102,48,4,-22,52,10.616415633,13.535929932,6.3698493796,0.5308207816,-2.919514299,6.9006701612
31095,2012,74,121,29,2,-47,31,9.8123715441,16.044553471,3.8453888484,0.2651992309,-6.232181927,4.1105880793
31095,2013,79,116,11,5,-37,16,10.502525924,15.421430471,1.4623770274,0.6647168306,-4.918904547,2.127093858
31095,2014,90,128,-181,4,-38,-177,12.153129431,17.284450746,-24.44129363,0.5401390858,-5.131321315,-23.90115455
31095,2015,60,101,-51,4,-41,-47,8.2690187431,13.919514884,-7.028665932,0.5512679162,-5.650496141,-6.477398015
31095,2016,91,101,-28,4,-10,-24,12.647671994,14.03752606,-3.891591383,0.5559416261,-1.389854065,-3.335649757
31095,2017,81,79,-5,4,2,-1,11.284480357,11.005851212,-0.696572862,0.5572582892,0.2786291446,-0.139314572
36045,2010,491,244,-2,137,247,135,NA,NA,NA,NA,NA,NA
36045,2011,2133,888,-178,152,1245,-26,18.199115214,7.5765655463,-1.518725977,1.296889598,10.622549668,-0.221836379
36045,2012,2198,878,1115,1156,1320,2271,18.373701699,7.3394495413,9.3205993605,9.66332992,11.034252158,18.98392928
36045,2013,2267,880,-4267,570,1387,-3697,18.839230808,7.3129788755,-35.45963734,4.7368158625,11.526251932,-30.72282148
36045,2014,2097,859,-1839,410,1238,-1429,17.602397351,7.210519468,-15.43672328,3.4415750662,10.391877883,-11.99514822
36045,2015,2136,919,-4684,650,1217,-4034,18.152074614,7.8098111283,-39.80539208,5.5238054771,10.342263486,-34.28158661
36045,2016,2005,923,-3591,296,1082,-3295,17.405647069,8.0126744363,-31.17390455,2.5696117369,9.3929726328,-28.60429281
36045,2017,1869,936,-923,97,933,-826,16.37527325,8.2007788988,-8.086879192,0.849867044,8.174494351,-7.237012148
39081,2010,162,200,0,-1,-38,-1,NA,NA,NA,NA,NA,NA
39081,2011,629,1002,-249,-15,-373,-264,9.0713085615,14.450637804,-3.59102676,-0.216326913,-5.379329242,-3.807353673
39081,2012,668,991,-147,-18,-323,-165,9.7133260144,14.410039042,-2.137513359,-0.26173633,-4.696713028,-2.399249689
39081,2013,668,948,-73,-15,-280,-88,9.775156761,13.872527858,-1.068243179,-0.219502023,-4.097371097,-1.287745202
39081,2014,658,904,-24,-14,-246,-38,9.6763994382,13.294019897,-0.352938581,-0.205880839,-3.617620459,-0.55881942
39081,2015,707,1023,-43,-14,-316,-57,10.448996483,15.119269309,-0.635511809,-0.206910821,-4.670272827,-0.84242263
39081,2016,640,885,-295,-15,-245,-310,9.5248725676,13.171112847,-4.390370949,-0.223239201,-3.6462402799999998,-4.61361015
39081,2017,657,933,-259,-16,-276,-275,9.8594614063,14.001335604,-3.886758758,-0.240108649,-4.141874198,-4.126867408
40067,2010,13,12,-23,0,1,-23,NA,NA,NA,NA,NA,NA
40067,2011,66,104,43,1,-38,44,10.2270086,16.115286279,6.6630510576,0.1549546758,-5.888277679,6.8180057333
40067,2012,81,99,-100,1,-18,-99,12.65625,15.46875,-15.625,0.15625,-2.8125,-15.46875
40067,2013,80,99,35,1,-19,36,12.597433273,15.589323675,5.5113770569,0.1574679159,-2.991890402,5.6688449728
40067,2014,73,107,-36,1,-34,-35,11.540589677,16.915658841,-5.691249704,0.1580902695,-5.375069164,-5.533159434
40067,2015,81,91,-17,2,-10,-15,12.901170662,14.493907781,-2.707653102,0.3185474237,-1.592737119,-2.389105678
40067,2016,65,87,4,2,-22,6,10.387534958,13.903316021,0.6392329205,0.3196164602,-3.515781063,0.9588493807
40067,2017,68,79,-57,2,-11,-55,10.938631062,12.708115499,-9.169146626,0.321724443,-1.769484437,-8.847422183
41031,2010,70,55,-83,1,15,-82,NA,NA,NA,NA,NA,NA
41031,2011,311,203,-35,10,108,-25,14.336091456,9.3576416899,-1.613386498,0.4609675709,4.9784497661,-1.152418927
41031,2012,287,182,-27,8,105,-19,13.180252583,8.3582089552,-1.239954076,0.3673938002,4.822043628,-0.872560276
41031,2013,281,198,-45,8,83,-37,12.867478707,9.0667643557,-2.060628263,0.3663339134,3.8007143511,-1.694294349
41031,2014,282,213,270,14,69,284,12.795498888,9.6646853306,12.251009574,0.6352375335,3.1308135578,12.886247107
41031,2015,291,217,269,17,74,286,12.990781456,9.687283766,12.008660521,0.7589116314,3.3034976898,12.767572152
41031,2016,286,204,435,18,82,453,12.516137502,8.9275945822,19.036782565,0.7877289337,3.5885429203,19.824511499
41031,2017,291,221,549,18,70,567,12.415470273,9.4289310323,23.423000619,0.7679672334,2.986539241,24.190967852
42065,2010,118,187,41,0,-69,41,NA,NA,NA,NA,NA,NA
42065,2011,489,556,-204,7,-67,-197,10.85930647,12.347186907,-4.530262822,0.1554501949,-1.487880437,-4.374812627
42065,2012,525,573,-73,4,-48,-69,11.709079555,12.779623971,-1.628119633,0.0892120347,-1.070544416,-1.538907599
42065,2013,516,580,105,4,-64,109,11.519271339,12.948018172,2.3440377725,0.089296677,-1.428746833,2.4333344495
42065,2014,490,548,-283,6,-58,-277,10.975350259,12.274473351,-6.338824742,0.134392044,-1.299123092,-6.204432698
42065,2015,501,582,-161,6,-81,-155,11.294340431,13.120371518,-3.629518582,0.135261562,-1.826031088,-3.49425702
42065,2016,492,546,-236,7,-54,-229,11.157095073,12.381654289,-5.351777312,0.1587391575,-1.224559215,-5.193038154
42065,2017,483,517,-123,7,-34,-116,11.007418043,11.782267346,-2.803131303,0.1595277977,-0.774849303,-2.643603505
47089,2010,131,103,20,3,28,23,NA,NA,NA,NA,NA,NA
47089,2011,522,567,229,5,-45,234,10.077609174,10.946368586,4.4210201166,0.0965288235,-0.868759412,4.5175489401
47089,2012,536,567,348,21,-31,369,10.29561476,10.891070091,6.6844662991,0.4033729663,-0.595455331,7.0878392655
47089,2013,518,579,-70,12,-61,-58,9.929458672,11.098757859,-1.341818739,0.2300260696,-1.169299187,-1.11179267
47089,2014,516,558,295,30,-42,325,9.8766377322,10.680550106,5.6465273857,0.574223124,-0.803912374,6.2207505096
47089,2015,540,575,595,36,-35,631,10.249499388,10.913818793,11.293429881,0.6832999592,-0.664319405,11.97672984
47089,2016,519,631,247,36,-112,283,9.7791679228,11.889508592,4.6540548689,0.6783237866,-2.110340669,5.3323786554
47089,2017,504,649,754,36,-145,790,9.423995662,12.135264255,14.098596685,0.6731425473,-2.711268593,14.771739232
48245,2010,875,535,-247,94,340,-153,NA,NA,NA,NA,NA,NA
48245,2011,3435,2350,-558,446,1085,-112,13.581101117,9.2912918849,-2.206187605,1.7633685875,4.289809232,-0.442819017
48245,2012,3356,2287,-3569,469,1069,-3100,13.294906458,9.0600271365,-14.1387131,1.857959216,4.2348793218,-12.28075388
48245,2013,3554,2441,-76,560,1113,484,14.089755788,9.6772914684,-0.301300349,2.2201078338,4.4124643197,1.9188074849
48245,2014,3534,2531,-2007,676,1003,-1331,13.975836909,10.009293497,-7.937041504,2.6733632571,3.9665434125,-5.263678247
48245,2015,3704,2501,247,763,1203,1010,14.594254891,9.8542741584,0.9732130017,3.0063219444,4.7399807327,3.979534946
48245,2016,3757,2583,-891,783,1174,-108,14.709020188,10.112696073,-3.488351607,3.0655211092,4.5963241152,-0.422830498
48245,2017,3676,2554,-1565,783,1122,-782,14.352282954,9.97163511,-6.110261921,3.057083121,4.3806478439,-3.0531788
53031,2010,47,101,65,2,-54,67,NA,NA,NA,NA,NA,NA
53031,2011,206,372,108,6,-166,114,6.8986303205,12.457720773,3.6167576437,0.2009309802,-5.559090452,3.817688624
53031,2012,183,328,93,0,-145,93,6.1391884865,11.003572806,3.1199154604,0,-4.86438432,3.1199154604
53031,2013,199,328,321,12,-129,333,6.6586361507,10.97503848,10.740815097,0.401525798,-4.316402329,11.142340895
53031,2014,194,326,263,10,-132,273,6.4532224532,10.844074844,8.7484407484,0.3326403326,-4.390852391,9.0810810811
53031,2015,194,358,365,11,-164,376,6.4148135901,11.837645697,12.069108043,0.3637265438,-5.422832107,12.432834587
53031,2016,177,363,733,12,-186,745,5.7787427154,11.851319806,23.93117746,0.3917791671,-6.072577091,24.322956627
53031,2017,191,376,496,12,-185,508,6.1471123055,12.101121607,15.963181694,0.3862060087,-5.954009301,16.349387703
54037,2010,149,132,82,22,17,104,NA,NA,NA,NA,NA,NA
54037,2011,619,415,384,89,204,473,11.473055002,7.6919512534,7.1173717622,1.6495991845,3.7811037487,8.7669709467
54037,2012,603,426,-33,83,177,50,11.084049446,7.8305224944,-0.606589771,1.5256651808,3.2535269519,0.9190754101
54037,2013,585,441,117,49,144,166,10.701350016,8.0671715509,2.1402700033,0.8963523945,2.6341784656,3.0366223978
54037,2014,630,445,412,34,185,446,11.426809472,8.0713178013,7.4727706385,0.6166849556,3.3554916702,8.0894555941
54037,2015,555,458,333,40,97,373,9.9677619231,8.225648578,5.9806571539,0.7183972557,1.7421133451,6.6990544096
54037,2016,570,462,-216,44,108,-172,10.200520763,8.2677905135,-3.8654605,0.7874086203,1.9327302499,-3.078051879
54037,2017,546,487,390,44,59,434,9.7338348814,8.682010233,6.952739201,0.7844116022,1.0518246484,7.7371508031
55055,2010,229,130,-76,14,99,-62,NA,NA,NA,NA,NA,NA
55055,2011,939,628,-210,31,311,-179,11.208594449,7.4962697702,-2.506714414,0.3700387944,3.7123246792,-2.136675619
55055,2012,892,598,189,57,294,246,10.606105645,7.1103712731,2.2472578104,0.677744419,3.4957343717,2.9250022294
55055,2013,881,631,-29,58,250,29,10.425912119,7.4673672501,-0.343191205,0.6863824097,2.9585448693,0.3431912048
55055,2014,920,673,-533,45,247,-488,10.885641602,7.9630834763,-6.306572798,0.532449861,2.9225581258,-5.774122937
55055,2015,844,649,-106,50,195,-56,9.9928960455,7.6841108217,-1.255031968,0.5919962112,2.3087852238,-0.663035757
55055,2016,832,663,-202,53,169,-149,9.8420772461,7.8429053055,-2.389542793,0.6269592476,1.9991719406,-1.762583545
55055,2017,828,672,84,53,156,137,9.7770063232,7.9349616536,0.9918702067,0.6258228685,1.8420446696,1.6176930752
28065,2010,35,13,-31,0,22,-31,NA,NA,NA,NA,NA,NA
28065,2011,147,155,-301,0,-8,-301,11.931818182,12.581168831,-24.43181818,0,-0.649350649,-24.43181818
28065,2012,145,160,-77,0,-15,-77,11.962215897,13.199686507,-6.352349132,0,-1.23747061,-6.352349132
28065,2013,164,159,-127,0,5,-127,13.651308944,13.235110501,-10.57144046,0,0.4161984434,-10.57144046
28065,2014,137,155,-113,0,-18,-113,11.524710831,13.038906414,-9.505783386,0,-1.514195584,-9.505783386
28065,2015,111,160,-133,0,-49,-133,9.4621089421,13.639075953,-11.33748189,0,-4.17696701,-11.33748189
28065,2016,141,149,-168,0,-8,-168,12.20567867,12.898199446,-14.54293629,0,-0.692520776,-14.54293629
28065,2017,122,154,-119,0,-32,-119,10.712090614,13.521819299,-10.44867855,0,-2.809728686,-10.44867855
22053,2010,99,56,-1,2,43,1,NA,NA,NA,NA,NA,NA
22053,2011,395,339,-102,3,56,-99,12.495254966,10.723775781,-3.226622801,0.0949006706,1.7714791851,-3.131722131
22053,2012,454,362,-234,0,92,-234,14.40401028,11.48513595,-7.424093404,0,2.9188743298,-7.424093404
22053,2013,426,395,-185,4,31,-181,13.578338407,12.590243358,-5.896696256,0.1274961353,0.9880950484,-5.769200121
22053,2014,438,378,96,1,60,97,13.960381839,12.048000765,3.0598097181,0.0318730179,1.9123810738,3.091682736
22053,2015,453,364,-110,1,89,-109,14.408855243,11.577976399,-3.498839022,0.0318076275,2.8308788447,-3.467031394
22053,2016,442,372,-130,1,70,-129,14.076881429,11.847511067,-4.140259244,0.031848148,2.2293703621,-4.108411096
22053,2017,438,391,62,1,47,63,13.938612822,12.442916925,1.9730456505,0.0318233169,1.4956958964,2.0048689675
22051,2010,1358,900,-732,405,458,-327,NA,NA,NA,NA,NA,NA
22051,2011,5833,3927,-2196,1664,1906,-532,13.460049636,9.0618232333,-5.067421396,3.8397947187,4.3982264025,-1.227626677
22051,2012,5617,3995,-2612,1532,1622,-1080,12.933560367,9.1987847012,-6.014324315,3.5275439705,3.7347756659,-2.486780345
22051,2013,5613,4270,-2300,1624,1343,-676,12.907068189,9.8188457452,-5.288839629,3.7343806769,3.088222444,-1.554458952
22051,2014,5805,4120,-3021,1749,1685,-1272,13.332843352,9.4627587617,-6.93859083,4.0170789015,3.8700845906,-2.921511928
22051,2015,5999,4028,-2583,1941,1971,-642,13.751714953,9.2335235589,-5.921100137,4.4494213575,4.5181913939,-1.47167878
22051,2016,6002,4229,-2156,1985,1773,-171,13.713011482,9.6621668706,-4.925900159,4.5352095621,4.0508446114,-0.390690597
22051,2017,5948,4282,-3077,1976,1666,-1101,13.556370731,9.7593106034,-7.012937582,4.5035959253,3.7970601273,-2.509341657
13165,2010,34,40,-8,-1,-6,-9,NA,NA,NA,NA,NA,NA
13165,2011,105,91,-207,-8,14,-215,12.765957447,11.063829787,-25.16717325,-0.972644377,1.7021276596,-26.13981763
13165,2012,101,131,981,-6,-30,975,11.7148988,15.19457171,113.78530418,-0.695934582,-3.479672911,113.0893696
13165,2013,101,92,79,-6,9,73,11.028608867,10.045861542,8.6263376283,-0.655164883,0.9827473247,7.9711727451
13165,2014,99,109,-147,-5,-10,-152,10.854668055,11.951099172,-16.11753742,-0.548215558,-1.096431117,-16.66575297
13165,2015,103,89,-183,-5,14,-188,11.501954216,9.9385817979,-20.43551089,-0.558347292,1.5633724176,-20.99385818
13165,2016,92,85,-99,-5,7,-104,10.431430353,9.6377345655,-11.22512614,-0.566925563,0.7936957877,-11.7920517
13165,2017,93,100,9,-5,-7,4,10.606147003,11.404459144,1.0264013229,-0.570222957,-0.79831214,0.4561783657
18079,2010,94,83,-62,1,11,-61,NA,NA,NA,NA,NA,NA
18079,2011,345,295,-391,3,50,-388,12.183924283,10.418138155,-13.80844752,0.1059471677,1.765786128,-13.70250035
18079,2012,320,239,-88,-3,81,-91,11.369692663,8.4917392077,-3.126665482,-0.106590869,2.8779534553,-3.233256351
18079,2013,363,287,17,-7,76,10,12.881247671,10.184347332,0.6032540232,-0.248398715,2.6969003389,0.3548553077
18079,2014,337,285,-361,-6,52,-367,12.007411102,10.154635502,-12.8625383,-0.2137818,1.8527756004,-13.0763201
18079,2015,347,298,-129,-6,49,-135,12.452451016,10.694035742,-4.629297352,-0.215316156,1.7584152731,-4.844613508
18079,2016,310,291,-213,-6,19,-219,11.182454368,10.497078133,-7.683428324,-0.216434601,0.6853762355,-7.899862925
18079,2017,300,299,10,-6,1,4,10.860121633,10.823921228,0.3620040544,-0.217202433,0.0362004054,0.1448016218
46073,2010,7,4,16,0,3,16,NA,NA,NA,NA,NA,NA
46073,2011,25,30,-10,0,-5,-10,12.001920307,14.402304369,-4.800768123,0,-2.400384061,-4.800768123
46073,2012,23,26,-21,2,-3,-19,11.140712037,12.593848389,-10.17195447,0.9687575684,-1.453136353,-9.2031969
46073,2013,24,35,26,4,-11,30,11.630724497,16.961473225,12.599951539,1.9384540829,-5.330748728,14.538405622
46073,2014,33,21,-48,3,12,-45,16.038882139,10.206561361,-23.32928311,1.4580801944,5.8323207776,-21.871202920000002
46073,2015,21,32,-15,4,-11,-11,10.339734121,15.755785327,-7.385524372,1.9694731659,-5.416051206,-5.416051206
46073,2016,17,16,-18,4,1,-14,8.4472049689,7.950310559,-8.944099379,1.9875776398,0.4968944099,-6.956521739
46073,2017,16,18,20,4,-2,24,7.9345400446,8.9263575502,9.9181750558,1.9836350112,-0.991817506,11.901810067
16053,2010,118,22,-14,4,96,-10,NA,NA,NA,NA,NA,NA
16053,2011,395,152,-198,30,243,-168,17.556335837,6.7558558158,-8.800391128,1.3333925952,10.800480021,-7.466998533
16053,2012,396,136,-289,8,260,-281,17.576174519,6.036261956,-12.82705666,0.3550742327,11.539912563,-12.47198242
16053,2013,416,166,-187,40,250,-147,18.428280322,7.3535926287,-8.283866395,1.771950031,11.074687694,-6.511916364
16053,2014,391,176,-67,47,215,-20,17.208749615,7.7461379341,-2.948813873,2.0685709256,9.4626116808,-0.880242947
16053,2015,400,176,-241,67,224,-174,17.510451551,7.7045986823,-10.55004706,2.9330006348,9.8058528684,-7.617046425
16053,2016,423,162,54,72,261,126,18.340668155,7.0240856765,2.3413618922,3.1218158562,11.316582479,5.4631777484
16053,2017,418,161,41,72,257,113,17.831243068,6.8680146745,1.7489975258,3.0714102892,10.963228393,4.820407815
17083,2010,57,40,-36,2,17,-34,NA,NA,NA,NA,NA,NA
17083,2011,208,244,-101,7,-36,-94,9.0807884569,10.652463382,-4.409421318,0.3056034577,-1.571674925,-4.10381786
17083,2012,238,264,-165,19,-26,-146,10.458780102,11.601335911,-7.250834945,0.83494463,-1.142555809,-6.415890315
17083,2013,212,268,-79,20,-56,-59,9.3751381948,11.851589793,-3.493565648,0.8844469995,-2.476451599,-2.609118649
17083,2014,202,226,-109,16,-24,-93,8.9781768079,10.044890884,-4.844659763,0.7111427175,-1.066714076,-4.133517045
17083,2015,190,260,-196,17,-70,-179,8.5134983757,11.650050409,-8.782345693,0.7617340652,-3.136552033,-8.020611628
17083,2016,195,207,-257,19,-12,-238,8.8359236939,9.3796728443,-11.6452943,0.8609361548,-0.54374915,-10.78435815
17083,2017,178,193,-5,18,-15,13,8.1119263546,8.7955156542,-0.2278631,0.8203071595,-0.6835893,0.5924440596
21113,2010,165,116,39,14,49,53,NA,NA,NA,NA,NA,NA
21113,2011,676,366,-121,25,310,-96,13.855724197,7.5017678346,-2.480092645,0.5124158357,6.3539563627,-1.967676809
21113,2012,700,377,177,73,323,250,14.233428223,7.6657177715,3.5990239935,1.484343229,6.5677104514,5.0833672224
21113,2013,654,387,250,88,267,338,13.14123817,7.7762372657,5.0234090863,1.7682399984,5.3650009042,6.7916490847
21113,2014,686,444,415,120,242,535,13.595330816,8.7993103243,8.2245805959,2.3781919795,4.7960204921,10.602772575
21113,2015,647,477,635,132,170,767,12.607662029,9.2949842161,12.373825948,2.57219689,3.3126778129,14.946022838
21113,2016,682,441,87,137,241,224,13.109964149,8.4772642081,1.672385456,2.6335265227,4.6326999414,4.3059119787
21113,2017,657,411,737,137,246,874,12.439647827,7.7818801477,13.954369024,2.5939600492,4.6577676796,16.548329073
20089,2010,5,12,-2,0,-7,-2,NA,NA,NA,NA,NA,NA
20089,2011,29,48,43,0,-19,43,9.4155844156,15.584415584,13.961038961,0,-6.168831169,13.961038961
20089,2012,23,43,-16,0,-20,-16,7.4796747967,13.983739837,-5.203252033,0,-6.504065041,-5.203252033
20089,2013,23,39,22,0,-16,22,7.5163398693,12.745098039,7.1895424837,0,-5.22875817,7.1895424837
20089,2014,38,47,-8,0,-9,-8,12.438625205,15.384615385,-2.618657938,0,-2.94599018,-2.618657938
20089,2015,22,44,-59,0,-22,-59,7.3174787959,14.634957592,-19.62414768,0,-7.317478796,-19.62414768
20089,2016,33,27,-84,0,6,-84,11.27434233,9.2244619064,-28.69832593,0,2.0498804236,-28.69832593
20089,2017,27,34,-30,0,-7,-30,9.41094458,11.850819101,-10.45660509,0,-2.439874521,-10.45660509
48247,2010,16,21,-6,-2,-5,-8,NA,NA,NA,NA,NA,NA
48247,2011,89,51,-43,3,38,-40,16.833743144,9.6463022508,-8.1331568,0.5674295442,7.1874408928,-7.565727256
48247,2012,100,47,-64,0,53,-64,18.937600606,8.9006722848,-12.12006439,0,10.036928321,-12.12006439
48247,2013,81,43,-66,12,38,-54,15.375854214,8.1624905087,-12.5284738,2.277904328,7.2133637054,-10.25056948
48247,2014,109,68,2,17,41,19,20.602967583,12.853227483,0.3780361024,3.2133068708,7.7497401002,3.5913429733
48247,2015,83,52,-88,20,31,-68,15.654470011,9.8076197661,-16.59751037,3.7721614485,5.8468502452,-12.82534892
48247,2016,85,49,-95,20,36,-75,16.147416413,9.3085106383,-18.04711246,3.7993920973,6.8389057751,-14.24772036
48247,2017,86,47,-100,20,39,-80,16.465632778,8.9986597741,-19.14608463,3.8292169251,7.466973004,-15.3168677
48249,2010,167,117,1,1,50,2,NA,NA,NA,NA,NA,NA
48249,2011,656,385,51,2,271,53,15.981874216,9.3796060565,1.2424932698,0.0487252263,6.6022681593,1.2912184961
48249,2012,596,384,199,12,212,211,14.390226236,9.2715551585,4.8047903035,0.2897360987,5.1186710771,5.0945264022
48249,2013,674,431,-236,28,243,-208,16.184027278,10.34913317,-5.666810738,0.6723334774,5.8348941075,-4.994477261
48249,2014,695,402,-527,37,293,-490,16.719591994,9.6709006928,-12.67802156,0.8901077752,7.048691301,-11.78791378
48249,2015,673,410,-313,45,263,-268,16.228403323,9.8865458579,-7.547533789,1.0851086917,6.3418574649,-6.462425097
48249,2016,637,389,-650,48,248,-602,15.42671704,9.4207110336,-15.741548,1.1624527754,6.006006006,-14.57909522
48249,2017,614,378,-530,49,236,-481,14.978167004,9.221086527,-12.92903666,1.1953260313,5.7570804772,-11.73371063
17085,2010,41,70,-5,4,-29,-1,NA,NA,NA,NA,NA,NA
17085,2011,186,244,32,15,-58,47,8.2169994699,10.779289627,1.4136773281,0.6626612476,-2.562290157,2.0763385757
17085,2012,210,221,-89,6,-11,-83,9.3000597861,9.7872057749,-3.941453909,0.2657159939,-0.487145989,-3.675737915
17085,2013,184,235,-100,7,-51,-93,8.1925243216,10.463278345,-4.45245887,0.3116721209,-2.270754024,-4.140786749
17085,2014,172,258,24,7,-86,31,7.6936840222,11.540526033,1.0735373054,0.3131150474,-3.846842011,1.3866523528
17085,2015,191,258,-204,8,-67,-196,8.6055417887,11.624239694,-9.191259293,0.3604415409,-3.018697905,-8.830817752
17085,2016,190,228,-177,11,-38,-166,8.6511098463,10.381331816,-8.059191804,0.5008537279,-1.730221969,-7.558338076
17085,2017,178,245,-211,12,-67,-199,8.1923829249,11.276032677,-9.71119549,0.5522954781,-3.083649753,-9.158900012
05071,2010,94,84,0,6,10,6,NA,NA,NA,NA,NA,NA
05071,2011,329,259,-14,37,70,23,12.85357087,10.118768558,-0.546960463,1.4455383654,2.7348023129,0.8985779028
05071,2012,367,248,81,40,119,121,14.24689441,9.6273291925,3.1444099379,1.5527950311,4.6195652174,4.6972049689
05071,2013,361,295,-78,38,66,-40,13.94360757,11.394360757,-3.012746234,1.4677481653,2.5492468134,-1.544998069
05071,2014,352,227,-107,52,125,-55,13.57160758,8.752144661,-4.125460259,2.0048965743,4.8194629191,-2.120563684
05071,2015,341,274,36,56,67,92,13.090713655,10.518637952,1.3820108258,2.1497946178,2.5720757035,3.5318054436
05071,2016,375,246,-89,59,129,-30,14.326373899,9.3981012779,-3.400126072,2.2540161601,4.9282726213,-1.146109912
05071,2017,362,246,154,59,116,213,13.718096898,9.3222426436,5.8358754761,2.2358224226,4.3958542547,8.0716978987
13167,2010,34,7,-14,0,27,-14,NA,NA,NA,NA,NA,NA
13167,2011,87,86,14,0,1,14,8.6978255436,8.5978505374,1.3996500875,0,0.0999750062,1.3996500875
13167,2012,90,102,20,0,-12,20,8.9887640449,10.187265918,1.9975031211,0,-1.198501873,1.9975031211
13167,2013,99,112,-83,-1,-13,-84,9.9317817014,11.235955056,-8.326645265,-0.100321027,-1.304173355,-8.426966292
13167,2014,60,83,-67,0,-23,-67,6.0759493671,8.4050632911,-6.784810127,0,-2.329113924,-6.784810127
13167,2015,85,87,-94,0,-2,-94,8.6894295645,8.8938867307,-9.609486813,0,-0.204457166,-9.609486813
13167,2016,108,78,-34,0,30,-34,11.097410604,8.0147965475,-3.493629264,0,3.0826140567,-3.493629264
13167,2017,93,96,61,0,-3,61,9.5296649247,9.8370734706,6.2506404345,0,-0.307408546,6.2506404345
17087,2010,23,17,22,0,6,22,NA,NA,NA,NA,NA,NA
17087,2011,125,121,234,-1,4,233,9.8177819667,9.5036129438,18.378887842,-0.078542256,0.3141690229,18.300345586
17087,2012,109,118,15,1,-9,16,8.4775422905,9.1775228466,1.1666342602,0.0777756173,-0.699980556,1.2444098775
17087,2013,115,126,21,-1,-11,20,8.9393291616,9.7943954293,1.6323992382,-0.077733297,-0.855066268,1.5546659412
17087,2014,111,111,22,-1,0,21,8.6186815747,8.6186815747,1.7082071589,-0.07764578,0,1.630561379
17087,2015,102,128,15,-1,-26,14,7.9177178343,9.9359596352,1.1643702697,-0.077624685,-2.018241801,1.0867455851
17087,2016,97,123,113,-1,-26,112,7.5086116809,9.5212292449,8.7471455664,-0.077408368,-2.012617564,8.6697371986
17087,2017,99,134,-26,0,-35,-26,7.6563164611,10.363095008,-2.010749778,0,-2.706778547,-2.010749778
18081,2010,445,244,160,48,201,208,NA,NA,NA,NA,NA,NA
18081,2011,1846,1188,647,159,658,806,13.09270929,8.4258605832,4.5888314792,1.1277035629,4.6668487069,5.7165350421
18081,2012,1829,1254,966,182,575,1148,12.82779613,8.7950007364,6.7750962611,1.2764674115,4.0327953935,8.0515636726
18081,2013,1804,1195,1190,161,609,1351,12.49112846,8.2743339854,8.2397133411,1.1147847461,4.2167944745,9.3544980872
18081,2014,1890,1180,716,205,710,921,12.926612407,8.0705834074,4.8970658642,1.4020928801,4.8560289994,6.2991587443
18081,2015,1801,1314,1208,227,487,1435,12.170892577,8.8798183489,8.1634859707,1.5340325458,3.2910742283,9.6975185165
18081,2016,1916,1331,1811,213,585,2024,12.753013532,8.8592176465,12.054127091,1.4177410659,3.8937958852,13.471868157
18081,2017,1915,1292,1525,206,623,1731,12.539287585,8.4599266632,9.9855945521,1.3488737559,4.0793609219,11.334468308
19103,2010,453,164,-23,159,289,136,NA,NA,NA,NA,NA,NA
19103,2011,1760,576,435,757,1184,1192,13.284673186,4.3477112244,3.2834277476,5.7139190918,8.9369619613,8.9973468394
19103,2012,1793,632,1166,759,1161,1925,13.25903933,4.6735710298,8.6224427543,5.6127221703,8.5854683,14.235164925
19103,2013,1808,684,891,849,1124,1740,13.080785426,4.9487042209,6.4463383929999996,6.1424705899,8.1320812051,12.588808983
19103,2014,1799,685,386,963,1114,1349,12.770050363,4.8624149521,2.7399885716,6.8357745969,7.9076354112,9.5757631684
19103,2015,1848,690,239,1037,1158,1276,12.894807537,4.8146196974,1.6676726198,7.2358849655,8.0801878399,8.9035575853
19103,2016,1793,751,-2,1064,1042,1062,12.316252232,5.1586756423,-0.013738151,7.3086962495,7.1575765902,7.2949580986
19103,2017,1821,761,456,1059,1060,1515,12.310583654,5.1446206265,3.0827161704,7.1592026852,7.1659630277,10.241918856
20091,2010,1925,781,240,200,1144,440,NA,NA,NA,NA,NA,NA
20091,2011,7405,3409,2047,1064,3996,3111,13.482413689,6.2068262344,3.7270088887,1.9372435064,7.2755874545,5.6642523952
20091,2012,7259,3464,1861,1029,3795,2890,13.05401799,6.2293867363,3.3466768811,1.8504731385,6.8246312541,5.1971500196
20091,2013,7369,3729,2337,962,3640,3299,13.092588891,6.6253581185,4.1521753614,1.7091967042,6.4672307726,5.8613720656
20091,2014,7451,3550,1606,1165,3901,2771,13.081431074,6.2325970091,2.8195917737,2.0453452156,6.8488340654,4.8649369893
20091,2015,7508,3890,1147,1343,3618,2490,13.036928994,6.7546155816,1.9916565738,2.3319919604,6.2823134124,4.3236485343
20091,2016,7472,3868,843,1355,3604,2198,12.842504013,6.6481270775,1.4489067028,2.3289069778,6.1943769357,3.7778136806
20091,2017,7482,3917,1575,1346,3565,2921,12.725636835,6.6621651271,2.6788128862,2.2893219967,6.0634717075,4.9681348829
21115,2010,74,104,55,0,-30,55,NA,NA,NA,NA,NA,NA
21115,2011,283,261,15,-1,22,14,12.093500278,11.153369514,0.6409982479,-0.042733217,0.9401307636,0.5982650314
21115,2012,332,301,-32,-1,31,-33,14.179247902,12.855281983,-1.366674497,-0.042708578,1.3239659186,-1.409383075
21115,2013,306,292,42,0,14,42,13.056278534,12.458932457,1.7920382301,0,0.5973460767,1.7920382301
21115,2014,307,284,-232,0,23,-232,13.142123288,12.157534247,-9.931506849,0,0.9845890411,-9.931506849
21115,2015,275,286,-108,0,-11,-108,11.854981248,12.329180497,-4.655774454,0,-0.47419925,-4.655774454
21115,2016,246,309,-204,0,-63,-204,10.694024822,13.432738496,-8.868215706,0,-2.738713674,-8.868215706
21115,2017,238,293,-221,0,-55,-221,10.469822277,12.889319022,-9.721977829,0,-2.419496745,-9.721977829
29101,2010,192,66,-44,46,126,2,NA,NA,NA,NA,NA,NA
29101,2011,720,419,340,43,301,383,13.568393182,7.8960510322,6.4072967803,0.8103345928,5.6723421496,7.2176313731
29101,2012,728,371,279,274,357,553,13.51464241,6.8872696895,5.1793753191,5.0865549729,6.6273727201,10.265930292
29101,2013,687,378,-457,143,309,-314,12.646809764,6.9585066824,-8.412797761,2.6324509407,5.6883030816,-5.780346821
29101,2014,769,388,-634,123,381,-511,14.173286396,7.1511510036,-11.68512819,2.2669885913,7.0221353927,-9.418139595
29101,2015,724,443,-1016,173,281,-843,13.427673248,8.2161039346,-18.84325417,3.2085462318,5.2115693129,-15.63470794
29101,2016,690,428,-358,104,262,-254,12.861856208,7.9780789233,-6.673252931,1.9385986169,4.8837772848,-4.734654314
29101,2017,692,403,-75,34,289,-41,12.868672593,7.494328114,-1.394726076,0.632275821,5.3743444787,-0.762450255
31097,2010,13,9,11,0,4,11,NA,NA,NA,NA,NA,NA
31097,2011,47,61,-3,1,-14,-2,8.9960761795,11.675758446,-0.574217628,0.1914058762,-2.679682266,-0.382811752
31097,2012,50,47,-37,0,3,-37,9.6144601481,9.0375925392,-7.11470051,0,0.5768676089,-7.11470051
31097,2013,39,72,11,0,-33,11,7.5376884422,13.915732509,2.1260146888,0,-6.378044066,2.1260146888
31097,2014,41,61,72,3,-20,75,7.8975248002,11.749975922,13.868824039,0.5778676683,-3.852451122,14.446691708
31097,2015,47,60,15,3,-13,18,9.000382995,11.489850632,2.872462658,0.5744925316,-2.489467637,3.4469551896
31097,2016,43,62,0,3,-19,3,8.2438650307,11.886503067,0,0.5751533742,-3.642638037,0.5751533742
31097,2017,45,54,-18,3,-9,-15,8.6596747811,10.391609737,-3.463869912,0.5773116521,-1.731934956,-2.88655826
47091,2010,43,27,30,0,16,30,NA,NA,NA,NA,NA,NA
47091,2011,167,202,-44,-2,-35,-46,9.1519386217,11.07000959,-2.411289218,-0.109604055,-1.918070969,-2.520893273
47091,2012,133,198,9,-1,-65,8,7.3165364727,10.89228738,0.4951039718,-0.055011552,-3.575750908,0.4400924194
47091,2013,137,209,-80,-2,-72,-82,7.5807879593,11.564851704,-4.426737494,-0.110668437,-3.984063745,-4.537405932
47091,2014,155,240,30,-4,-85,26,8.6286080107,13.360425307,1.6700531634,-0.222673755,-4.731817296,1.4473794082
47091,2015,169,217,-44,-4,-48,-48,9.4500517237,12.134090083,-2.460368496,-0.223669863,-2.684038359,-2.684038359
47091,2016,164,246,29,-4,-82,25,9.2103785241,13.815567786,1.6286644951,-0.224643379,-4.605189262,1.4040211165
47091,2017,151,224,-7,-4,-73,-11,8.5147174918,12.631104094,-0.394722003,-0.22555543,-4.116386602,-0.620277433
48251,2010,482,229,43,24,253,67,NA,NA,NA,NA,NA,NA
48251,2011,1920,1286,134,58,634,192,12.660481494,8.4798850006,0.8835961043,0.3824520451,4.1805964933,1.2660481494
48251,2012,1963,1174,543,8,789,551,12.853924933,7.6874721706,3.5556195814,0.0523848189,5.166452762,3.6080044003
48251,2013,1938,1271,476,12,667,488,12.589238734,8.2564099233,3.0920937242,0.0779519426,4.332828811,3.1700456668
48251,2014,1952,1307,1571,25,645,1596,12.542689803,8.398204699,10.09455209,0.1606389575,4.1444851039,10.255191048
48251,2015,2105,1323,1797,54,782,1851,13.316927048,8.3697360971,11.368417057,0.3416218815,4.9471909508,11.710038939
48251,2016,2143,1363,2688,59,780,2747,13.297963109,8.4578272134,16.679852934,0.3661128434,4.8401358961,17.045965778
48251,2017,2139,1385,3568,60,754,3628,12.955156625,8.3884487729,21.610097633,0.3633985028,4.5667078518,21.973496136
56019,2010,29,9,-3,1,20,-2,NA,NA,NA,NA,NA,NA
56019,2011,102,86,40,3,16,43,11.838440111,9.9814298979,4.6425255339,0.348189415,1.8570102136,4.9907149489
56019,2012,90,79,-23,5,11,-18,10.415461173,9.1424603634,-2.661728967,0.5786367319,1.2730008101,-2.083092235
56019,2013,101,93,-10,1,8,-9,11.693875188,10.767627648,-1.157809425,0.1157809425,0.9262475397,-1.042028482
56019,2014,96,85,-66,4,11,-62,11.149178329,9.8716683119,-7.665060101,0.464549097,1.2775100168,-7.200511004
56019,2015,77,95,46,4,-18,50,8.9534883721,11.046511628,5.3488372093,0.4651162791,-2.093023256,5.8139534884
56019,2016,81,90,-114,4,-9,-110,9.4670406732,10.518934081,-13.32398317,0.4675081814,-1.051893408,-12.85647499
56019,2017,77,83,-18,4,-6,-14,9.07376856,9.7808154608,-2.121140702,0.4713646005,-0.707046901,-1.649776102
37101,2010,572,303,469,39,269,508,NA,NA,NA,NA,NA,NA
37101,2011,2256,1234,1717,92,1022,1809,13.184578251,7.2117772882,10.034539387,0.5376689712,5.9728009631,10.572208358
37101,2012,2245,1195,865,71,1050,936,12.937430667,6.8865165464,4.98480068,0.40915705,6.0509141202,5.39395773
37101,2013,2152,1275,1906,100,877,2006,12.22928778,7.2455120446,10.831330162,0.5682754545,4.9837757358,11.399605617
37101,2014,2285,1223,2312,127,1062,2439,12.751756506,6.8251195652,12.902433716000001,0.7087409524,5.9266369405,13.611174668
37101,2015,2215,1354,3326,170,861,3496,12.093317828,7.3924841258,18.159085822,0.9281553186,4.7008337019,19.08724114
37101,2016,2344,1485,4715,158,859,4873,12.453147953,7.8894729991,25.049740869,0.839418676,4.5636749537,25.889159545
37101,2017,2366,1503,4573,161,863,4734,12.202103135,7.7513782807,23.584200185,0.8303206275,4.4507248544,24.414520812
40069,2010,36,28,32,3,8,35,NA,NA,NA,NA,NA,NA
40069,2011,109,152,100,7,-43,107,9.8785571869,13.775602683,9.0628965017,0.6344027551,-3.897045496,9.6972992568
40069,2012,132,138,-105,3,-6,-102,11.985834922,12.530645601,-9.53418687,0.2724053391,-0.544810678,-9.261781531
40069,2013,127,115,7,1,12,8,11.577555951,10.483613656,0.6381330052,0.0911618579,1.0939422945,0.729294863
40069,2014,157,135,91,3,22,94,14.224235561,12.231030578,8.2446206116,0.2718006795,1.993204983,8.5164212911
40069,2015,127,132,-126,4,-5,-122,11.511965192,11.965192168,-11.4213198,0.3625815809,-0.453226976,-11.05873822
40069,2016,106,150,165,4,-44,169,9.6105897819,13.599891201,14.959880321,0.3626637654,-3.989301419,15.322544086
40069,2017,108,164,21,4,-56,25,9.7512527651,14.807457903,1.8960769265,0.3611575098,-5.056205137,2.2572344364
13169,2010,82,75,-29,0,7,-29,NA,NA,NA,NA,NA,NA
13169,2011,323,238,-6,9,85,3,11.258081944,8.2954288005,-0.209128457,0.3136926857,2.962653143,0.1045642286
13169,2012,314,260,-179,9,54,-170,10.94896874,9.066025071,-6.241609568,0.3138239448,1.8829436686,-5.927785623
13169,2013,309,252,-104,0,57,-104,10.804573586,8.8114969055,-3.636490786,0,1.993076681,-3.636490786
13169,2014,289,215,9,-1,74,8,10.099774590000001,7.5136731377,0.3145258523,-0.034947317,2.5861014521,0.2795785354
13169,2015,308,267,-249,-1,41,-250,10.787902138,9.3518502303,-8.721388417,-0.035025656,1.436051908,-8.756414073
13169,2016,292,268,84,-1,24,83,10.245614035,9.4035087719,2.9473684211,-0.035087719,0.8421052632,2.9122807018
13169,2017,248,285,-46,-1,-37,-47,8.698244568,9.9959665398,-1.613384073,-0.035073567,-1.297721972,-1.64845764
19105,2010,58,30,27,0,28,27,NA,NA,NA,NA,NA,NA
19105,2011,210,191,24,4,19,28,10.139294595,9.2219298457,1.1587765251,0.1931294209,0.9173647491,1.351905946
19105,2012,200,218,-128,3,-18,-125,9.679136621,10.550258917,-6.194647437,0.1451870493,-0.871122296,-6.049460388
19105,2013,204,194,-106,11,10,-95,9.9270072993,9.4403892944,-5.158150852,0.5352798054,0.4866180049,-4.622871046
19105,2014,223,232,-2,19,-9,17,10.872745002,11.311555339,-0.097513408,0.9263773769,-0.438810336,0.8288639688
19105,2015,211,199,-144,20,12,-124,10.314317837,9.7277215623,-7.039155301,0.9776604585,0.5865962751,-6.061494843
19105,2016,218,204,-52,20,14,-32,10.689942627,10.00343255,-2.549894572,0.9807286814,0.686510077,-1.56916589
19105,2017,213,195,116,19,18,135,10.410557185,9.5307917889,5.669599218,0.9286412512,0.8797653959,6.5982404692
28067,2010,215,193,25,-3,22,22,NA,NA,NA,NA,NA,NA
28067,2011,994,666,-207,-8,328,-215,14.649963154,9.8157700811,-3.050847458,-0.117907148,4.834193073,-3.168754606
28067,2012,952,675,153,-2,277,151,13.976466098,9.9097842603,2.2462177657,-0.029362324,4.0666818372,2.2168554419
28067,2013,1013,712,243,-1,301,242,14.768055515,10.379916611,3.5425838995,-0.014578535,4.3881389043,3.5280053649
28067,2014,952,728,-789,-2,224,-791,13.881092115,10.614952794,-11.50439252,-0.029161958,3.2661393213,-11.53355448
28067,2015,1021,853,-101,6,168,-95,14.941208321,12.48271371,-1.478023546,0.087803379,2.4584946111,-1.390220167
28067,2016,962,745,-408,8,217,-400,14.09038646,10.911993673,-5.97596432,0.117175771,3.1783927878,-5.858788549
28067,2017,952,777,-429,7,175,-422,13.988582848,11.417152177,-6.303678615,0.1028572268,2.5714306706,-6.200821388
37103,2010,21,53,6,1,-32,7,NA,NA,NA,NA,NA,NA
37103,2011,110,146,-51,5,-36,-46,10.891089109,14.455445545,-5.04950495,0.495049505,-3.564356436,-4.554455446
37103,2012,99,123,22,12,-24,34,9.8370429253,12.221780604,2.186009539,1.1923688394,-2.384737679,3.3783783784
37103,2013,94,120,-49,10,-26,-39,9.3658147761,11.956359289,-4.882180043,0.996363274,-2.590544513,-3.885816769
37103,2014,98,131,-126,11,-33,-115,9.8685866774,13.191682191,-12.68818287,1.1076985046,-3.323095514,-11.58048437
37103,2015,112,126,-60,15,-14,-45,11.397750979,12.822469852,-6.105938025,1.5264845062,-1.424718872,-4.579453519
37103,2016,75,97,-162,14,-22,-148,7.7235981669,9.9891869626,-16.68297204,1.4417383245,-2.265588796,-15.24123372
37103,2017,80,115,-7,14,-35,7,8.3237956508,11.965456248,-0.72833211899999994,1.4566642389,-3.641660597,0.7283321194
46075,2010,1,1,5,0,0,5,NA,NA,NA,NA,NA,NA
46075,2011,17,11,-13,1,6,-12,16.873449132,10.918114144,-12.90322581,0.9925558313,5.9553349876,-11.91066998
46075,2012,9,10,-12,0,-1,-12,9.0180360721,10.02004008,-12.0240481,0,-1.002004008,-12.0240481
46075,2013,6,11,-14,0,-5,-14,6.106870229,11.195928753,-14.24936387,0,-5.089058524,-14.24936387
46075,2014,11,8,-20,0,3,-20,11.398963731,8.2901554404,-20.7253886,0,3.1088082902,-20.7253886
46075,2015,12,11,-41,0,1,-41,12.8,11.733333333,-43.73333333,0,1.0666666667,-43.73333333
46075,2016,11,7,13,0,4,13,11.872638964,7.5553157043,14.031300594,0,4.3173232596,14.031300594
46075,2017,14,5,-7,0,9,-7,14.96525922,5.3447354356,-7.48262961,0,9.6205237841,-7.48262961
48253,2010,25,21,35,3,4,38,NA,NA,NA,NA,NA,NA
48253,2011,154,213,75,10,-59,85,7.6041872408,10.517479755,3.7033379419,0.4937783923,-2.913292514,4.1971163342
48253,2012,189,173,-429,10,16,-419,9.4168057597,8.6196158541,-21.37465434,0.498243691,0.7971899056,-20.87641065
48253,2013,189,206,165,11,-17,176,9.4710731377,10.322968605,8.2683971837,0.5512264789,-0.851895467,8.8196236626
48253,2014,180,196,-185,12,-16,-173,9.0254970291,9.8277634317,-9.27620528,0.6016998019,-0.802266403,-8.674505478
48253,2015,159,202,162,13,-43,175,7.9833304044,10.142344287,8.13395928,0.6527251274,-2.159013883,8.7866844074
48253,2016,164,190,23,14,-26,37,8.2047177127,9.5054656427,1.1506616304,0.7004027316,-1.30074793,1.851064362
48253,2017,161,165,-23,15,-4,-8,8.0546314131,8.2547464792,-1.15066163,0.7504314981,-0.200115066,-0.400230132
41033,2010,215,235,171,2,-20,173,NA,NA,NA,NA,NA,NA
41033,2011,782,1212,270,-26,-430,244,9.4483241911,14.643694271,3.2622091197,-0.314138656,-5.19537008,2.9480704637
41033,2012,780,1156,471,-23,-376,448,9.4317948222,13.978403608,5.6953530272,-0.278117027,-4.546608786,5.4172360004
41033,2013,819,1184,764,-26,-365,738,9.8769898698,14.278822962,9.2136999518,-0.313555234,-4.401833092,8.9001447178
41033,2014,860,1181,583,-22,-321,561,10.332936837,14.189765587,7.004769972,-0.264330942,-3.85682875,6.7404390297
41033,2015,879,1194,1388,-15,-315,1373,10.478506545,14.233602747,16.546265169,-0.178814105,-3.755096202,16.367451065
41033,2016,867,1213,1278,-13,-346,1265,10.214420358,14.290763431,15.056550424,-0.153157399,-4.076343073,14.903393025
41033,2017,879,1183,1329,-12,-304,1317,10.239384938,13.780651174,15.481390879,-0.139786825,-3.541266236,15.341604054
49023,2010,47,16,-16,1,31,-15,NA,NA,NA,NA,NA,NA
49023,2011,194,80,-63,-3,114,-66,18.858753767,7.7768056771,-6.124234471,-0.291630213,11.08194809,-6.415864684
49023,2012,178,72,-123,0,106,-123,17.276521402,6.9882558478,-11.93827041,0,10.288265554,-11.93827041
49023,2013,159,64,-128,-1,95,-129,15.469183247,6.2265894829,-12.45317897,-0.097290461,9.2425937637,-12.55046943
49023,2014,195,86,41,0,109,41,18.865186475,8.3200309583,3.9665263871,0,10.545155517,3.9665263871
49023,2015,170,72,36,0,98,36,16.224470319,6.8715403703,3.4357701851,0,9.3529299485,3.4357701851
49023,2016,213,66,310,0,147,310,19.769816224,6.1258585484,28.77297197,0,13.643957676,28.77297197
49023,2017,213,89,124,0,124,124,19.143486272,7.9989214937,11.144564778,0,11.144564778,11.144564778
30045,2010,5,2,-2,0,3,-2,NA,NA,NA,NA,NA,NA
30045,2011,16,27,-53,0,-11,-53,7.8412153884,13.232050968,-25.97402597,0,-5.39083558,-25.97402597
30045,2012,15,24,4,0,-9,4,7.4757039621,11.961126339,1.9935210566,0,-4.485422377,1.9935210566
30045,2013,15,18,-2,0,-3,-2,7.4925074925,8.991008991,-0.999000999,0,-1.498501499,-0.999000999
30045,2014,17,27,-7,1,-10,-6,8.5341365462,13.554216867,-3.514056225,0.5020080321,-5.020080321,-3.012048193
30045,2015,11,14,-52,1,-3,-51,5.619412516,7.1519795658,-26.56449553,0.5108556833,-1.53256705,-26.05363985
30045,2016,19,10,8,1,9,9,9.793814433,5.1546391753,4.1237113402,0.5154639175,4.6391752577,4.6391752577
30045,2017,16,7,4,1,9,5,8.1841432225,3.5805626598,2.0460358056,0.5115089514,4.6035805627,2.557544757
02110,2010,101,61,61,16,40,77,NA,NA,NA,NA,NA,NA
02110,2011,410,158,439,68,252,507,12.902007678,4.9719932028,13.814588709,2.1398451759,7.9300144754,15.954433885
02110,2012,368,185,-31,84,183,53,11.400777607,5.7313691776,-0.960391592,2.6023514104,5.6694084298,1.6419598185
02110,2013,397,180,-110,73,217,-37,12.221965674,5.5414453937,-3.386438852,2.2473639652,6.6805202802,-1.139074886
02110,2014,406,180,-372,64,226,-308,12.480786966,5.5333538272,-11.43559791,1.9674146941,6.9474331386,-9.468183215
02110,2015,384,201,-135,74,183,-61,11.7968726,6.1749255015,-4.147338023,2.2733556573000002,5.6219470984,-1.873982366
02110,2016,369,185,-456,64,184,-392,11.350877463,5.6908193242,-14.0271006,1.9687158743,5.6600581386,-12.05838473
02110,2017,357,175,-561,65,182,-496,11.069939069,5.42644072,-17.39561854,2.0155351246,5.6434983488,-15.38008341
55057,2010,60,49,-1,1,11,0,NA,NA,NA,NA,NA,NA
55057,2011,267,268,24,6,-1,30,10.005808615,10.043283554,0.8993985272,0.2248496318,-0.037474939,1.124248159
55057,2012,274,276,72,5,-2,77,10.249504358,10.324318258,2.6933004152,0.1870347511,-0.0748139,2.8803351663
55057,2013,297,313,-193,3,-16,-190,11.137778444,11.737793445,-7.237680942,0.1125028126,-0.600015,-7.125178129
55057,2014,244,293,-180,4,-49,-176,9.224952741,11.077504726,-6.805293006,0.1512287335,-1.852551985,-6.654064272
55057,2015,292,264,-64,4,28,-60,11.094646453,10.030776245,-2.431703332,0.1519814583,1.0638702078,-2.279721874
55057,2016,274,297,75,5,-23,80,10.406380555,11.279908849,2.8484618306,0.1898974554,-0.873528295,3.038359286
55057,2017,273,257,197,5,16,202,10.314536696,9.7100217248,7.4430905828,0.1889109285,0.6045149712,7.6320015113
42067,2010,72,81,-4,2,-9,-2,NA,NA,NA,NA,NA,NA
42067,2011,279,232,2,35,47,37,11.312721744,9.4069944247,0.0810947795,1.4191586417,1.9057273188,1.5002534212
42067,2012,260,235,-155,21,25,-134,10.548737194,9.5344355411,-6.288670251,0.8520133888,1.0143016533,-5.436656862
42067,2013,272,255,-191,22,17,-169,11.093890203,10.400522065,-7.790194959,0.8972999429,0.6933681377,-6.892895016
42067,2014,246,254,-26,28,-8,2,10.066290204,10.393649235,-1.063916851,1.1457566086,-0.327359031,0.0818397578
42067,2015,296,270,-109,28,26,-81,12.128910652,11.063533365,-4.466389395,1.147329386,1.065377287,-3.319060009
42067,2016,258,265,79,30,-7,109,10.562731572,10.849317312,3.2343247835,1.2282246013,-0.28658574,4.4625493849
42067,2017,260,260,11,29,0,40,10.614627774,10.614627774,0.4490804058,1.1839392517,0,1.6330196575
26077,2010,783,449,-28,120,334,92,NA,NA,NA,NA,NA,NA
26077,2011,3065,2088,313,452,977,765,12.183172912,8.2996623294,1.2441543626,1.7966701977,3.8835105823,3.0408245603
26077,2012,3055,1904,1032,483,1151,1515,12.039053033,7.5032265056,4.0668748707,1.903392018,4.5358265273,5.9702668887
26077,2013,3155,1987,244,488,1168,732,12.323231929,7.7610972559,0.9530486816,1.9060973633,4.5621346728,2.8591460449
26077,2014,3188,2076,66,540,1112,606,12.366607058,8.0530352107,0.2560213506,2.0947201415,4.313571847,2.3507414921
26077,2015,3205,2163,-707,585,1042,-122,12.370911182,8.3489175935,-2.72893423,2.2580290301,4.0219935887,-0.470905199
26077,2016,3143,2125,-77,591,1018,514,12.074970082,8.1639552731,-0.29582332,2.2705400312,3.9110148085,1.9747167108
26077,2017,3173,2184,366,586,989,952,12.109739505,8.3352256789,1.3968372704,2.2364662307,3.7745138262,3.6333035011
15005,2010,0,0,0,0,0,0,NA,NA,NA,NA,NA,NA
15005,2011,0,0,0,0,0,0,0,0,0,0,0,0
15005,2012,0,1,0,0,-1,0,0,11.173184358,0,0,-11.17318436,0
15005,2013,0,0,0,0,0,0,0,0,0,0,0,0
15005,2014,0,0,0,0,0,0,0,0,0,0,0,0
15005,2015,0,1,0,0,-1,0,0,11.299435028,0,0,-11.29943503,0
15005,2016,0,0,0,0,0,0,0,0,0,0,0,0
15005,2017,0,0,0,0,0,0,0,0,0,0,0,0
26079,2010,46,27,-25,1,19,-24,NA,NA,NA,NA,NA,NA
26079,2011,159,187,44,8,-28,52,9.2703262105,10.902836487,2.5653732910000002,0.4664315074,-1.632510276,3.0318047984
26079,2012,181,204,-60,11,-23,-49,10.568725914,11.911713185,-3.503445054,0.64229826,-1.342987271,-2.861146794
26079,2013,188,180,174,5,8,179,10.940409683,10.474860335,10.125698324,0.2909683426,0.4655493482,10.416666667
26079,2014,167,188,89,4,-21,93,9.6456522367,10.858578566,5.1404972998,0.2310335865,-1.212926329,5.3715308863
26079,2015,176,189,-109,5,-13,-104,10.179588768,10.931490211,-6.304404407,0.2891928627,-0.751901443,-6.015211545
26079,2016,163,171,73,6,-8,79,9.4410657399,9.9044309296,4.2282073559,0.3475238923,-0.46336519,4.5757312482
26079,2017,168,168,325,6,0,331,9.6181370585,9.6181370585,18.606515143,0.3435048949,0,18.950020038
27065,2010,37,51,-14,1,-14,-13,NA,NA,NA,NA,NA,NA
27065,2011,159,146,-6,3,13,-3,9.8057354302,9.004008634,-0.370027752,0.185013876,0.8017267962,-0.185013876
27065,2012,114,132,-236,0,-18,-236,7.0838252656,8.2023239918,-14.66476108,0,-1.118498726,-14.66476108
27065,2013,166,142,13,0,24,13,10.38473569,8.8833281201,0.8132624335,0,1.5014075696,0.8132624335
27065,2014,152,144,-56,7,8,-49,9.5109970904,9.0104182962,-3.50405156,0.438006445,0.5005787942,-3.066045115
27065,2015,177,159,-113,7,18,-106,11.120884644,9.9899472229,-7.099773813,0.4398089972,1.1309374215,-6.659964815
27065,2016,143,157,16,9,-14,25,9.0067393084,9.888517982,1.0077470555,0.5668577187,-0.881778674,1.5746047742
27065,2017,153,159,139,9,-6,148,9.5906726008,9.9667774086,8.7130947157,0.5641572118,-0.376104808,9.2772519275
54039,2010,507,582,-38,12,-75,-26,NA,NA,NA,NA,NA,NA
54039,2011,2097,2466,-467,24,-369,-443,10.893478199,12.810356337,-2.425967725,0.1246750008,-1.916878138,-2.301292724
54039,2012,2262,2309,43,91,-47,134,11.774718711,12.01937467,0.2238341753,0.4736955803,-0.244655959,0.6975297556
54039,2013,2222,2481,-489,57,-259,-432,11.586585216,12.937136779,-2.549883065,0.2972256334,-1.350551562,-2.252657432
54039,2014,2219,2455,-1063,105,-236,-958,11.629156218,12.865965982,-5.57088466,0.5502755308,-1.236809765,-5.020609129
54039,2015,2037,2540,-1706,116,-503,-1590,10.768348351,13.427395587,-9.018557824,0.613219641,-2.659047236,-8.405338183
54039,2016,2084,2460,-1761,117,-376,-1644,11.137952413,13.147487013,-9.411676679,0.6253073091,-2.0095346,-8.78636937
54039,2017,1985,2464,-2444,114,-479,-2330,10.747448496,13.340913398,-13.23262676,0.6172338179,-2.593464902,-12.61539295
27067,2010,135,112,-42,18,23,-24,NA,NA,NA,NA,NA,NA
27067,2011,577,387,-322,89,190,-233,13.667641799,9.1670318477,-7.627349496,2.1081804508,4.5006099511,-5.519169045
27067,2012,540,372,-90,104,168,14,12.770183985,8.7972378565,-2.128363998,2.4594428416,3.9729461287,0.3310788441
27067,2013,593,395,-245,155,198,-90,13.976619214,9.3098896955,-5.774488545,3.6532478552,4.6667295182,-2.12124069
27067,2014,574,361,-414,189,213,-225,13.512877254,8.4985168793,-9.746221574,4.4493620227,5.0143603748,-5.296859551
27067,2015,598,427,-299,217,171,-82,14.06463145,10.0428054,-7.032315725,5.1037207771,4.0218260501,-1.928594948
27067,2016,607,361,-412,226,246,-186,14.25150263,8.4757700977,-9.673178062,5.3061607814,5.7757325319,-4.36701728
27067,2017,589,348,-343,225,241,-118,13.799566567,8.1532243894,-8.036080361,5.2714812862,5.6463421777,-2.764599075
17089,2010,1819,738,-373,75,1081,-298,NA,NA,NA,NA,NA,NA
17089,2011,7095,2796,-1809,490,4299,-1319,13.706661979,5.401525989,-3.494764132,0.9466193615,8.3051359896,-2.548144771
17089,2012,6957,2870,-2677,461,4087,-2216,13.37731548,5.5185993141,-5.147487932,0.8864370327,7.8587161661,-4.261050899
17089,2013,6761,3003,-2029,601,3758,-1428,12.948113704,5.7510997566,-3.885774694,1.1509859986,7.1970139478,-2.734788695
17089,2014,6759,2944,-1329,715,3815,-614,12.876775224,5.6087033969,-2.531918076,1.3621681144,7.2680718272,-1.169749961
17089,2015,6767,3163,-923,894,3604,-29,12.810586197,5.9878652494,-1.747328367,1.6924285593,6.8227209481,-0.054899808
17089,2016,6683,3300,-1757,930,3383,-827,12.579196422,6.211484093,-3.307144713,1.7505091535,6.3677123292,-1.556635559
17089,2017,6577,3369,-2035,940,3208,-1095,12.325481157,6.3135998201,-3.813646671,1.7615861772,6.0118813366,-2.052060494
49025,2010,15,26,88,0,-11,88,NA,NA,NA,NA,NA,NA
49025,2011,78,60,63,-2,18,61,10.754170688,8.2724389908,8.6860609403,-0.275747966,2.4817316972,8.4103129739
49025,2012,90,70,-140,-3,20,-143,12.442969722,9.6778653394,-19.35573068,-0.414765657,2.7651043827,-19.77049634
49025,2013,74,80,-45,-1,-6,-46,10.353270374,11.192724729,-6.29590766,-0.139909059,-0.839454355,-6.435816719
49025,2014,84,87,47,0,-3,47,11.755650409,12.175495067,6.5775663005,0,-0.419844657,6.5775663005
49025,2015,81,85,-120,0,-4,-120,11.396412241,11.95919803,-16.88357369,0,-0.56278579,-16.88357369
49025,2016,83,57,255,0,26,255,11.550236571,7.9320901753,35.485666574,0,3.6181463958,35.485666574
49025,2017,87,62,215,0,25,215,11.683341167,8.3260592225,28.872624723,0,3.3572819445,28.872624723
17091,2010,370,300,-108,13,70,-95,NA,NA,NA,NA,NA,NA
17091,2011,1341,1011,-344,79,330,-265,11.820445581,8.9116110976,-3.032239582,0.6963573459,2.9088344829,-2.335882236
17091,2012,1377,1017,-982,87,360,-895,12.162753004,8.9829482973,-8.673800617,0.7684528042,3.179804707,-7.905347813
17091,2013,1330,1075,-1087,71,255,-1016,11.813873751,9.5488077314,-9.655399074,0.6306654409,2.26506602,-9.024733633
17091,2014,1361,1084,-1197,80,277,-1117,12.17401416,9.6962757893,-10.70704993,0.7155923092,2.4777383705,-9.991457617
17091,2015,1335,1109,-953,91,226,-862,12.019447195,9.9846943369,-8.580174665,0.8193031422,2.0347528586,-7.760871522
17091,2016,1295,1143,-949,94,152,-855,11.729594355,10.352838879,-8.595664126,0.851414571,1.3767554765,-7.744249555
17091,2017,1295,1126,-709,93,169,-616,11.791057007,10.252301305,-6.455489898,0.8467708893,1.538755702,-5.608719009
48255,2010,36,11,30,5,25,35,NA,NA,NA,NA,NA,NA
48255,2011,134,157,72,14,-23,86,8.9839428782,10.525962924,4.8271931883,0.9386208977,-1.542020046,5.765814086
48255,2012,162,159,-113,6,3,-107,10.87430777,10.6729317,-7.585165296,0.4027521396,0.2013760698,-7.182413157
48255,2013,163,186,-125,17,-23,-108,11.024687183,12.58031789,-8.454514711,1.1498140007,-1.555630707,-7.30470071
48255,2014,190,138,46,16,52,62,12.857384537,9.3385214008,3.1128404669,1.0827271189,3.5188631365,4.1955675859
48255,2015,176,148,357,18,28,375,11.70212766,9.8404255319,23.736702128,1.1968085106,1.8617021277,24.933510638
48255,2016,193,107,-86,16,86,-70,12.651174986,7.0138638524,-5.637311134,1.0488020714,5.6373111337,-4.588509062
48255,2017,182,138,-137,16,44,-121,11.953630423,9.063741749,-8.998062461,1.0508686086,2.8898886736,-7.947193852
15007,2010,195,161,6,78,34,84,NA,NA,NA,NA,NA,NA
15007,2011,895,573,-49,371,322,322,13.256215239,8.486940036,-0.72575927,5.4950344736,4.7692752035,4.7692752035
15007,2012,879,495,-23,390,384,367,12.888090613,7.2577984678,-0.33723104,5.7182654595,5.6302921447,5.3810344196
15007,2013,843,516,393,330,327,723,12.199798841,7.4674925289,5.6874507051,4.7757219662,4.7323063119,10.463172671
15007,2014,907,579,204,372,328,576,12.943367416,8.2626347673,2.9111873791,5.308635809,4.6807326488,8.2198231882
15007,2015,894,540,122,395,354,517,12.599534916,7.6104573321,1.7193996195,5.566908604,4.9890775844,7.2863082235
15007,2016,863,646,-223,392,217,169,12.056777222,9.0251194501,-3.115482411,5.4765430719,3.0316577719,2.3610606611
15007,2017,867,662,-201,392,205,191,12.047690512,9.1990439664,-2.793063198,5.4471680285,2.8486465455,2.6541048302
48257,2010,356,246,381,12,110,393,NA,NA,NA,NA,NA,NA
48257,2011,1392,788,655,46,604,701,13.315859456,7.5380008992,6.2657240977,0.4400355855,5.7778585573,6.7057596832
48257,2012,1412,781,673,46,631,719,13.338308434,7.3776337727,6.3574232126,0.4345341275,5.9606746615,6.7919573401
48257,2013,1473,855,1045,54,618,1099,13.71578619,7.9613015564,9.7304796801,0.5028190457,5.7544846338,10.233298726
48257,2014,1517,891,1915,81,626,1996,13.843135466,8.1306748186,17.475019391,0.7391522562,5.712460647,18.214171648
48257,2015,1537,899,2484,100,638,2584,13.657669666,7.988448295,22.072642453,0.8885926913,5.6692213707,22.961235144
48257,2016,1623,937,3094,103,686,3197,13.978906751,8.070385475,26.648636777,0.8871394919,5.9085212763,27.535776269
48257,2017,1670,957,4007,105,713,4112,13.863005284,7.9442491356,33.26291148,0.8716260807,5.9187561481,34.134537561
40071,2010,155,103,-192,0,52,-192,NA,NA,NA,NA,NA,NA
40071,2011,627,597,-622,1,30,-621,13.588193225,12.93804044,-13.47983443,0.0216717595,0.6501527859,-13.45816267
40071,2012,645,559,-245,3,86,-242,14.090968672,12.212172849,-5.352383449,0.0655393892,1.878795823,-5.28684406
40071,2013,641,593,-179,1,48,-178,14.048237395,12.9962633,-3.92298673,0.021916127,1.0519740951,-3.901070603
40071,2014,643,575,-142,10,68,-132,14.123487161,12.62986799,-3.119028269,0.2196498781,1.493619171,-2.899378391
40071,2015,602,606,-217,14,-4,-203,13.263709873,13.351840835,-4.781104722,0.3084583691,-0.088130963,-4.472646352
40071,2016,628,557,-385,15,71,-370,13.914584834,12.341439096,-8.530438154,0.3323547333,1.5731457376,-8.198083421
40071,2017,614,551,-519,16,63,-503,13.716532443,12.309135791,-11.59426765,0.3574340702,1.4073966513,-11.23683358
31099,2010,19,30,-1,0,-11,-1,NA,NA,NA,NA,NA,NA
31099,2011,76,81,76,-1,-5,75,11.671657836,12.439530062,11.671657836,-0.153574445,-0.767872226,11.518083391
31099,2012,97,68,-66,-2,29,-68,14.861345182,10.418262602,-10.11184311,-0.306419488,4.4430825801,-10.4182626
31099,2013,59,66,-15,0,-7,-15,9.0811143605,10.158534708,-2.308757888,0,-1.077420348,-2.308757888
31099,2014,91,62,75,0,29,75,13.91862955,9.483022331,11.471397981,0,4.4356072193,11.471397981
31099,2015,81,80,-32,0,1,-32,12.320328542,12.168225721,-4.867290288,0,0.1521028215,-4.867290288
31099,2016,84,76,4,0,8,4,12.797074954,11.578305911,0.6093845216,0,1.2187690433,0.6093845216
31099,2017,84,67,-57,0,17,-57,12.82540652,10.229788533,-8.702954424,0,2.5956179861,-8.702954424
20093,2010,14,4,7,3,10,10,NA,NA,NA,NA,NA,NA
20093,2011,58,47,-60,10,11,-50,14.560060249,11.798669512,-15.06213129,2.5103552153,2.7613907368,-12.55177608
20093,2012,74,35,-31,7,39,-24,18.623379892,8.8083553542,-7.801686171,1.7616710708,9.8150245376,-6.0400151
20093,2013,52,47,-74,8,5,-66,13.161225006,11.895722602,-18.72943559,2.0248038471,1.2655024045,-16.70463174
20093,2014,66,45,-11,8,21,-3,16.796030029,11.451838656,-2.799338338,2.0358824278,5.3441913729,-0.76345591
20093,2015,56,34,-37,9,22,-28,14.225835133,8.6371141877,-9.399212498,2.286294932,5.588720945,-7.112917566
20093,2016,65,30,-78,9,35,-69,16.594332397,7.6589226449,-19.91319888,2.2976767935,8.9354097524,-17.61552208
20093,2017,64,23,10,10,41,20,16.284987277,5.8524173028,2.5445292621,2.5445292621,10.432569975,5.0890585242
31101,2010,20,41,8,0,-21,8,NA,NA,NA,NA,NA,NA
31101,2011,76,90,-95,-7,-14,-102,9.160489363,10.84794793,-11.4506117,-0.843729283,-1.687458567,-12.29434099
31101,2012,81,80,-14,-3,1,-17,9.8414434117,9.7199441103,-1.700990219,-0.364497904,0.1214993014,-2.065488123
31101,2013,75,106,-25,-6,-31,-31,9.1569501251,12.941822844,-3.052316708,-0.73255601,-3.784872718,-3.784872718
31101,2014,70,83,34,-6,-13,28,8.5716035021,10.163472724,4.1633502725,-0.734708872,-1.591869222,3.4286414008
31101,2015,78,98,-13,-4,-20,-17,9.5646842428,12.017167382,-1.59411404,-0.490496628,-2.452483139,-2.084610668
31101,2016,88,100,-14,-4,-12,-18,10.836103928,12.313754464,-1.723925625,-0.492550179,-1.477650536,-2.216475803
31101,2017,84,84,-29,-4,0,-33,10.384472741,10.384472741,-3.585115589,-0.494498702,0,-4.079614291
28069,2010,19,10,1,-1,9,0,NA,NA,NA,NA,NA,NA
28069,2011,93,105,-153,-2,-12,-155,8.951345108,10.10635738,-14.72640647,-0.192502045,-1.155012272,-14.91890851
28069,2012,90,103,114,-1,-13,113,8.6876779767,9.9425647956,11.004392104,-0.096529755,-1.254886819,10.907862349
28069,2013,85,94,-87,0,-9,-87,8.2014666152,9.069857198,-8.3944423,0,-0.868390583,-8.3944423
28069,2014,87,105,-50,1,-18,-49,8.4609773888,10.211524435,-4.862630683,0.0972526137,-1.750547046,-4.76537807
28069,2015,86,102,-225,1,-16,-224,8.4904728996,10.070095765,-22.21344654,0.0987264291,-1.579622865,-22.11472011
28069,2016,88,86,-58,1,2,-57,8.8158685634,8.6155079142,-5.810458826,0.1001803246,0.2003606492,-5.710278501
28069,2017,80,100,-52,1,-20,-51,8.0657357463,10.082169683,-5.242728235,0.1008216968,-2.016433937,-5.141906538
02122,2010,183,100,73,6,83,79,NA,NA,NA,NA,NA,NA
02122,2011,710,388,400,19,322,419,12.693872078,6.9369329102,7.151477227,0.3396951683,5.7569391677,7.4911723953
02122,2012,717,347,212,25,370,237,12.666278022,6.1299839242,3.7451198615,0.4416414931,6.5362940979,4.1867613546
02122,2013,713,393,-293,54,320,-239,12.519424423,6.9006084124,-5.144728409,0.9481752017,5.6188160101,-4.196553208
02122,2014,714,394,211,61,320,272,12.463125556,6.8774110213,3.6830805216,1.0647768332,5.5857145351,4.7478573548
02122,2015,704,443,162,65,261,227,12.174454398,7.6609137758,2.8015079722,1.1240618407,4.5135406219,3.9255698129
02122,2016,755,456,111,64,299,175,12.949146728,7.8209416002,1.9037818369,1.0976760141,5.1282051282,3.001457851
02122,2017,732,486,-235,65,246,-170,12.495732332,8.2963468761,-4.011608057,1.109593718,4.1993854558,-2.902014339
17093,2010,508,143,184,14,365,198,NA,NA,NA,NA,NA,NA
17093,2011,1723,494,100,102,1229,202,14.842316538,4.2554291178,0.8614228983,0.8786513563,10.586887421,1.7400742547
17093,2012,1685,486,158,112,1199,270,14.337802019,4.1354135201,1.3444348481,0.9530171075,10.202388499,2.2974519556
17093,2013,1712,529,62,130,1183,192,14.395566973,4.4481629255,0.5213347852,1.0931213239,9.9474040471,1.6144561091
17093,2014,1682,536,513,135,1146,648,13.959606774,4.4484834904,4.257597072,1.1204202821,9.5111232836,5.3780173541
17093,2015,1621,575,339,149,1046,488,13.272253131,4.7079244603,2.7756285079,1.2199665123,8.5643286704,3.9955950202
17093,2016,1605,582,503,156,1023,659,12.971531328,4.7036954721,4.0652213444,1.2607843533,8.2678358556,5.3260056978
17093,2017,1585,543,450,156,1042,606,12.640007018,4.3302989342,3.5886455256,1.2440637822,8.3097080836,4.8327093078
48259,2010,85,90,193,10,-5,203,NA,NA,NA,NA,NA,NA
48259,2011,314,310,768,47,4,815,9.224306341,9.1067992538,22.561360732,1.380708274,0.1175070871,23.942069006
48259,2012,344,299,1002,52,45,1054,9.8243609881,8.5391974868,28.616307297,1.4850778238,1.2851635014,30.101385121
48259,2013,318,345,1553,36,-27,1589,8.7438305127,9.4862312166,42.701788636,0.9898676052,-0.742400704,43.691656241
48259,2014,349,349,1166,58,0,1224,9.2363472761,9.2363472761,30.858398063,1.5349803496,0,32.393378412
48259,2015,360,354,1472,62,6,1534,9.1864856589,9.0333775646,37.562519139,1.5821169746,0.1531080943,39.144636113
48259,2016,386,367,1908,67,19,1975,9.4224478836,8.9586486355,46.57520871,1.6355026119,0.4637992482,48.210711322
48259,2017,402,393,1979,68,9,2047,9.3499244098,9.1405977439,46.028607978,1.5815792534,0.2093266659,47.610187231
48261,2010,0,0,4,0,0,4,NA,NA,NA,NA,NA,NA
48261,2011,5,0,9,5,5,14,11.723329426,0,21.101992966,11.723329426,11.723329426,32.825322392
48261,2012,1,3,3,6,-2,9,2.2727272727,6.8181818182,6.8181818182,13.636363636,-4.545454545,20.454545455
48261,2013,9,3,-24,8,6,-16,20.4778157,6.8259385666,-54.60750853,18.202502844,13.651877133,-36.40500569
48261,2014,4,3,-14,8,1,-6,9.2378752887,6.9284064665,-32.33256351,18.475750577,2.3094688222,-13.85681293
48261,2015,3,1,-8,8,2,0,6.9444444444,2.3148148148,-18.51851852,18.518518519,4.6296296296,0
48261,2016,2,2,-13,8,0,-5,4.6457607433,4.6457607433,-30.19744483,18.583042973,0,-11.61440186
48261,2017,2,0,-21,9,2,-12,4.7337278107,0,-49.70414201,21.301775148,4.7337278107,-28.40236686
23011,2010,309,352,-29,6,-43,-23,NA,NA,NA,NA,NA,NA
23011,2011,1192,1286,-221,17,-94,-204,9.7770231753,10.548030036,-1.812686344,0.1394374111,-0.771006861,-1.673248933
23011,2012,1203,1188,-211,47,15,-164,9.8861002909,9.7628322075,-1.73397104,0.3862399947,0.1232680834,-1.347731045
23011,2013,1203,1291,-407,68,-88,-339,9.9102884116,10.63523054,-3.352857343,0.5601825536,-0.724942128,-2.792674789
23011,2014,1127,1338,138,70,-211,208,9.3019416875,11.043476467,1.1390132679,0.5777603533,-1.741534779,1.7167736211
23011,2015,1243,1334,-128,75,-91,-53,10.267339041,11.019010684,-1.057296378,0.6195095962,-0.751671643,-0.437786781
23011,2016,1180,1354,448,74,-174,522,9.7395495871,11.175720458,3.6977273009,0.6107853131,-1.436170871,4.308512614
23011,2017,1194,1277,509,73,-83,582,9.8211384789,10.503847435,4.1867332376,0.6004548651,-0.682708956,4.7871881028
55059,2010,525,261,-77,17,264,-60,NA,NA,NA,NA,NA,NA
55059,2011,2028,1331,-533,61,697,-472,12.163086113,7.9827749589,-3.19670853,0.3658521957,4.1803111543,-2.830856334
55059,2012,1949,1393,-198,69,556,-129,11.667270284,8.3388955902,-1.185284513,0.413053694,3.3283746936,-0.772230819
55059,2013,1974,1397,-544,42,577,-502,11.800044833,8.3508929239,-3.251886722,0.2510647837,3.4491519091,-3.000821938
55059,2014,1989,1406,-105,58,583,-47,11.869028936,8.3900727418,-0.626570155,0.3461054189,3.4789561938,-0.280464736
55059,2015,1904,1430,-501,85,474,-416,11.342887015,8.5190800585,-2.98465672,0.5063788846,2.8238069565,-2.478277835
55059,2016,1917,1355,-657,81,562,-576,11.419176711,8.0714577172,-3.913614554,0.4825004244,3.3477189941,-3.431114129
55059,2017,1905,1336,15,74,569,89,11.326139303,7.9431612117,0.0891821992,0.4399655162,3.3829780909,0.5291477154
10001,2010,573,333,289,86,240,375,NA,NA,NA,NA,NA,NA
10001,2011,2213,1373,1072,252,840,1324,13.488885232,8.3688384199,6.5341549789,1.5360140436,5.1200468119,8.0701690225
10001,2012,2187,1379,1049,432,808,1481,13.151287918,8.2924673247,6.3080480229,2.5977852678,4.8588205935,8.9058332907
10001,2013,2187,1496,744,281,691,1025,12.994961259,8.8891001569,4.420782431,1.6696772353,4.1058611019,6.0904596663
10001,2014,2254,1477,1382,336,777,1718,13.227156161,8.667484317,8.1099954814,1.9717499868,4.5596718445,10.081745468
10001,2015,2254,1553,592,388,701,980,13.066818166,9.0030029334,3.4319238484,2.2493014412,4.0638152326,5.6812252896
10001,2016,2234,1609,456,341,625,797,12.835908367,9.244841792,2.6200421735,1.9592859236,3.5910665755,4.5793280971
10001,2017,2172,1667,1284,283,505,1567,12.355721917,9.4829596846,7.3042112988,1.6098845775,2.872762232,8.9140958763
24029,2010,41,44,18,3,-3,21,NA,NA,NA,NA,NA,NA
24029,2011,161,234,106,9,-73,115,7.959264386,11.568123393,5.2402610243,0.4449278228,-3.608859007,5.6851888471
24029,2012,183,229,-235,6,-46,-229,9.0983667686,11.385387924,-11.68369503,0.2983071072,-2.287021155,-11.38538792
24029,2013,181,243,-92,0,-62,-92,9.0957059223,12.211362095,-4.623231739,0,-3.115656172,-4.623231739
24029,2014,161,261,60,-5,-100,55,8.132134559,13.183149813,3.0306091524,-0.252550763,-5.051015254,2.7780583897
24029,2015,158,253,24,-3,-95,21,8.0060805675,12.819863187,1.2161135039,-0.152014188,-4.81378262,1.0640993159
24029,2016,162,261,59,-2,-99,57,8.2337992376,13.265565438,2.998729352,-0.101651842,-5.031766201,2.8970775095
24029,2017,154,294,-126,-2,-140,-128,7.8897484502,15.062247041,-6.455248732,-0.102464266,-7.172498591,-6.557712998
26081,2010,2230,1050,-1080,166,1180,-914,NA,NA,NA,NA,NA,NA
26081,2011,8660,4233,-65,991,4427,926,14.301213952,6.9904201683,-0.107341675,1.6365476936,7.3107937834,1.5292060184
26081,2012,8861,4459,1368,1242,4402,2610,14.487090614,7.2901407345,2.2365805169,2.0305796798,7.1969498797,4.2671601967
26081,2013,8920,4359,2347,1437,4561,3784,14.403602838,7.0387112974,3.7898268903,2.3204010402,7.364891541,6.1102279306
26081,2014,8847,4492,1134,1532,4355,2666,14.111510763,7.165017107,1.8087999553,2.4436345076,6.9464936556,4.2524344629
26081,2015,8873,4745,369,1674,4128,2043,14.007187504,7.4906012293,0.5825146161,2.642627283,6.5165862749,3.2251418991
26081,2016,8814,4688,559,1719,4126,2278,13.778150517,7.3283378289,0.8738355048,2.6871614181,6.4498126881,3.5609969228
26081,2017,8839,4668,-175,1715,4171,1540,13.687927941,7.228786925,-0.271002081,2.6558203891,6.4591410163,2.3848183086
44003,2010,407,423,-139,43,-16,-96,NA,NA,NA,NA,NA,NA
44003,2011,1592,1763,-788,170,-171,-618,9.6119884197,10.644431899,-4.757692761,1.0264057986,-1.03244348,-3.731286962
44003,2012,1624,1703,-661,131,-79,-530,9.8472583511,10.326281387,-4.008028184,0.7943293374,-0.479023036,-3.213698846
44003,2013,1594,1769,-116,56,-175,-60,9.6910300215,10.754976228,-0.705244343,0.3404627862,-1.063946207,-0.364781557
44003,2014,1503,1711,305,87,-208,392,9.1404176131,10.405358973,1.8548418975,0.5290860495,-1.26494136,2.383927947
44003,2015,1588,1744,-706,98,-156,-608,9.6754637429,10.625950106,-4.301560077,0.5971004073,-0.950486363,-3.70445967
44003,2016,1669,1775,-31,90,-106,59,10.194545399,10.842012033,-0.18935345,0.5497358214,-0.647466634,0.3603823718
44003,2017,1634,1709,64,90,-75,154,9.9801496412,10.438234845,0.390899374,0.5497022446,-0.458085204,0.9406016186
48263,2010,1,1,5,0,0,5,NA,NA,NA,NA,NA,NA
48263,2011,6,12,6,0,-6,6,7.3891625616,14.778325123,7.3891625616,0,-7.389162562,7.3891625616
48263,2012,5,11,18,0,-6,18,6.1087354918,13.439218082,21.99144777,0,-7.33048259,21.99144777
48263,2013,9,16,-37,0,-7,-37,11.200995644,19.912881145,-46.04853765,0,-8.711885501,-46.04853765
48263,2014,12,19,-27,0,-7,-27,15.68627451,24.836601307,-35.29411765,0,-9.150326797,-35.29411765
48263,2015,9,15,4,0,-6,4,12.040133779,20.066889632,5.3511705686,0,-8.026755853,5.3511705686
48263,2016,8,4,1,0,4,1,10.673782522,5.3368912608,1.3342228152,0,5.3368912608,1.3342228152
48263,2017,6,9,14,0,-3,14,7.9207920792,11.881188119,18.481848185,0,-3.96039604,18.481848185
21117,2010,631,304,-42,17,327,-25,NA,NA,NA,NA,NA,NA
21117,2011,2116,1284,-506,91,832,-415,13.207912264,8.0146310711,-3.158413802,0.5680151304,5.1932811925,-2.590398672
21117,2012,2018,1335,127,122,683,249,12.544758305,8.298935747,0.7894867714,0.7584046151,4.2458225582,1.5478913865
21117,2013,2378,1417,289,102,961,391,14.679918513,8.7474535465,1.7840607445,0.6296684981,5.932464967,2.4137292425
21117,2014,2375,1432,-514,129,943,-385,14.577035798,8.7891853739,-3.154777432,0.7917632076,5.7878504243,-2.363014224
21117,2015,2356,1509,-82,145,847,63,14.397501826,9.2214899214,-0.501101507,0.8860941276,5.1760119042,0.384992621
21117,2016,2267,1529,-376,154,738,-222,13.794572228,9.3038821954,-2.287939637,0.93708166,4.4906900329,-1.350857977
21117,2017,2268,1470,-140,154,798,14,13.745662813,8.9092258974,-0.848497705,0.933347475,4.8364369157,0.0848497705
19107,2010,29,12,-18,0,17,-18,NA,NA,NA,NA,NA,NA
19107,2011,126,101,-141,0,25,-141,12.053955802,9.6622979049,-13.48895054,0,2.3916578973,-13.48895054
19107,2012,136,97,-10,1,39,-9,13.06185171,9.3161736458,-0.960430273,0.0960430273,3.7456780638,-0.864387245
19107,2013,118,143,-67,2,-25,-65,11.366372875,13.774502721,-6.453787988,0.1926503877,-2.408129846,-6.261137601
19107,2014,131,116,-75,5,15,-70,12.707343098,11.252303812,-7.27519643,0.4850130954,1.4550392861,-6.790183335
19107,2015,107,122,-103,5,-15,-98,10.464547677,11.931540342,-10.07334963,0.488997555,-1.466992665,-9.584352078
19107,2016,125,108,-14,5,17,-9,12.288031457,10.616859179,-1.376259523,0.4915212583,1.6711722782,-0.884738265
19107,2017,121,105,-44,5,16,-39,11.903590753,10.329562223,-4.328578455,0.4918839154,1.5740285293,-3.83669454
06029,2010,3488,1364,-962,303,2124,-659,NA,NA,NA,NA,NA,NA
06029,2011,14411,5397,-2748,1424,9014,-1324,17.055618643,6.3874244548,-3.252296165,1.6853237769,10.668194189,-1.566972388
06029,2012,14209,5234,-4091,1536,8975,-2555,16.677190899,6.1431780677,-4.801631921,1.8028126695,10.534012831,-2.998819252
06029,2013,14414,5651,-1433,1502,8763,69,16.767766894,6.57379289,-1.667004992,1.7472725041,10.193974004,0.0802675118
06029,2014,14092,5600,-2203,1694,8492,-509,16.235874116,6.4519511103,-2.538151481,1.9517152109,9.7839230052,-0.586436271
06029,2015,14092,5827,-2544,2068,8265,-476,16.091331897,6.6537177805,-2.904935307,2.361401814,9.4376141163,-0.543533493
06029,2016,13757,5976,-4415,2105,7781,-2310,15.591380484,6.7728494418,-5.003703194,2.3856840822,8.8185310419,-2.618019112
06029,2017,13643,6050,-1622,2072,7593,450,15.34468748,6.804614766,-1.824311595,2.3304399661,8.5400727138,0.506128371
48265,2010,135,186,38,11,-51,49,NA,NA,NA,NA,NA,NA
48265,2011,475,674,168,25,-199,193,9.5741035616,13.585149054,3.3862092597,0.5039001875,-4.011045492,3.8901094471
48265,2012,486,683,273,4,-197,277,9.7892097127,13.757263855,5.4988770608,0.0805696273,-3.968054143,5.5794466881
48265,2013,507,745,315,0,-238,315,10.196488547,14.983005852,6.3350964342,0,-4.786517306,6.3350964342
48265,2014,507,707,702,4,-200,706,10.136452242,14.135052732,14.035087719,0.0799720098,-3.99860049,14.115059729
48265,2015,536,751,678,12,-215,690,10.610919745,14.867165538,13.422021618,0.2375579047,-4.256245793,13.659579523
48265,2016,563,710,679,12,-147,691,11.03391508,13.914884026,13.307332752,0.2351811385,-2.880968946,13.54251389
48265,2017,548,733,597,11,-185,608,10.63912402,14.230799099,11.590432554,0.2135590588,-3.59167508,11.803991613
45055,2010,192,195,107,7,-3,114,NA,NA,NA,NA,NA,NA
45055,2011,725,548,226,25,177,251,11.713669448,8.8539184244,3.6514335108,0.4039196361,2.8597510239,4.0553531469
45055,2012,711,593,41,24,118,65,11.432614306,9.5352184015,0.6592646787,0.3859110314,1.8973959045,1.0451757101
45055,2013,705,697,273,22,8,295,11.293371352,11.16521962,4.3731778426,0.352417262,0.1281517317,4.7255951046
45055,2014,728,595,444,14,133,458,11.579357568,9.4638980126,7.0621356598,0.2226799532,2.1154595558,7.284815613
45055,2015,718,663,390,17,55,407,11.325725012,10.458155547,6.1518562043,0.2681578345,0.8675694647,6.4200140389
45055,2016,784,701,549,13,83,562,12.260057078000001,10.962117362,8.5851675202,0.2032917628,1.2979397162,8.788459283
45055,2017,773,747,730,14,26,744,11.956227524,11.554077569,11.291133367,0.2165422837,0.4021499555,11.507675651
02130,2010,41,14,15,9,27,24,NA,NA,NA,NA,NA,NA
02130,2011,186,103,-24,42,83,18,13.682506988,7.5768721495,-1.765484773,3.0895983522,6.1056348389,1.3241135795
02130,2012,190,109,-82,57,81,-25,13.897015799,7.9724985372,-5.99765945,4.1691047396,5.9245172616,-1.82855471
02130,2013,174,85,-148,40,89,-108,12.709078957,6.2084581112,-10.81002118,2.9216273464,6.5006208458,-7.888393835
02130,2014,176,94,-21,37,82,16,12.817711747,6.8458233195,-1.529386061,2.6946325832,5.9718884276,1.1652465225
02130,2015,163,100,-203,39,63,-164,11.871813547,7.2833211945,-14.78514202,2.8404952658,4.5884923525,-11.94464676
02130,2016,164,57,-99,37,107,-62,11.967745466,4.1595212902,-7.224431715,2.7000401357,7.8082241763,-4.524391579
02130,2017,148,82,28,36,66,64,10.731247508,5.9456911866,2.0302360149,2.6103034478,4.7855563209,4.6405394627
55061,2010,42,55,-1,0,-13,-1,NA,NA,NA,NA,NA,NA
55061,2011,208,166,-47,3,42,-44,10.118700136,8.0755010702,-2.28643705,0.1459427904,2.043199066,-2.14049426
55061,2012,205,160,-102,3,45,-99,9.9861168619,7.7940424288,-4.968702048,0.1461382955,2.1920744331,-4.822563753
55061,2013,191,197,-136,12,-6,-124,9.3457943925,9.6393795567,-6.654597054,0.5871703283,-0.293585164,-6.067426726
55061,2014,207,191,-52,16,16,-36,10.166245119,9.3804483953,-2.553839354,0.7857967242,0.7857967242,-1.768042629
55061,2015,182,188,-26,17,-6,-9,8.9463464989,9.2412809988,-1.2780495,0.8356477499,-0.2949345,-0.44240175
55061,2016,198,166,-3,20,32,17,9.7249508841,8.1532416503,-0.147347741,0.9823182711,1.5717092338,0.8349705305
55061,2017,197,185,31,20,12,51,9.6500036739,9.0621861912,1.5185284969,0.9796958045,0.5878174827,2.4982243014
26083,2010,2,1,11,0,1,11,NA,NA,NA,NA,NA,NA
26083,2011,19,22,12,0,-3,12,8.7416609156,10.121923165,5.5210489993,0,-1.38026225,5.5210489993
26083,2012,17,19,-11,1,-2,-10,7.8268876611,8.7476979742,-5.064456722,0.4604051565,-0.920810313,-4.604051565
26083,2013,13,18,-18,0,-5,-18,6.0366844671,8.3584861853,-8.358486185,0,-2.321801718,-8.358486185
26083,2014,26,30,34,0,-4,34,12.053778396,13.908205841,15.762633287,0,-1.854427446,15.762633287
26083,2015,17,15,-53,0,2,-53,7.9161816065,6.9848661234,-24.6798603,0,0.9313154831,-24.6798603
26083,2016,17,20,20,0,-3,20,7.979347571,9.3874677306,9.3874677306,0,-1.40812016,9.3874677306
26083,2017,19,19,-34,0,0,-34,8.9538171536,8.9538171536,-16.02262017,0,0,-16.02262017
31103,2010,0,2,2,1,-2,3,NA,NA,NA,NA,NA,NA
31103,2011,6,6,-5,0,0,-5,7.2948328267,7.2948328267,-6.079027356,0,0,-6.079027356
31103,2012,5,13,-16,1,-8,-15,6.1804697157,16.069221261,-19.77750309,1.2360939431,-9.888751545,-18.54140915
31103,2013,12,9,-10,0,3,-10,15.103838892,11.327879169,-12.58653241,0,3.7759597231,-12.58653241
31103,2014,4,7,8,0,-3,8,5.0409577820000004,8.8216761185,10.081915564000001,0,-3.780718336,10.081915564000001
31103,2015,10,6,-2,0,4,-2,12.547051443,7.5282308657,-2.509410289,0,5.0188205772,-2.509410289
31103,2016,7,4,-6,0,3,-6,8.7884494664,5.0219711237,-7.532956685,0,3.7664783427,-7.532956685
31103,2017,6,4,-3,0,2,-3,7.556675063,5.0377833753,-3.778337531,0,2.5188916877,-3.778337531
38043,2010,0,0,11,0,0,11,NA,NA,NA,NA,NA,NA
38043,2011,38,23,-20,0,15,-20,15.54192229,9.4069529652,-8.1799591,0,6.1349693252,-8.1799591
38043,2012,21,18,3,0,3,3,8.5872009814,7.3604579841,1.2267429973,0,1.2267429973,1.2267429973
38043,2013,24,19,-6,0,5,-6,9.8099325567,7.7661966074,-2.452483139,0,2.0437359493,-2.452483139
38043,2014,35,15,-18,0,20,-18,14.306151645,6.1312078479,-7.357449418,0,8.1749437973,-7.357449418
38043,2015,30,20,-12,0,10,-12,12.259910094,8.173273396,-4.903964038,0,4.086636698,-4.903964038
38043,2016,21,12,9,0,9,9,8.5557139947,4.8889794255,3.6667345692,0,3.6667345692,3.6667345692
38043,2017,31,12,0,0,19,0,12.537917088,4.8533872599,0,0,7.6845298281,0
31105,2010,9,3,3,4,6,7,NA,NA,NA,NA,NA,NA
31105,2011,44,57,-40,27,-13,-13,11.518324607,14.921465969,-10.47120419,7.0680628272,-3.403141361,-3.403141361
31105,2012,40,63,15,3,-23,18,10.512483574000001,16.557161629,3.9421813403,0.7884362681,-6.044678055,4.7306176084
31105,2013,37,47,-106,8,-10,-98,9.8692984796,12.536676447,-28.27420646,2.133902374,-2.667377967,-26.14030408
31105,2014,44,51,31,7,-7,38,11.859838275,13.746630728,8.3557951482,1.8867924528,-1.886792453,10.242587601
31105,2015,44,39,-22,7,5,-15,11.827956989,10.483870968,-5.913978495,1.8817204301,1.3440860215,-4.032258065
31105,2016,47,43,-42,8,4,-34,12.704419516,11.623192323,-11.35288553,2.1624543857,1.0812271929,-9.190431139
31105,2017,43,39,-78,8,4,-70,11.775982473,10.680542243,-21.36108449,2.1908804601,1.09544023,-19.17020403
48267,2010,12,5,-10,0,7,-10,NA,NA,NA,NA,NA,NA
48267,2011,37,70,24,0,-33,24,8.0469769465,15.224010439,5.2196607221,0,-7.177033493,5.2196607221
48267,2012,43,58,-55,0,-15,-55,9.4298245614,12.719298246,-12.06140351,0,-3.289473684,-12.06140351
48267,2013,44,49,-57,0,-5,-57,9.7886540601,10.901001112,-12.6807564,0,-1.112347052,-12.6807564
48267,2014,42,53,13,0,-11,13,9.4075484377,11.871430171,2.9118602307,0,-2.463881734,2.9118602307
48267,2015,41,53,-62,0,-12,-62,9.2582138422,11.967934967,-14.00022581,0,-2.709721125,-14.00022581
48267,2016,34,38,40,0,-4,40,7.7097505669,8.6167800454,9.0702947846,0,-0.907029478,9.0702947846
48267,2017,35,52,0,0,-17,0,7.9203439692,11.767368183,0,0,-3.847024214,0
51097,2010,21,7,21,0,14,21,NA,NA,NA,NA,NA,NA
51097,2011,62,83,26,3,-21,29,8.8806130488,11.88856263,3.7241280527,0.429707083,-3.007949581,4.1538351357
51097,2012,63,72,32,1,-9,33,9.0032154341,10.289389068,4.5730618078,0.1429081815,-1.286173633,4.7159699893000004
51097,2013,52,74,38,-1,-22,37,7.4100463128,10.545065907,5.415033844,-0.142500891,-3.135019594,5.2725329533
51097,2014,66,73,63,-1,-7,62,9.3570567803,10.349471893,8.9317360176,-0.141773588,-0.992415113,8.78996243
51097,2015,66,79,14,1,-13,15,9.3200593095,11.155828567,1.9769822778,0.1412130198,-1.835769258,2.1181952976
51097,2016,60,54,-22,1,6,-21,8.4811647466,7.633048272,-3.109760407,0.1413527458,0.8481164747,-2.968407661
51097,2017,58,84,-37,1,-26,-36,8.2444918266,11.940298507,-5.2594172,0.1421464108,-3.695806681,-5.117270789
48269,2010,1,0,2,0,1,2,NA,NA,NA,NA,NA,NA
48269,2011,4,0,-35,0,4,-35,14.598540146,0,-127.7372263,0,14.598540146,-127.7372263
48269,2012,3,2,11,0,1,11,11.320754717,7.5471698113,41.509433962,0,3.7735849057,41.509433962
48269,2013,2,2,2,0,0,2,7.3394495413,7.3394495413,7.3394495413,0,0,7.3394495413
48269,2014,1,2,-8,0,-1,-8,3.717472119,7.4349442379,-29.73977695,0,-3.717472119,-29.73977695
48269,2015,2,1,18,1,1,19,7.299270073,3.6496350365,65.693430657,3.6496350365,3.6496350365,69.343065693
48269,2016,1,0,9,1,1,10,3.4602076125,0,31.141868512,3.4602076125,3.4602076125,34.602076125
48269,2017,2,0,-3,1,2,-2,6.7796610169,0,-10.16949153,3.3898305085,6.7796610169,-6.779661017
53033,2010,6302,2831,229,2602,3471,2831,NA,NA,NA,NA,NA,NA
53033,2011,24504,12150,9834,12530,12354,22364,12.535352236,6.2154966399,5.030715552,6.4098907735,6.3198555959,11.440606326
53033,2012,24478,11975,11165,13314,12503,24479,12.295868391,6.015320859,5.6084390305,6.687931684,6.2805475323,12.296370715
53033,2013,25149,12486,10689,14277,12663,24966,12.39986648,6.1562977802,5.270276067,7.0393611571,6.2435687002,12.309637224
53033,2014,25256,12345,5211,16067,12911,21278,12.235580463,5.9806873939,2.5245331721,7.7838561651,6.2548930695,10.308389337
53033,2015,25244,13157,6998,17330,12087,24328,12.023972688,6.2668122588,3.3332182251,8.2544543927,5.7571604296,11.587672618
53033,2016,25853,13322,8172,17499,12531,25671,12.098768783,6.2344717336,3.8243584302,8.1892374168,5.8642970495,12.013595847
53033,2017,25950,13433,2802,17327,12517,20129,11.945833586,6.1837526996,1.289873823,7.9763182481,5.762080886,9.2661920711
51099,2010,69,15,37,26,54,63,NA,NA,NA,NA,NA,NA
51099,2011,336,148,376,3,188,379,14.005835765,6.1692371822,15.673197165,0.125052105,7.8365985827,15.798249271
51099,2012,311,147,129,40,164,169,12.722958599,6.0137457045,5.2773686794,1.636393389,6.7092128948,6.9137620684
51099,2013,306,185,155,18,121,173,12.359641328,7.4723321755,6.2606026335,0.7270377252,4.8873091526,6.9876403587
51099,2014,298,164,212,13,134,225,11.879372546,6.5376412669,8.4510972474,0.5182276614,5.341731279,8.9693249088000009
51099,2015,306,164,-32,22,142,-10,12.080536913,6.4745361232,-1.263324122,0.8685353336,5.6060007896,-0.394788788
51099,2016,322,156,360,-2,166,358,12.550425818,6.0803305205,14.03153197,-0.077952955,6.4700952975,13.953579015
51099,2017,328,166,258,-2,162,256,12.553822601,6.3534589991,9.8746531432,-0.076547699,6.2003636016,9.7981054445
51101,2010,51,19,38,0,32,38,NA,NA,NA,NA,NA,NA
51101,2011,199,131,-52,1,68,-51,12.432449317,8.1841751788,-3.248680224,0.0624746197,4.2482741386,-3.186205604
51101,2012,190,148,-78,-1,42,-79,11.877969492,9.2523130783,-4.876219055,-0.062515629,2.6256564141,-4.938734684
51101,2013,191,149,72,5,42,77,11.910700923,9.2915939137,4.4898977301,0.3117984535,2.6191070092,4.8016961836
51101,2014,173,130,7,7,43,14,10.731011382,8.0637657786,0.4342027727,0.4342027727,2.6672456037,0.8684055454
51101,2015,197,156,84,9,41,93,12.149619168,9.6210182244,5.1805482747,0.5550587437,2.5286009436,5.7356070184
51101,2016,188,144,79,8,44,87,11.500932921,8.8092252164,4.832838834,0.4894014009,2.691707705,5.3222402349
51101,2017,196,131,223,8,65,231,11.835748792,7.9106280193,13.466183575,0.4830917874,3.9251207729,13.949275362
40073,2010,54,42,9,0,12,9,NA,NA,NA,NA,NA,NA
40073,2011,193,154,52,0,39,52,12.786961275,10.203067546,3.4451916388,0,2.5838937291,3.4451916388
40073,2012,176,153,-166,-1,23,-167,11.680382267,10.153968675,-11.01672418,-0.066365808,1.5264135917,-11.08308999
40073,2013,206,139,215,4,67,219,13.605442177,9.1803711776,14.199854699,0.2641833432,4.4250709993,14.464038042
40073,2014,214,163,139,5,51,144,13.913269618,10.59749041,9.0371237241,0.325076393,3.3157792081,9.362200117
40073,2015,225,156,0,10,69,10,14.501627405,10.054461667,0,0.6445167735,4.4471657375,0.6445167735
40073,2016,192,130,-60,10,62,-50,12.33972814,8.3550242617,-3.856165044,0.642694174,3.9847038787,-3.21347087
40073,2017,186,136,43,10,50,53,11.909716664,8.7081799264,2.7533215944,0.6403073475,3.2015367376,3.3936289419
20095,2010,16,12,-7,1,4,-6,NA,NA,NA,NA,NA,NA
20095,2011,86,87,31,4,-1,35,10.92340912,11.050425505,3.9375079385,0.5080655405,-0.127016385,4.445573479
20095,2012,71,98,-34,-5,-27,-39,9.0371030357,12.473747852,-4.327626806,-0.636415707,-3.436644816,-4.964042513
20095,2013,74,109,17,-4,-35,13,9.4726062468,13.952892985,2.1761392729,-0.51203277,-4.480286738,1.6641065028
20095,2014,96,87,-128,-5,9,-133,12.40470345,11.241762502,-16.5396046,-0.646078305,1.1629409484,-17.1856829
20095,2015,92,124,-13,-5,-32,-18,12.021429505,16.202796289,-1.698680256,-0.65333856,-4.181366784,-2.352018816
20095,2016,78,110,-178,-5,-32,-183,10.370961308,14.625714666,-23.66706555,-0.664805212,-4.254753357,-24.33187076
20095,2017,86,102,-33,-5,-16,-38,11.642073914,13.808041153,-4.467307432,-0.676864762,-2.16596724,-5.144172194
06031,2010,570,215,-1117,85,355,-1032,NA,NA,NA,NA,NA,NA
06031,2011,2578,753,-2371,121,1825,-2250,16.936347451,4.9468850391,-15.57644678,0.7949177819,11.989462412,-14.781529
06031,2012,2395,816,-2789,387,1579,-2402,15.793204636,5.380899784,-18.39133517,2.5519708535,10.412304852,-15.83936432
06031,2013,2464,802,-2480,176,1662,-2304,16.321123402,5.3123137047,-16.42710472,1.1657945287,11.008809697,-15.26131019
06031,2014,2301,825,-2523,175,1476,-2348,15.312590463,5.4901725911,-16.789946,1.1645820648,9.822417872,-15.62536393
06031,2015,2359,818,-1199,275,1541,-924,15.708654077,5.4470873399,-7.984178142,1.8312335189,10.261566737,-6.152944623
06031,2016,2234,801,-2317,196,1433,-2121,14.879495403,5.3350384143,-15.43231461,1.3054525958,9.5444569883,-14.12686202
06031,2017,2220,865,-1189,128,1355,-1061,14.805033711,5.7686280002,-7.92936265,0.8536235653,9.0364057113,-7.075739085
36047,2010,10335,3738,-5397,4920,6597,-477,NA,NA,NA,NA,NA,NA
36047,2011,42202,16109,-13032,23025,26093,9993,16.688864705,6.3703360393,-5.153530279,9.1052819731,10.318528666,3.9517516941
36047,2012,41804,15374,-15543,22020,26430,6477,16.310799467,5.9985224142,-6.064461681,8.5916133446,10.312277053,2.5271516636
36047,2013,42478,15987,-21709,21846,26491,137,16.384798604,6.1665750571,-8.373689743,8.4265339775,10.218223547,0.0528442349
36047,2014,41643,15721,-27799,22745,25922,-5054,15.917278922,6.0090661561,-10.62566186,8.693862332,9.9082127663,-1.931799526
36047,2015,41926,15654,-34164,24709,26272,-9455,15.910621818,5.9405827873,-12.96499747,9.3768915352,9.9700390309,-3.588105932
36047,2016,41046,16796,-42132,25198,24250,-16934,15.505425067,6.3448111733,-15.91566947,9.5187277891,9.1606138933,-6.396941677
36047,2017,40752,17398,-50598,25114,23354,-25484,15.379186849,6.5657413819,-19.09491795,9.4776427788,8.8134454669,-9.617275168
46077,2010,11,27,1,1,-16,2,NA,NA,NA,NA,NA,NA
46077,2011,67,74,43,1,-7,44,13.004658385,14.363354037,8.3462732919,0.1940993789,-1.358695652,8.5403726708
46077,2012,59,64,61,2,-5,63,11.343972313,12.305325899,11.728513747,0.3845414343,-0.961353586,12.113055182
46077,2013,63,68,-164,1,-5,-163,12.236573759,13.207730407,-31.85393804,0.1942313295,-0.971156648,-31.65970671
46077,2014,52,75,6,2,-23,8,10.278711208,14.825064242,1.1860051394,0.3953350465,-4.546353034,1.5813401858
46077,2015,73,73,-100,2,0,-98,14.591245253,14.591245253,-19.9880072,0.3997601439,0,-19.58824705
46077,2016,65,60,15,2,5,17,13.09032323,12.083375289,3.0208438224,0.4027791763,1.0069479408,3.4236229987
46077,2017,65,58,-34,2,7,-32,13.092960016,11.682948937,-6.848625239,0.4028603082,1.4100110787,-6.445764931
48271,2010,5,22,7,2,-17,9,NA,NA,NA,NA,NA,NA
48271,2011,29,29,2,17,0,19,8.0577938316,8.0577938316,0.5557099194,4.7235343151,0,5.2792442345
48271,2012,35,28,5,17,7,22,9.6605023461,7.7284018769,1.3800717637,4.6922439967,1.9321004692,6.0723157604
48271,2013,33,37,-31,28,-4,-3,9.0796533223,10.180217361,-8.529371303,7.7039482735,-1.100564039,-0.825423029
48271,2014,29,36,-110,30,-7,-80,8.0791196545,10.029251985,-30.64493662,8.3577099875,-1.95013233,-22.28722663
48271,2015,38,55,29,33,-17,62,10.642767119,15.404005041,8.1221117491,9.2424030248,-4.761237922,17.364514774
48271,2016,36,19,-2,32,17,30,9.9543757777,5.2536983271,-0.553020877,8.8483340246,4.7006774506,8.2953131481
48271,2017,41,29,60,32,12,92,11.103588355,7.8537576168,16.24915369,8.6662153013,3.249830738,24.915368991
08061,2010,3,2,4,0,1,4,NA,NA,NA,NA,NA,NA
08061,2011,19,22,30,0,-3,30,13.403880071,15.520282187,21.164021164,0,-2.116402116,21.164021164
08061,2012,8,21,-8,0,-13,-8,5.6338028169,14.788732394,-5.633802817,0,-9.154929577,-5.633802817
08061,2013,15,18,-15,0,-3,-15,10.71046055,12.85255266,-10.71046055,0,-2.14209211,-10.71046055
08061,2014,18,20,-11,0,-2,-11,12.987012987,14.43001443,-7.936507937,0,-1.443001443,-7.936507937
08061,2015,15,24,13,0,-9,13,10.853835022,17.366136035,9.4066570188,0,-6.512301013,9.4066570188
08061,2016,18,16,-38,0,2,-38,13.17715959,11.713030747,-27.81844802,0,1.4641288433,-27.81844802
08061,2017,17,14,25,0,3,25,12.48164464,10.279001468,18.355359765,0,2.2026431718,18.355359765
20097,2010,6,3,12,0,3,12,NA,NA,NA,NA,NA,NA
20097,2011,38,26,-26,3,12,-23,14.823483519,10.14238346,-10.14238346,1.1702750146,4.6811000585,-8.972108445
20097,2012,29,28,-49,3,1,-46,11.439842209,11.045364892,-19.32938856,1.1834319527,0.3944773176,-18.14595661
20097,2013,39,27,7,2,12,9,15.457788347,10.701545779,2.7744748315,0.7927070947,4.7562425684,3.5671819263
20097,2014,30,34,-6,3,-4,-3,11.850681414,13.430772269,-2.370136283,1.1850681414,-1.580090855,-1.185068141
20097,2015,35,22,21,3,13,24,13.738959764,8.6359175662,8.2433758587,1.1776251227,5.1030421982,9.4210009814
20097,2016,33,17,-80,3,16,-77,13.017751479,6.7061143984,-31.5581854,1.1834319527,6.3116370809,-30.37475345
20097,2017,31,25,-28,3,6,-25,12.427340148,10.022048507,-11.22469433,1.2026458208,2.4052916416,-10.02204851
40075,2010,24,15,-14,2,9,-12,NA,NA,NA,NA,NA,NA
40075,2011,96,141,17,4,-45,21,10.180275716,14.952279958,1.802757158,0.4241781548,-4.772004242,2.2269353128
40075,2012,130,133,-71,4,-3,-67,13.854843867,14.174571033,-7.566876266,0.4263028882,-0.319727166,-7.140573377
40075,2013,119,156,23,2,-37,25,12.737489965,16.697886005,2.4618678084,0.2140754616,-3.96039604,2.67594327
40075,2014,123,128,-55,-2,-5,-57,13.218699624,13.756045137,-5.910800645,-0.214938205,-0.537345513,-6.12573885
40075,2015,117,155,-132,-2,-38,-134,12.734000871,16.869830213,-14.36656508,-0.217675229,-4.135829343,-14.58424031
40075,2016,124,128,-68,-2,-4,-70,13.678230655,14.119463902,-7.500965198,-0.220616623,-0.441233247,-7.721581821
40075,2017,123,112,-145,-2,11,-147,13.726912561,12.499302494,-16.18213269,-0.22320183,1.2276100664,-16.40533452
08063,2010,29,27,-5,-1,2,-6,NA,NA,NA,NA,NA,NA
08063,2011,102,82,-137,2,20,-135,12.423873325,9.987819732,-16.68696711,0.2436053593,2.4360535932,-16.44336175
08063,2012,91,69,-129,10,22,-119,11.22348298,8.5101134682,-15.91021214,1.233349778,2.7133695116,-14.67686236
08063,2013,83,76,156,3,7,159,10.18779919,9.32858721,19.148152694,0.3682337057,0.8592119799,19.5163864
08063,2014,94,79,-255,2,15,-253,11.575641894,9.728464996,-31.40200727,0.2462902531,1.847176898,-31.15571701
08063,2015,115,77,152,2,38,154,14.189647727,9.5008945647,18.755012647,0.2467764822,4.6887531618,19.001789129
08063,2016,88,55,-614,5,33,-609,11.118130133,6.9488313329,-77.57422615,0.6317119394,4.1692987997,-76.94251421
08063,2017,102,76,-507,5,26,-502,13.796834844,10.279994589,-68.57838496,0.6763154335,3.5168402543,-67.90206953
53035,2010,764,505,180,101,259,281,NA,NA,NA,NA,NA,NA
53035,2011,2962,2033,1495,145,929,1640,11.709638907,8.0370344015,5.9101654846,0.5732267527,3.6726045052,6.4833922373
53035,2012,3026,1919,-1609,556,1107,-1053,11.900361022,7.5468581631,-6.327720054,2.1865831885,4.3535028591,-4.141136866
53035,2013,2874,2017,-3070,292,857,-2778,11.343095078,7.9606899001,-12.11666732,1.1524647748,3.3824051782,-10.96420255
53035,2014,2935,2084,-108,248,851,140,11.605033461,8.2401668594,-0.427033599,0.9805956723,3.3648666014,0.5535620731
53035,2015,3041,2200,4513,373,841,4886,11.866020493,8.5844278479,17.609783126,1.4554507215,3.2815926455,19.065233848
53035,2016,3151,2247,2752,275,904,3027,12.066232165,8.6045140192,10.538327806,1.0530669138,3.4617181457,11.59139472
53035,2017,3127,2297,2318,153,830,2471,11.810629567,8.6757326877,8.7550493557,0.5778785813,3.1348968789,9.332927937
53037,2010,100,95,57,18,5,75,NA,NA,NA,NA,NA,NA
53037,2011,424,282,337,68,142,405,10.275798556,6.8343754544,8.1673210218,1.6480054287,3.4414231012,9.8153264505
53037,2012,404,271,-127,68,133,-59,9.7173782321,6.5183403488,-3.054720385,1.6355983163,3.1990378833,-1.419122069
53037,2013,426,288,17,65,138,82,10.211419531,6.9034948943,0.4074979625,1.5580804449,3.3079246368,1.9655784074
53037,2014,366,280,584,74,86,658,8.6722665182,6.6345208336,13.837714881,1.7534090774,2.0377456846,15.591123959
53037,2015,406,269,289,83,137,372,9.4778985211,6.2796913847,6.7465829374,1.937599944,3.1982071364,8.6841828814
53037,2016,410,306,1639,88,104,1727,9.3161703723,6.9530442291,37.241959122,1.999568275,2.3631261432,39.241527397
53037,2017,436,298,1046,86,138,1132,9.5684329496,6.5398922454,22.9554607,1.8873514534,3.0285407042,24.842812154
27069,2010,9,7,0,0,2,0,NA,NA,NA,NA,NA,NA
27069,2011,53,53,-13,0,0,-13,11.657318817,11.657318817,-2.859342351,0,0,-2.859342351
27069,2012,48,77,-12,0,-29,-12,10.622994357,17.041053447,-2.655748589,0,-6.41805909,-2.655748589
27069,2013,43,64,23,0,-21,23,9.5608671484,14.230127849,5.1139521957,0,-4.6692607,5.1139521957
27069,2014,62,80,-29,0,-18,-29,13.85320076,17.875097754,-6.479722936,0,-4.021896995,-6.479722936
27069,2015,45,76,-21,0,-31,-21,10.163749294,17.165443252,-4.743083004,0,-7.001693958,-4.743083004
27069,2016,32,53,-62,0,-21,-62,7.3394495413,12.155963303,-14.22018349,0,-4.816513761,-14.22018349
27069,2017,37,57,-47,0,-20,-47,8.6367880486,13.305322129,-10.97105509,0,-4.66853408,-10.97105509
41035,2010,227,206,-85,0,21,-85,NA,NA,NA,NA,NA,NA
41035,2011,813,696,-126,-6,117,-132,12.262443439,10.497737557,-1.900452489,-0.090497738,1.7647058824,-1.990950226
41035,2012,794,762,-403,12,32,-391,12.011194312,11.527115952,-6.096361849,0.1815293851,0.4840783602,-5.914832464
41035,2013,777,696,-291,22,81,-269,11.803756846,10.573249375,-4.420712023,0.3342119055,1.2305074704,-4.086500118
41035,2014,772,744,-412,19,28,-393,11.77780829,11.350633896,-6.285566082,0.2898683387,0.4271743939,-5.995697744
41035,2015,816,754,325,34,62,359,12.444620675,11.499073516,4.9564972053,0.5185258615,0.9455471592,5.4750230668
41035,2016,829,773,430,21,56,451,12.554899288,11.706799939,6.5121914281,0.3180372558,0.8480993488,6.8302286839
41035,2017,829,787,589,20,42,609,12.445765587,11.815220165,8.8426488913,0.3002597247,0.6305454218,9.142908616
48273,2010,98,86,-67,27,12,-40,NA,NA,NA,NA,NA,NA
48273,2011,470,257,-316,89,213,-227,14.673972432,8.0238530105,-9.865904869,2.7786883966000002,6.6501194212,-7.087216472
48273,2012,493,242,-308,124,251,-184,15.377897002,7.5485823014,-9.607286565,3.8678686172,7.829314701,-5.739417948
48273,2013,503,213,-474,99,290,-375,15.692269296,6.6450365009,-14.78754602,3.088538092,9.0472327947,-11.69900792
48273,2014,483,249,-516,106,234,-410,15.125418846,7.7975761751,-16.15883256,3.3194500986,7.3278426706,-12.83938246
48273,2015,435,254,-765,122,181,-643,13.755375664,8.0318745257,-24.19048824,3.8578294966,5.7235011384,-20.33265874
48273,2016,447,260,-353,114,187,-239,14.248147263,8.2875129492,-11.25189258,3.6337556777,5.9606343135,-7.618136903
48273,2017,441,258,-548,103,183,-445,14.126691759,8.264595179,-17.55425643,3.2994314087,5.8620965804,-14.25482502
53039,2010,68,60,45,2,8,47,NA,NA,NA,NA,NA,NA
53039,2011,224,170,246,3,54,249,10.910862153,8.2805650268,11.982464686,0.1461276181,2.6302971262,12.128592304
53039,2012,209,192,-66,6,17,-60,10.115921686,9.2930955204,-3.194501585,0.290409235,0.8228261659,-2.90409235
53039,2013,194,167,194,7,27,201,9.3484965305,8.0474171164,9.3484965305,0.3373168851,1.301079414,9.6858134156
53039,2014,203,182,-27,12,21,-15,9.7275798452,8.7212784819,-1.293816039,0.5750293505,1.0063013633,-0.718786688
53039,2015,196,185,113,14,11,127,9.3605234252,8.8351879268,5.3966283013,0.6686088161,0.5253354984,6.0652371173
53039,2016,188,163,256,16,25,272,8.8859479132,7.7043059035,12.10001418,0.7562508862,1.1816420097,12.856265066
53039,2017,188,180,479,17,8,496,8.7204582879,8.3493749565,22.218614468,0.7885520792,0.3710833314,23.007166547
21119,2010,52,54,-5,0,-2,-5,NA,NA,NA,NA,NA,NA
21119,2011,182,207,-15,-2,-25,-17,11.156404205,12.68887731,-0.919483863,-0.122597848,-1.532473105,-1.042081711
21119,2012,164,231,-116,-3,-67,-119,10.123769252,14.259699373,-7.1607148370000004,-0.185190901,-4.135930121,-7.345905738
21119,2013,189,212,-11,-2,-23,-13,11.747156442,13.176704581,-0.683696936,-0.124308534,-1.429548138,-0.80800547
21119,2014,206,185,-170,1,21,-169,12.877817022,11.56502985,-10.62732473,0.0625136749,1.3127871722,-10.56481105
21119,2015,162,195,-234,1,-33,-233,10.259658011,12.349588347,-14.81950602,0.0633312223,-2.089930336,-14.75617479
21119,2016,177,170,-155,1,7,-154,11.358167292,10.908974236,-9.946417685,0.0641704367,0.4491930568,-9.882247249
21119,2017,162,192,-191,1,-30,-190,10.519138989,12.467127691,-12.40219473,0.0649329567,-1.947988702,-12.33726178
17095,2010,120,172,29,17,-52,46,NA,NA,NA,NA,NA,NA
17095,2011,520,695,-98,53,-175,-45,9.8502571485,13.165247535,-1.856394616,1.0039685171,-3.314990387,-0.852426099
17095,2012,540,688,-305,50,-148,-255,10.290908744,13.11138003,-5.812457717,0.9528619208,-2.820471286,-4.859595796
17095,2013,556,728,-76,70,-172,-6,10.655934071,13.952374108,-1.456566528,1.3415744334,-3.296440036,-0.114992094
17095,2014,560,637,-196,83,-77,-113,10.772027353,12.253181114,-3.770209574,1.5965683399,-1.481153761,-2.173641234
17095,2015,577,710,-532,87,-133,-445,11.181953838,13.759423267,-10.30987772,1.6860138369,-2.577469429,-8.623863879
17095,2016,536,623,-370,90,-87,-280,10.483287371,12.184865732,-7.236597626,1.7602534765,-1.701578361,-5.476344149
17095,2017,539,579,-357,90,-40,-267,10.612011852,11.399545199,-7.028735123,1.771950031,-0.787533347,-5.256785092
18083,2010,105,119,-38,5,-14,-33,NA,NA,NA,NA,NA,NA
18083,2011,492,484,55,15,8,70,12.803664138,12.595474477,1.4313039179,0.390355614,0.2081896608,1.8216595318
18083,2012,451,439,-526,8,12,-518,11.801648567,11.487635745,-13.76422871,0.2093418815,0.3140128222,-13.55488682
18083,2013,489,417,9,5,72,14,12.866220252,10.971807454,0.2368015997,0.1315564443,1.8944127978,0.368358044
18083,2014,501,454,-139,8,47,-131,13.183516657,11.946739645,-3.657702226,0.210515236,1.2367770117,-3.44718699
18083,2015,437,476,-167,8,-39,-159,11.542982421,12.573134171,-4.411162619,0.2113131793,-1.030151749,-4.199849439
18083,2016,424,430,-219,9,-6,-210,11.261470631,11.420831065,-5.816655821,0.2390406502,-0.159360433,-5.577615171
18083,2017,417,393,-65,9,24,-56,11.112591606,10.473017988,-1.732178548,0.2398401066,0.6395736176,-1.492338441
21121,2010,99,126,-7,1,-27,-6,NA,NA,NA,NA,NA,NA
21121,2011,384,388,41,-1,-4,40,12.052163269,12.177706637,1.2868195157,-0.031385842,-0.125543367,1.2554336739
21121,2012,425,357,-443,-6,68,-449,13.411382319,11.265561148,-13.97939381,-0.189337162,2.1458211711,-14.16873097
21121,2013,452,356,57,-7,96,50,14.315349412,11.274921218,1.80525424,-0.221697889,3.0404281936,1.5835563509
21121,2014,410,383,-151,-5,27,-156,12.981872873,12.126969049,-4.78112879,-0.158315523,0.8549038233,-4.939444313
21121,2015,388,388,-106,-5,0,-111,12.332729411,12.332729411,-3.369250818,-0.158926925,0,-3.528177744
21121,2016,349,450,28,-5,-101,23,11.127407218,14.347659737,0.8927432725,-0.159418442,-3.220252519,0.733324831
21121,2017,360,458,7,-5,-98,2,11.510607344,14.644050455,0.223817365,-0.159869546,-3.13344311,0.0639478186
23013,2010,97,76,-26,2,21,-24,NA,NA,NA,NA,NA,NA
23013,2011,332,443,45,6,-111,51,8.3633523944,11.159533466,1.1335869209,0.1511449228,-2.796181072,1.2847318437
23013,2012,354,392,-27,27,-38,0,8.9298101785,9.8883773728,-0.681087217,0.681087217,-0.958567194,0
23013,2013,362,468,87,36,-106,123,9.1351856058,11.810129457,2.1954727837,0.9084714967,-2.674943851,3.1039442804
23013,2014,360,422,144,36,-62,180,9.0704090503,10.632535053,3.6281636201,0.907040905,-1.562126003,4.5352045251
23013,2015,352,491,36,39,-139,75,8.8641543169,12.364487982,0.906561237,0.9821080067,-3.500333665,1.8886692436999999
23013,2016,303,483,121,41,-180,162,7.6389764276,12.176982226,3.0505483424,1.0336568763,-4.538005799,4.0842052187
23013,2017,314,428,210,41,-114,251,7.9048398263,10.774749827,5.2866763169,1.0321606143,-2.869910001,6.3188369312
29103,2010,10,18,3,0,-8,3,NA,NA,NA,NA,NA,NA
29103,2011,42,55,13,0,-13,13,10.181818182,13.333333333,3.1515151515,0,-3.151515152,3.1515151515
29103,2012,50,52,-33,0,-2,-33,12.174336499,12.661309959,-8.035062089,0,-0.48697346,-8.035062089
29103,2013,58,53,-35,0,5,-35,14.234875445,13.00773101,-8.590011044,0,1.2271444349,-8.590011044
29103,2014,58,58,-70,0,0,-70,14.404569726,14.404569726,-17.38482553,0,0,-17.38482553
29103,2015,51,48,-90,0,3,-90,12.911392405,12.151898734,-22.78481013,0,0.7594936709,-22.78481013
29103,2016,42,32,28,0,10,28,10.69791136,8.1507896077,7.1319409068,0,2.5471217524,7.1319409068
29103,2017,43,44,34,0,-1,34,10.855844484,11.108305983,8.5836909871,0,-0.2524615,8.5836909871
31107,2010,23,44,-4,0,-21,-4,NA,NA,NA,NA,NA,NA
31107,2011,91,120,-76,1,-29,-75,10.550724638,13.913043478,-8.811594203,0.115942029,-3.362318841,-8.695652174
31107,2012,103,107,0,4,-4,4,12.013763341,12.480317257,0,0.4665539161,-0.466553916,0.4665539161
31107,2013,104,117,-8,5,-13,-3,12.143149045,13.661042676,-0.934088388,0.5838052426,-1.517893631,-0.350283146
31107,2014,106,135,-53,2,-29,-51,12.44715829,15.852512917,-6.223579145,0.2348520432,-3.405354627,-5.988727102
31107,2015,95,113,14,2,-18,16,11.210100891,13.334120007,1.6520148681,0.236002124,-2.124019116,1.8880169922
31107,2016,108,104,23,2,4,25,12.725344645,12.254035584,2.7100271003,0.2356545305,0.4713090609,2.9456816307
31107,2017,98,98,-31,2,0,-29,11.547752312,11.547752312,-3.652860425,0.2356684145,0,-3.417192011
39083,2010,190,122,90,3,68,93,NA,NA,NA,NA,NA,NA
39083,2011,677,617,130,-2,60,128,11.065436447,10.08474784,2.1248253148,-0.03268962,0.9806886069,2.0921356946
39083,2012,736,635,-644,1,101,-643,12.064485989,10.408897558,-10.55642524,0.0163919647,1.6555884306,-10.54003328
39083,2013,740,623,-65,0,117,-65,12.178363656,10.252865618,-1.069721132,0,1.9254980375,-1.069721132
39083,2014,694,572,28,5,122,33,11.403595255,9.3989286536,0.4600874166,0.0821584673,2.0046666009,0.5422458839
39083,2015,745,603,-157,6,142,-151,12.228651155,9.8978210021,-2.577044606,0.0984857811,2.3308301531,-2.478558825
39083,2016,757,617,-231,9,140,-222,12.435522555,10.135690114,-3.794723527,0.1478463712,2.2998324408,-3.646877156
39083,2017,741,625,309,9,116,318,12.138288026,10.238097188,5.0617152499,0.1474285995,1.9001908381,5.2091438494
47093,2010,1276,973,333,85,303,418,NA,NA,NA,NA,NA,NA
47093,2011,5085,3921,2026,477,1164,2503,11.69469599,9.0176800345,4.6594796608,1.0970245796,2.6770159552,5.7565042403
47093,2012,5273,4050,2318,509,1223,2827,12.020178764,9.2322632266,5.2840459653,1.160301724,2.7879155373,6.4443476893
47093,2013,5204,4182,1951,527,1022,2478,11.761794284,9.451926152,4.409542784,1.191096385,2.3098681318,5.600639169
47093,2014,5140,4126,2125,620,1014,2745,11.52294557,9.2497419107,4.763863684,1.3899272866,2.2732036591,6.1537909706
47093,2015,5343,4515,1887,694,828,2581,11.883103885,10.041589752,4.1967840224,1.5434913151,1.8415141338,5.7402753375
47093,2016,5351,4281,3018,702,1070,3720,11.793682192,9.4353865566,6.6517161009,1.5472182581,2.3582956355,8.1989343589
47093,2017,5350,4314,3995,703,1036,4698,11.65610355,9.3989590119,8.7039502208,1.5316337935,2.2571445379,10.235584014
48275,2010,10,22,16,0,-12,16,NA,NA,NA,NA,NA,NA
48275,2011,45,51,-1,3,-6,2,12.091898428,13.704151552,-0.268708854,0.8061265619,-1.612253124,0.5374177079
48275,2012,55,53,5,2,2,7,14.76708283,14.230098,1.3424620754,0.5369848302,0.5369848302,1.8794469056
48275,2013,49,57,-2,3,-8,1,13.152596967,15.299959737,-0.536840693,0.8052610388,-2.14736277,0.2684203463
48275,2014,62,57,68,5,5,73,16.482786123,15.153529177,18.077894457,1.3292569454,1.3292569454,19.407151402
48275,2015,54,54,-13,5,0,-8,14.223627025,14.223627025,-3.424206506,1.3170025023,0,-2.107204004
48275,2016,37,47,-50,6,-10,-44,9.824747743,12.480084971,-13.27668614,1.5932023367,-2.655337228,-11.6834838
48275,2017,43,44,-33,6,-1,-27,11.543624161,11.812080537,-8.859060403,1.610738255,-0.268456376,-7.248322148
02150,2010,66,12,-39,30,54,-9,NA,NA,NA,NA,NA,NA
02150,2011,222,63,-48,59,159,11,16.161910309,4.5864880606,-3.494467094,4.2952824694,11.575422248,0.8008153757
02150,2012,220,66,-39,116,154,77,15.785319653,4.7355958958,-2.798306666,8.3231685442,11.049723757,5.5248618785
02150,2013,223,60,-237,94,163,-143,15.853831935,4.265605005,-16.84913977,6.6827811745,11.58822693,-10.1663586
02150,2014,240,61,-437,76,179,-361,17.152658662,4.3596340766,-31.23213265,5.431675243,12.793024585,-25.8004574
02150,2015,223,60,-413,89,163,-324,16.124950287,4.3385516468,-29.86369717,6.4355182761,11.786398641,-23.42817889
02150,2016,207,39,-309,67,168,-242,15.091863517,2.8433945757,-22.52843395,4.8848060659,12.248468941,-17.64362788
02150,2017,208,43,-448,51,165,-397,15.335274818,3.1702731596,-33.02982269,3.7600914218,12.165001659,-29.26973126
27071,2010,29,46,18,1,-17,19,NA,NA,NA,NA,NA,NA
27071,2011,124,163,-50,3,-39,-47,9.3443858327,12.283345893,-3.767897513,0.2260738508,-2.93896006,-3.541823662
27071,2012,105,151,-30,5,-46,-25,7.9590676521,11.44589729,-2.274019329,0.3790032215,-3.486829638,-1.895016108
27071,2013,104,152,-29,5,-48,-24,7.9271313693,11.585807386,-2.210450093,0.3811120851,-3.658676017,-1.829338008
27071,2014,106,156,-199,12,-50,-187,8.1761733966,12.032858961,-15.34960855,0.9256045355,-3.856685564,-14.42400401
27071,2015,102,126,-32,14,-24,-18,7.9529063194,9.8241783946,-2.495029434,1.0915753772,-1.871272075,-1.403454056
27071,2016,101,159,-139,12,-58,-127,7.9458736527,12.508850602,-10.93541027,0.9440641964,-4.562976949,-9.991346078
27071,2017,98,146,-55,12,-48,-43,7.7944802354,11.612184841,-4.374453193,0.9544261513,-3.817704605,-3.420027042
16055,2010,411,249,236,-9,162,227,NA,NA,NA,NA,NA,NA
16055,2011,1735,1235,1558,-54,500,1504,12.404508521,8.8297222034,11.139034164,-0.386076922,3.5747863171,10.752957242
16055,2012,1683,1229,747,1,454,748,11.896010631,8.6869857785,5.2800474992,0.0070683367,3.2090248523,5.2871158359
16055,2013,1712,1244,1404,-58,468,1346,11.97378636,8.7005784066,9.8196238608,-0.405653977,3.2732079536,9.4139698837
16055,2014,1792,1267,2148,-37,525,2111,12.339770626,8.7246034506,14.791198273,-0.25478321,3.6151671757,14.536415063
16055,2015,1803,1336,2400,-34,467,2366,12.183667264,9.0279420212,16.217859918,-0.229753016,3.1557252424,15.988106903
16055,2016,1823,1333,3266,-27,490,3239,12.050582037,8.8115336564,21.589249003,-0.178478176,3.2390483808,21.410770827
16055,2017,1856,1388,4036,-26,468,4010,11.944102117,8.9323349883,25.973273784,-0.167320396,3.0117671286,25.805953388
18085,2010,255,156,-125,9,99,-116,NA,NA,NA,NA,NA,NA
18085,2011,997,650,-349,39,347,-310,12.888630341,8.4028181759,-4.51166699,0.5041690906,4.4858121647,-4.007497899
18085,2012,960,649,42,35,311,77,12.377593976,8.367769261,0.5415197365,0.4512664471,4.0098247152,0.9927861835
18085,2013,1042,760,22,26,282,48,13.37500722,9.7552835771,0.2823897878,0.3337333855,3.6197236431,0.6161231733
18085,2014,1060,694,137,46,366,183,13.531540617,8.8593294228,1.7488877967,0.5872178004,4.6722111942,2.3361055971
18085,2015,1110,707,-259,54,403,-205,14.104282746,8.9835386502,-3.290999307,0.6861542958,5.1207440962,-2.604845012
18085,2016,992,719,-197,59,273,-138,12.579174618,9.1173654745,-2.498082056,0.7481565549,3.461809144,-1.749925501
18085,2017,1019,694,-100,59,325,-41,12.887885514,8.7774215376,-1.264758147,0.7462073065,4.1104639765,-0.51855084
19109,2010,54,53,-22,0,1,-22,NA,NA,NA,NA,NA,NA
19109,2011,163,185,-113,4,-22,-109,10.545042859,11.968300178,-7.310367136,0.2587740579,-1.423257318,-7.051593078
19109,2012,165,174,24,2,-9,26,10.714981492,11.299435028,1.5585427625,0.1298785635,-0.584453536,1.6884213261
19109,2013,151,204,-36,7,-53,-29,9.8275301009,13.276928083,-2.342987309,0.4555808656,-3.449397982,-1.887406443
19109,2014,146,183,-74,10,-37,-64,9.5590401676,11.981536648,-4.844992962,0.6547287786,-2.422496481,-4.190264183
19109,2015,180,212,-46,11,-32,-35,11.85146168,13.958388201,-3.028706874,0.7242559916,-2.106926521,-2.304450882
19109,2016,180,160,-52,12,20,-40,11.886680314,10.565938057,-3.433929869,0.7924453543,1.3207422571,-2.641484514
19109,2017,171,154,-163,12,17,-151,11.350059737,10.221691225,-10.81906279,0.7964954202,1.1283685119,-10.02256737
02158,2010,55,9,-42,0,46,-42,NA,NA,NA,NA,NA,NA
02158,2011,243,64,3,3,179,6,32.153489911,8.4684088654,0.3969566656,0.3969566656,23.685081045,0.7939133311
02158,2012,240,57,-42,0,183,-42,31.090096509,7.3838979208,-5.440766889,0,23.706198588,-5.440766889
02158,2013,226,68,19,3,158,22,28.680203046,8.6294416244,2.4111675127,0.3807106599,20.050761421,2.7918781726
02158,2014,243,52,-61,5,191,-56,30.233281493,6.4696734059,-7.589424572,0.6220839813,23.763608087,-6.967340591
02158,2015,233,54,-91,5,179,-86,28.580190126,6.6237350506,-11.16222018,0.613308801,21.956455075,-10.54891138
02158,2016,226,80,-191,6,146,-185,27.626673186,9.7793533403,-23.3482061,0.7334515005,17.847319846,-22.6147546
02158,2017,233,90,-109,6,143,-103,28.47888529,11.000427794,-13.32274033,0.733361853,17.478457496,-12.58937848
55063,2010,360,236,95,24,124,119,NA,NA,NA,NA,NA,NA
55063,2011,1297,988,-2,52,309,50,11.273947359,8.5880184973,-0.017384653,0.4520009735,2.685928862,0.4346163207
55063,2012,1257,947,947,43,310,990,10.848036868,8.1727055798,8.1727055798,0.3710943399,2.675331288,8.5437999197
55063,2013,1218,1008,70,41,210,111,10.438359686,8.638642499,0.5999057291,0.3513733556,1.7997171873,0.9512790847
55063,2014,1268,944,208,49,324,257,10.826364075,8.0600060621,1.7759335391,0.4183689587,2.7663580128,2.1943024978
55063,2015,1271,992,-51,53,279,2,10.813662139,8.4399314256,-0.433907765,0.4509237556,2.3737307134,0.0170159908
55063,2016,1219,950,-269,55,269,-214,10.357191408,8.0716421968,-2.285549212,0.4673056009,2.2855492115,-1.818243611
55063,2017,1225,976,253,53,249,306,10.3814879,8.2712915842,2.1440950521,0.449158252,2.1101963161,2.5932533041
04012,2010,42,26,-10,0,16,-10,NA,NA,NA,NA,NA,NA
04012,2011,195,197,60,32,-2,92,9.4950577007,9.5924429079,2.9215562156,1.558163315,-0.097385207,4.4797195306
04012,2012,184,214,-86,27,-30,-59,8.9594390612,10.420217169,-4.187563909,1.314700297,-1.460778108,-2.872863612
04012,2013,201,258,12,33,-57,45,9.8118181153,12.594273999,0.585780186,1.6108955115,-2.782455883,2.1966756974
04012,2014,215,246,-50,50,-31,0,10.5080521,12.023166589,-2.443733047,2.4437330466,-1.515114489,0
04012,2015,215,265,-109,57,-50,-52,10.543350333,12.995292271,-5.345233425,2.7952138093,-2.451941938,-2.550019616
04012,2016,204,249,170,58,-45,228,9.9840939679,12.186467637,8.3200783066,2.8386149517,-2.202373669,11.158693258
04012,2017,212,268,78,58,-56,136,10.310281101,13.033751581,3.7934053108,2.8207372824,-2.72347048,6.6141425931
08067,2010,165,85,-74,-1,80,-75,NA,NA,NA,NA,NA,NA
08067,2011,543,249,142,0,294,142,10.532645382,4.8298871087,2.7543934515,0,5.7027582729,2.7543934515
08067,2012,537,334,363,-7,203,356,10.31621009,6.4164137242,6.9735274907,-0.134475737,3.8997963653,6.8390517539
08067,2013,497,315,725,-14,182,711,9.4139485548,5.9665871122,13.732621131,-0.265181649,3.4473614426,13.467439482
08067,2014,553,302,253,-15,251,238,10.337414712,5.6453874194,4.7294139639,-0.280400037,4.6920272923,4.4490139265
08067,2015,580,358,592,-9,222,583,10.711779263,6.6117534075,10.933402283,-0.166217264,4.100025856,10.767185018
08067,2016,550,336,459,-10,214,449,10.021135486,6.1220027695,8.363093069,-0.182202463,3.8991327163,8.1808906056
08067,2017,560,353,175,-9,207,166,10.107847119,6.3715536303,3.1587022246,-0.162447543,3.7362934886,2.9962546816
48283,2010,20,3,9,0,17,9,NA,NA,NA,NA,NA,NA
48283,2011,91,63,43,15,28,58,13.081290879,9.0562783009,6.1812693165,2.1562567383,4.0250125782,8.3375260548
48283,2012,103,53,86,13,50,99,14.558303887,7.4911660777,12.155477032,1.8374558304,7.0671378092,13.992932862
48283,2013,89,53,220,27,36,247,12.199300939,7.2647522445,30.155575355,3.7009115208,4.9345486944,33.856486875
48283,2014,103,59,-36,30,44,-6,13.807895972,7.9093773041,-4.826060728,4.0217172733,5.8985186675,-0.804343455
48283,2015,110,55,78,31,55,109,14.547378166,7.2736890829,10.315413608,4.0997156649,7.2736890829,14.415129273
48283,2016,87,44,-102,35,43,-67,11.400117932,5.7655768853,-13.36565551,4.5862543406,5.634541047,-8.779401166
48283,2017,84,51,-104,35,33,-69,11.050450569,6.7092021312,-13.68151023,4.6043544037,4.3412484378,-9.077155825
20099,2010,66,81,-64,3,-15,-61,NA,NA,NA,NA,NA,NA
20099,2011,254,282,-140,11,-28,-129,11.836525467,13.141339298,-6.524069155,0.5126054336,-1.304813831,-6.011463722
20099,2012,276,271,-226,6,5,-220,12.973277868,12.738254718,-10.62304637,0.2820277797,0.2350231498,-10.34101859
20099,2013,286,275,-302,-3,11,-305,13.603824292,13.080600281,-14.3648774,-0.142697458,0.5232240112,-14.50757486
20099,2014,271,258,-110,-2,13,-112,13.010393912,12.386279075,-5.280971699,-0.096017667,0.6241148371,-5.376989366
20099,2015,267,260,-154,-1,7,-155,12.894501727,12.556443629,-7.437278149,-0.048294014,0.3380580977,-7.485572163
20099,2016,242,238,-305,-1,4,-306,11.815829305,11.620526341,-14.89185098,-0.048825741,0.1953029637,-14.94067672
20099,2017,243,225,-203,-1,18,-204,12.007411983,11.117974058,-10.03088326,-0.049413218,0.8894379246,-10.08029648
27073,2010,23,17,-19,0,6,-19,NA,NA,NA,NA,NA,NA
27073,2011,72,100,-1,1,-28,0,9.9550639475,13.826477705,-0.138264777,0.138264777,-3.871413757,0
27073,2012,65,105,-62,2,-40,-60,9.0661831369,14.64537276,-8.647743915,0.2789594811,-5.579189623,-8.368784434
27073,2013,63,86,-99,3,-23,-96,8.9216172201,12.17871557,-14.0196842,0.4248389152,-3.25709835,-13.59484529
27073,2014,68,91,-86,4,-23,-82,9.7827650698,13.09164149,-12.37232053,0.5754567688,-3.308876421,-11.79686376
27073,2015,61,72,-21,5,-11,-16,8.8604836953,10.458275837,-3.050330452,0.7262691553,-1.597792142,-2.324061297
27073,2016,57,74,-115,5,-17,-110,8.3743480497,10.871960626,-16.89561449,0.7345919342,-2.497612576,-16.16102255
27073,2017,59,92,-30,5,-33,-25,8.7876079833,13.702710754,-4.468275246,0.744712541,-4.91510277,-3.723562705
42069,2010,575,597,55,93,-22,148,NA,NA,NA,NA,NA,NA
42069,2011,2206,2665,-109,423,-459,314,10.286900057,12.427284067,-0.508282913,1.9725107544,-2.14038401,1.4642278413
42069,2012,2212,2713,-177,531,-501,354,10.323568258,12.661772461,-0.826072144,2.4782164309,-2.338204203,1.6521442873
42069,2013,2160,2819,-479,656,-659,177,10.096996611,13.177515484,-2.239102489,3.066495267,-3.080518873,0.8273927778
42069,2014,2204,2668,-1224,722,-464,-502,10.338074745,12.514511533,-5.741290149,3.3866106922,-2.176436788,-2.354679456
42069,2015,2211,2728,-1169,759,-517,-410,10.41718199,12.853040465,-5.507772839,3.5760475487,-2.435858475,-1.93172529
42069,2016,2180,2579,-1287,779,-399,-508,10.315790968,12.203864636,-6.090102282,3.6862390661,-1.888073668,-2.403863216
42069,2017,2157,2557,-483,779,-400,296,10.231646954,12.129031646,-2.291092016,3.6951566884,-1.897384692,1.4040646724
29105,2010,113,58,47,1,55,48,NA,NA,NA,NA,NA,NA
29105,2011,445,359,-121,-3,86,-124,12.480717992,10.068714065,-3.393633431,-0.084139672,2.4120039265,-3.477773103
29105,2012,485,386,-281,-6,99,-287,13.645443547,10.860084968,-7.905916777,-0.168809611,2.7853585797,-8.074726388
29105,2013,423,401,163,-8,22,155,11.902751984,11.283696325,4.5866396533,-0.225111149,0.6190556587,4.3615285047
29105,2014,492,390,-216,-4,102,-220,13.83382539,10.965837199,-6.073386757,-0.112470125,2.8679881906,-6.185856882
29105,2015,474,416,-114,-4,58,-118,13.362087192,11.727063865,-3.21366654,-0.112760229,1.6350233273,-3.326426769
29105,2016,498,393,-116,-4,105,-120,14.054099818,11.090886001,-3.273645741,-0.112884336,2.963213817,-3.386530077
29105,2017,487,386,-81,-4,101,-85,13.743473966,10.893184704,-2.285875547,-0.112882743,2.850289262,-2.39875829
05073,2010,20,10,-6,0,10,-6,NA,NA,NA,NA,NA,NA
05073,2011,74,119,-70,1,-45,-69,9.7496706192,15.678524374,-9.222661397,0.1317523057,-5.928853755,-9.090909091
05073,2012,65,89,-61,-1,-24,-62,8.6776583673,11.881716841,-8.143648622,-0.133502436,-3.204058474,-8.277151058
05073,2013,58,119,-109,6,-61,-103,7.874015748,16.155308173,-14.79771925,0.8145533532,-8.281292425,-13.9831659
05073,2014,81,105,-102,5,-24,-97,11.213400706,14.535889804,-14.12057867,0.6921852288,-3.322489098,-13.42839344
05073,2015,74,105,-121,5,-31,-116,10.437971648,14.810635447,-17.06749418,0.7052683546,-4.372663799,-16.36222583
05073,2016,78,58,-113,4,20,-109,11.187607573,8.3189902467,-16.20768789,0.5737234653,2.8686173264,-15.63396443
05073,2017,71,94,-46,4,-23,-42,10.297316896,13.63306744,-6.671501088,0.5801305294,-3.335750544,-6.091370558
12067,2010,23,22,-71,2,1,-69,NA,NA,NA,NA,NA,NA
12067,2011,80,83,-22,13,-3,-9,9.0857467348,9.4264622374000009,-2.498580352,1.4764338444,-0.340715503,-1.022146508
12067,2012,83,80,-14,3,3,-11,9.4355709657,9.094526232,-1.591542091,0.3410447337,0.3410447337,-1.250497357
12067,2013,80,68,6,7,12,13,9.0847149671,7.722007722,0.6813536225,0.7949125596,1.3627072451,1.4762661821
12067,2014,79,71,12,4,8,16,8.9467723669,8.0407701019,1.3590033975,0.4530011325,0.906002265,1.81200453
12067,2015,64,63,-196,6,1,-190,7.3159579332,7.2016460905,-22.40512117,0.6858710562,0.1143118427,-21.71925011
12067,2016,63,56,-14,7,7,-7,7.2794499971,6.4706222197,-1.617655555,0.8088277775,0.8088277775,-0.808827777
12067,2017,62,70,-204,7,-8,-197,7.2493422976,8.1847413037,-23.85267466,0.8184741304,-0.935399006,-23.03420053
28071,2010,148,59,94,17,89,111,NA,NA,NA,NA,NA,NA
28071,2011,509,336,541,57,173,598,10.61367475,7.006276456,11.280939175,1.1885647559,3.6073982943,12.469503931
28071,2012,578,385,1563,23,193,1586,11.732467269,7.8148787171,31.726377753,0.4668628844,3.9175885517,32.193240637
28071,2013,543,418,1012,31,125,1043,10.692449319,8.2310199179,19.927732433,0.6104344915,2.4614294013,20.538166924
28071,2014,525,365,246,42,160,288,10.173137105,7.0727524634,4.7668413863,0.8138509684,3.1003846415,5.5806923546
28071,2015,572,388,589,45,184,634,10.949254417,7.4271166325,11.274669321,0.8613923929,3.5221377845,12.136061714
28071,2016,579,359,550,53,220,603,10.910838288,6.765096624,10.364354159,0.9987468554,4.1457416638,11.363101015
28071,2017,577,385,643,54,192,697,10.699748732,7.1393470743,11.923636802,1.0013629663,3.5604016578,12.924999768
29107,2010,108,112,19,1,-4,20,NA,NA,NA,NA,NA,NA
29107,2011,372,299,-253,-2,73,-255,11.169661757,8.9777657674,-7.596571034,-0.060051945,2.19189599,-7.656622979
29107,2012,370,343,-178,-1,27,-179,11.164924033,10.350186334,-5.371233724,-0.03017547,0.8147376997,-5.401409194
29107,2013,362,392,-198,0,-30,-198,10.986509659,11.896993885,-6.009195891,0,-0.910484226,-6.009195891
29107,2014,384,366,-221,-2,18,-223,11.730921977,11.181035009,-6.751389992,-0.061098552,0.5498869677,-6.812488544
29107,2015,399,400,-3,0,-1,-3,12.228198409,12.258845523,-0.091941341,0,-0.030647114,-0.091941341
29107,2016,344,400,-29,2,-56,-27,10.55732875,12.275963663,-0.890007366,0.0613798183,-1.718634913,-0.828627547
29107,2017,355,361,105,2,-6,107,10.892410598,11.076507678,3.2216989092,0.0613656935,-0.184097081,3.2830646027
55065,2010,40,22,-46,0,18,-46,NA,NA,NA,NA,NA,NA
55065,2011,208,132,-23,6,76,-17,12.352644238,7.8391780741,-1.365917392,0.3563262761,4.5134661639,-1.009591116
55065,2012,202,128,-135,-2,74,-137,11.997030438,7.6020786934,-8.017817372,-0.11878248,4.3949517446,-8.136599852
55065,2013,210,140,-205,1,70,-204,12.544053521,8.3627023475,-12.24538558,0.0597335882,4.1813511738,-12.18565199
55065,2014,220,135,25,2,85,27,13.150815948,8.0698188774,1.4944109032,0.1195528723,5.080997071,1.6139637755
55065,2015,231,125,-93,3,106,-90,13.756960367,7.4442426228,-5.538516511,0.1786618229,6.3127177441,-5.359854688
55065,2016,214,133,-107,3,81,-104,12.747200381,7.9223254706,-6.373600191,0.1786990708,4.8248749107,-6.19490112
55065,2017,223,143,-119,3,80,-116,13.306680192,8.5329832622,-7.100874183,0.1790136349,4.7736969299,-6.921860548
22055,2010,755,333,65,98,422,163,NA,NA,NA,NA,NA,NA
22055,2011,3085,1640,321,470,1445,791,13.81753685,7.3454652949,1.4377404632,2.1051028589,6.4720715556,3.5428433221
22055,2012,3128,1623,933,390,1505,1323,13.853826189,7.1882224761,4.132231405,1.7272993011,6.6656037133,5.8595307061
22055,2013,3406,1692,2074,397,1714,2471,14.853417354,7.3787381573,9.0446234859,1.731299674,7.4746791971,10.77592316
22055,2014,3491,1651,2088,458,1840,2546,14.942686174,7.0668504362,8.9373614238,1.9603982433,7.8758357375,10.897759667
22055,2015,3485,1755,1580,524,1730,2104,14.658285296,7.3817189942,6.6456501486,2.204000429,7.2765663019,8.8496505776
22055,2016,3517,1830,-146,541,1687,395,14.61121578,7.6026513727,-0.606550328,2.2475597774,7.0085644075,1.6410094493
22055,2017,3444,1892,-1357,542,1552,-815,14.224615937,7.8144521933,-5.604763016,2.2386009983,6.4101637442,-3.366162018
22057,2010,293,156,-63,33,137,-30,NA,NA,NA,NA,NA,NA
22057,2011,1168,794,-262,171,374,-91,12.056898652,8.1962136383,-2.704544047,1.7651795115,3.8606850135,-0.939364535
22057,2012,1230,859,-347,148,371,-199,12.668136033,8.847096628,-3.573856263,1.524296043,3.8210394051,-2.04956022
22057,2013,1210,902,-334,109,308,-225,12.446574877,9.2783558177,-3.435666123,1.1212203815,3.1682190597,-2.314445742
22057,2014,1252,937,221,125,315,346,12.830826779,9.6026235556,2.2648663883,1.281033025,3.2282032231,3.5458994133
22057,2015,1324,883,-108,143,441,35,13.492031142,8.9980842131,-1.100558432,1.4572208862,4.4939469286,0.3566624547
22057,2016,1325,872,-346,147,453,-199,13.453142451,8.85369073,-3.51304701,1.4925373134,4.599451721,-2.020509696
22057,2017,1291,868,-766,151,423,-615,13.103738778,8.8102596895,-7.774952675,1.5326603838,4.2934790883,-6.242292292
18087,2010,196,86,-88,3,110,-85,NA,NA,NA,NA,NA,NA
18087,2011,757,254,-211,7,503,-204,20.290282375,6.8081000308,-5.655547663,0.187624804,13.482182345,-5.467922859
18087,2012,732,263,-301,23,469,-278,19.490893599,7.0028757056,-8.014698051,0.6124187879,12.488017893,-7.402279263
18087,2013,746,247,-76,9,499,-67,19.700530805,6.5228299047,-2.007024586,0.2376739641,13.177700901,-1.769350622
18087,2014,753,265,-132,10,488,-122,19.680100361,6.9259317338,-3.449898071,0.2613559145,12.754168627,-3.188542157
18087,2015,729,266,-279,10,463,-269,18.915167162,6.9018305419,-7.23913805,0.2594673136,12.01333662,-6.979670736
18087,2016,754,258,-8,9,496,1,19.390261151,6.6348638953,-0.205732214,0.2314487405,12.755397256,0.0257165267
18087,2017,753,254,-340,9,499,-331,19.200367178,6.4766178795,-8.6694885,0.2294864603,12.723749299,-8.44000204
02164,2010,10,1,-5,0,9,-5,NA,NA,NA,NA,NA,NA
02164,2011,21,12,-1,1,9,0,12.777608762,7.301490721,-0.60845756,0.6084575601,5.4761180408,0
02164,2012,38,16,-27,2,22,-25,23.065250379,9.7116843703,-16.38846737,1.2139605463,13.353566009,-15.17450683
02164,2013,21,8,-2,4,13,2,12.688821752,4.833836858,-1.208459215,2.416918429,7.8549848943,1.2084592145
02164,2014,39,10,-50,6,29,-44,23.564954683,6.0422960725,-30.21148036,3.6253776435,17.52265861,-26.58610272
02164,2015,31,19,-72,7,12,-65,19.123997532,11.721159778,-44.41702653,4.3183220234,7.4028377545,-40.0987045
02164,2016,37,14,-24,8,23,-16,23.146700031,8.7582108226,-15.0140757,5.0046918987,14.388489209,-10.0093838
02164,2017,36,12,-15,8,24,-7,22.346368715,7.4487895717,-9.310986965,4.9658597145,14.897579143,-4.34512725
06033,2010,162,169,80,3,-7,83,NA,NA,NA,NA,NA,NA
06033,2011,743,801,-397,-12,-58,-409,11.518040538,12.417160795,-6.154323141,-0.186024881,-0.899120257,-6.340348022
06033,2012,729,852,-130,-7,-123,-137,11.3659396,13.283649574,-2.02684794,-0.109137966,-1.917709974,-2.135985906
06033,2013,741,832,-36,-13,-91,-49,11.59080244,13.014234319,-0.563115908,-0.203347411,-1.423431879,-0.766463319
06033,2014,767,828,329,-5,-61,324,11.987371843,12.940735184,5.1419104776,-0.078144536,-0.953363341,5.0637659415
06033,2015,710,860,349,4,-150,353,11.057209378,13.393239529,5.4351634832,0.0622941373,-2.33603015,5.4974576205
06033,2016,728,856,-231,1,-128,-230,11.351941369,13.347887104,-3.602058319,0.0155933261,-1.995945735,-3.586464993
06033,2017,702,798,390,1,-96,391,10.951979781,12.449686418,6.0844332116,0.0156011108,-1.497706637,6.1000343224
08065,2010,26,14,-55,-3,12,-58,NA,NA,NA,NA,NA,NA
08065,2011,103,42,17,-9,61,8,14.108622697,5.7530306143,2.3286076296,-1.232792275,8.3555920827,1.0958153551
08065,2012,71,41,-114,-6,30,-120,9.7380331916,5.6233712797,-15.63571527,-0.822932382,4.1146619119,-16.45864765
08065,2013,77,38,-21,-3,39,-24,10.614833195,5.2384891095,-2.894954508,-0.41356493,5.376344086,-3.308519438
08065,2014,80,43,24,-7,37,17,10.975442448,5.8993003155,3.2926327343,-0.960351214,5.076142132,2.3322815201
08065,2015,85,43,86,-5,42,81,11.516834903,5.8261635391,11.652327078,-0.677460877,5.6906713637,10.974866201
08065,2016,76,27,118,-4,49,114,10.099667774,3.5880398671,15.681063123,-0.531561462,6.511627907,15.149501661
08065,2017,78,28,125,-4,50,121,10.140405616,3.6401456058,16.250650026,-0.520020801,6.5002600104,15.730629225
12069,2010,733,821,628,110,-88,738,NA,NA,NA,NA,NA,NA
12069,2011,3017,3398,2543,630,-381,3173,10.086674523,11.360464047,8.5019599977,2.1062661418,-1.273789524,10.608226139
12069,2012,3001,3250,2950,591,-249,3541,9.9314297817,10.755463776,9.7626517348,1.9558397204,-0.824033994,11.718491455
12069,2013,3099,3658,4112,704,-559,4816,10.127798503,11.954658575,13.438369617,2.3007325415,-1.826860072,15.739102159
12069,2014,3126,3575,7024,878,-449,7902,10.020419088,11.459692335,22.515490619,2.8144363274,-1.439273247,25.329926946
12069,2015,3157,3969,9654,929,-812,10583,9.8428787225,12.374528239,30.099192647,2.8964315278,-2.531649516,32.995624175
12069,2016,3245,4085,9594,972,-840,10566,9.8165262505,12.357630118,29.023036317,2.9404201897,-2.541103868,31.963456506
12069,2017,3302,4192,10440,974,-890,11414,9.6911283033,12.303213158,30.640635823,2.858618706,-2.612084855,33.499254529
17097,2010,2226,1020,-733,409,1206,-324,NA,NA,NA,NA,NA,NA
17097,2011,8150,4028,-8159,1075,4122,-7084,11.594870941,5.7305693437,-11.60767509,1.5293848174,5.8643015975,-10.07829028
17097,2012,8091,4233,-5474,2179,3858,-3295,11.528284977,6.0312977763,-7.799509574,3.1047006507,5.4969872008,-4.694808923
17097,2013,7959,4318,-3141,1742,3641,-1399,11.316786852,6.1397016742,-4.466142417,2.4769245754,5.1770851773,-1.989217842
17097,2014,7736,4364,-5109,1772,3372,-3337,10.980977756,6.1945432944,-7.252044384,2.5152911819,4.7864344612,-4.736753202
17097,2015,7929,4506,-5328,2253,3423,-3075,11.250774209,6.3937430428,-7.560111614,3.1968715214,4.8570311663,-4.363240092
17097,2016,7628,4596,-5019,1962,3032,-3057,10.820779073,6.5197038046,-7.119754873,2.7832155928,4.3010752688,-4.33653928
17097,2017,7588,4579,-6210,1741,3009,-4469,10.774927136,6.5021601684,-8.818173105,2.4722124598,4.2727669681,-6.345960645
18089,2010,1592,1176,-576,3,416,-573,NA,NA,NA,NA,NA,NA
18089,2011,6185,4531,-2792,131,1654,-2661,12.485339567,9.1464953238,-5.636065978,0.2644429237,3.3388442431,-5.371623054
18089,2012,6132,4517,-3348,176,1615,-3172,12.41007904,9.1416058424,-6.775757441,0.3561927448,3.268473198,-6.419564696
18089,2013,6053,4764,-3002,131,1289,-2871,12.288982956,9.6720163231,-6.09475084,0.2659601466,2.6169666332,-5.828790693
18089,2014,6077,4653,-2253,241,1424,-2012,12.365184995,9.4676988283,-4.5842951770000004,0.4903751166,2.8974861662,-4.093920061
18089,2015,5987,4901,-4228,285,1086,-3943,12.224953853,10.007432576,-8.633222798,0.5819461914,2.2175212768,-8.051276606
18089,2016,5823,4853,-2990,298,970,-2692,11.945742573,9.955811215,-6.133912123,0.6113397367,1.9899313576,-5.522572386
18089,2017,5761,4859,-2155,301,902,-1854,11.851080812,9.9955566161,-4.433098273,0.6191937727,1.8555241959,-3.8139045
26085,2010,24,46,-4,0,-22,-4,NA,NA,NA,NA,NA,NA
26085,2011,93,156,6,-1,-63,5,8.0992815153,13.585891574,0.5225342913,-0.087089049,-5.486610059,0.4354452428
26085,2012,97,136,42,0,-39,42,8.4671787709,11.87150838,3.6662011173,0,-3.404329609,3.6662011173
26085,2013,105,162,-12,2,-57,-10,9.1911764706,14.180672269,-1.050420168,0.175070028,-4.989495798,-0.87535014
26085,2014,90,166,65,9,-76,74,7.9016681299,14.574187884,5.7067603161,0.790166813,-6.672519754,6.4969271291
26085,2015,86,157,354,11,-71,365,7.4513711389,13.603084521,30.67192306,0.953082355,-6.151713382,31.625005415
26085,2016,111,147,191,13,-36,204,9.4251507175,12.481956356,16.218052136,1.1038464804,-3.056805638,17.321898616
26085,2017,106,143,175,13,-37,188,8.879953087,11.979559353,14.660299908,1.0890508503,-3.099606266,15.749350758
27075,2010,36,51,8,1,-15,9,NA,NA,NA,NA,NA,NA
27075,2011,112,141,-48,0,-29,-48,10.351679837,13.032025509,-4.436434216,0,-2.680345672,-4.436434216
27075,2012,117,120,12,6,-3,18,10.845886443,11.123986095,1.1123986095,0.5561993048,-0.278099652,1.6685979143
27075,2013,112,155,-47,7,-43,-40,10.417635569,14.41726351,-4.371686355,0.651102223,-3.999627942,-3.720584132
27075,2014,100,141,-80,11,-41,-69,9.3865865678,13.235087061,-7.509269254,1.0325245225,-3.848500493,-6.476744732
27075,2015,104,141,-29,12,-37,-17,9.8377713664,13.337747718,-2.743224708,1.1351274654,-3.499976352,-1.608097243
27075,2016,94,132,-3,13,-38,10,8.9268755935,12.535612536,-0.284900285,1.2345679012,-3.608736942,0.9496676163
27075,2017,101,131,25,13,-30,38,9.6007604563,12.452471483,2.3764258555,1.2357414449,-2.851711027,3.6121673004
30047,2010,80,47,8,1,33,9,NA,NA,NA,NA,NA,NA
30047,2011,354,274,99,6,80,105,12.258891159,9.4885202757,3.4283339682,0.2077778163,2.7703708834,3.6361117845
30047,2012,385,240,-133,35,145,-98,13.279983443,8.2784312373,-4.587630644,1.2072712221,5.0015522059,-3.380359422
30047,2013,389,300,-78,29,89,-49,13.398777232,10.333247223,-2.686644278,0.9988805649,3.0655300095,-1.687763713
30047,2014,350,286,-4,32,64,28,12.029765076,9.8300366049,-0.137483029,1.0998642355,2.199728471,0.9623812061
30047,2015,377,301,169,35,76,204,12.877002425,10.281108037,5.772449363,1.1954776787,2.5958943881,6.9679270417
30047,2016,359,306,211,33,53,244,12.143352445,10.350601248,7.137179292,1.1162413111,1.7927511966,8.2534206031
30047,2017,360,307,474,33,53,507,12.003200854,10.23606295,15.804214457,1.1002934116,1.7671379034,16.904507869
39085,2010,580,543,-96,22,37,-74,NA,NA,NA,NA,NA,NA
39085,2011,2371,2384,-146,119,-13,-27,10.310376692,10.366907648,-0.634886123,0.5174756754,-0.056530956,-0.117410447
39085,2012,2207,2337,-443,151,-130,-292,9.6077872269,10.173719415,-1.928522765,0.6573520033,-0.565932188,-1.271170761
39085,2013,2280,2448,367,235,-168,602,9.9266386573,10.65807519,1.5978405207,1.0231403879,-0.731436533,2.6209809086
39085,2014,2258,2192,-536,274,66,-262,9.8270688308,9.5398294407,-2.332732017,1.1924786801,0.2872393901,-1.140253336
39085,2015,2297,2501,-170,312,-204,142,10.003636498,10.892074394,-0.740364913,1.3587873694,-0.888437895,0.6184224566
39085,2016,2228,2416,-419,313,-188,-106,9.7114250906,10.530881068,-1.826340715,1.3643070257,-0.819455977,-0.462033689
39085,2017,2244,2444,748,314,-200,1062,9.769540714,10.640266268,3.2565135713,1.3670391195,-0.870725554,4.6235526909
41037,2010,16,17,-9,0,-1,-9,NA,NA,NA,NA,NA,NA
41037,2011,66,83,-29,-1,-17,-30,8.4065724112,10.571901669,-3.693796969,-0.127372309,-2.165329257,-3.821169278
41037,2012,68,75,-107,0,-7,-107,8.7504825634,9.6512675331,-13.76914168,0,-0.90078497,-13.76914168
41037,2013,79,82,75,-2,-3,73,10.193548387,10.580645161,9.6774193548,-0.258064516,-0.387096774,9.4193548387
41037,2014,83,89,33,-2,-6,31,10.64443732,11.413914716,4.2321256813,-0.256492466,-0.769477397,3.9756332158
41037,2015,83,98,-32,-2,-15,-34,10.662213373,12.589119404,-4.110732867,-0.256920804,-1.926906031,-4.367653671
41037,2016,80,92,75,-2,-12,73,10.270235574,11.81077091,9.6283458502,-0.256755889,-1.540535336,9.3715899608
41037,2017,85,102,62,-2,-17,60,10.8397628,13.007715361,7.9066505133,-0.255053242,-2.16795256,7.6515972709
46079,2010,40,18,44,9,22,53,NA,NA,NA,NA,NA,NA
46079,2011,116,109,245,23,7,268,10.154950538,9.542151799,21.447955878,2.0134815723,0.6127987394,23.461437451
46079,2012,147,118,118,26,29,144,12.615318601,10.126582278,10.126582278,2.231280841,2.4887363227,12.35786312
46079,2013,121,99,143,-1,22,142,10.233856303,8.3731551571,12.094557449,-0.084577325,1.860701146,12.009980124
46079,2014,140,122,159,2,18,161,11.669097729,10.168785164,13.252760992,0.1667013961,1.5003125651,13.419462388
46079,2015,127,110,229,2,17,231,10.397478407,9.0056899587,18.748209096,0.1637398174,1.3917884482,18.911948913
46079,2016,130,111,245,2,19,247,10.422930447,8.899579074,19.643215073,0.1603527761,1.523351373,19.803567849
46079,2017,131,120,190,2,11,192,10.309278351,9.4436137562,14.952388447,0.1573935626,0.8656645943,15.10978201
47095,2010,17,25,5,0,-8,5,NA,NA,NA,NA,NA,NA
47095,2011,73,110,2,1,-37,3,9.3463926765,14.083605403,0.2560655528,0.1280327764,-4.737212726,0.3840983292
47095,2012,72,86,-59,0,-14,-59,9.2825372268,11.087475021,-7.606523561,0,-1.804937794,-7.606523561
47095,2013,61,76,-5,0,-15,-5,7.9123159738,9.8579674428,-0.64855049,0,-1.945651469,-0.64855049
47095,2014,65,104,7,1,-39,8,8.4591358667,13.534617387,0.9109838626,0.1301405518,-5.07548152,1.0411244144
47095,2015,70,104,-64,2,-34,-62,9.184543725,13.64560782,-8.39729712,0.262415535,-4.461064095,-8.134881585
47095,2016,64,89,-19,1,-25,-18,8.4745762712,11.784957627,-2.515889831,0.1324152542,-3.310381356,-2.383474576
47095,2017,66,97,-33,1,-31,-32,8.8011734898,12.935058008,-4.400586745,0.1333511135,-4.133884518,-4.267235631
27077,2010,3,17,2,0,-14,2,NA,NA,NA,NA,NA,NA
27077,2011,31,46,-13,5,-15,-8,7.7056922695,11.434253045,-3.231419339,1.2428535918,-3.728560776,-1.988565747
27077,2012,34,56,-47,4,-22,-43,8.5459343974,14.075656655,-11.81349755,1.0054040468,-5.529722257,-10.8080935
27077,2013,35,44,-32,4,-9,-28,8.911521324,11.203055379,-8.147676639,1.0184595799,-2.291534055,-7.129217059
27077,2014,35,42,-18,3,-7,-15,8.9789635711,10.774756285,-4.617752694,0.7696254489,-1.795792714,-3.848127245
27077,2015,28,46,-2,3,-18,1,7.2192858064,11.860255253,-0.515663272,0.7734949078,-4.640969447,0.2578316359
27077,2016,45,42,-80,3,3,-77,11.740151318,10.957474563,-20.87138012,0.7826767545,0.7826767545,-20.08870337
27077,2017,37,37,-55,3,0,-52,9.8143236074,9.8143236074,-14.58885942,0.7957559682,0,-13.79310345
01075,2010,33,73,-28,0,-40,-28,NA,NA,NA,NA,NA,NA
01075,2011,140,199,-152,2,-59,-150,9.7286404225,13.828567458,-10.56252389,0.1389805775,-4.099927035,-10.42354331
01075,2012,141,173,-8,1,-32,-7,9.8836394224,12.126734894,-0.560773868,0.0700967335,-2.243095472,-0.490677134
01075,2013,143,198,18,3,-55,21,10.050957652,13.916710596,1.2651555087,0.2108592514,-3.865752943,1.4760147601
01075,2014,142,204,-80,3,-62,-77,10.042432815,14.427157001,-5.657708628,0.2121640736,-4.384724187,-5.445544554
01075,2015,162,186,-118,3,-24,-115,11.571015321,13.285239813,-8.428270419,0.2142780615,-1.714224492,-8.213992357
01075,2016,151,201,65,3,-50,68,10.832137733,14.418938307,4.6628407461,0.2152080344,-3.586800574,4.8780487805
01075,2017,155,189,29,3,-34,32,11.113102707,13.550815558,2.0792256677,0.2150923104,-2.437712852,2.2943179781
13171,2010,46,41,-55,1,5,-54,NA,NA,NA,NA,NA,NA
13171,2011,203,193,-124,5,10,-119,11.146802844,10.597699256,-6.808884496,0.2745517942,0.5491035884,-6.534332702
13171,2012,192,190,-150,10,2,-140,10.611838833,10.501298845,-8.290499088,0.5526999392,0.1105399878,-7.737799149
13171,2013,185,186,-132,23,-1,-109,10.293503964,10.349144526,-7.34455418,1.2797329253,-0.055640562,-6.064821255
13171,2014,185,225,265,33,-40,298,10.248455807,12.464338144,14.68022048,1.8281029277,-2.215882337,16.508323408
13171,2015,219,215,16,34,4,50,12.026028939,11.806375443,0.8786139864,1.8670547212,0.2196534966,2.7456687076
13171,2016,204,205,198,36,-1,234,11.115348989,11.169835994,10.78842696,1.9615321746,-0.054487005,12.749959135
13171,2017,212,220,101,36,-8,137,11.438128895,11.8697564,5.4492972565,1.9423237746,-0.431627505,7.3916210311
28073,2010,170,114,298,0,56,298,NA,NA,NA,NA,NA,NA
28073,2011,773,386,860,-5,387,855,13.638328467,6.8103425461,15.173302046,-0.088216872,6.8279859206,15.085085173
28073,2012,813,401,356,5,412,361,14.091220286,6.9502820844,6.170325242,0.0866618714,7.1409382014,6.2569871134
28073,2013,765,395,639,-7,370,632,13.057058492,6.7418798751,10.906484152,-0.119476352,6.3151786171,10.7870078
28073,2014,763,395,600,-11,368,589,12.806848223,6.6300197222,10.070916034,-0.184633461,6.1768285007,9.8862825731
28073,2015,793,432,421,-11,361,410,13.119690289,7.1471704981,6.9651823604,-0.181988138,5.9725197912,6.7831942227
28073,2016,789,432,59,-13,357,46,12.928385918,7.0786599703,0.9667614311,-0.213015231,5.8497259477,0.7537462005
28073,2017,793,422,-215,-13,371,-228,12.935956413,6.883951584,-3.507226518,-0.212064859,6.0520048286,-3.719291377
48277,2010,151,144,23,2,7,25,NA,NA,NA,NA,NA,NA
48277,2011,649,549,-40,-6,100,-46,13.021799978,11.015359303,-0.80257627,-0.12038644,2.0064406746,-0.92296271
48277,2012,671,588,-267,4,83,-263,13.481069244,11.813515224,-5.36430028,0.0803640491,1.6675540197,-5.283936231
48277,2013,615,646,-565,-3,-31,-568,12.452291525,13.079968009,-11.4399101,-0.060742885,-0.627676483,-11.50065299
48277,2014,727,636,214,2,91,216,14.763519688,12.915541295,4.3457953415,0.0406149097,1.8479783929,4.3864102512
48277,2015,654,648,-36,6,6,-30,13.244228433,13.12272175,-0.729040097,0.1215066829,0.1215066829,-0.607533414
48277,2016,716,557,34,8,159,42,14.474588606,11.260259572,0.6873407997,0.161727247,3.2143290341,0.8490680467
48277,2017,680,625,-40,8,55,-32,13.716314346,12.606906568,-0.80684202,0.1613684041,1.109407778,-0.645473616
48279,2010,49,63,29,2,-14,31,NA,NA,NA,NA,NA,NA
48279,2011,217,161,-9,10,56,1,15.475681073,11.481956925,-0.641848524,0.7131650264,3.9937241478,0.0713165026
48279,2012,204,149,-253,-4,55,-257,14.621559633,10.679472477,-18.13360092,-0.286697248,3.942087156,-18.42029817
48279,2013,183,159,-235,8,24,-227,13.304736632,11.559853139,-17.08531753,0.5816278309,1.7448834927,-16.5036897
48279,2014,192,162,-216,12,30,-204,14.148857775,11.938098747,-15.917465,0.8843036109,2.2107590273,-15.03316139
48279,2015,206,165,-276,16,41,-260,15.40014204,12.335065226,-20.63320001,1.1961275371,3.0650768138,-19.43707248
48279,2016,188,129,-119,16,59,-103,14.192963914,9.7387890684,-8.983844179,1.2079118224,4.4541748452,-7.775932357
48279,2017,186,142,-75,16,44,-59,14.073317444,10.744145576,-5.674724776,1.2106079522,3.3291718685,-4.464116824
50015,2010,88,65,22,-2,23,20,NA,NA,NA,NA,NA,NA
50015,2011,262,201,102,-5,61,97,10.652355106,8.1722266268,4.1471000793,-0.20328922,2.4801284788,3.9438108597
50015,2012,251,176,157,11,75,168,10.122396306,7.0977758958,6.3315387252,0.4436109935,3.0246204101,6.7751497187
50015,2013,271,180,45,5,91,50,10.844988695,7.2033135242,1.8008283811,0.2000920423,3.6416751706,2.0009204234
50015,2014,254,207,-24,14,47,-10,10.129611167,8.2552342971,-0.957128614,0.5583250249,1.8743768694,-0.398803589
50015,2015,275,187,3,15,88,18,10.937220355,7.4373098415,0.1193151311,0.5965756557,3.4999105137,0.7158907869
50015,2016,240,214,43,11,26,54,9.510788801,8.4804533476,1.7040163269,0.4359111534,1.0303354534,2.1399274802
50015,2017,258,193,-12,12,65,0,10.195412065,7.6268004979,-0.474205212,0.4742052123,2.5686115667,0
38045,2010,8,17,-2,0,-9,-2,NA,NA,NA,NA,NA,NA
38045,2011,31,50,-16,0,-19,-16,7.5416615983,12.16397032,-3.892470502,0,-4.622308722,-3.892470502
38045,2012,30,41,0,0,-11,0,7.3385518591,10.029354207,0,0,-2.690802348,0
38045,2013,47,39,9,0,8,9,11.488633586,9.5331214862,2.1999511122,0,1.9555120997,2.1999511122
38045,2014,40,46,1,0,-6,1,9.7644330526,11.22909801,0.2441108263,0,-1.464664958,0.2441108263
38045,2015,56,42,27,0,14,27,13.612056393,10.209042295,6.5629557608,0,3.4030140982,6.5629557608
38045,2016,46,44,-23,0,2,-23,11.154219205,10.669253152,-5.577109602,0,0.4849660524,-5.577109602
38045,2017,44,43,-27,0,1,-27,10.730398732,10.486526033,-6.584562858,0,0.2438726985,-6.584562858
48281,2010,61,27,40,9,34,49,NA,NA,NA,NA,NA,NA
48281,2011,221,193,92,46,28,138,11.136586964,9.7256166696,4.6360452518,2.3180226259,1.410970294,6.9540678777
48281,2012,234,202,51,43,32,94,11.706438541,10.105558057,2.5514032718,2.1511831507,1.6008804843,4.7025864225
48281,2013,230,213,35,39,17,74,11.445063694,10.599124204,1.7416401274,1.9406847134,0.8459394904,3.6823248408
48281,2014,257,224,-89,42,33,-47,12.764794993,11.125735714,-4.420493208,2.0860754464,1.6390592793,-2.334417761
48281,2015,230,174,186,46,56,232,11.345978344,8.5834792689,9.1754433564,2.2691956688,2.7624990751,11.444639025
48281,2016,220,200,173,48,20,221,10.712633604,9.7387578214,8.4240255155,2.3373018771,0.9738757821,10.761327393
48281,2017,220,197,298,49,23,347,10.555608867,9.4520679397,14.29805201,2.3510219749,1.103540927,16.649073985
31109,2010,1034,388,-13,176,646,163,NA,NA,NA,NA,NA,NA
31109,2011,4065,2008,1081,733,2057,1814,14.109071977,6.9694997614,3.7520065946,2.5441450822,7.1395722157,6.2961516769
31109,2012,4018,1919,654,901,2099,1555,13.76711038,6.5751828819,2.2408387727,3.0871494406,7.1919274982,5.3279882133
31109,2013,4136,2029,864,909,2107,1773,13.991999256,6.8640634647,2.9228934615,3.075127496,7.1279357911,5.9980209576
31109,2014,4045,1961,2049,1161,2084,3210,13.474799294,6.532529398,6.8256770712,3.8675505513,6.9422698957,10.693227623
31109,2015,4084,2143,477,1265,1941,1742,13.404403366,7.0337013746,1.5655975528,4.1519515814,6.3707019916,5.7175491342
31109,2016,4031,2106,858,1262,1925,2120,13.065434132,6.826049189,2.7809830029,4.0904435311,6.2393849425,6.8714265341
31109,2017,4036,2062,596,1247,1974,1843,12.917142738,6.5993925486,1.907486886,3.9910002464,6.3177501896,5.8984871325
42071,2010,1718,1021,17,211,697,228,NA,NA,NA,NA,NA,NA
42071,2011,6975,4494,-61,1124,2481,1063,13.360878772,8.6084285595,-0.116847829,2.153064909,4.7524502128,2.0362170803
42071,2012,7088,4543,-579,1176,2545,597,13.492522767,8.6479304358,-1.10216855,2.2386014071,4.8445923309,1.1364328572
42071,2013,7038,4931,-60,1298,2107,1238,13.316695348,9.3300120433,-0.113526815,2.4559634217,3.9866833047,2.3424366071
42071,2014,7224,4683,-376,1505,2541,1129,13.580287528,8.8035003454,-0.706836671,2.8292265684,4.7767871829,2.1223898975
42071,2015,7302,5056,-982,1580,2246,598,13.645027469,9.4479949172,-1.835033823,2.9524984116,4.1970325522,1.1174645887
42071,2016,7171,4977,-1239,1656,2194,417,13.333073031,9.2537588166,-2.303678355,3.0790083585,4.0793142141,0.7753300033
42071,2017,7206,5008,-64,1653,2198,1589,13.319285794,9.2565894052,-0.118295072,3.0553399135,4.0626963883,2.9370448412
45057,2010,203,130,230,3,73,233,NA,NA,NA,NA,NA,NA
45057,2011,927,748,700,-9,179,691,11.975042307,9.6627094341,9.0426425185,-0.116262547,2.3123328726,8.9263799718
45057,2012,880,760,1318,16,120,1334,11.197709559,9.6707491649,16.771114999,0.2035947193,1.5269603945,16.974709718
45057,2013,872,795,1184,51,77,1235,10.901021971,9.938431728,14.80138763,0.6375597712,0.9625902428,15.438947401
45057,2014,957,837,2475,79,120,2554,11.666392378,10.203521861,30.171704427,0.9630564241,1.4628705177,31.134760851
45057,2015,1058,888,2555,88,170,2643,12.472223368,10.468179916,30.11959424,1.0373871989,2.0040434524,31.156981439
45057,2016,1058,911,3349,97,147,3446,12.015217762,10.345806598,38.033047527,1.1015842371,1.6694111635,39.134631764
45057,2017,1086,915,2414,97,171,2511,11.907568323,10.03261972,26.468572682,1.0635673364,1.8749486034,27.532140018
51103,2010,25,68,17,1,-43,18,NA,NA,NA,NA,NA,NA
51103,2011,87,206,28,6,-119,34,7.6861913597,18.199487587,2.4737167594,0.5300821627,-10.51329623,3.0037989222
51103,2012,91,207,-42,9,-116,-33,8.124637293,18.481317798,-3.749832597,0.8035355564,-10.35668051,-2.94629704
51103,2013,65,203,-32,13,-138,-19,5.8847494455,18.378525191,-2.897107419,1.1769498891,-12.49377575,-1.72015753
51103,2014,74,173,-6,15,-99,9,6.7765567766,15.842490842,-0.549450549,1.3736263736,-9.065934066,0.8241758242
51103,2015,98,192,41,17,-94,58,9.0280976509,17.68770152,3.7770612621,1.5660985721,-8.659603869,5.3431598342
51103,2016,94,201,34,17,-107,51,8.6980660683,18.599056167,3.1461090034,1.5730545017,-9.900990099,4.7191635051
51103,2017,100,204,97,17,-104,114,9.2738569971,18.918668274,8.9956412872,1.5765556895,-9.644811277,10.572196977
32015,2010,17,2,3,1,15,4,NA,NA,NA,NA,NA,NA
32015,2011,85,36,-3,7,49,4,14.60230201,6.1845043807,-0.515375365,1.2025425185,8.4177976293,0.6871671534
32015,2012,85,34,26,8,51,34,14.432464556,5.7729858222,4.414636217,1.3583496052,8.6594787333,5.7729858222
32015,2013,88,43,89,11,45,100,14.65567491,7.1612956949,14.822216671,1.8319593638,7.4943792156,16.654176035
32015,2014,94,48,-155,18,46,-137,15.578389128,7.9549221081,-25.68776931,2.9830957905,7.6234670202,-22.70467352
32015,2015,89,44,-147,19,45,-128,14.957983193,7.3949579832,-24.70588235,3.1932773109,7.5630252101,-21.51260504
32015,2016,108,34,-238,19,74,-219,18.502655474,5.8249100565,-40.7743704,3.2550967963,12.677745417,-37.5192736
32015,2017,95,31,-154,19,64,-135,16.582300576,5.4110665038,-26.88078199,3.3164601152,11.171234072,-23.56432187
20101,2010,3,8,-8,0,-5,-8,NA,NA,NA,NA,NA,NA
20101,2011,22,28,14,0,-6,14,12.643678161,16.091954023,8.0459770115,0,-3.448275862,8.0459770115
20101,2012,21,26,-56,0,-5,-56,12.255617158,15.173621243,-32.68164575,0,-2.918004085,-32.68164575
20101,2013,21,22,17,0,-1,17,12.422360248,13.013901213,10.056196392,0,-0.591540964,10.056196392
20101,2014,23,22,-34,0,1,-34,13.674197384,13.079667063,-20.21403092,0,0.594530321,-20.21403092
20101,2015,18,28,-25,0,-10,-25,10.922330097,16.990291262,-15.16990291,0,-6.067961165,-15.16990291
20101,2016,13,24,-20,0,-11,-20,8.0495356037,14.860681115,-12.38390093,0,-6.811145511,-12.38390093
20101,2017,14,18,-35,0,-4,-35,8.8635644191,11.396011396,-22.15891105,0,-2.532446977,-22.15891105
41039,2010,947,726,-122,111,221,-11,NA,NA,NA,NA,NA,NA
41039,2011,3468,3123,659,577,345,1236,9.8341270865,8.8558185961,1.8687110006,1.6361855043,0.9783084904,3.5048965049
41039,2012,3477,3407,531,519,70,1050,9.8233520034,9.625585354,1.5002012982,1.466298444,0.1977666495,2.9664997422
41039,2013,3451,3309,88,380,142,468,9.7276072651,9.3273406086,0.2480525759,1.0711361231,0.4002666565,1.319188699
41039,2014,3641,3383,1718,582,258,2300,10.218844942,9.4947411259,4.8217455673,1.6334434925,0.7241038163,6.4551890599
41039,2015,3709,3523,3286,665,186,3951,10.313019179,9.7958389234,9.1368511786,1.84905844,0.5171802554,10.985909619
41039,2016,3555,3554,5894,660,1,6554,9.7396726593,9.7369329483,16.147856724,1.8082092701,0.002739711,17.956065994
41039,2017,3685,3481,5583,657,204,6240,9.9188324579,9.3697301997,15.027636801,1.7684322727,0.5491022582,16.796069074
55067,2010,58,63,-9,2,-5,-7,NA,NA,NA,NA,NA,NA
55067,2011,194,217,-159,13,-23,-146,9.7590422053,10.916042054,-7.998390261,0.6539564364,-1.156999849,-7.344433825
55067,2012,211,226,-163,7,-15,-156,10.704682665,11.465679062,-8.269494191,0.3551316524,-0.760996398,-7.914362539
55067,2013,180,249,-149,6,-69,-143,9.2210752798,12.755820804,-7.633001204,0.307369176,-3.534745524,-7.325632028
55067,2014,201,237,-140,14,-36,-126,10.396193235,12.258197993,-7.241129616,0.7241129616,-1.862004758,-6.517016655
55067,2015,174,267,-134,14,-93,-120,9.0882975112,13.945835836,-6.999033715,0.7312423285,-4.857538325,-6.267791387
55067,2016,198,221,55,16,-23,71,10.387157696,11.593746721,2.8853215822,0.8393662785,-1.206589025,3.7246878607
55067,2017,193,230,96,16,-37,112,10.092558699,12.027401558,5.0201328243,0.8366888041,-1.934842859,5.8568216284
13173,2010,28,34,30,2,-6,32,NA,NA,NA,NA,NA,NA
13173,2011,132,75,302,7,57,309,12.831729367,7.2907553223,29.357441431,0.6804704967,5.5409740449,30.037911928
13173,2012,127,78,-92,32,49,-60,12.129894938,7.4498567335,-8.787010506,3.0563514804,4.6800382044,-5.730659026
13173,2013,132,94,-105,13,38,-92,12.646706587,9.005988024,-10.05988024,1.245508982,3.6407185629,-8.814371257
13173,2014,140,79,-112,9,61,-103,13.47254968,7.6023673194,-10.77803974,0.8660924794,5.8701823606,-9.911947265
13173,2015,148,99,-159,16,49,-143,14.335528865,9.5893064704,-15.40100736,1.5497869043,4.7462223944,-13.85122046
13173,2016,145,61,87,6,84,93,13.988712556,5.8849066615,8.3932275336,0.5788432782,8.1038058946,8.9720708118
13173,2017,127,100,-57,2,27,-55,12.165333589,9.5790028258,-5.460031611,0.1915800565,2.586330763,-5.268451554
26087,2010,230,185,-179,6,45,-173,NA,NA,NA,NA,NA,NA
26087,2011,806,780,-208,40,26,-168,9.1466182478,8.8515660463,-2.360417612,0.4539264639,0.2950522015,-1.906491148
26087,2012,837,725,-70,42,112,-28,9.5013763941,8.2299855266,-0.794619292,0.4767715753,1.2713908676,-0.317847717
26087,2013,817,776,6,39,41,45,9.2657174126,8.8007303699,0.0680468843,0.442304748,0.4649870427,0.5103516323
26087,2014,800,788,-132,52,12,-80,9.0724548929,8.9363680695,-1.496955057,0.589709568,0.1360868234,-0.907245489
26087,2015,857,851,154,58,6,212,9.7114883394,9.6434965891,1.7451215919,0.6572535866,0.0679917503,2.4023751785
26087,2016,769,861,-172,56,-92,-116,8.7143253764,9.7568714552,-1.949107887,0.6345932654,-1.042546079,-1.314514621
26087,2017,768,866,82,55,-98,137,8.7116807986,9.8233275671,0.9301534186,0.6238833905,-1.111646769,1.5540368091
18091,2010,334,226,-120,4,108,-116,NA,NA,NA,NA,NA,NA
18091,2011,1325,1139,-325,1,186,-324,11.895837355,10.22593113,-2.917846898,0.0089779905,1.6699062249,-2.908868908
18091,2012,1301,1156,-162,8,145,-154,11.689180994,10.386389876,-1.455532145,0.0718781306,1.3027911177,-1.383654015
18091,2013,1325,1157,-22,-4,168,-26,11.899202529,10.390473454,-0.197571665,-0.035922121,1.5087290754,-0.233493785
18091,2014,1340,1128,121,-7,212,114,12.0108815,10.110652487,1.0845646728,-0.062743411,1.9002290134,1.0218212619
18091,2015,1318,1261,-953,0,57,-953,11.84495511,11.332692256,-8.564675432,0,0.5122628538,-8.564675432
18091,2016,1327,1181,-761,-2,146,-763,12.007256835,10.68618713,-6.885849624,-0.018096845,1.3210697045,-6.90394647
18091,2017,1314,1184,-305,-2,130,-307,11.932599881,10.75205347,-2.769743504,-0.018162252,1.1805464114,-2.787905756
56021,2010,358,234,168,36,124,204,NA,NA,NA,NA,NA,NA
56021,2011,1292,771,-122,-17,521,-139,13.982230014,8.3438849388,-1.320303453,-0.183976711,5.6383450754,-1.504280164
56021,2012,1222,719,1380,189,503,1569,13.049212189,7.6778916232,14.736426203,2.0182496756,5.3713205653,16.754675879
56021,2013,1252,748,427,98,504,525,13.148843437,7.8556987949,4.4844697666,1.0292225694,5.2931446425,5.513692336
56021,2014,1229,723,-161,65,506,-96,12.811825659,7.5369812462,-1.678359586,0.6775985906,5.2748444129,-1.000760995
56021,2015,1312,848,322,108,464,430,13.586843958,8.7817406073,3.3345760325,1.1184292283,4.8051033511,4.4530052608
56021,2016,1336,811,393,45,525,438,13.704461643,8.3191005934,4.0313274146,0.4616023757,5.38536105,4.4929297903
56021,2017,1317,845,-104,-3,472,-107,13.418579179,8.6094908174,-1.059629639,-0.03056624,4.8090883619,-1.090195879
08069,2010,843,489,399,44,354,443,NA,NA,NA,NA,NA,NA
08069,2011,3317,1868,2791,319,1449,3110,10.957066928,6.1705761296,9.2195278254,1.0537547031,4.7864907986,10.273282528
08069,2012,3407,1870,3523,365,1537,3888,11.069810965,6.075886852,11.446710898,1.1859351342,4.9939241131,12.632646032
08069,2013,3375,1988,3495,398,1387,3893,10.776206137,6.3475845334,11.159360133,1.2707940867,4.4286216035,12.430154219
08069,2014,3495,1980,5728,433,1515,6161,10.929867466,6.1920279204,17.913098954,1.3541151967,4.7378395452,19.26721415
08069,2015,3446,2253,7357,485,1193,7842,10.497888084,6.8635350709,22.412351317,1.4775031111,3.6343530136,23.889854428
08069,2016,3472,2223,3931,499,1249,4430,10.343014518,6.6222699521,11.710365804,1.4865104391,3.720744566,13.196876243
08069,2017,3488,2202,3649,489,1286,4138,10.221140589000001,6.4526810714,10.692930622,1.432952336,3.7684595176,12.125882958
21123,2010,31,50,6,1,-19,7,NA,NA,NA,NA,NA,NA
21123,2011,136,179,54,-2,-43,52,9.5882684715,12.619853356,3.807106599,-0.141003948,-3.031584884,3.6661026509
21123,2012,151,134,-145,-1,17,-146,10.690265487,9.4867256637,-10.26548673,-0.07079646,1.203539823,-10.33628319
21123,2013,164,175,-17,0,-11,-17,11.675921971,12.459063078,-1.210308985,0,-0.783141108,-1.210308985
21123,2014,162,170,98,-2,-8,96,11.509769094,12.078152753,6.9626998224,-0.142095915,-0.568383659,6.8206039076
21123,2015,149,167,25,-1,-18,24,10.552034276,11.826776672,1.7704755497,-0.070819022,-1.274742396,1.6996565277
21123,2016,145,148,-86,-1,-3,-87,10.300124312,10.513230332,-6.109039247,-0.07103534,-0.21310602,-6.180074587
21123,2017,149,159,184,-1,-10,183,10.553155323,11.261420781,13.032084425,-0.070826546,-0.708265458,12.961257879
08071,2010,29,44,-89,3,-15,-86,NA,NA,NA,NA,NA,NA
08071,2011,148,196,-344,9,-48,-335,9.7227696755,12.876100381,-22.59887006,0.5912495073,-3.153330706,-22.00762055
08071,2012,148,162,-52,3,-14,-49,9.8653512865,10.798560192,-3.466204506,0.1999733369,-0.933208905,-3.266231169
08071,2013,146,183,-575,8,-37,-567,9.9488926746,12.470187394,-39.18228279,0.5451448041,-2.521294719,-38.63713799
08071,2014,120,163,-324,13,-43,-311,8.4477296727,11.474832805,-22.80887012,0.9151707145,-3.027103133,-21.8936994
08071,2015,126,178,29,16,-52,45,8.9833166976,12.690717239,2.0675887637,1.1407386283,-3.707400542,3.208327392
08071,2016,137,157,70,16,-20,86,9.7481144158,11.171196812,4.9807883876,1.1384659172,-1.423082396,6.1192543048
08071,2017,138,164,160,17,-26,177,9.7440423654,11.579876434000001,11.297440424,1.200353045,-1.835834069,12.497793469
17099,2010,291,273,-124,11,18,-113,NA,NA,NA,NA,NA,NA
17099,2011,1238,1300,-291,53,-62,-238,10.892182352,11.43767129,-2.560278727,0.4663050603,-0.545488938,-2.093973667
17099,2012,1167,1314,-500,52,-147,-448,10.308640885,11.607158631,-4.416727029,0.459339611,-1.298517746,-3.957387418
17099,2013,1121,1299,-342,47,-178,-295,9.9498071726,11.529705189,-3.035534392,0.4171640831,-1.579898017,-2.618370309
17099,2014,1229,1287,-749,63,-58,-686,10.96802406,11.485636261,-6.684336876,0.5622339429,-0.517612201,-6.122102933
17099,2015,1234,1355,-549,68,-121,-481,11.0792381,12.165613959,-4.929093774,0.6105252762,-1.086375859,-4.318568498
17099,2016,1262,1280,-618,67,-18,-551,11.390714131,11.553180735,-5.578020074,0.6047368041,-0.162466604,-4.97328327
17099,2017,1255,1216,-545,66,39,-479,11.379401017,11.025778197,-4.941652235,0.5984386192,0.3536228205,-4.343213615
22059,2010,43,58,32,0,-15,32,NA,NA,NA,NA,NA,NA
22059,2011,171,160,10,3,11,13,11.462278379,10.724938834,0.6703086771,0.2010926031,0.7373395449,0.8714012803
22059,2012,152,160,-73,7,-8,-66,10.206822455,10.744023637,-4.901960784,0.4700510341,-0.537201182,-4.43190975
22059,2013,182,192,-51,20,-10,-31,12.26993865,12.944111104,-3.438279512,1.3483449066,-0.674172453,-2.089934605
22059,2014,185,166,23,19,19,42,12.465467287,11.185230106,1.5497607978,1.2802371808,1.2802371808,2.8299979786
22059,2015,172,141,64,21,31,85,11.522744021,9.4459703892,4.2875326589,1.4068466537,2.0767736317,5.6943793127
22059,2016,197,160,9,21,37,30,13.117592223,10.653882008,0.599280863,1.3983220136,2.4637102144,1.9976028765
22059,2017,184,180,-144,21,4,-123,12.272803068,12.006003002,-9.604802401,1.4007003502,0.2668000667,-8.204102051
06035,2010,85,92,-58,3,-7,-55,NA,NA,NA,NA,NA,NA
06035,2011,299,199,-737,34,100,-703,8.6572566051,5.7618530583,-21.33912414,0.9844372059,2.8954035469,-20.35468693
06035,2012,306,270,-689,21,36,-668,9.0164417467,7.9556838942,-20.30172668,0.618775414,1.0607578526,-19.68295126
06035,2013,283,225,-1615,9,58,-1606,8.6061398574,6.8423373424,-49.11277692,0.2736934937,1.7638025149,-48.83908343
06035,2014,319,194,-570,18,125,-552,9.9920126545,6.0766471942,-17.8540665,0.5638126263,3.9153654602,-17.29025387
06035,2015,291,136,-512,24,155,-488,9.222139473,4.3100033276,-16.22589488,0.7605888225,4.9121361454,-15.46530606
06035,2016,301,193,-586,26,108,-560,9.6571859409,6.1921491249,-18.80103309,0.8341755298,3.465036816,-17.96685756
06035,2017,312,226,106,27,86,133,10.047176647,7.277762571,3.4134638608,0.8694672098,2.7694140757,4.2829310706
16057,2010,104,83,-7,2,21,-5,NA,NA,NA,NA,NA,NA
16057,2011,482,217,223,63,265,286,12.843401103,5.7821951025,5.9420714647,1.6787018039,7.0612060007,7.6207732687
16057,2012,431,217,-23,80,214,57,11.360341601,5.7197079522,-0.606236327,2.108648093,5.6406336488,1.5024117663
16057,2013,455,231,-228,128,224,-100,11.931609587,6.0575864058,-5.978916453,3.3565846751,5.8740231814,-2.622331777
16057,2014,431,250,-3,136,181,133,11.238738445,6.5189898173,-0.078227878,3.5463304606,4.7197486278,3.4681025828
16057,2015,465,206,-245,144,259,-101,12.052252346,5.3392773832,-6.350111451,3.7323104038,6.7129749624,-2.617801047
16057,2016,443,212,-246,144,231,-102,11.439195383,5.4742876325,-6.352239423,3.7183840523,5.9649077505,-2.63385537
16057,2017,453,225,168,144,228,312,11.5968,5.76,4.3008,3.6864,5.8368,7.9872
40077,2010,31,13,-19,0,18,-19,NA,NA,NA,NA,NA,NA
40077,2011,143,119,-7,-2,24,-9,12.814194184,10.663560195,-0.627268247,-0.179219499,2.150633989,-0.806487746
40077,2012,115,122,-177,1,-7,-176,10.382340992,11.014309574,-15.97977701,0.090281226,-0.631968582,-15.88949578
40077,2013,100,112,-209,5,-12,-204,9.1911764706,10.294117647,-19.20955882,0.4595588235,-1.102941176,-18.75
40077,2014,116,138,4,4,-22,8,10.77466097,12.818131154,0.3715400334,0.3715400334,-2.043470184,0.7430800669
40077,2015,129,149,-144,4,-20,-140,12.079782751,13.952617286,-13.48440865,0.374566907,-1.872834535,-13.10984175
40077,2016,138,129,-51,4,9,-47,13.042861869,12.192240442,-4.820188082,0.3780539672,0.8506214262,-4.442134115
40077,2017,134,100,-189,4,34,-185,12.778334049,9.5360701855,-18.02317265,0.3814428074,3.2422638631,-17.64172984
01077,2010,239,228,15,16,11,31,NA,NA,NA,NA,NA,NA
01077,2011,950,1097,-21,47,-147,26,10.251540429,11.837831422,-0.226612999,0.5071814738,-1.586290993,0.2805684749
01077,2012,892,1023,158,32,-131,190,9.6299695015,11.044236323,1.7057569296,0.3454697579,-1.414266821,2.0512266875
01077,2013,944,1125,221,5,-181,226,10.186683932,12.139851084,2.3848063019,0.0539548937,-1.953167152,2.4387611956
01077,2014,936,1085,444,8,-149,452,10.082349963,11.687339434,4.7826531876,0.0861739313,-1.604989471,4.8688271189
01077,2015,953,1094,-428,15,-141,-413,10.280197406,11.801191985,-4.616919716,0.161807934,-1.520994579,-4.455111782
01077,2016,930,1149,104,14,-219,118,10.068149463,12.439036272,1.1259005851,0.1515635403,-2.370886809,1.2774641255
01077,2017,925,1128,412,14,-203,426,10.007735709,12.204027978,4.4574995808,0.1514684324,-2.196292269,4.6089680131
28075,2010,256,177,46,39,79,85,NA,NA,NA,NA,NA,NA
28075,2011,1040,864,5,34,176,39,12.915404103,10.729720332,0.062093289,0.4222343649,2.1856837713,0.4843276539
28075,2012,1044,824,-708,110,220,-598,12.978698276,10.243723544,-8.801645958,1.3674873663,2.7349747326,-7.434158591
28075,2013,1058,911,-187,33,147,-154,13.184704248,11.352802996,-2.330377783,0.4112431382,1.8319012518,-1.919134645
28075,2014,1040,887,-1220,19,153,-1201,13.044923455,11.125814524,-15.30269867,0.238320717,1.9191089314,-15.06437795
28075,2015,1052,899,-1146,44,153,-1102,13.359748044,11.416742863,-14.55348979,0.5587727319,1.9430051813,-13.99471706
28075,2016,965,846,-1178,12,119,-1166,12.411336116,10.88081902,-15.1508331,0.1543378584,1.5305170961,-14.99649524
28075,2017,964,837,-1197,-4,127,-1201,12.569841508,10.913856164,-15.60798785,-0.052157019,1.6559853439,-15.66014487
47097,2010,56,93,-70,2,-37,-68,NA,NA,NA,NA,NA,NA
47097,2011,330,252,-132,20,78,-112,11.913142362,9.0973087128,-4.765256945,0.722008628,2.8158336492,-4.043248317
47097,2012,296,269,-65,22,27,-43,10.69615336,9.7204907222,-2.348817461,0.7949843713,0.9756626375,-1.553833089
47097,2013,307,286,-148,23,21,-125,11.117750376,10.357252793,-5.35969725,0.8329259239,0.7604975827,-4.526771326
47097,2014,286,282,-225,18,4,-207,10.414770038,10.269108918,-8.193437967,0.6554750373,0.1456611194,-7.537962929
47097,2015,289,275,-460,19,14,-441,10.644567219,10.128913444,-16.94290976,0.6998158379,0.5156537753,-16.24309392
47097,2016,321,314,-1622,20,7,-1602,12.277682157,12.00994454,-62.03863071,0.7649646204,0.2677376171,-61.27366609
47097,2017,307,289,-114,21,18,-93,12.12863464,11.417509482,-4.503792668,0.8296460177,0.711125158,-3.67414665
21125,2010,150,116,100,7,34,107,NA,NA,NA,NA,NA,NA
21125,2011,733,567,160,13,166,173,12.390233183,9.5842595019,2.7045529458,0.2197449269,2.8059736813,2.9242978727
21125,2012,755,618,28,-1,137,27,12.709688823,10.403427407,0.4713526981,-0.016834025,2.3062614156,0.4545186731
21125,2013,763,513,-102,8,250,-94,12.811794239,8.6139586429,-1.712716923,0.1343307391,4.197835596,-1.578386184
21125,2014,688,567,96,4,121,100,11.517632189,9.4920021093,1.6071114682,0.0669629778,2.0256300798,1.6740744461
21125,2015,762,603,-128,7,159,-121,12.730766018,10.074346337,-2.138501378,0.1169492941,2.6564196809,-2.021552084
21125,2016,709,619,25,6,90,31,11.83046888,10.328716836,0.4171533456,0.1001168029,1.5017520441,0.5172701485
21125,2017,713,665,134,6,48,140,11.867114943,11.068206784,2.2302852768,0.0998635199,0.7989081588,2.3301487966
13175,2010,176,160,-62,1,16,-61,NA,NA,NA,NA,NA,NA
13175,2011,628,508,-683,7,120,-676,13.051791504,10.557818605,-14.19486242,0.1454817524,2.4939728988,-14.04938066
13175,2012,698,549,-244,11,149,-233,14.602052237,11.484995241,-5.104442329,0.2301183017,3.1170569961,-4.874324027
13175,2013,659,555,-189,2,104,-187,13.811170491,11.631562402,-3.961018548,0.0419155402,2.1796080897,-3.919103007
13175,2014,626,545,-136,16,81,-120,13.137184949,11.437325555,-2.854084909,0.3357746952,1.6998593943,-2.518310214
13175,2015,630,522,-325,17,108,-308,13.254507585,10.982306284,-6.837642802,0.3576613158,2.2722013002,-6.479981486
13175,2016,630,565,-322,19,65,-303,13.316001395,11.942128235,-6.805956269,0.4015936929,1.3738731598,-6.404362576
13175,2017,634,560,47,19,74,66,13.41486638,11.849093333,0.9944774761,0.4020228095,1.5657730475,1.3965002856
45059,2010,204,153,-60,4,51,-56,NA,NA,NA,NA,NA,NA
45059,2011,813,732,-148,26,81,-122,12.224736672,11.006773978,-2.225413318,0.3909509883,1.2179626943,-1.83446233
45059,2012,781,778,-234,17,3,-217,11.766921541,11.721722099,-3.525556518,0.2561301744,0.0451994425,-3.269426344
45059,2013,738,870,57,17,-132,74,11.142734197,13.135743566,0.8606176819,0.256675449,-1.993009369,1.1172931309
45059,2014,746,783,306,24,-37,330,11.244592497,11.802300167,4.6123931688,0.361756327,-0.557707671,4.9741494958
45059,2015,730,836,38,25,-106,63,10.983967921,12.578900249,0.5717681931,0.376163285,-1.594932328,0.9479314781
45059,2016,783,839,168,26,-56,194,11.773993459,12.616067065,2.5262208188,0.3909627458,-0.842073606,2.9171835645
45059,2017,775,836,313,27,-61,340,11.617535733,12.531948223,4.6919853994,0.4047399546,-0.91441249,5.096725354
48285,2010,45,51,-3,2,-6,-1,NA,NA,NA,NA,NA,NA
48285,2011,201,191,40,6,10,46,10.425851963,9.9071528606,2.0747964106,0.3112194616,0.5186991027,2.3860158722
48285,2012,224,251,245,-1,-27,244,11.537768163,12.92848129,12.619433928,-0.051507894,-1.390713127,12.567926035
48285,2013,236,246,109,7,-10,116,12.054962456,12.56576595,5.5677580835,0.3575624457,-0.510803494,5.9253205292
48285,2014,215,284,209,9,-69,218,10.911213175,14.412951356,10.606714202,0.4567484585,-3.501738182,11.063462661
48285,2015,235,269,162,10,-34,172,11.840282151,13.55334425,8.1622370576,0.5038417937,-1.713062099,8.6660788512
48285,2016,231,242,-5,11,-11,6,11.60046201,12.152864963,-0.251092251,0.5524029528,-0.552402953,0.3013107016
48285,2017,227,238,153,11,-11,164,11.357950565,11.908335835,7.6553587511,0.5503852697,-0.55038527,8.2057440208
01079,2010,78,60,-10,0,18,-10,NA,NA,NA,NA,NA,NA
01079,2011,345,421,-222,0,-76,-222,10.089194327,12.311741483,-6.492177219,0,-2.222547156,-6.492177219
01079,2012,375,388,-233,1,-13,-232,11.053469316,11.436656252,-6.867888935,0.0294759182,-0.383186936,-6.838413017
01079,2013,373,391,-209,-2,-18,-211,11.07153458,11.60581775,-6.203621253,-0.059364797,-0.53428317,-6.262986049
01079,2014,355,411,-64,-3,-56,-67,10.593378392,12.264446533,-1.909792161,-0.089521508,-1.671068141,-1.999313668
01079,2015,370,412,-267,-3,-42,-270,11.113614177,12.37515957,-8.019824285,-0.090110385,-1.261545393,-8.10993467
01079,2016,364,386,121,-3,-22,118,10.96897648,11.631936597,3.6462806431,-0.090403652,-0.662960117,3.5558769908
01079,2017,366,403,-144,-3,-37,-147,11.043888897,12.160347611,-4.345136615,-0.090523679,-1.116458714,-4.435660295
05075,2010,50,37,84,0,13,84,NA,NA,NA,NA,NA,NA
05075,2011,167,233,-179,1,-66,-178,9.5996321099,13.393498692,-10.28942603,0.057482827,-3.793866582,-10.23194321
05075,2012,190,247,-185,1,-57,-184,11.074519861,14.39687582,-10.78308513,0.0582869466,-3.322355958,-10.72479818
05075,2013,188,223,48,1,-35,49,11.030598175,13.084166984,2.8163229384,0.0586733945,-2.053568809,2.8749963329
05075,2014,199,261,-18,4,-62,-14,11.699000588,15.343915344,-1.058201058,0.2351557907,-3.644914756,-0.823045267
05075,2015,194,222,-249,5,-28,-244,11.523611524,13.186813187,-14.79061479,0.297000297,-1.663201663,-14.49361449
05075,2016,175,240,0,5,-65,5,10.498215303,14.397552416,0,0.2999490087,-3.899337113,0.2999490087
05075,2017,177,262,-33,5,-85,-28,10.674225063,15.800265348,-1.990109758,0.3015317814,-5.126040285,-1.688577976
17101,2010,51,33,18,0,18,18,NA,NA,NA,NA,NA,NA
17101,2011,157,216,21,-2,-59,19,9.2795082452,12.766711981,1.2412081092,-0.118210296,-3.487203735,1.1229978131
17101,2012,166,221,-120,-1,-55,-121,9.8747806431,13.146545314,-7.138395646,-0.05948663,-3.271764671,-7.197882276
17101,2013,171,182,15,-1,-11,14,10.224826597,10.88256398,0.8969146137,-0.059794308,-0.657737383,0.8371203061
17101,2014,179,179,-170,-1,0,-171,10.756888315,10.756888315,-10.21603918,-0.060094348,0,-10.27613353
17101,2015,193,217,-36,0,-24,-36,11.678920456,13.131221446,-2.178451484,0,-1.452300989,-2.178451484
17101,2016,152,221,-83,1,-69,-82,9.2575674523,13.460015835,-5.055119069,0.060905049,-4.202448383,-4.99421402
17101,2017,160,225,-112,1,-65,-111,9.8428224293,13.841469041,-6.889975701,0.0615176402,-3.998646612,-6.82845806
18093,2010,116,147,4,6,-31,10,NA,NA,NA,NA,NA,NA
18093,2011,479,501,28,29,-22,57,10.386850551,10.863908405,0.6071645416,0.6288489895,-0.477057854,1.2360135311
18093,2012,472,553,41,20,-81,61,10.235170387,11.991629712,0.889072004,0.4336936605,-1.756459325,1.3227656645
18093,2013,495,549,-178,16,-54,-162,10.762858354,11.936988357,-3.870280378,0.347890371,-1.174130002,-3.522390007
18093,2014,453,568,-132,17,-115,-115,9.8986102613,12.411502491,-2.884363255,0.3714710253,-2.51289223,-2.51289223
18093,2015,509,565,-27,19,-56,-8,11.159466363,12.387226905,-0.591955976,0.4165616128,-1.227760543,-0.175394363
18093,2016,490,543,36,18,-53,54,10.7512726,11.91416535,0.7898894155,0.3949447077,-1.162892751,1.1848341232
18093,2017,489,535,123,18,-46,141,10.718865422,11.727184051,2.6961563332,0.3945594634,-1.008318629,3.0907157966
21127,2010,56,64,15,0,-8,15,NA,NA,NA,NA,NA,NA
21127,2011,202,194,71,-1,8,70,12.701606565,12.198572641,4.4644260697,-0.06287924,0.5030339234,4.4015468293
21127,2012,219,206,-61,4,13,-57,13.757145549,12.940511339,-3.831898989,0.2512720648,0.8166342107,-3.580626924
21127,2013,180,194,10,13,-14,23,11.321110727,12.201641561,0.6289505959,0.8176357747,-0.880530834,1.4465863706
21127,2014,222,187,-63,15,35,-48,13.965777554,11.763965778,-3.963261198,0.9436336185,2.2018117765,-3.019627579
21127,2015,213,227,-27,15,-14,-12,13.416900255,14.298762244,-1.700733835,0.9448521306,-0.881861989,-0.755881705
21127,2016,190,199,-20,14,-9,-6,11.98435726,12.552037341,-1.261511291,0.8830579034,-0.567680081,-0.378453387
21127,2017,177,206,-111,14,-29,-97,11.214953271,13.052431491,-7.033106289,0.8870584508,-1.83747822,-6.146047838
28077,2010,43,19,-50,0,24,-50,NA,NA,NA,NA,NA,NA
28077,2011,173,139,-220,-1,34,-221,13.499804916,10.846664066,-17.16738197,-0.078033554,2.6531408506,-17.24541553
28077,2012,162,152,-66,-1,10,-67,12.7609295,11.973217802,-5.198897204,-0.07877117,0.7877116975,-5.277668373
28077,2013,134,162,-62,0,-28,-62,10.617225259,12.835749941,-4.912447508,0,-2.218524681,-4.912447508
28077,2014,176,135,-15,0,41,-15,13.981014418000001,10.724073559,-1.191563729,0,3.2569408587,-1.191563729
28077,2015,156,144,59,0,12,59,12.34519052,11.39556048,4.6690143632,0,0.94963004,4.6690143632
28077,2016,165,138,105,0,27,105,12.953876349,10.834151129,8.2433758587,0,2.1197252208,8.2433758587
28077,2017,166,149,-177,0,17,-177,13.047237287,11.711074432,-13.91181325,0,1.3361628547,-13.91181325
29109,2010,124,109,-69,1,15,-68,NA,NA,NA,NA,NA,NA
29109,2011,481,426,-149,1,55,-148,12.482159076,11.054885169,-3.866614766,0.0259504347,1.4272739068,-3.840664331
29109,2012,491,428,-174,-5,63,-179,12.776975422,11.13756717,-4.527889457,-0.130111766,1.6394082517,-4.658001223
29109,2013,510,432,-344,-11,78,-355,13.339436343,11.299287256,-8.997580592,-0.287713333,2.0401490878,-9.285293925
29109,2014,462,460,-188,-1,2,-189,12.157254881,12.104626072,-4.947108047,-0.026314405,0.052628809,-4.973422451
29109,2015,482,466,74,1,16,75,12.700754931,12.279153107,1.9499084334,0.026350114,0.4216018234,1.9762585473
29109,2016,520,439,151,1,81,152,13.645249747,11.519739691,3.9623705997,0.0262408649,2.1255100568,3.9886114646
29109,2017,506,442,147,0,64,147,13.201492343,11.53173837,3.8352161549,0,1.6697539722,3.8352161549
39087,2010,162,139,-36,-4,23,-40,NA,NA,NA,NA,NA,NA
39087,2011,734,694,-19,-26,40,-45,11.759805178,11.118943861,-0.304409126,-0.416559856,0.6408613176,-0.720968982
39087,2012,739,702,-270,-36,37,-306,11.866910749,11.272762309,-4.335677811,-0.578090375,0.5941484408,-4.913768186
39087,2013,681,765,-175,-28,-84,-203,10.985111222,12.340102915,-2.82289936,-0.451663898,-1.354991693,-3.274563257
39087,2014,723,753,-255,-18,-30,-273,11.71941484,12.205697613,-4.133403574,-0.291769664,-0.486282773,-4.425173238
39087,2015,686,795,-490,-18,-109,-508,11.203749826,12.983937481,-8.002678447,-0.293975943,-1.780187655,-8.29665439
39087,2016,674,769,-78,-19,-95,-97,11.080969996,12.642827785,-1.282367448,-0.312371558,-1.561857789,-1.594739005
39087,2017,661,728,-392,-19,-67,-411,10.927606672,12.035246078,-6.480517119,-0.314106697,-1.107639406,-6.794623816
42073,2010,211,270,-107,7,-59,-100,NA,NA,NA,NA,NA,NA
42073,2011,860,1100,-293,14,-240,-279,9.4803970743,12.126089281,-3.229949236,0.1543320454,-2.645692207,-3.07561719
42073,2012,934,1068,-481,21,-134,-460,10.359820755,11.846133369,-5.33519677,0.2329295887,-1.486312614,-5.102267181
42073,2013,909,1147,-296,15,-238,-281,10.145259128,12.801553597,-3.303626735,0.167413517,-2.656294469,-3.136213218
42073,2014,913,1056,-408,24,-143,-384,10.250479965,11.855976827,-4.58071832,0.2694540188,-1.605496862,-4.311264301
42073,2015,952,1196,-254,24,-244,-230,10.74989555,13.50512088,-2.868144401,0.2710057702,-2.75522533,-2.597138631
42073,2016,952,1126,-536,25,-174,-511,10.821379044,12.799236138,-6.09270921,0.2841748698,-1.977857094,-5.80853434
42073,2017,929,1086,-427,25,-157,-402,10.635374928,12.432741843,-4.88838008,0.2862049227,-1.797366915,-4.602175157
46081,2010,75,31,70,-2,44,68,NA,NA,NA,NA,NA,NA
46081,2011,242,208,96,-6,34,90,9.9723904891,8.5713108336,3.9559896155,-0.247249351,1.4010796555,3.7087402646
46081,2012,217,228,72,3,-11,75,8.9074974858,9.3590296164,2.9554830368,0.1231451265,-0.451532131,3.0786281633
46081,2013,231,242,550,6,-11,556,9.3630302171,9.8088887988,22.292929088,0.2431955901,-0.445858582,22.536124678
46081,2014,249,229,-241,-3,20,-244,10.023751057,9.2186304899,-9.70170283,-0.120768085,0.8051205668,-9.822470915
46081,2015,216,235,89,-3,-19,86,8.7221627733,9.4893900543,3.5938541057,-0.12114115,-0.767227281,3.472712956
46081,2016,241,222,371,-4,19,367,9.6440505012,8.8837311671,14.846235419,-0.160067228,0.7603193341,14.686168191
46081,2017,231,214,234,-4,17,230,9.1282699755,8.4564925314,9.2468189362,-0.158065281,0.6717774441,9.0887536553
47099,2010,141,142,110,3,-1,113,NA,NA,NA,NA,NA,NA
47099,2011,563,480,9,9,83,18,13.399816734,11.424355297,0.2142066618,0.2142066618,1.9754614369,0.4284133237
47099,2012,569,502,-69,14,67,-55,13.525559504,11.93291893,-1.640182084,0.3327905678,1.5926405743,-1.307391516
47099,2013,550,481,-229,11,69,-218,13.096173536,11.453199038,-5.452770436,0.2619234707,1.6429744982,-5.190846965
47099,2014,577,543,247,12,34,259,13.716703712,12.908440408,5.8717951766,0.2852694013,0.8082633037,6.1570645779
47099,2015,571,543,199,15,28,214,13.489410458,12.827933238,4.701213102,0.3543627966,0.6614772204,5.0555758986
47099,2016,568,526,473,16,42,489,13.297747811,12.314463642,11.073652667,0.3745844454,0.9832841691,11.448237112
47099,2017,567,492,327,16,75,343,13.128798842,11.392185239,7.5716353111,0.3704775687,1.7366136035,7.9421128799
40079,2010,116,86,80,6,30,86,NA,NA,NA,NA,NA,NA
40079,2011,450,489,-133,24,-39,-109,8.9249412441,9.698436152,-2.637815968,0.4759968664,-0.773494908,-2.161819101
40079,2012,549,598,-287,45,-49,-242,10.936363908,11.912469248,-5.717188418,0.8964232711,-0.97610534,-4.820765147
40079,2013,704,631,-156,57,73,-99,14.068745004,12.60991207,-3.117505995,1.139088729,1.4588329337,-1.978417266
40079,2014,659,584,-239,79,75,-160,13.185010304,11.684440087,-4.78181709,1.5806006282,1.5005702167,-3.201216462
40079,2015,632,617,-268,84,15,-184,12.677652628,12.376758974,-5.375966621,1.6850044633,0.3008936542,-3.690962158
40079,2016,575,674,88,88,-99,176,11.545257409,13.533049554,1.7669263513,1.7669263513,-1.987792145,3.5338527026
40079,2017,579,667,-111,89,-88,-22,11.629658642,13.39720607,-2.229520051,1.7876331937,-1.767547428,-0.441886857
27079,2010,102,31,-40,1,71,-39,NA,NA,NA,NA,NA,NA
27079,2011,320,193,-87,7,127,-80,11.528831085,6.9533262479,-3.134400951,0.25219318,4.5755048367,-2.882207771
27079,2012,315,198,-246,3,117,-243,11.363841339,7.1429859846,-8.874618951,0.1082270604,4.2208553545,-8.76639189
27079,2013,299,237,-19,1,62,-18,10.801828002,8.5619840682,-0.686403786,0.0361265151,2.2398439335,-0.650277271
27079,2014,297,212,18,4,85,22,10.701545779,7.6388138219,0.6485785321,0.1441285627,3.0627319569,0.7927070947
27079,2015,318,239,-171,6,79,-165,11.455125088,8.6093550188,-6.159831415,0.2161344356,2.845770069,-5.94369698
27079,2016,312,228,-93,6,84,-87,11.257238729000001,8.2264436867,-3.355523083,0.2164853602,3.0307950425,-3.139037723
27079,2017,310,218,299,6,92,305,11.106135244,7.8101209136,10.712046574,0.2149574563,3.2960143305,10.92700403
35025,2010,246,194,-205,10,52,-195,NA,NA,NA,NA,NA,NA
35025,2011,1056,516,-173,30,540,-143,16.298308433,7.9639461662,-2.670082726,0.4630201259,8.3343622669,-2.2070626
35025,2012,1128,514,527,21,614,548,17.202202126,7.8385921035,8.0368444329,0.320253763,9.3636100224,8.3570981959
35025,2013,1160,514,1309,40,646,1349,17.271028594,7.6528523253,19.489462439,0.5955527101,9.6181762687,20.085015149
35025,2014,1162,544,861,91,618,952,16.849126368,7.8880591604,12.484593634,1.3195098963,8.961067208,13.804103531
35025,2015,1186,542,454,128,644,582,16.853533416,7.7020363502,6.4515212232,1.8189310938,9.1514970656,8.270452317
35025,2016,1155,516,-1915,139,639,-1776,16.402172755,7.3277239323,-27.19494444,1.9739411368,9.0744488231,-25.2210033
35025,2017,1102,490,-1848,139,612,-1709,15.90084338,7.0702479637,-26.66493518,2.0056417693,8.8305954159,-24.65929341
28079,2010,64,88,-40,-3,-24,-43,NA,NA,NA,NA,NA,NA
28079,2011,328,249,-563,-8,79,-571,13.959525887,10.597323006,-23.96101547,-0.340476241,3.3622028813,-24.30149171
28079,2012,295,231,-115,-7,64,-122,12.702103382,9.9463928179,-4.95166742,-0.301405843,2.7557105643,-5.253073263
28079,2013,296,233,9,-3,63,6,12.742692324,10.030565242,0.3874467261,-0.129148909,2.7121270825,0.2582978174
28079,2014,309,262,-124,-2,47,-126,13.305774448,11.281918787,-5.339534083,-0.086121517,2.0238556603,-5.4256556
28079,2015,319,221,-501,0,98,-501,13.881032157,9.6166398329,-21.8006179,0,4.2643923241,-21.8006179
28079,2016,290,257,-74,-1,33,-75,12.742491816,11.292484127,-3.251532394,-0.043939627,1.4500076894,-3.295472021
28079,2017,293,263,-50,-1,30,-51,12.892721992,11.572648068,-2.200123207,-0.044002464,1.3200739241,-2.244125671
20103,2010,230,117,154,37,113,191,NA,NA,NA,NA,NA,NA
20103,2011,945,585,146,26,360,172,12.306129625,7.6180802438,1.9012644711,0.3385813442,4.6880493808,2.2398458153
20103,2012,981,543,-97,243,438,146,12.684333361,7.0209918606,-1.254210332,3.1419908326,5.6633415008,1.8877805003
20103,2013,934,580,-38,125,354,87,11.998741031,7.4510383279,-0.488171477,1.6058272258,4.5477027036,1.1176557492
20103,2014,964,544,-61,107,420,46,12.313745026,6.9488353675,-0.77918926,1.3667746035,5.3649096588,0.5875853436
20103,2015,1008,594,-76,163,414,87,12.797887333,7.5416121783,-0.964920077,2.0694996382,5.2562751546,1.1045795615
20103,2016,1025,591,598,75,434,673,12.882953653,7.4281225452,7.5161036921,0.9426551453,5.4548311076,8.4587588374
20103,2017,1019,595,528,28,424,556,12.641895664,7.3816760747,6.5504621301,0.3473729917,5.2602195894,6.8978351219
42075,2010,365,381,36,51,-16,87,NA,NA,NA,NA,NA,NA
42075,2011,1704,1419,160,385,285,545,12.713287026,10.586945006,1.193735871,2.8724269396,2.1263420202,4.0661628107
42075,2012,1617,1394,303,527,223,830,11.981949271,10.32952213,2.2452261158,3.9050632442,1.6524271413,6.15028936
42075,2013,1668,1413,-548,550,255,2,12.301429267,10.42081508,-4.041476762,4.0562266767,1.8806141865,0.0147499152
42075,2014,1611,1362,-76,636,249,560,11.835580208,10.00624472,-0.558351394,4.6725195607,1.8293354884,4.1141681666
42075,2015,1611,1395,175,662,216,837,11.756978654,10.180623974,1.2771392082,4.8312351761,1.5763546798,6.1083743842
42075,2016,1585,1498,255,678,87,933,11.481472091,10.851258797,1.847176898,4.9113173993,0.6302132946,6.7584942973
42075,2017,1583,1484,426,678,99,1104,11.375763085000001,10.664328755,3.0613234834,4.8722472342,0.7114343307,7.9335707177
01081,2010,412,238,216,113,174,329,NA,NA,NA,NA,NA,NA
01081,2011,1631,804,1975,469,827,2444,11.448707195,5.6436300334,13.863394672,3.2921175195,5.8050771612,17.155512191
01081,2012,1662,880,2768,586,782,3354,11.366628482,6.0184314463,18.930702549,4.0077282131,5.3481970352,22.938430762
01081,2013,1830,1042,1804,504,788,2308,12.20964562,6.9521588722,12.036175245,3.3626564986,5.2574867479,15.398831744
01081,2014,1831,1118,1492,536,713,2028,11.980788861,7.3154134059,9.762608946,3.5072107205,4.6653754548,13.269819667
01081,2015,1912,1087,1112,590,825,1702,12.297757524,6.9914552454,7.1522522841,3.7948101148,5.3063022791,10.947062399
01081,2016,1956,1023,735,572,933,1307,12.390608223,6.4803641166,4.6559800838,3.6234293986,5.9102441064,8.2794094824
01081,2017,1947,1048,1166,550,899,1716,12.146468821,6.5380068437,7.2741564692,3.4312058817,5.6084619776,10.705362351
05077,2010,20,11,-48,2,9,-46,NA,NA,NA,NA,NA,NA
05077,2011,105,112,-96,0,-7,-96,10.152775092,10.829626765,-9.282537227,0,-0.676851673,-9.282537227
05077,2012,112,142,-79,2,-30,-77,10.93856822,13.86854185,-7.715597226,0.1953315753,-2.92997363,-7.520265651
05077,2013,97,145,-127,1,-48,-126,9.6044358632,14.357146393,-12.57487994,0.0990148027,-4.75271053,-12.47586514
05077,2014,107,122,-155,1,-15,-154,10.777598711,12.288477035,-15.61240935,0.1007252216,-1.510878324,-15.51168413
05077,2015,106,123,-150,2,-17,-148,10.858986836,12.600522461,-15.36649081,0.2048865441,-1.741535625,-15.16160426
05077,2016,103,98,-326,2,5,-324,10.819896003,10.294658333,-34.24549609,0.210095068,0.52523767,-34.03540102
05077,2017,94,108,-173,2,-14,-171,10.14242555,11.652999568,-18.66637894,0.2157962883,-1.510574018,-18.45058265
12071,2010,1535,1467,1083,566,68,1649,NA,NA,NA,NA,NA,NA
12071,2011,6268,6072,7746,2556,196,10302,10.016427708,9.7032145893,12.378310311,4.084554758,0.3132131192,16.462865069
12071,2012,6399,6055,10441,2504,344,12945,10.032477382,9.4931474526,16.369604055,3.9258201852,0.5393299296,20.29542424
12071,2013,6361,6191,13075,2387,170,15462,9.7485768319,9.4880426295,20.038145272,3.6582067124,0.2605342024,23.696351985
12071,2014,6360,6346,14666,2749,14,17415,9.5019541755,9.4810379242,21.911267286,4.1070553504,0.0209162513,26.018322636
12071,2015,6638,6624,18792,3069,14,21861,9.6296264059,9.6093168594,27.261214134,4.4521427297,0.0203095465,31.713356863
12071,2016,6738,7168,19334,3164,-430,22498,9.4706193642,10.075007362,27.174971028,4.4471712182,-0.604387997,31.622142246
12071,2017,6892,7417,14000,3174,-525,17174,9.4299220786,10.148248993,19.155384373,4.3427992858,-0.718326914,23.498183659
13177,2010,74,69,103,3,5,106,NA,NA,NA,NA,NA,NA
13177,2011,363,149,-52,3,214,-49,12.737512501,5.2283453515,-1.824657438,0.1052686984,7.5091671491,-1.71938874
13177,2012,378,170,-104,19,208,-85,13.195789915,5.9346145118999996,-3.630587701,0.6632804454,7.2611754028,-2.967307256
13177,2013,365,199,148,24,166,172,12.639160621,6.8909396264,5.1249199231,0.8310680956,5.7482209949,5.9559880188
13177,2014,365,202,-101,25,163,-76,12.54618888,6.9433702844,-3.471685142,0.8593280055,5.6028185959,-2.612357137
13177,2015,368,206,-132,26,162,-106,12.616782378,7.0626553527,-4.525584983,0.8914031028,5.5541270249,-3.634181881
13177,2016,331,189,-141,31,142,-110,11.330378079,6.4696116521,-4.826535677,1.061153234,4.8607664265,-3.765382443
13177,2017,320,218,110,30,102,140,10.902896082,7.4275979557,3.7478705281,1.0221465077,3.4752981261,4.7700170358
17103,2010,68,44,-79,0,24,-79,NA,NA,NA,NA,NA,NA
17103,2011,350,371,-367,1,-21,-366,9.780634344,10.367472405,-10.25569373,0.0279446696,-0.586838061,-10.22774906
17103,2012,373,334,-441,1,39,-440,10.537318493,9.4355613311,-12.45833098,0.0282501836,1.1017571614,-12.4300808
17103,2013,363,360,-92,-1,3,-93,10.325994197,10.240655402,-2.61705638,-0.028446265,0.085338795,-2.645502646
17103,2014,364,377,-203,5,-13,-198,10.399554305,10.770966959,-5.799751439,0.1428510207,-0.371412654,-5.656900419
17103,2015,333,377,-316,6,-44,-310,9.5908757074,10.858138564,-9.101251422,0.1728085713,-1.267262856,-8.928442851
17103,2016,330,367,-113,6,-37,-107,9.5731256255,10.646476074,-3.27807029,0.1740568296,-1.073350449,-3.10401346
17103,2017,324,389,70,6,-65,76,9.4179202093,11.307317782,2.0347358477,0.1744059298,-1.889397573,2.2091417775
19111,2010,87,77,-22,3,10,-19,NA,NA,NA,NA,NA,NA
19111,2011,391,430,-266,10,-39,-256,10.95222756,12.044649235,-7.450876038,0.2801081217,-1.092421675,-7.170767916
19111,2012,412,435,-8,11,-23,3,11.591756348,12.23886896,-0.225082648,0.3094886404,-0.647112612,0.0844059928
19111,2013,429,445,-294,3,-16,-291,12.12549463,12.57772753,-8.309779536,0.0847936687,-0.4522329,-8.224985868
19111,2014,427,453,-153,4,-26,-149,12.151221525,12.89110855,-4.35395057,0.1138287731,-0.739887025,-4.240121797
19111,2015,429,439,-154,6,-10,-148,12.266430297,12.552361073,-4.403333953,0.1715584657,-0.285930776,-4.231775487
19111,2016,396,428,-412,7,-32,-405,11.420166977,12.343008753,-11.88158786,0.2018716385,-0.922841776,-11.67971623
19111,2017,403,406,-164,7,-3,-157,11.72346584,11.810737298,-4.770839697,0.2036334017,-0.087271458,-4.567206295
21129,2010,11,15,-187,-1,-4,-188,NA,NA,NA,NA,NA,NA
21129,2011,68,95,22,-3,-27,19,8.8145699656,12.314472746,2.8517726359,-0.388878087,-3.49990278,2.4628945492
21129,2012,66,107,-85,-2,-41,-87,8.6308356218,13.992415326,-11.11547012,-0.261540473,-5.361579704,-11.37701059
21129,2013,84,98,-711,-3,-14,-714,11.614241272,13.549948151,-98.30625648,-0.414794331,-1.935706879,-98.72105081
21129,2014,78,112,-45,-3,-34,-48,11.405176195,16.376663255,-6.579909343,-0.438660623,-4.97148706,-7.018569966
21129,2015,63,91,-25,-3,-28,-28,9.3078230036,13.444633227,-3.693580557,-0.443229667,-4.136810224,-4.136810224
21129,2016,77,91,-127,-3,-14,-130,11.545958914,13.645224172,-19.04333483,-0.449842555,-2.099265257,-19.49317739
21129,2017,66,102,13,-3,-36,10,10.024301337,15.492102066,1.9744835966,-0.455650061,-5.467800729,1.5188335358
28081,2010,274,258,-46,4,16,-42,NA,NA,NA,NA,NA,NA
28081,2011,1180,854,788,13,326,801,14.141305195,10.234470031,9.4435156723,0.1557940403,3.9068351639,9.5993097126
28081,2012,1195,840,410,12,355,422,14.15918718,9.9529014485,4.8579638022,0.1421843064,4.2062857312,5.0001481087
28081,2013,1132,916,-37,11,216,-26,13.337574965,10.792595996,-0.435945471,0.1296054104,2.5449789686,-0.306340061
28081,2014,1168,891,-489,11,277,-478,13.763927433,10.499708341,-5.762466194,0.1296260289,3.2642190916,-5.632840165
28081,2015,1183,966,-249,14,217,-235,13.959690362,11.3990371,-2.938261116,0.1652034362,2.5606532616,-2.77305768
28081,2016,1142,890,-178,14,252,-164,13.471270334,10.498625742,-2.099725148,0.1651469218,2.972644592,-1.934578227
28081,2017,1147,993,-49,14,154,-35,13.514070775,11.699627096,-0.577322989,0.1649494253,1.8144436786,-0.412373563
37105,2010,225,91,-117,18,134,-99,NA,NA,NA,NA,NA,NA
37105,2011,838,547,342,64,291,406,14.388736264,9.3921703297,5.8722527473,1.0989010989,4.9965659341,6.9711538462
37105,2012,806,508,367,72,298,439,13.67190813,8.6170339084,6.2252981188,1.2213118925,5.0548742218,7.4466100114
37105,2013,781,546,265,59,235,324,13.10490637,9.1616887039,4.4466071548,0.9899993288,3.9432176656,5.4366064837
37105,2014,796,522,-716,69,274,-647,13.336125654,8.7455497382,-11.99581152,1.1560209424,4.5905759162,-10.83979058
37105,2015,773,606,-282,96,167,-186,12.994108105,10.186842835,-4.740412012,1.6137572808,2.8072652698,-3.126654732
37105,2016,760,575,1,85,185,86,12.749324789,9.6458707286,0.0167754274,1.4259113251,3.1034540605,1.4426867524
37105,2017,758,532,373,83,226,456,12.61483158,8.8536812675,6.207562242,1.3813074158,3.7611503129,7.5888696578
45061,2010,49,18,-36,0,31,-36,NA,NA,NA,NA,NA,NA
45061,2011,165,251,-255,0,-86,-255,8.6614173228,13.175853018,-13.38582677,0,-4.514435696,-13.38582677
45061,2012,200,230,-220,-3,-30,-223,10.661833302,12.261108298,-11.72801663,-0.1599275,-1.599274995,-11.88794413
45061,2013,178,213,-221,0,-35,-221,9.617982385,11.509158697,-11.94142757,0,-1.891176312,-11.94142757
45061,2014,183,201,-20,0,-18,-20,9.96759171,10.948010567,-1.089354285,0,-0.980418857,-1.089354285
45061,2015,171,228,-480,0,-57,-480,9.4605809129,12.614107884,-26.5560166,0,-3.153526971,-26.5560166
45061,2016,174,248,-131,0,-74,-131,9.8255124513,14.004178666,-7.39736857,0,-4.178666215,-7.39736857
45061,2017,173,287,-143,0,-114,-143,9.8978745316,16.420173356,-8.181480104,0,-6.522298824,-8.181480104
48287,2010,49,53,-13,-1,-4,-14,NA,NA,NA,NA,NA,NA
48287,2011,197,163,-64,-5,34,-69,11.886803838,9.8352742412,-3.86170277,-0.301695529,2.0515295963,-4.163398298
48287,2012,181,135,-89,-7,46,-96,10.950119483,8.1672161892,-5.384312895,-0.423485284,2.7829032941,-5.807798179
48287,2013,208,147,-11,2,61,-9,12.583943372,8.8934599794,-0.665497005,0.1209994555,3.6904833928,-0.54449755
48287,2014,191,178,65,1,13,66,11.510531232,10.727091934,3.9171964926,0.0602645614,0.7834392985,3.977461054
48287,2015,220,160,190,0,60,190,13.128058241,9.5476787206,11.337868481,0,3.5803795202,11.337868481
48287,2016,208,191,99,0,17,99,12.278268056,11.274755763,5.8439833535,0,1.003512293,5.8439833535
48287,2017,209,155,133,0,54,133,12.22901612,9.0693660221,7.7821011673,0,3.159650098,7.7821011673
51105,2010,61,53,10,0,8,10,NA,NA,NA,NA,NA,NA
51105,2011,256,266,-54,3,-10,-51,10.013494749,10.404646887,-2.112221549,0.1173456416,-0.391152139,-1.994875907
51105,2012,259,296,-72,-2,-37,-74,10.166032107,11.618322408,-2.826078424,-0.078502178,-1.452290301,-2.904580602
51105,2013,250,286,-310,-12,-36,-322,9.9031472202,11.32920042,-12.27990255,-0.475351067,-1.4260532,-12.75525362
51105,2014,215,307,-255,-10,-92,-265,8.6374866922,12.333527509,-10.24446096,-0.401743567,-3.696040817,-10.64620453
51105,2015,226,313,-67,-10,-87,-77,9.175429337,12.707563639,-2.720149405,-0.405992449,-3.532134302,-3.126141854
51105,2016,229,307,-408,-10,-78,-418,9.4242561422,12.634264785,-16.79081444,-0.41153957,-3.210008642,-17.20235401
51105,2017,223,320,-187,-10,-97,-197,9.3287874668,13.386600849,-7.822794871,-0.418331277,-4.057813382,-8.241126148
26089,2010,39,71,38,4,-32,42,NA,NA,NA,NA,NA,NA
26089,2011,161,199,-279,15,-38,-264,7.4645895635,9.2264181561,-12.93553098,0.695458655,-1.761828593,-12.24007233
26089,2012,168,223,-11,14,-55,3,7.8532195863,10.424214094,-0.514198901,0.6544349655,-2.570994507,0.140236064
26089,2013,176,242,157,10,-66,167,8.2187302996,11.300754162,7.3314810059,0.4669733125,-3.082023862,7.7984543183
26089,2014,163,251,190,16,-88,206,7.573117755,11.661672126,8.8275605733,0.743373522,-4.088554371,9.5709340953
26089,2015,174,245,96,17,-71,113,8.0542504687,11.34075497,4.4437243965,0.7869095285,-3.286504502,5.2306339251
26089,2016,173,222,-98,18,-49,-80,8.0246770415,10.297562446,-4.54577081,0.8349374957,-2.272885405,-3.710833314
26089,2017,176,232,203,18,-56,221,8.157589803,10.753186559,9.4090382386999991,0.8342989571,-2.595596756,10.243337196
28083,2010,140,47,-68,9,93,-59,NA,NA,NA,NA,NA,NA
28083,2011,553,348,-629,43,205,-586,17.156330469,10.796388794,-19.5141625,1.3340365464,6.3599416747,-18.18012596
28083,2012,470,388,-1407,13,82,-1394,14.959101181,12.349215443,-44.78181992,0.4137623731,2.6098857379,-44.36805754
28083,2013,458,364,-149,6,94,-143,14.888256806,11.832588379,-4.843559529,0.1950426656,3.0556684275,-4.648516863
28083,2014,442,365,-130,4,77,-126,14.392237309,11.884992348,-4.233010973,0.1302464915,2.5072449611,-4.102764482
28083,2015,537,382,-660,6,155,-654,17.641551274,12.549483402,-21.68235352,0.1971123047,5.0920678723,-21.48524122
28083,2016,473,383,-562,5,90,-557,15.78745348,12.783498273,-18.75803141,0.1668864004,3.0039552077,-18.59114501
28083,2017,465,374,-600,5,91,-595,15.776081425,12.688719254,-20.356234100000002,0.1696352841,3.0873621713,-20.18659881
42077,2010,1020,843,75,288,177,363,NA,NA,NA,NA,NA,NA
42077,2011,4172,3237,830,1505,935,2335,11.859718744,9.2017999937,2.3594358958,4.2782542449,2.6579187501,6.6376901407
42077,2012,4107,3259,-1003,1705,848,702,11.596551812,9.2021335171,-2.832077299,4.8142490477,2.3944182947,1.9821717487
42077,2013,4147,3473,-1863,1905,674,42,11.672582239,9.7754709705,-5.243795686,5.3620133023,1.8971112681,0.1182176161
42077,2014,4244,3284,-568,2139,960,1571,11.891952477,9.2019726519,-1.591571397,5.9936112979,2.6899798252,4.4020399014
42077,2015,4163,3507,-474,2234,656,1760,11.585918225,9.7602246494,-1.319174931,6.2173772075,1.8256935757,4.8982022763
42077,2016,4179,3269,-620,2323,910,1703,11.55029311,9.0351539072,-1.713611325,6.4205146915,2.5151392033,4.7069033661
42077,2017,4194,3329,214,2323,865,2537,11.496600225,9.1254606932,0.5866171788,6.3678117123,2.3711395313,6.9544288912
16059,2010,31,38,22,0,-7,22,NA,NA,NA,NA,NA,NA
16059,2011,78,86,38,1,-8,39,9.7897709445,10.793850016,4.7693755883,0.1255098839,-1.004079071,4.8948854722
16059,2012,69,95,-193,-1,-26,-194,8.7624611086,12.064258048,-24.50949267,-0.12699219,-3.301796939,-24.63648486
16059,2013,53,85,-20,1,-32,-19,6.8475452196,10.981912145,-2.583979328,0.1291989664,-4.134366925,-2.454780362
16059,2014,67,101,45,-3,-34,42,8.6821303615,13.08798756,5.8312815861,-0.388752106,-4.405857198,5.4425294804
16059,2015,68,106,54,-3,-38,51,8.8003105992,13.718131228,6.9884819464,-0.388248997,-4.917820629,6.6002329494
16059,2016,89,88,0,-2,1,-2,11.509116772,11.379800853,0,-0.258631838,0.1293159188,-0.258631838
16059,2017,82,86,150,-2,-4,148,10.508105337,11.020695842,19.22214391,-0.256295252,-0.512590504,18.965848658
26091,2010,261,235,-329,20,26,-309,NA,NA,NA,NA,NA,NA
26091,2011,1022,946,-418,32,76,-386,10.273731616,9.5097359189,-4.201976336,0.3216823989,0.7639956975,-3.880293937
26091,2012,1060,874,-545,12,186,-533,10.690818503,8.8148824262,-5.496694419,0.121028134,1.875936077,-5.375666285
26091,2013,1053,1017,-251,8,36,-243,10.650133506,10.286026378,-2.538635812,0.0809126952,0.3641071284,-2.457723117
26091,2014,1080,991,-185,32,89,-153,10.939035137,10.037577611,-1.873816204,0.3241195596,0.9014575251,-1.549696644
26091,2015,1036,1065,-358,35,-29,-323,10.516378549,10.810755941,-3.634038147,0.3552830591,-0.294377392,-3.278755088
26091,2016,1047,1002,93,40,45,133,10.637865518,10.180650668,0.9449106907,0.4064132003,0.4572148503,1.351323891
26091,2017,1042,972,9,40,70,49,10.57154307,9.8613626333,0.0913089133,0.4058173923,0.7101804366,0.4971263056
37107,2010,181,138,-78,19,43,-59,NA,NA,NA,NA,NA,NA
37107,2011,660,660,-85,32,0,-53,11.098032621,11.098032621,-1.42929208,0.5380864301,0,-0.89120565
37107,2012,670,666,-303,25,4,-278,11.298005986,11.230555204,-5.109396737,0.4215673875,0.067450782,-4.68782935
37107,2013,641,716,-283,28,-75,-255,10.864867155,12.136107462,-4.796813424,0.4745963812,-1.271240307,-4.322217043
37107,2014,682,718,-442,44,-36,-398,11.635445457,12.249633193,-7.540860545,0.7506739004,-0.614187737,-6.790186645
37107,2015,674,729,-269,59,-55,-210,11.568531535,12.51255117,-4.617114218,1.0126756091,-0.944019636,-3.604438609
37107,2016,628,746,-643,66,-118,-577,10.869000848,12.911265339,-11.12861074,1.1422835286,-2.042264491,-9.986327212
37107,2017,615,741,-490,67,-126,-423,10.759742816,12.964177929,-8.572803219,1.1721996238,-2.204435114,-7.400603595
12073,2010,751,350,-27,137,401,110,NA,NA,NA,NA,NA,NA
12073,2011,3053,1658,386,619,1395,1005,11.015298023,5.9821041997,1.3926973589,2.2333670082,5.0331938231,3.6260643672
12073,2012,2986,1665,3170,696,1321,3866,10.626504695,5.9253617941,11.281319452,2.4769079932,4.7011429009,13.758227445
12073,2013,3036,1866,-3607,647,1170,-2960,10.735843786,6.5985126825,-12.75500281,2.2879087383,4.1373311032,-10.46709407
12073,2014,3034,1699,-38,748,1335,710,10.723292058,6.0049021774,-0.134306229,2.6437120828,4.7183898804,2.509405854
12073,2015,3075,1819,254,810,1256,1064,10.78678645,6.380866521,0.8910061002,2.8413974063,4.4059199287,3.7324035065
12073,2016,3031,1834,-1177,834,1197,-343,10.574147239,6.3982138029,-4.106160112,2.9095476072,4.1759334362,-1.196612505
12073,2017,2995,1855,1251,828,1140,2079,10.374701662,6.4257334169,4.3334730483,2.8681979888,3.9489682454,7.2016710371
48289,2010,42,85,-33,1,-43,-32,NA,NA,NA,NA,NA,NA
48289,2011,203,199,100,1,4,101,12.099538072,11.861123529,5.9603635822,0.0596036358,0.2384145433,6.019967218
48289,2012,225,197,-113,1,28,-112,13.403627915,11.735620886,-6.731599797,0.0595716796,1.6680070295,-6.672028118
48289,2013,203,234,-90,3,-31,-87,12.16734596,14.02541357,-5.394389835,0.1798129945,-1.85806761,-5.21457684
48289,2014,205,218,117,3,-13,120,12.290536287,13.069936149,7.014598759,0.1798615066,-0.779399862,7.1944602656
48289,2015,213,222,300,4,-9,304,12.616614838,13.149711239,17.769880053,0.236931734,-0.533096402,18.006811787
48289,2016,209,209,161,4,0,165,12.212580711,12.212580711,9.4077774856,0.2337336021,0,9.6415110877
48289,2017,214,212,43,4,2,47,12.427770841,12.31162345,2.4971689073,0.2322947821,0.116147391,2.7294636894
21131,2010,34,64,-1,0,-30,-1,NA,NA,NA,NA,NA,NA
21131,2011,158,168,-24,-7,-10,-31,14.035087719,14.92338441,-2.131912059,-0.621807684,-0.888296691,-2.753719742
21131,2012,152,143,-104,-3,9,-107,13.584770757,12.780409331,-9.29484315,-0.268120475,0.8043614264,-9.562963625
21131,2013,137,179,-109,-4,-42,-113,12.383061418,16.179328422,-9.852216749,-0.361549238,-3.796267004,-10.21376599
21131,2014,140,150,-145,-1,-10,-146,12.832852101,13.749484394,-13.29116825,-0.091663229,-0.916632293,-13.38283148
21131,2015,146,159,-174,-1,-13,-175,13.594673867,14.805158527,-16.2018716,-0.093114205,-1.210484659,-16.2949858
21131,2016,128,154,-181,-1,-26,-182,12.141332701,14.607540906,-17.16860327,-0.094854162,-2.466208205,-17.26345743
21131,2017,132,167,-69,-1,-35,-70,12.708804698,16.07856352,-6.64323882,-0.096278823,-3.369758822,-6.739517643
21133,2010,71,104,56,0,-33,56,NA,NA,NA,NA,NA,NA
21133,2011,315,327,-156,7,-12,-149,12.876852325,13.36739908,-6.377107818,0.2861522739,-0.490546755,-6.090955544
21133,2012,286,310,-350,3,-24,-347,11.817449332,12.809123401,-14.46191352,0.1239592587,-0.99167407,-14.33795426
21133,2013,283,340,-422,2,-57,-420,11.898755466,14.295324588,-17.74302052,0.0840901446,-2.396569122,-17.65893037
21133,2014,288,312,-162,3,-24,-159,12.277784883,13.300933623,-6.906253997,0.1278935925,-1.02314874,-6.778360404
21133,2015,256,282,-291,3,-26,-288,11.029490963,12.149673639,-12.53742918,0.1292518472,-1.120182676,-12.40817733
21133,2016,254,326,-237,3,-72,-234,11.090734434,14.234564667,-10.34844118,0.1309929264,-3.143830233,-10.21744826
21133,2017,234,294,-355,3,-60,-352,10.379701916,13.041163946,-15.74698368,0.1330731015,-2.66146203,-15.61391057
12075,2010,110,143,-55,12,-33,-43,NA,NA,NA,NA,NA,NA
12075,2011,390,536,-460,31,-146,-429,9.6441553945,13.254531517,-11.37515764,0.7665867108,-3.610376122,-10.60857093
12075,2012,393,509,-235,23,-116,-212,9.8274568642,12.728182046,-5.876469117,0.5751437859,-2.900725181,-5.301325331
12075,2013,373,524,-240,6,-151,-234,9.411467861,13.221472277,-6.055636157,0.1513909039,-3.810004416,-5.904245253
12075,2014,401,493,-43,16,-92,-27,10.183997664,12.52047593,-1.092049625,0.4063440464,-2.336478267,-0.685705578
12075,2015,404,560,434,17,-156,451,10.237956463,14.191226781,10.998200755,0.4308050987,-3.953270318,11.429005854
12075,2016,393,539,371,18,-146,389,9.8916449579,13.566403645,9.3379141969,0.4530524408,-3.674758687,9.7909666377
12075,2017,393,542,634,17,-149,651,9.7997656036,13.515198364,15.809291075,0.4239084358,-3.715432761,16.233199511
30049,2010,200,176,134,7,24,141,NA,NA,NA,NA,NA,NA
30049,2011,757,535,421,29,222,450,11.845986527,8.3719984038,6.588058557,0.4538092593,3.4739881227,7.0418678163
30049,2012,729,543,265,27,186,292,11.305480599,8.420954685,4.1096740176,0.4187215037,2.8845259142,4.5283955212
30049,2013,754,526,186,10,228,196,11.612326932,8.1009071168,2.8645793227,0.154009641,3.5114198149,3.0185889637
30049,2014,770,575,286,-8,195,278,11.778653103,8.7957474473,4.3749282955,-0.122375617,2.982905656,4.2525526789
30049,2015,778,595,356,-5,183,351,11.810874202,9.0327379823,5.4044617171,-0.075905361,2.7781362198,5.3285563559
30049,2016,794,590,462,-9,204,453,11.946137065,8.8768524787,6.9510268562,-0.135409614,3.0692845859,6.8156172422
30049,2017,794,614,807,-8,180,799,11.80098837,9.1257013339,11.994203545,-0.118901646,2.675287036,11.875301899
16061,2010,10,2,-8,0,8,-8,NA,NA,NA,NA,NA,NA
16061,2011,41,41,-15,-2,0,-17,10.755508919,10.755508919,-3.934942288,-0.524658972,0,-4.459601259
16061,2012,41,36,13,-2,5,11,10.756919848,9.4451003542,3.4107306835,-0.524727797,1.3118194936,2.886002886
16061,2013,39,44,-11,0,-5,-11,10.234877313,11.547041071,-2.886760268,0,-1.312163758,-2.886760268
16061,2014,40,41,5,3,-1,8,10.509721492,10.77246453,1.3137151865,0.7882291119,-0.262743037,2.1019442985
16061,2015,40,38,-36,3,2,-33,10.540184453,10.013175231,-9.486166008,0.790513834,0.5270092227,-8.695652174
16061,2016,40,27,49,3,13,52,10.494555949,7.0838252656,12.855831038,0.7870916962,3.4107306835,13.642922734
16061,2017,41,35,35,3,6,38,10.608020699,9.0556274256,9.0556274256,0.7761966365,1.552393273,9.8318240621
21135,2010,25,60,-10,0,-35,-10,NA,NA,NA,NA,NA,NA
21135,2011,121,140,-9,-2,-19,-11,8.7620840726,10.137948514,-0.651725262,-0.144827836,-1.375864441,-0.796553098
21135,2012,120,124,-25,0,-4,-25,8.709536943,8.9998548411,-1.814486863,0,-0.290317898,-1.814486863
21135,2013,183,172,-96,-3,11,-99,13.338678523,12.536900033,-6.997339553,-0.218666861,0.8017784905,-7.216006414
21135,2014,165,127,41,-3,38,38,12.032378035,9.2612849121,2.989863633,-0.21877051,2.7710931233,2.7710931233
21135,2015,157,175,-146,-3,-18,-149,11.486684226,12.803628914,-10.68188469,-0.219490781,-1.316944688,-10.90137548
21135,2016,143,158,-92,-3,-15,-95,10.568715125,11.677321607,-6.799453087,-0.221721296,-1.108606482,-7.021174384
21135,2017,142,144,-131,-3,-2,-134,10.591482062,10.740657865,-9.771015141,-0.223763706,-0.149175804,-9.994778847
29111,2010,28,16,-12,0,12,-12,NA,NA,NA,NA,NA,NA
29111,2011,110,101,-4,2,9,-2,10.770586507,9.8893567022,-0.391657691,0.1958288456,0.8812298052,-0.195828846
29111,2012,113,119,-98,3,-6,-95,11.11493631,11.70510992,-9.639502287,0.2950868047,-0.590173609,-9.344415482
29111,2013,112,104,-15,1,8,-14,11.07430662,10.283284718,-1.483166065,0.0988777377,0.7910219014,-1.384288327
29111,2014,114,96,-32,-1,18,-33,11.283777096,9.5021280808,-3.167376027,-0.098980501,1.7816490151,-3.266356528
29111,2015,105,134,70,-1,-29,69,10.380622837,13.247652002,6.9204152249,-0.098863075,-2.867029165,6.8215521503
29111,2016,126,114,-65,0,12,-65,12.464140865,11.27707983,-6.429913938,0,1.1870610347,-6.429913938
29111,2017,114,108,-123,1,6,-122,11.371571072,10.773067332,-12.26932668,0.0997506234,0.5985037406,-12.16957606
36049,2010,95,81,-26,0,14,-26,NA,NA,NA,NA,NA,NA
36049,2011,286,236,-114,12,50,-102,10.578683583,8.7292633759,-4.216678071,0.4438608496,1.8494202068,-3.772817222
36049,2012,342,232,24,44,110,68,12.621789194,8.5621493947,0.8857395926,1.6238559197,4.0596397992,2.5095955123
36049,2013,340,239,-218,26,101,-192,12.527634488,8.8061901253,-8.032424466,0.9579955785,3.7214443626000002,-7.074428887
36049,2014,349,247,-131,29,102,-102,12.880129908,9.1157366401,-4.834661943,1.0702686743,3.7643932684,-3.764393268
36049,2015,329,265,-359,33,64,-326,12.200548839,9.8271897946,-13.31306089,1.2237632574,2.3733590447,-12.08929763
36049,2016,315,251,-280,25,64,-255,11.779664186,9.3863355895,-10.47081261,0.934893983,2.3933285965,-9.535918627
36049,2017,305,271,-154,25,34,-129,11.466812038,10.188544467,-5.789800177,0.9399026261,1.2782675715,-4.849897551
47101,2010,21,17,1,-1,4,0,NA,NA,NA,NA,NA,NA
47101,2011,115,143,6,-5,-28,1,9.4576257247,11.760351988,0.4934413422,-0.411201118,-2.302726263,0.0822402237
47101,2012,126,115,-214,-4,11,-218,10.462509342,9.5491156689,-17.76965872,-0.332143154,0.9133936727,-18.10180188
47101,2013,142,155,68,-1,-13,67,11.865964736,12.952285452,5.6822929723,-0.083563132,-1.086320715,5.5987298404
47101,2014,130,163,-63,-1,-33,-64,10.883670309,13.646448156,-5.274394073,-0.083720541,-2.762777848,-5.358114613
47101,2015,142,135,-19,-1,7,-20,11.943311325,11.354556541,-1.598048698,-0.084107826,0.5887547836,-1.682156525
47101,2016,135,152,47,-1,-17,46,11.346921622,12.775793234,3.9504097499,-0.084051271,-1.428871612,3.8663584787
47101,2017,131,135,128,-1,-4,127,10.940827661,11.274898735,10.690274356,-0.083517768,-0.334071074,10.606756587
53041,2010,244,158,-47,11,86,-36,NA,NA,NA,NA,NA,NA
53041,2011,919,870,54,64,49,118,12.159542727,11.511210199,0.7144889089,0.8468016698,0.6483325284,1.5612905787
53041,2012,863,812,-301,34,51,-267,11.423125542,10.748062503,-3.984195583,0.450042026,0.675063039,-3.534153557
53041,2013,882,851,-529,29,31,-500,11.727631736,11.315436063,-7.033919715,0.385602404,0.4121956733,-6.648317311
53041,2014,820,768,-215,29,52,-186,10.947126713,10.252918678,-2.870283224,0.3871544813,0.6942080355,-2.483128742
53041,2015,868,845,527,38,23,565,11.553615163,11.247470983,7.0146949207,0.5058034288,0.3061441806,7.5204983495
53041,2016,967,878,1086,38,89,1124,12.719583818,11.548908576,14.284868694,0.4998388677,1.1706752428,14.784707561
53041,2017,934,883,1474,39,51,1513,12.064845314,11.406058257,19.04023768,0.5037783375,0.6587870568,19.544016018
54041,2010,57,28,15,0,29,15,NA,NA,NA,NA,NA,NA
54041,2011,201,215,40,-2,-14,38,12.237442922,13.089802131,2.4353120244,-0.121765601,-0.852359209,2.3135464231
54041,2012,185,203,35,-2,-18,33,11.250988262,12.345679012,2.128565347,-0.121632306,-1.09469075,2.0069330414
54041,2013,196,232,64,0,-36,64,11.904761905,14.091350826,3.8872691934,0,-2.186588921,3.8872691934
54041,2014,220,227,-38,8,-7,-30,13.367359339,13.792684409,-2.308907522,0.4860857941,-0.42532507,-1.822821728
54041,2015,189,226,14,10,-37,24,11.503347535,13.755325624,0.8520998174,0.6086427267,-2.251978089,1.4607425441
54041,2016,210,235,-116,12,-25,-104,12.838540075,14.366937703,-7.091764994,0.7336308614,-1.528397628,-6.358134132
54041,2017,192,226,-44,12,-34,-32,11.808844332,13.89999385,-2.706193493,0.7380527708,-2.091149517,-1.968140722
51678,2010,9,4,-1,5,5,4,NA,NA,NA,NA,NA,NA
51678,2011,39,65,-62,11,-26,-51,5.5682467162,9.2804111936000009,-8.852084523,1.5705311251,-3.712164477,-7.281553398
51678,2012,42,58,56,2,-16,58,6.0107334526,8.3005366726,8.0143112701,0.2862254025,-2.28980322,8.3005366726
51678,2013,38,65,142,11,-27,153,5.3714043395,9.1879284755,20.0720899,1.5548802035,-3.816524136,21.626970104
51678,2014,35,69,3,9,-34,12,4.9102132435,9.6801346801,0.4208754209,1.2626262626,-4.769921437,1.6835016835
51678,2015,23,88,57,9,-65,66,3.2319258062,12.365629172,8.0095552589,1.2646666198,-9.133703365,9.2742218787
51678,2016,0,62,21,11,-62,32,0,8.7299352295,2.9569135455,1.5488594762,-8.72993523,4.5057730217
51678,2017,0,41,50,11,-41,61,0,5.7774959487,7.0457267667,1.5500598887,-5.777495949,8.5957866554
45063,2010,886,605,530,75,281,605,NA,NA,NA,NA,NA,NA
45063,2011,3297,2174,1621,341,1123,1962,12.448978821,8.2086988042,6.1206535242,1.2875649918,4.2402800171,7.408218516
45063,2012,3189,2129,1995,326,1060,2321,11.895858085,7.9417628923,7.4419055755,1.2160707858,3.954095193,8.6579763612
45063,2013,3329,2268,2125,344,1061,2469,12.259907084,8.3524990287,7.8258643897,1.2668693412,3.9074080553,9.0927337309
45063,2014,3167,2209,2745,407,958,3152,11.501035892,8.0220360865,9.9685328462,1.4780301889,3.4789998057,11.446563035
45063,2015,3193,2365,2837,473,828,3310,11.423685274,8.46132655,10.150014132,1.69226531,2.9623587245,11.842279442
45063,2016,3296,2404,3449,472,892,3921,11.606124202,8.4651464146,12.144879361,1.6620420581,3.1409777878,13.806921419
45063,2017,3244,2411,2951,471,833,3422,11.243665906,8.3564976882,10.228131347,1.6324804692,2.8871682183,11.860611816
12077,2010,18,6,-29,-1,12,-30,NA,NA,NA,NA,NA,NA
12077,2011,80,73,-93,-4,7,-97,9.6333313264,8.7904148353,-11.19874767,-0.481666566,0.8429164911,-11.68041423
12077,2012,76,68,31,-2,8,29,9.1792982668,8.213056344,3.7441874509,-0.241560481,0.9662419228,3.5026269702
12077,2013,69,55,47,-3,14,44,8.2862975862,6.6050198151,5.6442896601,-0.360273808,1.6812777711,5.284015852
12077,2014,91,61,29,-2,30,27,10.851419032,7.2740281421,3.4581445266,-0.238492726,3.5773908896,3.2196518006
12077,2015,85,76,-20,-2,9,-22,10.107015458,9.0368608799,-2.378121284,-0.237812128,1.0701545779,-2.615933413
12077,2016,75,41,-118,-2,34,-120,8.9696824732,4.9034264187,-14.11230042,-0.239191533,4.0662560545,-14.35149196
12077,2017,74,59,-91,-2,15,-93,8.9366584143,7.1251736006,-10.98967454,-0.241531308,1.8114848137,-11.23120585
13179,2010,357,113,-1241,78,244,-1163,NA,NA,NA,NA,NA,NA
13179,2011,1219,301,1365,103,918,1468,19.084298116,4.7123656545,21.370030294,1.6125370844,14.371932461,22.982567378
13179,2012,1690,302,-3049,831,1388,-2218,26.116116271,4.6669036176,-47.11718255,12.84171161,21.449212653,-34.27547094
13179,2013,1426,311,-3570,317,1115,-3253,22.524977293,4.912530111,-56.39142282,5.0073056115,17.612447182,-51.38411721
13179,2014,1364,302,336,297,1062,633,21.599708626,4.7823401796,5.3207493389,4.703162362,16.817368446,10.023911701
13179,2015,1520,348,-4145,420,1172,-3725,24.215389517,5.5440497053,-66.03472997,6.6910944719,18.671339812,-59.34363549
13179,2016,1415,354,-1415,221,1061,-1194,23.024228322,5.7601249654,-23.02422832,3.5960102185,17.264103357,-19.4282181
13179,2017,1436,352,-1156,73,1084,-1083,23.392193914,5.7340196781,-18.8310419,1.1891574901,17.658174236,-17.64188441
30051,2010,6,7,8,1,-1,9,NA,NA,NA,NA,NA,NA
30051,2011,26,24,25,2,2,27,11.00762066,10.16088061,10.584250635,0.8467400508,0.8467400508,11.430990686
30051,2012,19,28,22,2,-9,24,7.96812749,11.74250367,9.2262528832,0.8387502621,-3.774376179,10.065003145
30051,2013,25,21,-36,0,4,-36,10.521885522,8.8383838384,-15.15151515,0,1.6835016835,-15.15151515
30051,2014,22,25,-11,1,-3,-10,9.3457943925,10.620220901,-4.672897196,0.424808836,-1.274426508,-4.24808836
30051,2015,22,24,45,1,-2,46,9.2807424594,10.124446319,18.983336849,0.42185193,-0.84370386,19.405188779
30051,2016,31,17,19,2,14,21,12.860402406,7.0524787389,7.8821821199,0.829703381,5.8079236673,8.7118855009
30051,2017,29,19,-13,2,10,-11,11.946446962,7.8269824923,-5.355303811,0.8238928939,4.1194644696,-4.531410917
48291,2010,251,176,126,14,75,140,NA,NA,NA,NA,NA,NA
48291,2011,1034,714,-222,22,320,-200,13.620855453,9.4055036687,-2.9244003,0.2898054352,4.2153517843,-2.634594865
48291,2012,1029,637,-41,23,392,-18,13.511916486,8.3645197295,-0.538375681,0.302015626,5.1473967566,-0.236360055
48291,2013,1083,779,140,51,304,191,14.141427331,10.17190387,1.8280700151,0.6659397912,3.9695234613,2.4940098063
48291,2014,1103,762,783,61,341,844,14.246872598,9.8423544152,10.113600403,0.7879050122,4.4045181832,10.901505415
48291,2015,1075,765,1139,70,310,1209,13.64594176,9.7108329737,14.458351316,0.8885729518,3.9351087867,15.346924268
48291,2016,1123,826,1463,76,297,1539,13.957332571,10.266034465,18.183061043,0.9445745996,3.6912981065,19.127635643
48291,2017,1143,804,1867,76,339,1943,13.851607235,9.7433877662,22.625503681,0.921016754,4.1082194686,23.546520435
39089,2010,497,360,89,11,137,100,NA,NA,NA,NA,NA,NA
39089,2011,1950,1451,-98,52,499,-46,11.681473184,8.6922141484,-0.587068909,0.3115059516,2.9892590352,-0.275562957
39089,2012,1959,1514,-121,113,445,-8,11.70541084,9.0464481935,-0.722998832,0.6751972562,2.6589626461,-0.047801576
39089,2013,1955,1505,329,81,450,410,11.637978504,8.9591599225,1.9585140296,0.4821873447,2.6788185815,2.4407013742
39089,2014,1955,1497,394,77,458,471,11.578461101,8.8659622856,2.3334596797,0.4560314602,2.7124988155,2.78949114
39089,2015,1970,1643,738,87,327,825,11.597786412,9.6726716119,4.3447545037,0.5121865065,1.9251148004,4.8569410102
39089,2016,2022,1573,864,87,449,951,11.816027606,9.1921916043,5.0489850897,0.5084047486,2.6238360015,5.5573898383
39089,2017,1970,1562,1137,88,408,1225,11.411359226,9.047991427,6.5861499696,0.5097459959,2.3633677991,7.0958959655
01083,2010,223,159,294,14,64,308,NA,NA,NA,NA,NA,NA
01083,2011,1011,685,1912,61,326,1973,11.985276248,8.1205877646,22.666516505,0.7231472316,3.8646884836,23.389663737
01083,2012,1001,716,1411,78,285,1489,11.582162775,8.284544003,16.32610557,0.9025061903,3.2976187721,17.22861176
01083,2013,977,672,1200,53,305,1253,11.088160523,7.626656982,13.619030325,0.6015071727,3.4615035409,14.220537498
01083,2014,1008,727,1343,72,281,1415,11.230071636,8.0994663488,14.962287904,0.802147974,3.1306052875,15.764435878
01083,2015,1031,755,658,84,276,742,11.314191024,8.2853678209,7.2208901009,0.9218157576,3.0288232034,8.1427058585
01083,2016,1018,767,943,94,251,1037,11.032061251,8.3119754217,10.219286601,1.0186775615,2.720085829,11.237964162
01083,2017,1020,772,1140,92,248,1232,10.890338561,8.2424915386,12.171554863,0.982265831,2.6478470228,13.153820694
48293,2010,84,33,34,10,51,44,NA,NA,NA,NA,NA,NA
48293,2011,282,278,50,33,4,83,11.988266803,11.818220465,2.1255792203,1.4028822854,0.1700463376,3.5284615058
48293,2012,322,250,-17,29,72,12,13.640888776,10.590752155,-0.720171147,1.22852725,3.0501366207,0.5083561035
48293,2013,296,280,-289,28,16,-261,12.582626623,11.902484644,-12.28506451,1.1902484644,0.6801419796,-11.09481604
48293,2014,312,257,6,40,55,46,13.304053046,10.958787284,0.255847174,1.7056478264,2.3452657613,1.9614950003
48293,2015,316,282,-137,47,34,-90,13.463996591,12.01533873,-5.837239029,2.002556455,1.4486578611,-3.834682573
48293,2016,316,247,-36,53,69,17,13.455970022,10.517799353,-1.53295861,2.2568557316,2.9381706694,0.7238971214
48293,2017,311,257,-107,56,54,-51,13.218854933,10.923619671,-4.547966167,2.380243975,2.2952352616,-2.167722192
05079,2010,33,19,-72,0,14,-72,NA,NA,NA,NA,NA,NA
05079,2011,123,115,231,-1,8,230,8.654353562,8.0914687775,16.253298153,-0.070360598,0.5628847845,16.182937555
05079,2012,129,108,-183,-2,21,-185,9.0485041911,7.5754918809,-12.83625013,-0.140286887,1.4730123102,-12.97653702
05079,2013,109,153,-68,-4,-44,-72,7.7206403173,10.837229069,-4.816546253,-0.28332625,-3.116588752,-5.099872503
05079,2014,127,123,-27,-3,4,-30,9.0423638305,8.7575649697,-1.92239231,-0.213599146,0.2847988608,-2.135991456
05079,2015,108,125,-135,-3,-17,-138,7.7397162104,8.9580048732,-9.674645263,-0.214992117,-1.218288663,-9.88963738
05079,2016,187,122,-128,-3,65,-131,13.508144617,8.8128002312,-9.246216636,-0.216708202,4.6953443855,-9.462924838
05079,2017,156,154,-163,-3,2,-166,11.363636364,11.217948718,-11.87354312,-0.218531469,0.1456876457,-12.09207459
08073,2010,12,15,6,1,-3,7,NA,NA,NA,NA,NA,NA
08073,2011,64,51,-74,4,13,-70,11.753902663,9.3663911846,-13.59044995,0.7346189164,2.3875114784,-12.85583104
08073,2012,48,56,23,8,-8,31,8.8414072573,10.314975134,4.2365076441,1.4735678762,-1.473567876,5.7100755204
08073,2013,72,42,-36,1,30,-35,13.238944562,7.7227176611,-6.619472281,0.18387423,5.5162269008000004,-6.435598051
08073,2014,49,46,63,3,3,66,8.9554966645,8.4072009504,11.514209997,0.5482957142,0.5482957142,12.062505711
08073,2015,74,65,30,3,9,33,13.387607417,11.759384894,5.4274084125,0.5427408412,1.6282225237,5.9701492537
08073,2016,47,46,10,3,1,13,8.4608460846,8.2808280828,1.800180018,0.5400540054,0.1800180018,2.3402340234
08073,2017,53,45,-29,3,8,-26,9.5426719481,8.1022686352,-5.221462009,0.5401512423,1.4404033129,-4.681310767
13181,2010,10,9,-28,0,1,-28,NA,NA,NA,NA,NA,NA
13181,2011,60,81,-80,0,-21,-80,7.5752793384,10.226627107,-10.10037245,0,-2.651347768,-10.10037245
13181,2012,73,83,-107,7,-10,-100,9.3392183202,10.618563296,-13.68899124,0.8955414828,-1.279344975,-12.79344975
13181,2013,70,99,-5,5,-29,0,9.0357557764,12.779140312,-0.645411127,0.6454111269,-3.743384536,0
13181,2014,66,84,-78,4,-18,-74,8.5864827945,10.928250829,-10.14766148,0.5203928966,-2.341768035,-9.627268588
13181,2015,88,87,75,5,1,80,11.456841557,11.326650176,9.7643535998,0.6509569067,0.1301913813,10.415310506
13181,2016,90,80,128,5,10,133,11.549566891,10.266281681,16.42605069,0.6416426051,1.2832852101,17.067693295
13181,2017,88,95,18,5,-7,23,11.178861789,12.068089431,2.2865853659,0.6351626016,-0.889227642,2.9217479675
16063,2010,20,15,-4,-1,5,-5,NA,NA,NA,NA,NA,NA
16063,2011,91,46,-120,-1,45,-121,17.606655703,8.9000677179,-23.21756796,-0.193479733,8.7065879849,-23.41104769
16063,2012,74,34,70,10,40,80,14.254069151,6.5491669074,13.483578927,1.926225561,7.7049022441,15.409804488
16063,2013,74,33,-3,13,41,10,14.023119197,6.2535531552,-0.568504832,2.4635209399,7.7695660413,1.8950161076
16063,2014,73,52,-25,10,21,-15,13.7580098,9.8002261591,-4.711647192,1.8846588767,3.9577836412,-2.826988315
16063,2015,67,30,-75,11,37,-64,12.649863117,5.6641178137,-14.16029453,2.0768431983,6.9857453035,-12.08345134
16063,2016,68,28,-67,11,40,-56,12.890995261,5.308056872,-12.7014218,2.0853080569,7.5829383886,-10.61611374
16063,2017,69,30,4,10,39,14,13.037316958,5.6683986774,0.7557864903,1.8894662258,7.3689182806,2.6452527161
20105,2010,8,2,-2,0,6,-2,NA,NA,NA,NA,NA,NA
20105,2011,35,46,-3,2,-11,-1,10.809141445,14.206300185,-0.926497838,0.6176652254,-3.39715874,-0.308832613
20105,2012,39,44,-53,2,-5,-51,12.168486739,13.728549142,-16.53666147,0.624024961,-1.560062402,-15.91263651
20105,2013,27,34,-15,2,-7,-13,8.5213823576,10.730629635,-4.73410131,0.631213508,-2.209247278,-4.102887802
20105,2014,27,32,27,2,-5,29,8.516006939,10.093045261,8.516006939,0.6308153288,-1.577038322,9.1468222678
20105,2015,36,34,-47,2,2,-45,11.385199241,10.752688172,-14.86401012,0.6325110689,0.6325110689,-14.23149905
20105,2016,23,36,-54,3,-13,-51,7.3966875703,11.577424023,-17.36613603,0.9647853353,-4.180736453,-16.4013507
20105,2017,25,34,-29,3,-9,-26,8.1699346405,11.111111111,-9.477124183,0.9803921569,-2.941176471,-8.496732026
21137,2010,85,82,-15,0,3,-15,NA,NA,NA,NA,NA,NA
21137,2011,331,250,-81,-2,81,-83,13.379954322,10.105705681,-3.274248641,-0.080845645,3.2742486408,-3.355094286
21137,2012,297,276,-338,-1,21,-339,12.08274852,11.228412766,-13.75073737,-0.040682655,0.854335754,-13.79142003
21137,2013,344,277,-29,-1,67,-30,14.074710527,11.333415163,-1.186530829,-0.040914856,2.7412953643,-1.227445686
21137,2014,307,283,-30,0,24,-30,12.554953481,11.573458747,-1.226868418,0,0.9814947347,-1.226868418
21137,2015,324,321,-88,0,3,-88,13.276784068,13.153850882,-3.606040117,0,0.1229331858,-3.606040117
21137,2016,298,290,-21,0,8,-21,12.236685419,11.908183797,-0.862316758,0,0.328501622,-0.862316758
21137,2017,307,275,80,0,32,80,12.58145158,11.270029917,3.2785541576,0,1.311421663,3.2785541576
23015,2010,69,78,-53,4,-9,-49,NA,NA,NA,NA,NA,NA
23015,2011,295,392,-49,28,-97,-21,8.5919410505,11.417087769,-1.427135971,0.8155062692,-2.825146718,-0.611629702
23015,2012,275,413,14,24,-138,38,8.0358838742,12.068436509,0.4090995427,0.7013135017,-4.032552635,1.1104130444
23015,2013,253,426,84,28,-173,112,7.4116389096,12.479676583,2.4607812981,0.8202604327,-5.068037673,3.2810417307
23015,2014,272,423,80,13,-151,93,7.9835632521,12.41561491,2.3481068389,0.3815673613,-4.432051658,2.7296742002
23015,2015,259,431,-106,14,-172,-92,7.6392166116,12.712364323,-3.126474752,0.4129306277,-5.073147711,-2.713544125
23015,2016,287,391,314,15,-104,329,8.4706993492,11.540221065,9.2675944099,0.4427194782,-3.069521715,9.7103138881
23015,2017,273,410,334,14,-137,348,8.0062172823,12.023989325,9.7951522794,0.4105752452,-4.017772043,10.205727525
27081,2010,20,32,2,0,-12,2,NA,NA,NA,NA,NA,NA
27081,2011,56,90,-44,0,-34,-44,9.5775611425,15.392508979,-7.525226612,0,-5.814947836,-7.525226612
27081,2012,66,71,-47,0,-5,-47,11.415722563,12.28055003,-8.129378189,0,-0.864827467,-8.129378189
27081,2013,77,67,-10,0,10,-10,13.378507515,11.641039006,-1.737468508,0,1.7374685083999999,-1.737468508
27081,2014,69,77,19,0,-8,19,11.977087311,13.365735115,3.298038535,0,-1.388647804,3.298038535
27081,2015,73,95,-33,0,-22,-33,12.721094363,16.554848828,-5.750631698,0,-3.833754465,-5.750631698
27081,2016,71,65,-8,0,6,-8,12.43541466,11.384534548,-1.401173483,0,1.0508801121,-1.401173483
27081,2017,67,77,-19,0,-10,-19,11.768838925,13.525382048,-3.337431934,0,-1.756543123,-3.337431934
28085,2010,106,66,-13,1,40,-12,NA,NA,NA,NA,NA,NA
28085,2011,436,404,-76,8,32,-68,12.500895993,11.583399039,-2.179055265,0.2293742384,0.9174969536,-1.949681026
28085,2012,488,394,-114,2,94,-112,14.003673095,11.306244261,-3.271349862,0.0573921028,2.6974288338,-3.213957759
28085,2013,470,417,-180,7,53,-173,13.51487355,11.990855894,-5.175909019,0.2012853507,1.5240176556,-4.9746236680000004
28085,2014,468,418,-46,10,50,-36,13.479068562,12.038997134,-1.324865713,0.2880142855,1.4400714275,-1.036851428
28085,2015,428,442,-203,10,-14,-193,12.362617524,12.76700221,-5.863577938,0.2888462038,-0.404384685,-5.574731734
28085,2016,414,391,-144,10,23,-134,12.013929193,11.346488683,-4.17875798,0.2901915264,0.6674405107,-3.888566454
28085,2017,401,396,-71,10,5,-61,11.665284869,11.519832439,-2.065424503,0.2909048596,0.1454524298,-1.774519643
29113,2010,176,80,41,1,96,42,NA,NA,NA,NA,NA,NA
29113,2011,743,419,45,8,324,53,14.050547934,7.9235256853,0.8509753123,0.1512845,6.1270222483,1.0022598122
29113,2012,700,411,-73,13,289,-60,13.164080865,7.7291960508,-1.372825576,0.2444757875,5.4348848143,-1.128349788
29113,2013,701,429,239,19,272,258,13.090936254,8.0114288916,4.4632436016,0.354818529,5.0795073625,4.8180621306
29113,2014,733,436,93,16,297,109,13.571686463,8.072653885,1.721919292,0.2962441793,5.4990325776,2.0181634712
29113,2015,743,454,104,18,289,122,13.655828999,8.3442077597,1.9114484736,0.3308276204,5.3116212391,2.242276094
29113,2016,728,504,333,17,224,350,13.260835906,9.1805787043,6.0657395011,0.3096623769,4.0802572019,6.375401878
29113,2017,756,459,680,17,297,697,13.576488969,8.2428683027,12.211656745,0.3052914186,5.3336206664,12.516948163
30053,2010,45,32,-2,2,13,0,NA,NA,NA,NA,NA,NA
30053,2011,169,224,-20,1,-55,-19,8.5967901925,11.394562149,-1.01737162,0.050868581,-2.797771956,-0.966503039
30053,2012,195,244,-82,-6,-49,-88,9.97365931,12.47986088,-4.194051607,-0.306881825,-2.50620157,-4.500933432
30053,2013,186,236,-16,-7,-50,-23,9.5659329356,12.137420284,-0.822875951,-0.360008229,-2.571487348,-1.18288418
30053,2014,172,237,-177,-8,-65,-185,8.9204678059,12.291574826,-9.179783731,-0.414905479,-3.37110702,-9.59468921
30053,2015,169,263,-40,-8,-94,-48,8.8548898378,13.780094836,-2.095831914,-0.419166383,-4.925204999,-2.514998297
30053,2016,170,248,302,-6,-78,296,8.8902834432,12.96935467,15.793327058,-0.31377471,-4.079071227,15.479552348
30053,2017,163,247,300,-6,-84,294,8.4303077321,12.774760796,15.515903801,-0.310318076,-4.344453064,15.205585725
31111,2010,117,104,-52,2,13,-50,NA,NA,NA,NA,NA,NA
31111,2011,415,342,-313,23,73,-290,11.482168055,9.462413192,-8.660044822,0.6363611211,2.0197548626,-8.023683701
31111,2012,453,344,-183,21,109,-162,12.580188286,9.5531672637,-5.082062818,0.5831875364,3.0270210225,-4.498875281
31111,2013,428,356,-114,12,72,-102,11.899962465,9.8980996205,-3.169616171,0.3336438074,2.0018628446,-2.835972363
31111,2014,413,354,-386,12,59,-374,11.537763127,9.8895112514,-10.78347837,0.3352376695,1.6482518752,-10.4482407
31111,2015,419,391,-183,13,28,-170,11.779589542,10.992409334,-5.144784931,0.3654765252,0.787180208,-4.779308406
31111,2016,429,355,-112,14,74,-98,12.089104307,10.003804264,-3.156129796,0.3945162245,2.0853000437,-2.761613571
31111,2017,423,356,-275,14,67,-261,11.956921163,10.063035305,-7.773412104,0.3957373435,1.893885858,-7.37767476
32017,2010,10,16,16,0,-6,16,NA,NA,NA,NA,NA,NA
32017,2011,33,38,-81,-2,-5,-83,6.2100112909,7.1509220926,-15.24275499,-0.376364321,-0.940910802,-15.61911931
32017,2012,22,46,127,-1,-24,126,4.1326195172,8.6409317179,23.856485395,-0.187846342,-4.508312201,23.668639053
32017,2013,21,45,-76,-4,-24,-80,3.9440323035,8.4514977932,-14.27364072,-0.751244248,-4.50746549,-15.02488497
32017,2014,36,49,-57,-3,-13,-60,6.8741645981,9.356501814,-10.88409395,-0.57284705,-2.482337216,-11.456941
32017,2015,43,57,-46,-3,-14,-49,8.3180191508,11.026211432,-8.898346068,-0.580326917,-2.708192282,-9.478672986
32017,2016,48,36,31,-3,12,28,9.305932532,6.979449399,6.0100814269,-0.581620783,2.326483133,5.4284606437
32017,2017,49,47,45,-3,2,42,9.4221709451,9.0375925392,8.6530141333,-0.576867609,0.3845784059,8.0761465244
35027,2010,38,65,-11,-3,-27,-14,NA,NA,NA,NA,NA,NA
35027,2011,210,188,-62,-7,22,-69,10.281517748,9.2044063647,-3.035495716,-0.342717258,1.0771113831,-3.378212974
35027,2012,187,186,-205,-10,1,-215,9.2145461713,9.1652705233,-10.10150783,-0.49275648,0.049275648,-10.59426431
35027,2013,181,203,-201,-13,-22,-214,9.0182108069,10.114346927,-10.01469819,-0.647716798,-1.09613612,-10.66241499
35027,2014,189,197,-376,-7,-8,-383,9.5645353103,9.9693833658,-19.02785861,-0.354242049,-0.404848055,-19.38210066
35027,2015,192,217,-261,-6,-25,-267,9.8856966327,11.172896715,-13.43836886,-0.30892802,-1.287200082,-13.74729688
35027,2016,177,183,30,-5,-6,25,9.1781177081,9.4892403422,1.5556131709,-0.259268862,-0.311122634,1.296344309
35027,2017,184,189,110,-5,-5,105,9.5117475251,9.7702189253,5.6863708031,-0.2584714,-0.2584714,5.4278994029
37109,2010,196,168,90,3,28,93,NA,NA,NA,NA,NA,NA
37109,2011,775,694,83,28,81,111,9.9132114328,8.8771209476,1.0616729664,0.3581547356,1.0360904852,1.419827702
37109,2012,779,676,344,5,103,349,9.924578301,8.6123426591,4.3826122407,0.0637007593,1.3122356418,4.4463130001
37109,2013,770,727,371,-13,43,358,9.757642959,9.2127356249,4.7014097893,-0.164739427,0.5449073341,4.5366703627
37109,2014,778,717,294,-26,61,268,9.8145578403,9.0450359531,3.7088431941,-0.327992936,0.7695218872,3.3808502586
37109,2015,800,781,1073,-22,19,1051,10.004189254,9.7665897595,13.418118837,-0.275115204,0.2375994948,13.143003633
37109,2016,803,831,618,-19,-28,599,9.9394104432,10.285990135,7.649508909,-0.235179076,-0.346579692,7.4143298325
37109,2017,796,817,1363,-18,-21,1345,9.7383134122,9.9952287158,16.675026609,-0.220213117,-0.256915304,16.454813492
40081,2010,102,52,34,1,50,35,NA,NA,NA,NA,NA,NA
40081,2011,378,376,-96,-10,2,-106,11.019123134,10.960820896,-2.798507463,-0.291511194,0.0583022388,-3.090018657
40081,2012,388,382,-96,-2,6,-98,11.343039233,11.16763141,-2.806525171,-0.058469274,0.1754078232,-2.864994445
40081,2013,397,372,57,2,25,59,11.608696288,10.877670073,1.6667397693,0.0584820972,0.7310262146,1.7252218665
40081,2014,393,404,300,6,-11,306,11.429568556,11.749480144,8.7248614928,0.1744972299,-0.319911588,8.8993587227
40081,2015,429,360,323,6,69,329,12.352255222,10.365528858,9.3001828364,0.1727588143,1.9867263644,9.4729416507
40081,2016,433,365,-48,6,68,-42,12.391963826,10.445881747,-1.373704997,0.1717131246,1.9460820789,-1.201991872
40081,2017,414,351,122,6,63,128,11.812371605,10.014836795,3.4809404246,0.1711937914,1.7975348094,3.6521342159
41041,2010,112,173,24,5,-61,29,NA,NA,NA,NA,NA,NA
41041,2011,435,591,-12,20,-156,8,9.4732028137,12.87048934,-0.261329733,0.4355495547,-3.397286526,0.1742198219
41041,2012,415,568,426,15,-153,441,9.0230141216,12.349571135,9.2621783513,0.3261330405,-3.326557013,9.5883113918
41041,2013,438,560,258,34,-122,292,9.4740598942,12.112953289,5.5806106226,0.7354293069,-2.638893395,6.3160399295
41041,2014,451,564,100,47,-113,147,9.7337779361,12.172618084,2.1582656177,1.0143848403,-2.438840148,3.1726504581
41041,2015,424,541,756,53,-117,809,9.0792291221,11.584582441,16.188436831,1.1349036403,-2.505353319,17.323340471
41041,2016,436,586,946,51,-150,997,9.183974386,12.343598601,19.926696718,1.0742722332,-3.159624215,21.000968951
41041,2017,435,582,1114,51,-147,1165,8.9860251815,12.022681967,23.012487476,1.0535339868,-3.036656785,24.066021463
46083,2010,223,40,159,2,183,161,NA,NA,NA,NA,NA,NA
46083,2011,756,214,1044,4,542,1048,16.436569192,4.6526796391,22.698119361,0.0869659746,11.783889553,22.785085335
46083,2012,836,212,947,4,624,951,17.562102831,4.4535476078,19.893913135,0.0840292001,13.108555223,19.977942335
46083,2013,786,195,897,5,591,902,15.990072322,3.9670026752,18.248212306,0.1017180173,12.023069646,18.349930323
46083,2014,782,194,1062,11,588,1073,15.407804388,3.822396485,20.924665294,0.2167338213,11.585407903,21.141399115
46083,2015,772,211,814,12,561,826,14.762405584,4.0348025624,15.565541639,0.2294674443,10.727603021,15.795009083
46083,2016,761,243,1048,12,518,1060,14.149583972,4.5181982987,19.485892251,0.2231209036,9.6313856738,19.709013155
46083,2017,773,235,1532,12,538,1544,13.898378223,4.2252508181,27.545039376,0.2157574886,9.6731274048,27.760796864
47103,2010,95,148,77,4,-53,81,NA,NA,NA,NA,NA,NA
47103,2011,348,367,2,17,-19,19,10.426810085,10.996089946,0.0599241959,0.5093556651,-0.569279861,0.569279861
47103,2012,357,406,44,4,-49,48,10.698712858,12.167163642,1.3186088676,0.1198735334,-1.468450784,1.4384824011
47103,2013,349,416,176,3,-67,179,10.443004833,12.447822379,5.2663863912,0.0897679498,-2.004817547,5.356154341
47103,2014,324,368,-9,-7,-44,-16,9.6885606208,11.004291075,-0.269126684,-0.209320754,-1.315730455,-0.478447438
47103,2015,356,407,205,-6,-51,199,10.632737482,12.155966728,6.1227842241,-0.179203441,-1.523229246,5.9435807834
47103,2016,371,418,25,-4,-47,21,11.061089413,12.4623595,0.7453564294,-0.119257029,-1.401270087,0.6260994007
47103,2017,349,403,282,-3,-54,279,10.374708304,11.97996403,8.3830021255,-0.089180874,-1.605255726,8.2938212518
53043,2010,28,26,4,0,2,4,NA,NA,NA,NA,NA,NA
53043,2011,106,127,-28,2,-21,-26,10.046441096,12.036773766,-2.653776893,0.1895554924,-1.99033267,-2.464221401
53043,2012,86,117,-69,2,-31,-67,8.2072815766,11.165720284,-6.584911963,0.1908670134,-2.958438708,-6.394044949
53043,2013,98,106,-129,2,-8,-127,9.4567210267,10.228698253,-12.44813278,0.1929943067,-0.771977227,-12.25513847
53043,2014,96,103,-68,2,-7,-66,9.3558132736,10.038007991,-6.627034402,0.1949127765,-0.682194718,-6.432121626
53043,2015,97,99,61,2,-2,63,9.4578783151,9.6528861154,5.9477379095,0.1950078003,-0.1950078,6.1427457098
53043,2016,99,117,64,2,-18,66,9.6027935399,11.348756002,6.2078665309,0.1939958291,-1.745962462,6.40186236
53043,2017,94,108,260,2,-14,262,8.9900535578,10.328997705,24.866105585,0.1912777353,-1.338944147,25.057383321
54043,2010,61,96,1,0,-35,1,NA,NA,NA,NA,NA,NA
54043,2011,289,287,-110,1,2,-109,13.361690323,13.269221878,-5.085764483,0.0462342226,0.0924684451,-5.03953026
54043,2012,252,251,41,1,1,42,11.669097729,11.622791785,1.8985436781,0.0463059434,0.0463059434,1.9448496214
54043,2013,287,268,-170,-3,19,-173,13.324666883,12.442546079,-7.892659826,-0.139282232,0.8821208041,-8.031942059
54043,2014,294,253,37,-4,41,33,13.676326929,11.769084058,1.7211703959,-0.186072475,1.9072428711,1.5350979206
54043,2015,227,246,-218,-4,-19,-222,10.601531851,11.488884738,-10.1812068,-0.186811134,-0.887352886,-10.36801793
54043,2016,240,305,-126,-4,-65,-130,11.323959611,14.390865339,-5.945078796,-0.18873266,-3.066905728,-6.133811456
54043,2017,229,307,-189,-4,-78,-193,10.925311896,14.646597171,-9.016960473,-0.190835142,-3.721285275,-9.207795616
55069,2010,82,51,9,-1,31,8,NA,NA,NA,NA,NA,NA
55069,2011,263,326,-254,1,-63,-253,9.1890569861,11.390237937,-8.874602565,0.0349393802,-2.201180951,-8.839663184
55069,2012,272,326,76,1,-54,77,9.5520710786,11.448438131,2.6689610367,0.0351179084,-1.896367052,2.7040789451
55069,2013,270,358,-78,1,-88,-77,9.5063727906,12.604746145,-2.746285473,0.0352087881,-3.098373354,-2.711076685
55069,2014,270,340,-153,2,-70,-151,9.5720920339,12.053745524,-5.424185486,0.0709043854,-2.48165349,-5.3532811
55069,2015,246,336,-145,2,-90,-143,8.7921513966,12.008792151,-5.182365661,0.0714809057,-3.216640755,-5.110884755
55069,2016,276,326,39,2,-50,41,9.9072096488,11.701994005,1.3999317982,0.0717913743,-1.794784357,1.4717231725
55069,2017,272,307,19,2,-35,21,9.768009768,11.02492279,0.6823242117,0.0718236012,-1.256913022,0.754147813
56023,2010,86,45,-56,0,41,-56,NA,NA,NA,NA,NA,NA
56023,2011,240,130,-196,-1,110,-197,13.29529402,7.2016175941,-10.85782345,-0.055397058,6.0936764258,-10.91322051
56023,2012,247,117,-201,-4,130,-205,13.742454169,6.5095835536,-11.18313072,-0.222549865,7.2328706151,-11.40568059
56023,2013,230,100,247,-5,130,242,12.689655172,5.5172413793,13.627586207,-0.275862069,7.1724137931,13.351724138
56023,2014,241,116,141,-10,125,131,13.069768703,6.2908430272,7.6466281624,-0.542314054,6.7789256759,7.1043141083
56023,2015,248,136,69,-10,112,59,13.296517706,7.2916387422,3.6994343618,-0.536149908,6.0048789642,3.1632844543
56023,2016,264,134,222,-11,130,211,13.963821009,7.0876970274,11.74230403,-0.581825875,6.8761239818,11.160478155
56023,2017,260,134,75,-11,126,64,13.56250489,6.9899063666,3.9122610261,-0.573798284,6.5725985238,3.3384627422
22061,2010,125,68,14,55,57,69,NA,NA,NA,NA,NA,NA
22061,2011,572,357,-234,212,215,-22,12.181746547,7.6029432122,-4.983441769,4.514913056,4.5788033351,-0.468528713
22061,2012,570,308,-405,179,262,-226,12.109238074,6.5432374154,-8.603932316,3.8027256408,5.5660006586,-4.801206675
22061,2013,593,386,-124,139,207,15,12.563160069,8.177706217,-2.627035158,2.9448216688,4.3854538521,0.317786511
22061,2014,566,397,-334,191,169,-143,11.959220326,8.3883577201,-7.057207754,4.0357086261,3.5708626063,-3.021499128
22061,2015,590,390,-109,203,200,94,12.424191375,8.2126010782,-2.295316712,4.2747641509,4.2115902965,1.9794474394
22061,2016,561,403,-356,211,158,-145,11.775695049,8.4591891353,-7.472633579,4.4290047334,3.3165059141,-3.043628845
22061,2017,564,406,-271,208,158,-63,11.825014939,8.5123334486,-5.681877745,4.360998417,3.3126814899,-1.320879328
19113,2010,760,333,-27,56,427,29,NA,NA,NA,NA,NA,NA
19113,2011,2632,1618,1059,257,1014,1316,12.367258716,7.6026689221,4.9760360868,1.2075932713,4.7645897942,6.1836293581
19113,2012,2771,1650,-28,276,1121,248,12.90953773,7.687021745,-0.13044643,1.2858290919,5.2225159855,1.1553826623
19113,2013,2707,1681,-416,329,1026,-87,12.545562824,7.7905766927,-1.927947593,1.5247470148,4.7549861313,-0.403200578
19113,2014,2716,1650,234,333,1066,567,12.514514256,7.6027056417,1.078201891,1.5343642295,4.9118086146,2.6125661205
19113,2015,2891,1775,690,369,1116,1059,13.207185147,8.1088736203,3.1521818581,1.6857320371,5.0983115269,4.8379138952
19113,2016,2806,1743,494,377,1063,871,12.700539298,7.8891803264,2.2359466903,1.7063803689000001,4.8113589713,3.9423270593
19113,2017,2818,1744,779,373,1074,1152,12.636346311,7.8203647859,3.4931560598,1.6725894869,4.8159815253,5.1657455467
20107,2010,25,38,-15,0,-13,-15,NA,NA,NA,NA,NA,NA
20107,2011,94,107,-2,1,-13,-1,9.771817662,11.123239254,-0.207911014,0.103955507,-1.351421592,-0.103955507
20107,2012,105,119,-114,0,-14,-114,10.996491596,12.462690475,-11.93904802,0,-1.466198879,-11.93904802
20107,2013,79,117,98,0,-38,98,8.3031162962,12.297020337,10.300068317,0,-3.993904041,10.300068317
20107,2014,113,115,-5,0,-2,-5,11.844863732,12.054507338,-0.524109015,0,-0.209643606,-0.524109015
20107,2015,98,101,46,0,-3,46,10.253191044,10.567064239,4.8127223268,0,-0.313873195,4.8127223268
20107,2016,117,101,31,0,16,31,12.183692596,10.5175466,3.2281578673,0,1.666145996,3.2281578673
20107,2017,104,114,109,0,-10,109,10.748243076,11.781727987,11.264985531,0,-1.033484911,11.264985531
29115,2010,28,19,-7,-1,9,-8,NA,NA,NA,NA,NA,NA
29115,2011,129,169,-139,2,-40,-137,10.177916289,13.333859324,-10.96690205,0.1577971518,-3.155943035,-10.8091049
29115,2012,138,178,-70,0,-40,-70,11.012688532,14.204772165,-5.586146357,0,-3.192083633,-5.586146357
29115,2013,127,164,-126,3,-37,-123,10.2452404,13.230074217,-10.16456922,0.2420135528,-2.984833817,-9.922555663
29115,2014,167,192,14,6,-25,20,13.562350266,15.592642222,1.1369634954,0.4872700694,-2.030291956,1.6242335648
29115,2015,157,180,-11,6,-23,-5,12.768899191,14.639502257,-0.894636249,0.4879834086,-1.870603066,-0.40665284
29115,2016,133,169,-109,6,-36,-103,10.892264854,13.84054707,-8.926743377,0.4913803694,-2.948282216,-8.435363007
29115,2017,135,160,73,6,-25,79,11.095586422,13.150324649,5.9998356209,0.4931371743,-2.054738226,6.4929727953
41043,2010,387,260,73,16,127,89,NA,NA,NA,NA,NA,NA
41043,2011,1453,1126,879,20,327,899,12.36648368,9.5833865271,7.4811694115,0.1702200094,2.7830971531,7.6513894208
41043,2012,1445,1124,-165,-6,321,-171,12.227421579,9.5111569933,-1.396210769,-0.050771301,2.7162645862,-1.446982069
41043,2013,1378,1137,-43,-33,241,-76,11.646874868,9.6099395681,-0.363436589,-0.278916452,2.0369352998,-0.642353041
41043,2014,1453,1215,421,-14,238,407,12.240273279,10.23532831,3.5465623197,-0.117937939,2.0049449693,3.4286243803
41043,2015,1471,1292,1015,-9,179,1006,12.297531716,10.801095157,8.4853804836,-0.075239827,1.4964365582,8.4101406567
41043,2016,1543,1318,2265,-2,225,2263,12.704293771,10.851755794,18.648882302,-0.016467004,1.852537977,18.632415298
41043,2017,1555,1301,2090,-3,254,2087,12.553128797,10.502649881,16.872050923,-0.024218255,2.050478916,16.847832668
48295,2010,14,10,-24,1,4,-23,NA,NA,NA,NA,NA,NA
48295,2011,58,25,4,9,33,13,17.543859649,7.5620084694,1.2099213551,2.722323049,9.9818511797,3.9322444041
48295,2012,35,31,104,4,4,108,10.33820706,9.1566976813,30.719243834,1.1815093782,1.1815093782,31.900753212
48295,2013,46,32,22,5,14,27,13.281362783,9.2392088927,6.3519561138,1.4436263895,4.0421538906,7.7955825032
48295,2014,48,30,39,7,18,46,13.651877133,8.5324232082000009,11.092150171,1.9908987486,5.1194539249,13.083048919
48295,2015,43,22,-20,8,21,-12,12.105855856,6.1936936937,-5.630630631,2.2522522523,5.9121621622,-3.378378378
48295,2016,48,16,-92,11,32,-81,13.586187376,4.5287291254,-26.04019247,3.1135012737,9.0574582508,-22.9266912
48295,2017,44,24,-164,11,20,-153,12.77769711,6.9696529694,-47.62596196,3.1944242776,5.8080441411,-44.43153768
09005,2010,416,372,-177,46,44,-131,NA,NA,NA,NA,NA,NA
09005,2011,1557,1669,-824,177,-112,-647,8.2184188649,8.8095960729,-4.349375173,0.9342711234,-0.591177208,-3.41510405
09005,2012,1466,1753,-1286,172,-287,-1114,7.7821218226,9.3056340757,-6.826608911,0.9130456709,-1.523512253,-5.91356324
09005,2013,1424,1824,-503,292,-400,-211,7.5997939943,9.7345675883,-2.684477794,1.5583847236,-2.134773594,-1.126093071
09005,2014,1429,1819,-1405,311,-390,-1094,7.6694566171,9.7625903335,-7.540648388,1.6691399636,-2.093133716,-5.871508425
09005,2015,1424,1762,-1235,332,-338,-903,7.6986705737,9.526023561,-6.676866684,1.7949147686,-1.827352987,-4.881951916
09005,2016,1450,1798,-1241,338,-348,-903,7.8923161499,9.7864720258,-6.754734029,1.8397261094,-1.894155876,-4.91500792
09005,2017,1423,1772,-906,337,-349,-569,7.7914113789,9.7023056664,-4.960659669,1.845190186,-1.910894288,-3.115469483
05081,2010,44,58,-25,0,-14,-25,NA,NA,NA,NA,NA,NA
05081,2011,126,171,-139,-4,-45,-143,9.6644295302,13.116011505,-10.66155321,-0.306807287,-3.451581975,-10.9683605
05081,2012,136,155,-1,-6,-19,-7,10.517768068,11.987162136,-0.07733653,-0.464019179,-1.469394068,-0.541355709
05081,2013,140,135,-179,-5,5,-184,10.912775741999999,10.523033752,-13.95276327,-0.389741991,0.3897419908,-14.34250526
05081,2014,156,150,-223,-4,6,-227,12.350077188,11.875074219,-17.65427701,-0.316668646,0.4750029688,-17.97094565
05081,2015,114,165,-48,-4,-51,-52,9.1412076016,13.230695213,-3.848929516,-0.320744126,-4.089487611,-4.169673643
05081,2016,132,169,53,-4,-37,49,10.623742455,13.601609658,4.2655935614,-0.32193159,-2.977867203,3.9436619718
05081,2017,122,173,-16,-4,-51,-20,9.8430755577,13.957803865,-1.290895155,-0.322723789,-4.114728307,-1.613618944
48297,2010,34,34,22,1,0,23,NA,NA,NA,NA,NA,NA
48297,2011,102,109,-46,6,-7,-40,8.8491736433,9.4564698738,-3.9908038,0.5205396261,-0.60729623,-3.470264174
48297,2012,120,111,126,7,9,133,10.36672282,9.5892186083,10.885058961,0.6047254978,0.7775042115,11.489784459
48297,2013,125,135,164,7,-10,171,10.654619843,11.506989431,13.978861234,0.5966587112,-0.852369587,14.575519945
48297,2014,130,109,197,10,21,207,10.897355296,9.1370132864,16.513684563,0.8382580997,1.7603420093,17.351942663
48297,2015,136,140,101,16,-4,117,11.2387406,11.569291794,8.3464176514,1.3222047765,-0.330551194,9.6686224279
48297,2016,127,115,-163,17,12,-146,10.504549214,9.511993383,-13.48221671,1.406120761,0.9925558313,-12.07609595
48297,2017,125,115,123,17,10,140,10.332286328,9.5057034221,10.166969747,1.4051909407,0.8265829063,11.572160688
17105,2010,127,141,-83,3,-14,-80,NA,NA,NA,NA,NA,NA
17105,2011,437,382,-130,16,55,-114,11.254619674,9.8381343601,-3.348056196,0.4120684549,1.4164853136,-2.935987741
17105,2012,427,454,-296,27,-27,-269,11.046865096,11.745378814,-7.65778002,0.698513718,-0.698513718,-6.959266302
17105,2013,415,441,-1138,12,-26,-1126,10.935873618,11.621012688,-29.98801007,0.3162180323,-0.68513907,-29.67179203
17105,2014,385,406,-374,15,-21,-359,10.349323262,10.913831803,-10.05362831,0.4032203868,-0.564508542,-9.650407925
17105,2015,398,422,-338,15,-24,-323,10.803474484,11.454940282,-9.174809989,0.4071661238,-0.651465798,-8.767643865
17105,2016,401,398,-211,15,3,-196,10.964822334,10.882791245,-5.769519981,0.4101554489,0.0820310898,-5.359364532
17105,2017,400,361,-9,15,39,6,10.959955064,9.8913594454,-0.246598989,0.4109983149,1.0685956188,0.164399326
21139,2010,23,46,23,0,-23,23,NA,NA,NA,NA,NA,NA
21139,2011,101,139,21,1,-38,22,10.618724702,14.613888451,2.2078536508,0.1051358881,-3.995163749,2.312989539
21139,2012,99,115,-52,3,-16,-49,10.45406547,12.143611404,-5.491024287,0.3167898627,-1.689545935,-5.174234424
21139,2013,108,128,-91,5,-20,-86,11.508951407,13.640238704,-9.697357204,0.5328218244,-2.131287298,-9.164535379
21139,2014,107,130,20,5,-23,25,11.467152502,13.932054442,2.1433929911,0.5358482478,-2.46490194,2.6792412389
21139,2015,94,114,-21,5,-20,-16,10.093417803,12.240953506,-2.254912488,0.5368839257,-2.147535703,-1.718028562
21139,2016,86,124,-47,5,-38,-42,9.2922744462,13.398163155,-5.078336035,0.5402485143,-4.105888709,-4.53808752
21139,2017,84,124,91,4,-40,95,9.0889417875,13.417009305,9.8463536031,0.4328067518,-4.328067518,10.279160355
26093,2010,479,257,-141,14,222,-127,NA,NA,NA,NA,NA,NA
26093,2011,1707,1348,573,28,359,601,9.4034820979,7.4258312056,3.1565291401,0.154245752,1.9776508923,3.3107748921
26093,2012,1709,1316,320,45,393,365,9.3712900741,7.2162772016,1.7547178606,0.2467571991,2.1550128725,2.0014750597
26093,2013,1778,1355,949,59,423,1008,9.6926217779,7.3866718273,5.1733959883,0.321633681,2.3059499505,5.4950296693
26093,2014,1758,1355,869,75,403,944,9.5128068462,7.3321122165,4.7022918938,0.4058364695,2.1806946297,5.1081283634
26093,2015,1819,1415,1179,82,404,1261,9.7643983273,7.595724922,6.3288761011,0.4401762852,2.1686734053,6.7690523863
26093,2016,1782,1494,872,87,288,959,9.4920526697,7.9579835514,4.6448203861,0.4634167128,1.5340691183,5.1082370989
26093,2017,1799,1522,945,86,277,1031,9.5182918925,8.0527183215,4.9998809552,0.4550156213,1.465573571,5.4548965765
29117,2010,50,63,-60,0,-13,-60,NA,NA,NA,NA,NA,NA
29117,2011,155,187,18,4,-32,22,10.250644799,12.366906951,1.1903974605,0.264532769,-2.116262152,1.4549302295
29117,2012,165,197,-96,5,-32,-91,10.959450035,13.084919133,-6.376407293,0.3321045465,-2.125469098,-6.044302747
29117,2013,173,172,-129,5,1,-124,11.584692135,11.517728597,-8.638296448,0.3348176918,0.0669635384,-8.303478756
29117,2014,153,193,169,5,-40,174,10.240278428,12.917475403,11.311157218,0.3346496218,-2.677196975,11.64580684
29117,2015,171,206,-46,5,-35,-41,11.421701232,13.759476338,-3.072504425,0.3339678723,-2.337775106,-2.738536553
29117,2016,147,197,249,5,-50,254,9.776861428,13.102324499,16.560806092,0.3325463071,-3.325463071,16.893352399
29117,2017,163,190,58,5,-27,63,10.75517139,12.536702847,3.8269935007,0.3299132328,-1.781531457,4.1569067335
36051,2010,145,109,-10,15,36,5,NA,NA,NA,NA,NA,NA
36051,2011,568,557,-512,106,11,-406,8.7310066021,8.5619202066,-7.870203134,1.6293779926,0.1690863955,-6.240825142
36051,2012,572,535,-149,90,37,-59,8.8204906783,8.2499344631,-2.297645299,1.3878394424,0.5705562152,-0.909805857
36051,2013,519,537,-219,87,-18,-132,8.0142681769,8.2922196743,-3.381743219,1.3434322377,-0.277951497,-2.038310981
36051,2014,520,517,-112,98,3,-14,8.040201005,7.99381523,-1.731735601,1.5152686509,0.046385775,-0.21646695
36051,2015,490,519,-227,107,-29,-120,7.5863136708,8.035299582,-3.514475925,1.6566031893,-0.448985911,-1.857872736
36051,2016,535,548,-408,107,-13,-301,8.3128748563,8.5148699462,-6.339538208,1.6625749713,-0.20199509,-4.676963237
36051,2017,503,534,-483,109,-31,-374,7.8593135991,8.343684815,-7.54681604,1.7031116944,-0.484371216,-5.843704346
22063,2010,447,189,369,16,258,385,NA,NA,NA,NA,NA,NA
22063,2011,1770,913,570,28,857,598,13.674870301,7.0537607825,4.4037717919,0.2163256319,6.6211095187,4.6200974238
22063,2012,1794,923,818,-4,871,814,13.694499681,7.0457208505,6.2442033106,-0.030534002,6.6487788308,6.2136693091
22063,2013,1825,1059,1397,7,766,1404,13.728410664,7.9662393934,10.508816272,0.0526569176,5.7621712704,10.56147319
22063,2014,1898,1067,693,30,831,723,14.079700899,7.9151953948,5.140797009,0.2225453251,6.1645055043,5.3633423341
22063,2015,1864,1084,1157,44,780,1201,13.648528427,7.9372343425,8.4717528913,0.3221755637,5.7112940841,8.7939284551
22063,2016,1916,1121,1666,55,795,1721,13.80184697,8.0750889628,12.000979672,0.3961908055,5.7267580067,12.397170477
22063,2017,1910,1133,-2695,55,777,-2640,13.725800193,8.1420584389,-19.36703221,0.3952455553,5.5837417537,-18.97178665
48299,2010,35,52,47,1,-17,48,NA,NA,NA,NA,NA,NA
48299,2011,137,301,-115,11,-164,-104,7.1367176308,15.679941656,-5.990675384,0.5730211236,-8.543224025,-5.41765426
48299,2012,155,294,317,11,-139,328,8.0904037372,15.345669024,16.546180546,0.5741576846,-7.255265287,17.120338231
48299,2013,155,313,393,0,-158,393,7.9989678751,16.152754483,20.281254032,0,-8.153786608,20.281254032
48299,2014,163,284,256,1,-121,257,8.329500741,14.512749757,13.081915274,0.0511012315,-6.183249016,13.133016506
48299,2015,167,299,535,3,-132,538,8.4139459895,15.064490125,26.954856913,0.1511487304,-6.650544135,27.106005643
48299,2016,177,306,640,3,-129,643,8.7134171856,15.063873779,31.506141236,0.147685037,-6.350456593,31.653826273
48299,2017,184,313,763,3,-129,766,8.8080421254,14.983245572,36.524652944,0.1436093825,-6.175203447,36.668262326
05083,2010,55,96,-12,3,-41,-9,NA,NA,NA,NA,NA,NA
05083,2011,259,265,-62,-1,-6,-63,11.633390976,11.902890381,-2.784827184,-0.044916567,-0.269499405,-2.829743751
05083,2012,270,261,-351,16,9,-335,12.234355884,11.826544021,-15.90466265,0.7249988672,0.4078118628,-15.17966378
05083,2013,258,271,80,38,-13,118,11.74863388,12.340619308,3.6429872495,1.7304189435,-0.591985428,5.3734061931
05083,2014,227,295,-130,38,-68,-92,10.351117191,13.451892385,-5.927952576,1.7327861377,-3.100775194,-4.195166439
05083,2015,291,304,-165,42,-13,-123,13.360268124,13.95711859,-7.575409761,1.9282861209,-0.596850466,-5.64712364
05083,2016,270,295,-16,42,-25,26,12.434946806,13.58633077,-0.736885737,1.9343250587,-1.151383964,1.1974393221
05083,2017,270,292,-9,42,-22,33,12.432370208,13.445378151,-0.41441234,1.9339242546,-1.013007943,1.5195119144
08075,2010,57,29,-670,-3,28,-673,NA,NA,NA,NA,NA,NA
08075,2011,211,183,-66,-14,28,-80,9.5425457341,8.2762363476,-2.984872125,-0.633154693,1.2663093865,-3.618026819
08075,2012,224,184,-249,-14,40,-263,10.193169666,8.3729607973,-11.33080021,-0.637073104,1.820208869,-11.96787331
08075,2013,252,199,-263,19,53,-244,11.573701977,9.1395503709,-12.07890325,0.8726203872,2.4341516063,-11.20628287
08075,2014,241,241,257,16,0,273,11.04541913,11.04541913,11.778724964,0.7333058344,0,12.512030799
08075,2015,219,186,-43,21,33,-22,9.9713153941,8.4687884169,-1.957838182,0.9561535309,1.5025269772,-1.001684651
08075,2016,233,233,-64,23,0,-41,10.616727041,10.616727041,-2.916182535,1.0480030984,0,-1.868179436
08075,2017,232,213,-72,24,19,-48,10.588530613,9.7213664681,-3.286095708,1.0953652358,0.867164145,-2.190730472
17107,2010,77,67,-32,1,10,-31,NA,NA,NA,NA,NA,NA
17107,2011,306,314,-30,12,-8,-18,10.110187831,10.374506468,-0.991194885,0.3964779542,-0.264318636,-0.594716931
17107,2012,268,298,96,15,-30,111,8.8470743583,9.8374185029,3.1691012627,0.4951720723,-0.990344145,3.664273335
17107,2013,303,341,-521,6,-38,-515,10.078834448,11.342846689,-17.33027309,0.1995808802,-1.264012241,-17.13069221
17107,2014,322,338,-136,7,-16,-129,10.835001767,11.373386948,-4.576274038,0.2355435167,-0.538385181,-4.340730521
17107,2015,327,368,-198,7,-41,-191,11.074234625,12.462747223,-6.705499865,0.2370631265,-1.388512598,-6.468436738
17107,2016,301,320,-61,7,-19,-54,10.246808511,10.893617021,-2.076595745,0.2382978723,-0.646808511,-1.838297872
17107,2017,302,312,-90,7,-10,-83,10.310158237,10.651554205,-3.072563713,0.2389771777,-0.341395968,-2.833586535
20109,2010,12,8,9,1,4,10,NA,NA,NA,NA,NA,NA
20109,2011,32,40,-5,5,-8,0,11.57323689,14.466546112,-1.808318264,1.808318264,-2.893309222,0
20109,2012,31,32,28,2,-1,30,11.171171171,11.531531532,10.09009009,0.7207207207,-0.36036036,10.810810811
20109,2013,33,37,-14,0,-4,-14,11.870503597,13.309352518,-5.035971223,0,-1.438848921,-5.035971223
20109,2014,37,49,5,0,-12,5,13.369467028,17.705510388,1.8066847335,0,-4.33604336,1.8066847335
20109,2015,37,43,23,0,-6,23,13.345356177,15.509467989,8.2957619477,0,-2.164111812,8.2957619477
20109,2016,44,20,7,0,24,7,15.733953156,7.151796889,2.5031289111,0,8.5821562668,2.5031289111
20109,2017,43,18,-15,0,25,-15,15.267175573,6.3909107048,-5.325758921,0,8.8762648677,-5.325758921
21141,2010,84,50,-15,0,34,-15,NA,NA,NA,NA,NA,NA
21141,2011,341,309,-52,2,32,-50,12.705154716,11.512882133,-1.937442948,0.0745170365,1.1922725833,-1.862925911
21141,2012,326,294,-146,-7,32,-153,12.177810982,10.982443033,-5.453866268,-0.261486739,1.1953679492,-5.715353007
21141,2013,403,307,170,-6,96,164,15.014343728,11.437725867,6.3335941284,-0.223538616,3.5766178607,6.1100555121
21141,2014,358,299,-215,-6,59,-221,13.313747002,11.119581993,-7.995686048,-0.223135425,2.1941650086,-8.218821473
21141,2015,331,342,-50,-6,-11,-56,12.363432627,12.774301989,-1.86758801,-0.224110561,-0.410869362,-2.091698571
21141,2016,353,299,-127,-6,54,-133,13.222459452,11.199760273,-4.757088811,-0.224744353,2.0226991797,-4.981833165
21141,2017,353,273,329,-6,80,323,13.142952883,10.164379991,12.249381015,-0.223392967,2.9785728913,12.025988048
31113,2010,3,0,6,0,3,6,NA,NA,NA,NA,NA,NA
31113,2011,9,6,4,0,3,4,11.605415861000001,7.7369439072,5.1579626048,0,3.8684719536,5.1579626048
31113,2012,10,6,2,0,4,2,12.787723785,7.6726342711,2.557544757,0,5.1150895141,2.557544757
31113,2013,11,3,-16,1,8,-15,14.084507042,3.8412291933,-20.4865557,1.2804097311,10.243277849,-19.20614597
31113,2014,12,7,-18,2,5,-16,15.544041451,9.067357513,-23.31606218,2.5906735751,6.4766839378,-20.7253886
31113,2015,9,7,20,2,2,22,11.553273427,8.9858793325,25.67394095,2.567394095,2.567394095,28.241335045
31113,2016,13,7,-3,2,6,-1,16.37279597,8.8161209068,-3.778337531,2.5188916877,7.556675063,-1.259445844
31113,2017,8,6,-34,2,2,-32,10.223642173,7.6677316294,-43.45047923,2.5559105431,2.5559105431,-40.89456869
38047,2010,3,2,9,0,1,9,NA,NA,NA,NA,NA,NA
38047,2011,20,28,-19,1,-8,-18,10.065425264,14.09159537,-9.562154001,0.5032712632,-4.026170106,-9.058882738
38047,2012,22,29,-26,2,-7,-24,11.2302195,14.803471159,-13.27207759,1.0209290454,-3.573251659,-12.25114855
38047,2013,16,27,2,1,-11,3,8.2495488528,13.921113689,1.0311936066,0.5155968033,-5.671564836,1.5467904099
38047,2014,19,30,18,3,-11,21,9.793814433,15.463917526,9.2783505155,1.5463917526,-5.670103093,10.824742268
38047,2015,26,29,-15,3,-3,-12,13.422818792,14.971605576,-7.743933918,1.5487867837,-1.548786784,-6.195147135
38047,2016,19,23,5,3,-4,8,9.842009842,11.914011914,2.59000259,1.554001554,-2.072002072,4.144004144
38047,2017,20,27,-10,3,-7,-7,10.38961039,14.025974026,-5.194805195,1.5584415584,-3.636363636,-3.636363636
39091,2010,123,149,-81,1,-26,-80,NA,NA,NA,NA,NA,NA
39091,2011,585,449,-270,8,136,-262,12.804797969,9.8279560478,-5.909906755,0.1751083483,2.9768419209,-5.734798407
39091,2012,515,434,-305,9,81,-296,11.314702522,9.5351085333,-6.700940329,0.1977326654,1.7795939889,-6.503207663
39091,2013,554,466,-127,20,88,-107,12.203046356,10.264656321,-2.797449255,0.4405431898,1.9383900349,-2.356906065
39091,2014,561,483,-12,24,78,12,12.349076021,10.632092189,-0.264151359,0.5283027175,1.7169838317,0.2641513587
39091,2015,548,532,-247,26,16,-221,12.079930342,11.727231646,-5.444786121,0.5731353812,0.3526986961,-4.87165074
39091,2016,540,481,-175,27,59,-148,11.942807223,10.637944953,-3.870354193,0.5971403612,1.3048622707,-3.273213832
39091,2017,532,484,82,27,48,109,11.757425743,10.696605375,1.8122347949,0.5967114569,1.0608203678,2.4089462518
40083,2010,127,104,163,6,23,169,NA,NA,NA,NA,NA,NA
40083,2011,483,357,392,-4,126,388,11.41506647,8.4372230428,9.2644017725,-0.094534712,2.9778434269,9.1698670606
40083,2012,456,307,336,-7,149,329,10.651841297,7.1713054345,7.8487251661,-0.163515108,3.4805358624,7.6852100585
40083,2013,472,371,676,-1,101,675,10.865686759999999,8.5406139573,15.56187341,-0.023020523,2.3250728024,15.538852887
40083,2014,474,335,694,3,139,697,10.710654163,7.5697661281,15.681843859,0.0677889504,3.1408880353,15.74963281
40083,2015,558,391,482,3,167,485,12.398209148,8.6876340084,10.709564174,0.0666570384,3.7105751391,10.776221212
40083,2016,538,354,482,3,184,485,11.780677936,7.7515984935,10.554436367,0.0656915127,4.0290794429,10.620127879
40083,2017,553,391,618,2,162,620,11.919901709,8.4279956028,13.320975147,0.0431099519,3.4919061065,13.364085099
54045,2010,100,150,20,0,-50,20,NA,NA,NA,NA,NA,NA
54045,2011,455,525,-189,-7,-70,-196,12.438660999,14.352301152,-5.166828415,-0.191364015,-1.913640154,-5.35819243
54045,2012,436,543,-26,-4,-107,-30,11.986419057,14.928040248,-0.714786458,-0.109967147,-2.941621191,-0.824753605
54045,2013,442,541,-282,-5,-99,-287,12.240037662,14.981584559,-7.809254798,-0.138461964,-2.741546897,-7.947716762
54045,2014,415,529,-582,-3,-114,-585,11.664839644,14.86915704,-16.35888355,-0.084324142,-3.204317396,-16.44320769
54045,2015,373,529,-665,-3,-156,-668,10.710081259,15.189364573,-19.0943808,-0.086140064,-4.479283315,-19.18052086
54045,2016,325,540,-557,-3,-215,-560,9.5499757578,15.867652028,-16.36718922,-0.088153622,-6.317676271,-16.45534284
54045,2017,332,492,-559,-3,-160,-562,9.9746128078,14.781655125,-16.79460409,-0.090132043,-4.807042317,-16.88473614
13183,2010,49,6,170,14,43,184,NA,NA,NA,NA,NA,NA
13183,2011,149,74,427,20,75,447,9.972558731,4.9528144033,28.579077706,1.3385984874,5.0197443277,29.917676193
13183,2012,247,92,662,80,155,742,15.765622008,5.8722154848,42.254420119,5.1062743346,9.8934065233,47.360694453
13183,2013,241,88,278,54,153,332,14.720254092,5.3750305399,16.980210115,3.298314195,9.3452235524,20.27852431
13183,2014,261,95,350,53,166,403,15.437392796,5.6189743893,20.701484592,3.1347962382,9.8184184066,23.83628083
13183,2015,307,105,377,77,202,454,17.514333799,5.990244459,21.507830105,4.3928459366,11.52408934,25.900676042
13183,2016,280,90,493,51,190,544,15.361404471,4.9375942943,27.047044301,2.7979701001,10.423810177,29.845014401
13183,2017,257,97,227,31,160,258,13.667304829,5.1584769198,12.071899596,1.6485854074,8.508827909,13.720485003
05085,2010,230,103,186,38,127,224,NA,NA,NA,NA,NA,NA
05085,2011,972,602,288,94,370,382,14.069726205,8.7139662298,4.1688077644,1.3606525342,5.3557599751,5.5294602986
05085,2012,954,604,89,127,350,216,13.680263281,8.6612987646,1.2762509769,1.8211671243,5.0189645159,3.0974181013
05085,2013,952,638,234,98,314,332,13.535801627,9.0712620144,3.3270772906,1.3933913439,4.4645396121,4.7204686345
05085,2014,961,578,135,107,383,242,13.543318183,8.1457210302,1.9025472994,1.5079448966,5.3975971532,3.410492196
05085,2015,978,676,-422,124,302,-298,13.723234081,9.485589201,-5.921477282,1.7399601493,4.2376448797,-4.181517133
05085,2016,956,664,108,90,292,198,13.368292257,9.2850900192,1.5102254851,1.2585212375,4.0832022374,2.7687467226
05085,2017,975,663,762,69,312,831,13.480349798,9.1666378625,10.535411842,0.9539939857,4.3137119353,11.489405828
39093,2010,825,721,-54,71,104,17,NA,NA,NA,NA,NA,NA
39093,2011,3478,2894,-572,365,584,-207,11.530358359,9.594265984,-1.896309655,1.2100577347,1.9360923755,-0.686251921
39093,2012,3316,2783,-1151,438,533,-713,10.990085392,9.2235849354,-3.814712993,1.4516457785,1.7665004565,-2.363067215
39093,2013,3395,2974,443,449,421,892,11.231587392,9.8388043901,1.4655650117,1.4854146507,1.3927830021,2.9509796624
39093,2014,3365,2916,421,593,449,1014,11.083279399,9.6044109146,1.38664506,1.9531603815,1.4788684845,3.3398054415
39093,2015,3456,3024,-25,612,432,587,11.338508278,9.9211947428,-0.082020459,2.0078608408,1.4173135347,1.9258403816
39093,2016,3333,3006,339,641,327,980,10.894275194,9.825439914,1.1080585931,2.0951786377,1.0688352801,3.2032372308
39093,2017,3329,2947,328,641,382,969,10.83457822,9.591319319,1.0675102601,2.0862014535,1.2432589005,3.1537117136
35028,2010,36,43,41,9,-7,50,NA,NA,NA,NA,NA,NA
35028,2011,188,110,50,55,78,105,10.394780493,6.0820524162,2.7645692801,3.0410262081,4.312728077,5.8055954882
35028,2012,167,121,-128,70,46,-58,9.1894568866,6.6582292412,-7.043416057,3.8518681561,2.5312276454,-3.191547901
35028,2013,160,139,-430,58,21,-372,8.8891358093,7.7224367344,-23.88955249,3.2223117309,1.166699075,-20.66724076
35028,2014,181,112,-267,73,69,-194,10.185706246,6.3027574564,-15.02532358,4.1080472707,3.8829487901,-10.91727631
35028,2015,149,125,-90,81,24,-9,8.4097643573,7.0551714407,-5.079723437,4.5717510936,1.3545929166,-0.507972344
35028,2016,181,116,281,83,65,364,10.090029824,6.4665384508,15.664631937,4.6269197536,3.6234913733,20.29155169
35028,2017,185,113,429,83,72,512,10.029818379,6.1263214963,23.258335592,4.4998644619,3.9034968826,27.758200054
06037,2010,31737,13806,-21877,9250,17931,-12627,NA,NA,NA,NA,NA,NA
06037,2011,132631,58181,-55988,43083,74450,-12905,13.457911341,5.9035575375,-5.681036411,4.3715812617,7.5543538039,-1.309455149
06037,2012,129152,57976,-38641,38602,71176,-39,13.017944124,5.8437215725,-3.894840025,3.8909089993,7.1742225515,-0.003931026
06037,2013,130661,60094,-45797,38343,70567,-7454,13.082612874,6.0169946506,-4.585487803,3.8391457698,7.0656182232999996,-0.746342033
06037,2014,129434,57997,-59884,43110,71437,-16774,12.884582525,5.7733449689,-5.961187477,4.2914099282,7.1112375561,-1.669777549
06037,2015,128601,60445,-65491,48289,68156,-17202,12.735330061,5.9858556741,-6.485559996,4.7820495433,6.749474387,-1.703510453
06037,2016,123057,65963,-79131,49296,57094,-29835,12.139506514,6.5072142843,-7.806230364,4.863023746,5.6322922297,-2.943206618
06037,2017,122923,67251,-91680,48844,55672,-42836,12.10225526,6.6211267907,-9.026258408,4.8088848785,5.4811284694,-4.217373529
47105,2010,117,152,171,7,-35,178,NA,NA,NA,NA,NA,NA
47105,2011,543,535,348,42,8,390,11.103953866,10.940359703,7.1163461244,0.8588693598,0.1635941638,7.9752154842
47105,2012,544,573,661,0,-29,661,11.007132379,11.593909657,13.374475188,0,-0.586777278,13.374475188
47105,2013,534,667,699,-12,-133,687,10.674555976,13.333200068,13.972873834,-0.239877662,-2.658644092,13.732996172
47105,2014,539,598,277,6,-59,283,10.690202301,11.860372868,5.4938516462,0.1190003967,-1.170170567,5.6128520428
47105,2015,532,645,420,14,-113,434,10.49464911,12.723775706,8.2852492972,0.2761749766,-2.229126597,8.5614242738
47105,2016,530,645,528,13,-115,541,10.379233699,12.631331577,10.34006678,0.2545849775,-2.252097878,10.594651757
47105,2017,544,611,926,14,-67,940,10.519496843,11.815096638,17.906349406,0.2707223452,-1.295599795,18.177071751
51107,2010,1291,194,1539,493,1097,2032,NA,NA,NA,NA,NA,NA
51107,2011,5017,1022,4985,2219,3995,7204,15.61721785,3.1813427632,15.517606335,6.9074359996,12.435875087,22.425042335
51107,2012,5005,1066,5026,2317,3939,7343,15.048761897,3.2051908457,15.111903556,6.9666296336,11.843571052,22.078533189
51107,2013,4910,1120,6440,2235,3790,8675,14.249789228,3.2504610866,18.690151248,6.4864111862,10.999328141,25.176562434
51107,2014,5109,1155,5618,2327,3954,7945,14.316297994,3.2365089417,15.742603666,6.5206548116,11.079789052,22.263258478
51107,2015,5172,1206,5253,2552,3966,7805,14.024412565,3.2701936492,14.244052437,6.9200117684,10.754218916,21.164064205
51107,2016,5340,1398,5056,2574,3942,7630,14.034608187,3.6742288849999998,13.288198314,6.7649965308,10.360379302,20.053194845
51107,2017,5339,1475,5392,2535,3864,7927,13.613664151,3.7610328944,13.74880635,6.4638768727,9.8526312569,20.212683223
19115,2010,25,12,-22,0,13,-22,NA,NA,NA,NA,NA,NA
19115,2011,133,108,-46,17,25,-29,11.690252263,9.4928364244,-4.043245144,1.4942427705,2.197415839,-2.549002373
19115,2012,136,99,-82,25,37,-57,11.967090501,8.7113379383,-7.215451626,2.1998328127,3.2557525628,-5.015618813
19115,2013,126,105,-80,41,21,-39,11.105724737,9.2547706139,-7.051253801,3.613767573,1.8509541228,-3.437486228
19115,2014,141,114,-183,42,27,-141,12.499445947,10.105935021,-16.22268516,3.7232392181,2.3935109259,-12.49944595
19115,2015,154,110,-57,43,44,-14,13.700458165,9.7860415462,-5.070948801,3.8254526044,3.9144166184999998,-1.245496197
19115,2016,138,98,-153,45,40,-108,12.297273213,8.732846195,-13.63393335,4.0099803957,3.5644270184,-9.62395295
19115,2017,141,111,-78,44,30,-34,12.605042017,9.9231181834,-6.973001967,3.9334882889,2.6819238334,-3.039513678
51109,2010,102,49,83,2,53,85,NA,NA,NA,NA,NA,NA
51109,2011,367,278,63,1,89,64,10.992796274,8.3269682946,1.8870467718,0.0299531234,2.6658279792,1.9169998952
51109,2012,382,300,-40,0,82,-40,11.409796894,8.9605734767,-1.19474313,0,2.449223417,-1.19474313
51109,2013,383,277,379,5,106,384,11.349493273,8.2083802525,11.230960706,0.1481657085,3.1411130208,11.379126415
51109,2014,375,298,245,5,77,250,10.979037358,8.7246750205,7.1729710739,0.1463871648,2.2543623375,7.3193582387
51109,2015,360,303,236,5,57,241,10.444318726,8.7906349275,6.8468311647,0.1450599823,1.6536837983,6.991891147
51109,2016,367,322,606,6,45,612,10.501616734,9.2139525567,17.340544253,0.171688557,1.2876641772,17.51223281
51109,2017,375,351,549,6,24,555,10.543184885,9.8684210526,15.435222672,0.1686909582,0.6747638327,15.60391363
31115,2010,0,3,2,0,-3,2,NA,NA,NA,NA,NA,NA
31115,2011,5,4,-12,0,1,-12,8.038585209,6.4308681672,-19.2926045,0,1.6077170418,-19.2926045
31115,2012,8,5,-13,0,3,-13,13.104013104,8.19000819,-21.29402129,0,4.914004914,-21.29402129
31115,2013,4,3,-19,0,1,-19,6.711409396,5.033557047,-31.87919463,0,1.677852349,-31.87919463
31115,2014,5,2,5,0,3,5,8.4530853762,3.3812341505,8.4530853762,0,5.0718512257,8.4530853762
31115,2015,8,8,10,0,0,10,13.311148087,13.311148087,16.638935108,0,0,16.638935108
31115,2016,6,6,9,0,0,9,9.8199672668,9.8199672668,14.7299509,0,0,14.7299509
31115,2017,6,4,-9,0,2,-9,9.7959183673,6.5306122449,-14.69387755,0,3.2653061224,-14.69387755
40085,2010,27,47,14,1,-20,15,NA,NA,NA,NA,NA,NA
40085,2011,135,112,-64,7,23,-57,14.363994254,11.916795233,-6.809597276,0.7447997021,2.4471990211,-6.064797574
40085,2012,118,88,140,4,30,144,12.461717182,9.2934840004,14.785088182,0.4224310909,3.168233182,15.207519273
40085,2013,145,116,96,4,29,100,15.07119842,12.056958736,9.9781727471,0.4157571978,3.014239684,10.393929945
40085,2014,111,116,40,7,-5,47,11.436814178,11.951985987,4.1213744784,0.7212405337,-0.51517181,4.8426150121
40085,2015,102,113,73,8,-11,81,10.450819672,11.577868852,7.4795081967,0.8196721311,-1.12704918,8.2991803279
40085,2016,127,119,168,7,8,175,12.846449525,12.037224358,16.993728505,0.708072021,0.8092251669,17.701800526
40085,2017,122,121,47,8,1,55,12.192684389,12.092744353,4.697181691,0.7995202878,0.099940036,5.4967019788
48301,2010,0,0,2,0,0,2,NA,NA,NA,NA,NA,NA
48301,2011,2,1,11,0,1,11,22.346368715,11.173184358,122.90502793,0,11.173184358,122.90502793
48301,2012,2,2,-9,0,0,-9,22.099447514,22.099447514,-99.44751381,0,0,-99.44751381
48301,2013,2,2,20,0,0,20,20.833333333,20.833333333,208.33333333,0,0,208.33333333
48301,2014,2,1,-17,0,1,-17,20.512820513,10.256410256,-174.3589744,0,10.256410256,-174.3589744
48301,2015,2,2,29,0,0,29,19.230769231,19.230769231,278.84615385,0,0,278.84615385
48301,2016,1,1,-4,0,0,-4,8.547008547,8.547008547,-34.18803419,0,0,-34.18803419
48301,2017,0,0,19,0,0,19,0,0,152.61044177,0,0,152.61044177
01085,2010,37,18,-26,0,19,-26,NA,NA,NA,NA,NA,NA
01085,2011,149,155,-147,0,-6,-147,13.296448331,13.831875781,-13.11797251,0,-0.53542745,-13.11797251
01085,2012,147,114,-324,-1,33,-325,13.378230797,10.374954496,-29.48671278,-0.091008373,3.0032763014,-29.57772115
01085,2013,140,141,-191,0,-1,-191,13.020833333,13.113839286,-17.7641369,0,-0.093005952,-17.7641369
01085,2014,119,109,-179,-1,10,-180,11.254551473,10.308790845,-16.92911524,-0.094576063,0.945760628,-17.0236913
01085,2015,129,146,-127,-1,-17,-128,12.383603725,14.015551502,-12.19160987,-0.095996928,-1.631947778,-12.2876068
01085,2016,122,128,-96,-1,-6,-97,11.852715438,12.435635869,-9.326726902,-0.097153405,-0.582920431,-9.423880307
01085,2017,120,147,-137,-1,-27,-138,11.812767633,14.47064035,-13.48624305,-0.09843973,-2.657872717,-13.58468278
13185,2010,417,235,192,52,182,244,NA,NA,NA,NA,NA,NA
13185,2011,1769,837,739,122,932,861,15.995659742,7.5683251577,6.6821891177,1.1031489477,8.4273345842,7.7853380654
13185,2012,1658,733,1272,358,925,1630,14.697930056,6.4979389211,11.276095918,3.1736181907,8.1999911351,14.449714108
13185,2013,1642,862,-2271,238,780,-2033,14.465877005,7.5941449319,-20.00731223,2.0967592735,6.8717320729,-17.91055295
13185,2014,1596,767,-385,230,829,-155,14.093524132,6.7730156698,-3.399753628,2.031021648,7.3205084619,-1.36873198
13185,2015,1626,862,-1223,287,764,-936,14.325738754,7.5945798312,-10.77514053,2.5285898046,6.7311589223,-8.246550722
13185,2016,1567,871,-42,226,696,184,13.761911035,7.6494093883,-0.368857858,1.9848065692,6.1125016467,1.6159487112
13185,2017,1630,917,311,165,713,476,14.186557584000001,7.9810265672,2.7067603734,1.4360625775,6.2055310168,4.1428229509
28087,2010,176,138,-50,31,38,-19,NA,NA,NA,NA,NA,NA
28087,2011,790,589,-435,27,201,-408,13.234382591,9.8671536026,-7.287286617,0.4523143417,3.3672289883,-6.834972275
28087,2012,804,557,-394,151,247,-243,13.49151746,9.3467353548,-6.611514775,2.5338546474,4.1447821053,-4.077660128
28087,2013,795,565,-149,124,230,-25,13.318144506,9.46509641,-2.496105071,2.0772954953,3.8530480961,-0.418809576
28087,2014,804,590,-336,115,214,-221,13.448189345,9.8686961612,-5.620138831,1.9235594213,3.5794931839,-3.69657941
28087,2015,792,610,-519,131,182,-388,13.271555805,10.221779092,-8.696890736,2.1951689526,3.0497767128,-6.501721783
28087,2016,794,626,-390,107,168,-283,13.340726179,10.51800326,-6.552749635,1.797805669,2.8227229195,-4.754943966
28087,2017,798,602,-555,85,196,-470,13.451780928,10.147834735,-9.355561924,1.4328338081,3.3039461929,-7.922728116
48303,2010,1079,509,691,82,570,773,NA,NA,NA,NA,NA,NA
48303,2011,3952,2219,1078,306,1733,1384,14.022289479,7.8733452315,3.8249058853,1.0857339526,6.1489442479,4.9106398379
48303,2012,3852,2203,713,338,1649,1051,13.528511021,7.7371001503,2.5041091272,1.1870811851,5.7914108706,3.6911903123
48303,2013,3972,2297,1509,352,1675,1861,13.799165171,7.9800308154,5.2424320855,1.2228867423,5.819134356,6.4653188278
48303,2014,4242,2263,2561,428,1979,2989,14.521901815,7.7470683183,8.7672302091,1.4651989572,6.7748334962,10.232429166
48303,2015,4213,2460,1637,469,1753,2106,14.207357273,8.2957747191,5.520399681,1.5815928225,5.9115825539,7.1019925035
48303,2016,4236,2452,1562,488,1784,2050,14.102043398,8.1629391908,5.2000452757,1.6245980119,5.9391042073,6.8246432875
48303,2017,4249,2525,720,482,1724,1202,13.987878708,8.3124014445,2.3702689268,1.5867633649,5.6754772635,3.9570322916
19117,2010,27,19,-13,2,8,-11,NA,NA,NA,NA,NA,NA
19117,2011,115,101,-49,10,14,-39,12.947534339,11.371312767,-5.516775501,1.1258725512,1.5762215717,-4.39090295
19117,2012,82,109,-76,2,-27,-74,9.2986335545,12.360378749,-8.618245733,0.2267959404,-3.061745195,-8.391449793
19117,2013,98,113,-68,0,-15,-68,11.229517589,12.948321302,-7.791910164,0,-1.718803713,-7.791910164
19117,2014,92,102,-52,0,-10,-52,10.629693819,11.785095321,-6.008087811,0,-1.155401502,-6.008087811
19117,2015,103,121,-5,0,-18,-5,11.96075016,14.050978343,-0.58061894,0,-2.090228183,-0.58061894
19117,2016,96,113,-25,-1,-17,-26,11.192072282,13.174001749,-2.914602157,-0.116584086,-1.981929467,-3.031186243
19117,2017,94,91,-22,-1,3,-23,11.000585138,10.649502633000001,-2.574605032,-0.117027501,0.3510825044,-2.691632534
39095,2010,1471,1048,-908,89,423,-819,NA,NA,NA,NA,NA,NA
39095,2011,5601,4206,-3887,300,1395,-3587,12.719254421,9.5513629881,-8.826949105,0.6812669749,3.1678914333,-8.14568213
39095,2012,5666,4302,-4389,356,1364,-4033,12.936737618,9.8224223847,-10.02106273,0.8128271429,3.1143152331,-9.208235583
39095,2013,5634,4471,-2338,391,1163,-1947,12.91373993,10.248017613,-5.358949939,0.896214468,2.6657223179,-4.462735471
39095,2014,5808,4372,-3464,494,1436,-2970,13.347765835,10.047595081,-7.960857585,1.1352955101,3.300170754,-6.825562075
39095,2015,5663,4518,-2733,537,1145,-2196,13.05309403,10.413893489,-6.299506619,1.2377735289,2.6392005412,-5.06173309
39095,2016,5537,4396,-2433,541,1141,-1892,12.789345369,10.15386712,-5.619735829,1.2496001164,2.6354782492,-4.370135712
39095,2017,5494,4465,-3249,539,1029,-2710,12.725708177,10.342243723,-7.525632666,1.2484813811,2.3834644548,-6.277151285
26095,2010,23,24,-33,0,-1,-33,NA,NA,NA,NA,NA,NA
26095,2011,50,72,-60,1,-22,-59,7.6231132795,10.977283122,-9.147735935,0.1524622656,-3.354169843,-8.99527367
26095,2012,53,63,-37,3,-10,-34,8.1576112052,9.6967831307,-5.694936124,0.4617515777,-1.539171926,-5.233184547
26095,2013,53,73,43,1,-20,44,8.1701865269,11.253275782,6.6286418992,0.1541544628,-3.083089255,6.782796362
26095,2014,50,69,-76,2,-19,-74,7.7477337879,10.691872627,-11.77655536,0.3099093515,-2.944138839,-11.46664601
26095,2015,59,61,16,2,-2,18,9.1964772816,9.5082222742,2.4939599408,0.3117449926,-0.311744993,2.8057049334
26095,2016,38,74,-47,1,-36,-46,5.9542463178,11.59511125,-7.364462551,0.1566906926,-5.640864933,-7.207771858
26095,2017,47,81,49,1,-34,50,7.4021576502,12.756909993,7.7171430821,0.157492716,-5.354752343,7.8746357981
13187,2010,85,37,262,7,48,269,NA,NA,NA,NA,NA,NA
13187,2011,309,224,78,22,85,100,10.160462975,7.365513613,2.5647770617,0.7233986584,2.7949493621,3.2881757201
13187,2012,357,220,82,9,137,91,11.659617551,7.1851984911,2.6781194376,0.2939399383,4.4744190604,2.9720593759
13187,2013,300,238,119,1,62,120,9.7325179646,7.7211309186,3.8605654593,0.0324417265,2.011387046,3.8930071858
13187,2014,316,241,169,8,75,177,10.179428535,7.7634249267,5.4440614631,0.2577070515,2.4160036079,5.7017685146
13187,2015,260,275,184,11,-15,195,8.3174714887,8.797325613,5.886210592,0.3518930245,-0.479854124,6.2381036165
13187,2016,300,295,161,11,5,172,9.5422882407,9.3832501034,5.1210280225,0.3498839022,0.1590381373,5.4709119247
13187,2017,280,269,1312,11,11,1323,8.6955171504,8.353907548,40.744708933,0.3416096023,0.3416096023,41.086318535
35029,2010,84,92,-4,1,-8,-3,NA,NA,NA,NA,NA,NA
35029,2011,381,295,-59,-17,86,-76,15.188056846,11.759781547,-2.351956309,-0.677682326,3.4282752985,-3.029638636
35029,2012,390,285,-268,-23,105,-291,15.601560156,11.401140114,-10.72107211,-0.920092009,4.200420042,-11.64116412
35029,2013,389,285,-429,-23,104,-452,15.727338886,11.522600469,-17.34454597,-0.929894073,4.2047384168,-18.274440040000002
35029,2014,395,312,-259,-4,83,-263,16.139906429,12.748483053,-10.58287535,-0.16344209,3.3914233763,-10.74631745
35029,2015,415,310,-213,4,105,-209,17.055028151,12.739900547,-8.753544569,0.1643858135,4.3151276045,-8.589158756
35029,2016,420,294,-123,5,126,-118,17.294982396,12.106487677,-5.06495913,0.2058926476,5.1884947189,-4.859066483
35029,2017,414,279,-347,4,135,-343,17.119464086,11.537030145,-14.3489228,0.1654054501,5.5824339412,-14.18351735
51111,2010,27,52,16,2,-25,18,NA,NA,NA,NA,NA,NA
51111,2011,138,145,6,5,-7,11,10.689388071,11.231603408,0.4647560031,0.3872966692,-0.542215337,0.8520526723
51111,2012,123,127,-283,6,-4,-277,9.6285568907,9.941680692,-22.15350894,0.469685702,-0.313123801,-21.68382324
51111,2013,112,148,-77,6,-36,-71,8.8998371012,11.760499027,-6.118638007,0.4767769876,-2.860661925,-5.64186102
51111,2014,110,154,-11,6,-44,-5,8.7957780265,12.314089237,-0.879577803,0.4797697105,-3.518311211,-0.399808092
51111,2015,126,130,-154,6,-4,-148,10.156785297,10.479222925,-12.4138487,0.4836564427,-0.322437628,-11.93019225
51111,2016,122,162,-33,9,-40,-24,9.9203122459,13.172873638,-2.683363148,0.7318263132,-3.252561392,-1.951536835
51111,2017,115,167,13,9,-52,22,9.387371944,13.632096649,1.0611811763,0.7346638913,-4.244724705,1.7958450675
42079,2010,831,897,78,123,-66,201,NA,NA,NA,NA,NA,NA
42079,2011,3105,4057,338,609,-952,947,9.6735903196,12.63953492,1.0530349527,1.8973322076,-2.9659446,2.9503671603
42079,2012,3203,3804,310,556,-601,866,9.9766080778,11.848584804,0.9655786775,1.7318120797,-1.871976726,2.6973907572
42079,2013,3103,4092,-1136,734,-989,-402,9.6832730274,12.769562755,-3.545020354,2.2905325176,-3.086289727,-1.254487837
42079,2014,3209,3950,-598,839,-741,241,10.044588709,12.364015394,-1.871818027,2.6261794723,-2.319426685,0.7543614456
42079,2015,3222,4164,-1142,911,-942,-231,10.11269281,13.06929015,-3.584325012,2.8592995501,-2.956597339,-0.725025462
42079,2016,3100,3906,-1355,953,-806,-402,9.7666403072,12.305966787,-4.268966973,3.0024542622,-2.53932648,-1.266512711
42079,2017,3104,3959,473,950,-855,1423,9.7895746077,12.486123026,1.4917747389,2.9961649089,-2.696548418,4.4879396478
42081,2010,330,249,24,11,81,35,NA,NA,NA,NA,NA,NA
42081,2011,1210,1306,516,44,-96,560,10.391618001,11.21607695,4.4314668499,0.3778770182,-0.824458949,4.8093438681
42081,2012,1310,1213,393,37,97,430,11.203331922,10.37377223,3.3609995767,0.3164299856,0.829559692,3.6774295623
42081,2013,1340,1264,-738,50,76,-688,11.464504952,10.814279298,-6.314033324,0.4277800355,0.650225654,-5.886253289
42081,2014,1274,1259,-368,59,15,-309,10.942244019,10.813410691,-3.160710988,0.5067444247,0.1288333283,-2.653966563
42081,2015,1289,1276,-778,65,13,-713,11.118682665,11.006546998,-6.710888373,0.5606783345,0.1121356669,-6.150210039
42081,2016,1170,1331,-779,68,-161,-711,10.161189467,11.559438616,-6.765441534,0.5905648579,-1.398249149,-6.174876676
42081,2017,1167,1320,-782,68,-153,-714,10.212252077,11.551133455,-6.843171486,0.5950583901,-1.338881378,-6.248113096
46085,2010,9,4,1,0,5,1,NA,NA,NA,NA,NA,NA
46085,2011,84,47,12,0,37,12,22.187004754,12.414157422,3.1695721078,0,9.7728473323,3.1695721078
46085,2012,63,40,-57,0,23,-57,16.602977994,10.54157333,-15.02174199,0,6.0614046646,-15.02174199
46085,2013,60,34,46,0,26,46,15.735641227,8.9168633622,12.063991608,0,6.8187778652,12.063991608
46085,2014,79,25,-45,0,54,-45,20.500843389,6.4876086674,-11.6776956,0,14.013234722,-11.6776956
46085,2015,64,36,-6,0,28,-6,16.5374677,9.3023255814,-1.550387597,0,7.2351421189,-1.550387597
46085,2016,80,26,-13,0,54,-13,20.510191001,6.6658120754,-3.332906038,0,13.844378926,-3.332906038
46085,2017,78,23,-72,0,55,-72,19.938650307,5.8793456033,-18.40490798,0,14.059304703,-18.40490798
51680,2010,238,216,-33,54,22,21,NA,NA,NA,NA,NA,NA
51680,2011,956,790,651,219,166,870,12.563821189,10.382237175,8.5554891151,2.8781138498,2.181584014,11.433602965
51680,2012,996,777,257,188,219,445,12.943217481,10.097269059,3.3397659565,2.4430972756,2.8459484221,5.782863232
51680,2013,1004,766,195,285,238,480,12.931145514,9.8657942866,2.5115272662,3.6706936967,3.0653512274,6.1822209629
51680,2014,1030,814,-394,324,216,-70,13.193879577,10.427007743,-5.046979178,4.1503077504,2.7668718336,-0.896671428
51680,2015,1113,890,435,347,223,782,14.153102747,11.317395727,5.5315361139,4.4125127162,2.8357070193,9.9440488301
51680,2016,1197,699,-94,362,498,268,15.05111343,8.7892466899,-1.181958782,4.5517987149,6.2618667404,3.3698399326
51680,2017,1194,703,231,360,491,591,14.840870814,8.7379666515,2.8712237504,4.4746344162,6.102904162,7.3458581665
48305,2010,22,3,-21,0,19,-21,NA,NA,NA,NA,NA,NA
48305,2011,71,53,-44,-2,18,-46,12.03287857,8.9822896365,-7.45699517,-0.338954326,3.0505889331,-7.795949496
48305,2012,81,59,-114,-1,22,-115,13.866301464,10.100145511,-19.51553539,-0.171188907,3.7661559531,-19.6867243
48305,2013,77,66,-79,-1,11,-80,13.363415481,11.454356126,-13.71051718,-0.17355085,1.9090593544,-13.88406803
48305,2014,80,45,35,0,35,35,13.880454585,7.807755704,6.0726988809,0,6.0726988809,6.0726988809
48305,2015,61,57,-58,0,4,-58,10.567345171,9.8744045041,-10.04763967,0,0.692940667,-10.04763967
48305,2016,82,37,5,0,45,5,14.210207088,6.4119227103,0.8664760419,0,7.7982843774,0.8664760419
48305,2017,76,44,32,0,32,32,13.042732109,7.5510554316,5.4916766775,0,5.4916766775,5.4916766775
19119,2010,47,49,-11,0,-2,-11,NA,NA,NA,NA,NA,NA
19119,2011,185,106,45,0,79,45,15.907820629,9.1147512791,3.8694698826,0,6.7930693495,3.8694698826
19119,2012,149,120,37,2,29,39,12.708973047,10.235414534,3.1559194814,0.1705902422,2.4735585125,3.3265097236
19119,2013,161,124,-100,0,37,-100,13.730172267,10.574791063,-8.528057309,0,3.1553812042,-8.528057309
19119,2014,172,98,-70,0,74,-70,14.703368097,8.3775004274,-5.983928877,0,6.3258676697,-5.983928877
19119,2015,162,105,-12,1,57,-11,13.817220351,8.9556057828,-1.023497804,0.0852914836,4.8616145678,-0.93820632
19119,2016,178,92,-46,1,86,-45,15.125764786,7.8178110129,-3.908905506,0.0849762067,7.3079537729,-3.8239293
19119,2017,166,101,-62,1,65,-61,14.079728584,8.566581849,-5.258693808,0.084817642100000007,5.5131467345,-5.173876166
20111,2010,111,45,-139,24,66,-115,NA,NA,NA,NA,NA,NA
20111,2011,417,311,-215,88,106,-127,12.395588716,9.2446716804,-6.391010969,2.6158556523,3.1509170358,-3.775155316
20111,2012,423,277,-360,110,146,-250,12.595658518,8.248220826,-10.71970938,3.275466754,4.3474376917,-7.444242623
20111,2013,433,280,-308,82,153,-226,12.925951908,8.3585832201,-9.194441542,2.4478708002,4.5673686882,-6.746570742
20111,2014,412,295,-562,107,117,-455,12.372929712,8.8592579245,-16.87763713,3.2133579591,3.513671787,-13.66427917
20111,2015,401,285,-248,116,116,-132,12.105112221,8.6033839977,-7.486453444,3.5017282236,3.5017282236,-3.98472522
20111,2016,420,275,18,118,145,136,12.627970956,8.2683143162,0.5411987552,3.5478585066,4.3596566395,4.0890572618
20111,2017,425,260,-292,116,165,-176,12.726074979,7.7853635166,-8.743562103,3.4734698766,4.9407114625,-5.270092227
21143,2010,17,17,12,0,0,12,NA,NA,NA,NA,NA,NA
21143,2011,59,105,144,0,-46,144,7.0380532029,12.52534892,17.177621377,0,-5.487295718,17.177621377
21143,2012,63,101,50,1,-38,51,7.4626865672,11.963989576,5.9227671168,0.1184553423,-4.501303009,6.0412224591
21143,2013,57,104,54,0,-47,54,6.7443649056,12.305507898,6.3893983317,0,-5.561142992,6.3893983317
21143,2014,52,117,24,-1,-65,23,6.1658860497,13.873243612,2.8457935614,-0.118574732,-7.707357562,2.7272188297
21143,2015,45,135,-9,-1,-90,-10,5.3818094839,16.145428452,-1.076361897,-0.119595766,-10.76361897,-1.195957663
21143,2016,51,122,-156,-1,-71,-157,6.2221679985,14.884401879,-19.03251388,-0.122003294,-8.66223388,-19.15451717
21143,2017,51,126,74,-1,-75,73,6.3099288586,15.589236004,9.1555830498,-0.123724095,-9.279307145,9.0318589545
27083,2010,90,67,-44,8,23,-36,NA,NA,NA,NA,NA,NA
27083,2011,379,206,-257,53,173,-204,14.671157047,7.9742964425,-9.948515465,2.051639376,6.6968606047,-7.896876089
27083,2012,343,209,-392,53,134,-339,13.334888422,8.1253401757,-15.23987248,2.0604929632,5.2095482466,-13.17937952
27083,2013,359,212,-123,71,147,-52,13.984107199,8.2580243066,-4.791212216,2.7656590838,5.7260828919,-2.025553132
27083,2014,368,221,-203,91,147,-112,14.296536586,8.5856918086,-7.886404693,3.5352848624,5.7108447777,-4.351119831
27083,2015,374,240,-224,96,134,-128,14.515252659,9.3146006365,-8.693627261,3.7258402546,5.200652022,-4.967787006
27083,2016,368,220,-156,99,148,-57,14.254725751,8.5218469166,-6.042764177,3.8348311125,5.7328788348,-2.207933065
27083,2017,374,228,-275,99,146,-176,14.470324228,8.8214810802,-10.63994429,3.8303799427,5.6488431479,-6.809564343
32019,2010,158,150,36,21,8,57,NA,NA,NA,NA,NA,NA
32019,2011,577,499,-733,-1,78,-734,11.156010131,9.6479186404,-14.17219311,-0.019334506,1.5080914909,-14.19152762
32019,2012,537,497,-430,-17,40,-447,10.488588533,9.707315644,-8.398683555,-0.332040978,0.7812728889,-8.730724533
32019,2013,556,508,121,-35,48,86,10.888936762,9.9488846674,2.369714655,-0.685454652,0.9400520946,1.6842600027
32019,2014,550,572,302,-18,-22,284,10.730869786,11.160104577,5.892223046,-0.351192102,-0.429234791,5.5410309439
32019,2015,589,575,649,-16,14,633,11.39088729,11.120136149,12.551249323,-0.309429875,0.270751141,12.241819448
32019,2016,590,581,830,-17,9,813,11.25030986,11.078694964,15.826707092,-0.324161471,0.1716148962,15.502545621
32019,2017,607,586,1259,-16,21,1243,11.348339815,10.955728388,23.537989829,-0.299132516,0.3926114269,23.238857314
26097,2010,26,22,-8,0,4,-8,NA,NA,NA,NA,NA,NA
26097,2011,72,138,-34,6,-66,-28,6.5102400651,12.477960125,-3.074280031,0.5425200054,-5.96772006,-2.531760025
26097,2012,85,118,73,13,-33,86,7.6999728236,10.689374038,6.6129178368,1.1776429024,-2.989401214,7.7905607392
26097,2013,74,132,-18,9,-58,-9,6.7074552459,11.964649898,-1.631543168,0.815771584,-5.257194652,-0.815771584
26097,2014,93,139,11,18,-46,29,8.4622383985,12.647861692,1.0009099181,1.6378525933,-4.185623294,2.6387625114
26097,2015,87,155,-136,18,-68,-118,7.9900812784,14.235202278,-12.490242,1.6531202645,-6.245120999,-10.83712173
26097,2016,87,146,-60,18,-59,-42,8.0967892043,13.587715216,-5.583992555,1.6751977664,-5.490926012,-3.908794788
26097,2017,79,134,55,18,-55,73,7.3811081005,12.519854246,5.1387461459,1.6817714659,-5.138746146,6.8205176119
26099,2010,2358,1874,-638,465,484,-173,NA,NA,NA,NA,NA,NA
26099,2011,8999,8020,-742,2045,979,1303,10.682186839,9.5200731692,-0.880784824,2.427499954,1.1621136699,1.5467151296
26099,2012,9111,7979,1678,2545,1132,4223,10.767677114,9.429842574,1.9831151572,3.0077640495,1.3378345399,4.9908792067
26099,2013,9126,8467,3912,2465,659,6377,10.708119268,9.9348724348,4.5901997124,2.8923420989,0.7732468329,7.4825418114
26099,2014,9453,8248,2026,2654,1205,4680,11.00955256,9.6061345092,2.3596057851,3.0910136988,1.4034180509,5.4506194839
26099,2015,9353,8885,-691,2832,468,2141,10.841129295,10.298667143,-0.80094305,3.2825914854,0.54246215229999994,2.4816484358
26099,2016,9398,8475,-209,2828,923,2619,10.855440599,9.7893018813,-0.241411692,3.2665658667,1.0661387182,3.0251541743
26099,2017,9395,8389,117,2794,1006,2911,10.805818465,9.6487505161,0.1345695328,3.2135664492,1.1570679484,3.3481359819
01087,2010,65,40,33,-3,25,30,NA,NA,NA,NA,NA,NA
01087,2011,217,237,-189,-12,-20,-201,10.142556672,11.077354522,-8.833839682,-0.56087871,-0.93479785,-9.394718392
01087,2012,210,223,-684,-2,-13,-686,10.026977344,10.647694989,-32.65929763,-0.095495022,-0.620717645,-32.75479266
01087,2013,177,224,-553,4,-47,-549,8.7140606538,11.027963765,-27.22528555,0.1969279244,-2.313903111,-27.02835762
01087,2014,201,234,-361,5,-33,-356,10.135901767,11.800005043,-18.20428128,0.2521368599,-1.664103275,-17.95214442
01087,2015,187,238,-293,6,-51,-287,9.6035332786,12.222678718,-15.04724733,0.3081347576,-2.61914544,-14.73911257
01087,2016,186,255,-169,7,-69,-162,9.693558474,13.289555972,-8.807588076,0.3648113404,-3.595997498,-8.442776735
01087,2017,189,262,-250,7,-73,-243,9.9928622413,13.852539192,-13.21807175,0.3701060089,-3.85967695,-12.84796574
13193,2010,35,52,-93,6,-17,-87,NA,NA,NA,NA,NA,NA
13193,2011,156,150,-224,33,6,-191,10.720544274,10.308215648,-15.39360203,2.2678074425,0.4123286259,-13.12579459
13193,2012,153,141,-192,20,12,-172,10.636818687,9.8025583982,-13.34816463,1.3904338154,0.8342602892,-11.95773081
13193,2013,125,133,-323,4,-8,-319,8.8373572767,9.4029481424,-22.8357312,0.2827954329,-0.565590866,-22.55293577
13193,2014,118,151,-128,13,-33,-115,8.4824958666,10.854719287,-9.201351448,0.9345122565,-2.37222342,-8.266839192
13193,2015,144,155,-121,13,-11,-108,10.450685826,11.249002105,-8.781479062,0.9434646926,-0.798316278,-7.83801437
13193,2016,141,144,-210,13,-3,-197,10.352802966,10.57307537,-15.41906825,0.9545137487,-0.220272404,-14.4645545
13193,2017,135,154,-200,12,-19,-188,10.061861817,11.477975702,-14.90646195,0.8943877171,-1.416113885,-14.01207423
17115,2010,357,248,-118,21,109,-97,NA,NA,NA,NA,NA,NA
17115,2011,1387,1172,-385,47,215,-338,12.527887421,10.585929385,-3.477459738,0.424521059,1.9419580356,-3.052938679
17115,2012,1317,1183,-738,61,134,-677,11.931833625,10.717812588,-6.686175562,0.5526513676,1.214021037,-6.133524194
17115,2013,1387,1173,-843,54,214,-789,12.629872791,10.681211812,-7.676267313,0.4917181908,1.9486609785,-7.184549122
17115,2014,1352,1266,-1170,64,86,-1106,12.400143079,11.611376581,-10.73089305,0.5869890215,0.7887664976,-10.14390403
17115,2015,1383,1336,-1233,68,47,-1165,12.808639117,12.37334914,-11.41941579,0.6297812436,0.4352899772,-10.78963454
17115,2016,1325,1183,-980,71,142,-909,12.379128323,11.052459476,-9.155883589,0.6633344233,1.3266688466,-8.492549166
17115,2017,1313,1156,-1080,71,157,-1009,12.360439064,10.882458155,-10.16700243,0.6683862708,1.4779809086,-9.498616158
29121,2010,37,24,16,0,13,16,NA,NA,NA,NA,NA,NA
29121,2011,188,208,-90,2,-20,-88,12.098979953,13.38610548,-5.792064871,0.1287125527,-1.287125527,-5.663352318
29121,2012,166,198,109,4,-32,113,10.69312033,12.754444731,7.0213862407,0.2576655501,-2.061324401,7.2790517908
29121,2013,167,205,-53,3,-38,-50,10.760655949,13.20918844,-3.415058475,0.1933051967,-2.448532491,-3.221753278
29121,2014,186,194,-18,2,-8,-16,12.029880671,12.547294894,-1.164182,0.1293535556,-0.517414222,-1.034828445
29121,2015,189,187,-174,2,2,-172,12.301483989,12.171309555,-11.32517574,0.1301744337,0.1301744337,-11.1950013
29121,2016,159,201,-97,2,-42,-95,10.452618085,13.213687013,-6.376754429,0.1314794728,-2.761068928,-6.245274956
29121,2017,164,169,111,2,-5,113,10.791603606,11.120615911,7.3040731723,0.131604922,-0.329012305,7.4356780944
37113,2010,88,64,12,2,24,14,NA,NA,NA,NA,NA,NA
37113,2011,299,458,86,25,-159,111,8.8144686998,13.50176142,2.5352652448,0.7369957107,-4.68729272,3.2722609554
37113,2012,321,417,15,14,-96,29,9.4809126486,12.316325777,0.4430333013,0.4134977479,-2.835413129,0.8565310493
37113,2013,357,445,23,18,-88,41,10.563536566,13.167433534,0.6805639804,0.532615289,-2.603896969,1.2131792694
37113,2014,350,417,143,30,-67,173,10.34829401,12.329253149,4.2280172669,0.8869966294,-1.980959139,5.1150138963
37113,2015,337,448,313,36,-111,349,9.9136599644,13.178990101,9.2076426376,1.0590259903,-3.265330137,10.266668628
37113,2016,350,460,271,37,-110,308,10.230627576,13.445967671,7.9214287802,1.0815234866,-3.215340095,9.0029522668
37113,2017,347,435,473,37,-88,510,10.051998088,12.601207978,13.702003158,1.0718268855,-2.54920989,14.773830043
47111,2010,74,87,16,11,-13,27,NA,NA,NA,NA,NA,NA
47111,2011,322,229,46,57,93,103,14.414898379,10.25158922,2.0592711971,2.5517056138,4.1633091593,4.6109768108
47111,2012,296,253,-57,53,43,-4,13.182212919,11.267229286,-2.538466677,2.3603286646,1.9149836336,-0.178138012
47111,2013,313,298,82,38,15,120,13.886732181,13.221233834,3.6380576322,1.6859291466,0.6654983473,5.3239867788
47111,2014,323,291,248,49,32,297,14.184397163,12.779131809,10.890806491,2.1518125727,1.4052653536,13.042619063
47111,2015,344,265,51,56,79,107,14.938011594,11.507479862,2.2146470678,2.4317693293,3.4305317324,4.6464163971
47111,2016,329,263,210,60,66,270,14.127750939,11.293612453,9.0177133655,2.576489533,2.8341384863,11.594202899
47111,2017,331,263,497,59,68,556,13.926873396,11.065763454,20.911347667,2.4824336265,2.8611099424,23.393781293
17117,2010,120,135,51,2,-15,53,NA,NA,NA,NA,NA,NA
17117,2011,497,534,-31,6,-37,-25,10.404890508,11.179500063,-0.648997195,0.1256123603,-0.774609555,-0.523384834
17117,2012,446,559,-585,2,-113,-583,9.4112682,11.795737497,-12.34437645,0.0422029964,-2.384469297,-12.30217345
17117,2013,454,557,-279,3,-103,-276,9.6887437711,11.886850838,-5.954095842,0.0640225359,-2.198107067,-5.890073306
17117,2014,442,579,-353,2,-137,-351,9.5202196974,12.471057024,-7.603252383,0.0430779172,-2.950837327,-7.560174466
17117,2015,450,550,-240,3,-100,-237,9.7793134922,11.952494268,-5.215633863,0.0651954233,-2.173180776,-5.150438439
17117,2016,440,553,-82,3,-113,-79,9.6175914491,12.087563799,-1.792369316,0.0655744872,-2.469972349,-1.726794828
17117,2017,435,577,-65,3,-142,-62,9.5500499457,12.667537514,-1.427018957,0.0658624134,-3.117487568,-1.361156544
06039,2010,573,325,-57,9,248,-48,NA,NA,NA,NA,NA,NA
06039,2011,2439,1014,-693,108,1425,-585,16.103633717,6.6949916313,-4.575571204,0.7130760317,9.4086420854,-3.862495172
06039,2012,2378,1050,-1435,99,1328,-1336,15.656273043,6.9129885179,-9.447750974,0.6517960603,8.7432845254,-8.795954914
06039,2013,2291,1045,-1490,147,1246,-1343,15.086313336,6.8813607315,-9.811700947,0.9680000263,8.2049526042,-8.843700921
06039,2014,2261,1048,890,164,1213,1054,14.781545623,6.8514196429,5.8184766051,1.0721687227,7.9301259798,6.8906453279
06039,2015,2299,1058,-1174,249,1241,-925,14.903119996,6.8584171188,-7.610379676,1.6141265242,8.0447028776,-5.996253152
06039,2016,2200,1024,-899,265,1176,-634,14.22157866,6.6194984308,-5.811454189,1.7130537931,7.6020802291,-4.098400396
06039,2017,2181,1004,483,269,1177,752,13.987224873,6.4388692217,3.0975835001,1.7251551998,7.5483556513,4.8227386999
01089,2010,964,602,788,108,362,896,NA,NA,NA,NA,NA,NA
01089,2011,4248,2717,1398,504,1531,1902,12.575097577,8.0429708372,4.1384148805,1.4919607295,4.5321267397,5.63037561
01089,2012,4033,2575,1106,495,1458,1601,11.82571367,7.5505114555,3.243054629,1.4514575419,4.2752022144,4.694512171
01089,2013,4002,2892,2334,369,1110,2703,11.618066936,8.3956645624,6.7757541801,1.0712310593,3.2224023735,7.8469852394
01089,2014,4194,2705,1323,448,1489,1771,12.052260948,7.7733347319,3.8018934751,1.2874136635,4.2789262165,5.0893071387
01089,2015,4207,3039,1504,506,1168,2010,11.980020959,8.6539775834,4.2828503736,1.4409057773,3.3260433753,5.7237561509
01089,2016,4173,3198,2097,499,975,2596,11.770645876,9.0204949707,5.914939948,1.4075131302,2.7501509057,7.3224530782
01089,2017,4174,3193,3265,491,981,3756,11.637146306,8.9021102434,9.1028468352,1.3689120356,2.7350360629,10.471758871
05087,2010,48,64,-24,2,-16,-22,NA,NA,NA,NA,NA,NA
05087,2011,167,180,-14,-1,-13,-15,10.657306956,11.486917677,-0.89342693,-0.063816209,-0.829610721,-0.95724314
05087,2012,206,165,-107,0,41,-107,13.185687768,10.561351853,-6.848876656,0,2.624335915,-6.848876656
05087,2013,193,149,39,2,44,41,12.346468782,9.5317297851,2.4948822927,0.1279426817,2.8147389969,2.6228249744
05087,2014,210,170,-6,13,40,7,13.377926421,10.82974996,-0.382226469,0.8281573499,2.5481764612,0.4459308807
05087,2015,183,192,-28,14,-9,-14,11.649743769,12.222681987,-1.782474457,0.8912372283,-0.572938218,-0.891237228
05087,2016,204,152,344,14,52,358,12.829785227,9.5594478161,21.634539794,0.8804754567,3.2703374108,22.515015251
05087,2017,200,135,155,14,65,169,12.328936013,8.3220318087,9.5549254099,0.8630255209,4.0069042042,10.417950931
12079,2010,35,25,15,-1,10,14,NA,NA,NA,NA,NA,NA
12079,2011,223,219,-130,4,4,-126,11.622452702,11.413978214,-6.775420858,0.2084744879,0.2084744879,-6.56694637
12079,2012,220,205,-176,7,15,-169,11.54885955,10.761437308,-9.23908764,0.367463713,0.7874222421,-8.871623927
12079,2013,212,243,-198,10,-31,-188,11.23774185,12.880996554,-10.49562682,0.5300821627,-1.643254704,-9.965544659
12079,2014,199,240,-122,13,-41,-109,10.652249552,12.846934133,-6.530524851,0.6958755989,-2.194684581,-5.834649252
12079,2015,207,239,-118,16,-32,-102,11.16565079,12.891741734,-6.364960354,0.8630454717,-1.726090943,-5.501914882
12079,2016,199,221,-160,16,-22,-144,10.821686878,12.018054272,-8.700853771,0.8700853771,-1.196367394,-7.830768394
12079,2017,196,225,155,17,-29,172,10.665215617,12.243232213,8.4342266358,0.9250442117,-1.578016596,9.3592708475
13195,2010,89,42,-1,2,47,1,NA,NA,NA,NA,NA,NA
13195,2011,325,285,-96,17,40,-79,11.547754406,10.126492325,-3.411028994,0.6040363843,1.4212620807,-2.806992609
13195,2012,318,284,-153,20,34,-133,11.326601485,10.115581201,-5.449591281,0.7123648733,1.2110202846,-4.737226407
13195,2013,331,290,62,30,41,92,11.783343123,10.323774942,2.2071518841,1.0679767181,1.4595681814,3.2751286022
13195,2014,343,309,116,29,34,145,12.144817208,10.940957776,4.1072851199,1.02682128,1.2038594317,5.1341063999
13195,2015,353,297,-30,32,56,2,12.448425433,10.473604401,-1.057939838,1.1284691611,1.9748210318,0.0705293226
13195,2016,350,262,324,31,88,355,12.235409274,9.1590777997,11.326493157,1.0837076786,3.0763314747,12.410200836
13195,2017,344,265,364,31,79,395,11.835744637,9.1176521186,12.523869325,1.0665932667,2.7180925184,13.590462592
16065,2010,257,40,-168,-9,217,-177,NA,NA,NA,NA,NA,NA
16065,2011,1017,127,-613,-6,890,-619,26.953249231,3.365843316,-16.24615711,-0.15901622,23.587405915,-16.40517333
16065,2012,1080,145,-1179,0,935,-1179,28.60207365,3.8400932216,-31.2239304,0,24.761980429,-31.2239304
16065,2013,1103,125,-1125,-7,978,-1132,29.348375595,3.325971849,-29.93374664,-0.186254424,26.022403746,-30.12000106
16065,2014,1100,124,-600,-1,976,-601,29.175010278,3.2888193404,-15.91364197,-0.026522737,25.886190937,-15.94016471
16065,2015,1155,128,-1059,7,1027,-1052,30.487804878,3.3787350861,-27.95375356,0.184774575,27.109069792,-27.76897899
16065,2016,1080,107,-76,7,973,-69,28.177098281,2.7916199223,-1.982832842,0.1826293407,25.385478358,-1.800203501
16065,2017,1092,111,-625,7,981,-618,28.028028028,2.849002849,-16.04168271,0.1796668463,25.179025179,-15.86201586
17119,2010,821,668,-151,31,153,-120,NA,NA,NA,NA,NA,NA
17119,2011,3229,2641,-1417,83,588,-1334,12.005190228,9.8190484335,-5.26830429,0.3085880424,2.1861417943,-4.959716248
17119,2012,3181,2627,-1236,120,554,-1116,11.855645128,9.7908770047,-4.606594586,0.4472421928,2.0647681236,-4.159352393
17119,2013,3078,2789,-1162,66,289,-1096,11.501275117,10.421395809,-4.34193687,0.2466160356,1.0798793076,-4.095320834
17119,2014,3105,2775,-1105,91,330,-1014,11.634791211,10.398243353,-4.140561767,0.3409874397,1.2365478581,-3.799574328
17119,2015,3132,2890,-867,114,242,-753,11.762938481,10.85405243,-3.256215729,0.4281529332,0.9088860512,-2.828062796
17119,2016,3033,2845,-688,109,188,-579,11.411006938,10.703697573,-2.588451293,0.4100889404,0.7073093651,-2.178362353
17119,2017,2990,2773,-488,109,217,-379,11.261218848,10.443933065,-1.837951437,0.4105260383,0.8172857826,-1.427425399
18095,2010,374,363,-34,19,11,-15,NA,NA,NA,NA,NA,NA
18095,2011,1634,1501,-822,58,133,-764,12.444972505,11.432009627,-6.260567564,0.4417432101,1.0129628783,-5.818824354
18095,2012,1495,1455,-935,74,40,-861,11.449402448,11.143063921,-7.16066307,0.566726275,0.306338527,-6.593936795
18095,2013,1498,1536,138,27,-38,165,11.503476768,11.795287261,1.0597328398,0.2073390339,-0.291810492,1.2670718737
18095,2014,1441,1457,-570,40,-16,-530,11.084871189,11.207950953,-4.38471657,0.3076994084,-0.123079763,-4.077017162
18095,2015,1510,1502,-374,50,8,-324,11.655371505,11.593621193,-2.886827115,0.3859394538,0.0617503126,-2.500887661
18095,2016,1489,1466,-139,53,23,-86,11.510735752,11.332933923,-1.074541484,0.4097172564,0.1778018283,-0.664824227
18095,2017,1477,1422,75,52,55,127,11.413205163,10.988204294,0.57954664,0.4018190037,0.4250008693,0.9813656437
19121,2010,62,45,34,0,17,34,NA,NA,NA,NA,NA,NA
19121,2011,160,154,-10,7,6,-3,10.169706985,9.7883429734,-0.635606687,0.4449246806,0.3813640119,-0.190682006
19121,2012,173,127,-145,4,46,-141,11.028943007,8.0963916869,-9.243911768,0.2550044626,2.9325513196,-8.988907306
19121,2013,160,166,-171,11,-6,-160,10.285089834,10.670780703,-10.99218976,0.7070999261,-0.385690869,-10.28508983
19121,2014,161,136,95,12,25,107,10.360693716,8.751890344,6.1134528138,0.7722256186,1.6088033721,6.8856784324
19121,2015,157,138,78,13,19,91,10.026503177,8.8131047035,4.9813200498,0.8302200083,1.2133984737,5.8115400581
19121,2016,173,164,59,13,9,72,10.981686609,10.410384994,3.7451994795,0.8252134446,0.5713016155,4.5704129241
19121,2017,178,154,185,13,24,198,11.192504795,9.6834030245,11.632659477,0.8174301254,1.5091017701,12.450089603
21151,2010,239,170,416,15,69,431,NA,NA,NA,NA,NA,NA
21151,2011,967,668,941,43,299,984,11.495619301,7.9411310168,11.186533363,0.5111805894,3.5544882845,11.697713953
21151,2012,1023,684,257,28,339,285,12.023977433,8.0394922426,3.0206864128,0.3291020216,3.9844851904,3.3497884344
21151,2013,1036,677,117,49,359,166,12.096091538,7.9044922502,1.3660643918,0.5721124376,4.1915992878,1.9381768294
21151,2014,974,702,771,99,272,870,11.262524355,8.1173430156,8.9152015171,1.1447535022,3.1451813394,10.059955019
21151,2015,989,761,761,105,228,866,11.289052245,8.6865204835,8.6865204835,1.1985343637,2.6025317612,9.8850548472
21151,2016,1069,750,953,107,319,1060,12.031987754,8.4415255525,10.726365135,1.2043243122,3.5904622017,11.930689448
21151,2017,1061,721,1233,105,340,1338,11.73912803,7.9772962387,13.642172347,1.1617421707,3.7618317908,14.803914518
28089,2010,276,212,200,49,64,249,NA,NA,NA,NA,NA,NA
28089,2011,1247,929,857,161,318,1018,12.962443218,9.6568642738,8.9084313053,1.6735792767,3.3055789441,10.582010582
28089,2012,1315,983,653,150,332,803,13.495761407,10.088466512,6.7016974897,1.5394404647,3.4072948952,8.2411379544
28089,2013,1241,1020,1079,99,221,1178,12.572117455,10.333247223,10.93095466,1.0029328187,2.2388702316,11.933887479
28089,2014,1323,958,860,145,365,1005,13.216453136,9.5701905547,8.5911940261,1.4485152718,3.6462625809,10.039709298
28089,2015,1347,1006,1061,167,341,1228,13.261006537,9.9039143105,10.445380799,1.6440891549,3.3570922265,12.089469954
28089,2016,1298,962,1003,171,336,1174,12.587337991,9.3289823942,9.726579357,1.6582702593,3.2583555971,11.384849616
28089,2017,1328,1097,348,167,231,515,12.739036802,10.523135069,3.3382415717,1.6019722485,2.2159017329,4.9402138201
29123,2010,28,24,-30,4,4,-26,NA,NA,NA,NA,NA,NA
29123,2011,143,143,34,21,0,55,11.691603303,11.691603303,2.7798217644,1.7169487368,0,4.4967705012
29123,2012,147,183,138,18,-36,156,11.933271096,14.855704834,11.202662662,1.4612168689,-2.922433738,12.663879531
29123,2013,134,163,-81,6,-29,-75,10.870006084,13.222470087,-6.570675319,0.4867166903,-2.352464003,-6.083958629
29123,2014,136,172,-40,-1,-36,-41,11.113381001,14.055158325,-3.268641471,-0.081716037,-2.941777324,-3.350357508
29123,2015,140,176,23,-1,-36,22,11.483881552,14.436879665,1.8866376835,-0.082027725,-2.952998113,1.8046099582
29123,2016,144,155,61,-1,-11,60,11.796510199,12.697632506,4.9971327927,-0.08192021,-0.901122307,4.9152125829
29123,2017,142,169,40,-1,-27,39,11.604151344,13.810574487,3.2687750266,-0.081719376,-2.206423143,3.1870556509
30057,2010,13,8,2,0,5,2,NA,NA,NA,NA,NA,NA
30057,2011,68,83,-36,0,-15,-36,8.8657105606,10.821382008,-4.693611473,0,-1.955671447,-4.693611473
30057,2012,57,71,36,-1,-14,35,7.4475730058,9.2768014634,4.7037303195,-0.130659176,-1.829228458,4.5730711439
30057,2013,63,78,17,-1,-15,16,8.2197142671,10.176789093,2.2180181356,-0.130471655,-1.957074825,2.0875464805
30057,2014,51,72,122,9,-21,131,6.6053619997,9.3252169408,15.801062039,1.1656521176,-2.719854941,16.966714156
30057,2015,57,56,132,12,1,144,7.2616090197,7.1342123702,16.81635773,1.5287597936,0.1273966495,18.345117523
30057,2016,64,87,58,12,-23,70,8.054873828,10.94959411,7.2997294066,1.5102888427,-2.894720282,8.8100182493
30057,2017,66,82,208,12,-16,220,8.1764122894,10.158572844,25.768087215,1.4866204163,-1.982160555,27.254707631
31119,2010,121,51,9,10,70,19,NA,NA,NA,NA,NA,NA
31119,2011,561,325,-227,42,236,-185,16.03452711,9.2891645468,-6.48812416,1.2004458799,6.7453625632,-5.287678281
31119,2012,508,323,-148,53,185,-95,14.490066603,9.2131722692,-4.221515467,1.5117589172,5.2768943338,-2.70975655
31119,2013,506,404,-87,64,102,-23,14.399339793,11.49670608,-2.475775814,1.8212603691,2.9026337132,-0.654515445
31119,2014,513,371,-322,76,142,-246,14.603527051,10.561225216,-9.166346414,2.163485489,4.0423018347,-7.002860925
31119,2015,542,374,-353,81,168,-272,15.473777372,10.677477375,-10.07793987,2.3125017843,4.7962999971,-7.765438091
31119,2016,516,340,-301,84,176,-217,14.761836647,9.7267915892,-8.611071377,2.4030896867,5.0350450579,-6.207981691
31119,2017,536,368,-42,84,168,42,15.297021932,10.502432969,-1.198647241,2.3972944819,4.7945889639,1.198647241
36053,2010,177,187,5,3,-10,8,NA,NA,NA,NA,NA,NA
36053,2011,661,605,-651,30,56,-621,9.0343743593,8.2689810702,-8.897696986,0.4100321192,0.7653932891,-8.487664867
36053,2012,717,602,-611,27,115,-584,9.8679456919,8.2852207901,-8.409086217,0.3715962813,1.5827249018,-8.037489936
36053,2013,675,576,-72,35,99,-37,9.3158701023,7.9495424873,-0.993692811,0.4830451164,1.366327615,-0.510647694
36053,2014,665,640,-303,35,25,-268,9.1897793071,8.844298882,-4.187222752,0.4836725951,0.3454804251,-3.703550157
36053,2015,641,616,-590,38,25,-552,8.9053133184,8.5579922061,-8.196778249,0.5279280906,0.3473211123,-7.668850159
36053,2016,642,612,-397,38,30,-359,8.9723074343,8.5530407318,-5.54829603,0.5310711565,0.4192667025,-5.017224874
36053,2017,633,597,-498,37,36,-461,8.8933222811,8.3875409191,-6.996642174,0.5198308442,0.505781362,-6.47681133
37115,2010,38,68,22,3,-30,25,NA,NA,NA,NA,NA,NA
37115,2011,178,230,120,-1,-52,119,8.5500876624,11.047866081,5.7641040421,-0.0480342,-2.4977784179999998,5.7160698417
37115,2012,183,187,52,4,-4,56,8.7654173153,8.9570111364,2.4907196743,0.1915938211,-0.191593821,2.6823134954
37115,2013,210,238,282,9,-28,291,9.982649205,11.313669099,13.40527179,0.4278278231,-1.331019894,13.833099613
37115,2014,178,226,83,15,-48,98,8.3982071243,10.662892192,3.9160179288,0.7077140835,-2.264685067,4.6237320123
37115,2015,214,240,-42,16,-26,-26,10.09767376,11.324493937,-1.981786439,0.7549662624,-1.226820176,-1.226820176
37115,2016,217,242,277,17,-25,294,10.187554283,11.361235652,13.004389568,0.7981033309,-1.173681369,13.802492899
37115,2017,220,232,301,20,-12,321,10.189902733,10.745715609,13.941639648,0.9263547939,-0.555812876,14.867994442
39097,2010,89,119,22,7,-30,29,NA,NA,NA,NA,NA,NA
39097,2011,431,376,-434,44,55,-390,9.9600212604,8.6890208675,-10.02934855,1.0168003143,1.2710003929,-9.01254824
39097,2012,429,375,-227,40,54,-187,9.9658512788,8.7114084605,-5.273305921,0.9292169025,1.2544428183,-4.344089019
39097,2013,405,432,240,33,-27,273,9.3960977194,10.022504234,5.5680579078,0.76560796229999994,-0.626406515,6.3336658701
39097,2014,438,383,628,37,55,665,10.048521973,8.7867212682,14.40746986,0.84884774650000006,1.2618007043,15.256317607
39097,2015,424,402,85,40,22,125,9.6311103035,9.1313828821,1.9307650373,0.9085953116,0.4997274214,2.8393603489
39097,2016,404,412,-776,41,-8,-735,9.2396711226,9.4226349072,-17.74748711,0.9376893961,-0.182963785,-16.80979771
39097,2017,405,404,639,40,1,679,9.2687950566,9.2459091429,14.624098867,0.9154365488,0.0228859137,15.539535416
47113,2010,297,270,-68,0,27,-68,NA,NA,NA,NA,NA,NA
47113,2011,1214,893,-588,48,321,-540,12.370083554,9.0992459751,-5.991440799,0.4890972081,3.270837579,-5.502343591
47113,2012,1312,850,-24,41,462,17,13.352126723,8.6503869776,-0.244246221,0.4172539601,4.7017397455,0.1730077396
47113,2013,1280,951,-172,53,329,-119,12.982929476,9.6459108844,-1.744581148,0.5375744236,3.337018592,-1.207006725
47113,2014,1244,920,-1006,51,324,-955,12.645296387,9.3518269099,-10.22601943,0.5184164917,3.293469477,-9.707602934
47113,2015,1222,1009,-812,55,213,-757,12.495718018,10.317659149,-8.303210336,0.5624095671,2.1780588689,-7.740800769
47113,2016,1266,1029,-308,62,237,-246,12.982152104,10.551844009,-3.158375078,0.6357768013,2.4303080954,-2.522598276
47113,2017,1211,985,-156,62,226,-94,12.41052076,10.094436787,-1.598712831,0.6353858688,2.3160839734,-0.963326962
48313,2010,45,42,54,5,3,59,NA,NA,NA,NA,NA,NA
48313,2011,147,111,-63,33,36,-30,10.701415936,8.0806610126,-4.586321115,2.4023586794,2.620754923,-2.183962436
48313,2012,151,127,-52,18,24,-34,10.99541251,9.2477972766,-3.786499672,1.310711425,1.7476152334,-2.475788247
48313,2013,156,138,50,5,18,55,11.334326298,10.026519417,3.6327968903,0.363279689,1.3078068805,3.9960765794
48313,2014,166,139,6,13,27,19,12.010273849,10.056795572,0.4341062837,0.9405636147,1.9534782766,1.3746698983
48313,2015,158,124,49,14,34,63,11.375499478,8.9276071853,3.5278447748,1.00795565,2.4478922927,4.5358004248
48313,2016,148,119,113,15,29,128,10.560114163,8.4909026044,8.062789868,1.0702818409,2.069211559,9.1330717089
48313,2017,148,114,80,15,34,95,10.453453878,8.0519847436,5.6505156095,1.0594716768,2.4014691341,6.7099872863
51113,2010,31,15,-22,1,16,-21,NA,NA,NA,NA,NA,NA
51113,2011,118,137,-142,-1,-19,-143,8.9241822651,10.361126867,-10.73927018,-0.075628663,-1.436944602,-10.81489885
51113,2012,115,139,17,-1,-24,16,8.7535680304,10.580399619,1.2940057088,-0.076117983,-1.826831589,1.217887726
51113,2013,122,149,-18,7,-27,-11,9.3037443758,11.36276977,-1.372683596,0.5338213986,-2.059025395,-0.838862198
51113,2014,116,148,-38,6,-32,-32,8.8817426592,11.331878565,-2.909536388,0.4594004824,-2.450135906,-2.450135906
51113,2015,118,141,22,8,-23,30,9.0553295986,10.82035147,1.6882817896,0.6139206508,-1.765021871,2.3022024403
51113,2016,151,124,40,8,27,48,11.552291332,9.4866498355,3.0602096244,0.6120419249,2.0656414964,3.6722515492
51113,2017,147,112,127,8,35,135,11.142694713,8.4896721622,9.6266818268,0.6064051544,2.6530225507,10.233086981
22065,2010,33,17,-8,0,16,-8,NA,NA,NA,NA,NA,NA
22065,2011,186,143,-177,-1,43,-178,15.448504983,11.877076412,-14.70099668,-0.083056478,3.5714285714,-14.78405316
22065,2012,191,128,169,-1,63,168,15.794261143,10.58463574,13.975026875,-0.082692467,5.2096254031,13.892334408
22065,2013,166,112,-365,0,54,-365,13.765081471,9.2872838841,-30.2665948,0,4.477797587,-30.2665948
22065,2014,178,135,-133,0,43,-133,15.004003877,11.379441143,-11.21085683,0,3.6245627344,-11.21085683
22065,2015,174,144,-301,0,30,-301,14.890248599,12.322964358,-25.75841855,0,2.5672842412,-25.75841855
22065,2016,146,125,-88,0,21,-88,12.675261536,10.852107479,-7.639883665,0,1.8231540565,-7.639883665
22065,2017,143,150,-162,0,-7,-162,12.543309504,13.157317662,-14.20990307,0,-0.614008158,-14.20990307
21153,2010,23,41,-5,0,-18,-5,NA,NA,NA,NA,NA,NA
21153,2011,168,150,-103,-1,18,-104,12.663952962,11.307100859,-7.764209257,-0.075380672,1.3568521031,-7.839589929
21153,2012,161,145,-176,1,16,-175,12.24753718,11.030390628,-13.38861207,0.0760716595,1.2171465521,-13.31254041
21153,2013,165,156,-133,1,9,-132,12.686452407,11.994464093,-10.22604952,0.0768875903,0.6919883131,-10.14916193
21153,2014,176,138,-3,2,38,-1,13.577627772,10.646094503,-0.231436837,0.1542912247,2.931533269,-0.077145612
21153,2015,140,173,-172,2,-33,-170,10.869565217,13.431677019,-13.35403727,0.1552795031,-2.562111801,-13.19875776
21153,2016,156,138,-124,2,18,-122,12.257887086,10.843515499,-9.743448709,0.1571523985,1.4143715868,-9.586296311
21153,2017,150,153,-136,2,-3,-134,11.899095669,12.137077582,-10.78851341,0.1586546089,-0.237981913,-10.6298588
19123,2010,74,30,-19,2,44,-17,NA,NA,NA,NA,NA,NA
19123,2011,306,222,1,2,84,3,13.63150392,9.8895224519,0.0445473984,0.0890947969,3.7419814683,0.1336421953
19123,2012,248,234,-114,3,14,-111,11.050954704,10.427110487,-5.07987434,0.1336809037,0.6238442172,-4.946193436
19123,2013,287,240,-60,26,47,-34,12.813072012,10.714764052,-2.678691013,1.1607661056,2.0983079602,-1.517924907
19123,2014,268,220,-135,35,48,-100,11.975780325,9.8308644458,-6.03257591,1.5640011618,2.1449158791,-4.468574748
19123,2015,297,228,-152,38,69,-114,13.300492611,10.210479176,-6.806986117,1.7017465293,3.0900134348,-5.105239588
19123,2016,295,230,-200,34,65,-166,13.254257088,10.33382756,-8.985937009,1.5276092915,2.9204295278,-7.458327717
19123,2017,272,231,-46,34,41,-12,12.240948674,10.395805675,-2.070160437,1.5301185842,1.8451429986,-0.540041853
27087,2010,28,4,3,0,24,3,NA,NA,NA,NA,NA,NA
27087,2011,120,66,-21,0,54,-21,21.988089785,12.093449382,-3.847915712,0,9.8946404031,-3.847915712
27087,2012,99,53,-14,0,46,-14,18.034429365,9.6547955187,-2.550323345,0,8.3796338464,-2.550323345
27087,2013,101,71,-62,0,30,-62,18.40211351,12.9361392,-11.29634691,0,5.4659743099,-11.29634691
27087,2014,98,67,-2,0,31,-2,17.860397303,12.210679789,-0.364497904,0,5.6497175141,-0.364497904
27087,2015,108,62,-114,0,46,-114,19.749474262,11.33766115,-20.84666728,0,8.4118131115,-20.84666728
27087,2016,97,48,12,0,49,12,17.750937872,8.7839692561,2.195992314,0,8.9669686156,2.195992314
27087,2017,98,47,51,0,51,51,17.673579802,8.4761045987,9.1974752029,0,9.1974752029,9.1974752029
39099,2010,607,778,-268,40,-171,-228,NA,NA,NA,NA,NA,NA
39099,2011,2339,3011,-568,191,-672,-377,9.8335361842,12.658733412,-2.387964323,0.8029950454,-2.825197228,-1.584969278
39099,2012,2327,3039,-1149,197,-712,-952,9.8396355064,12.850301807,-4.858505027,0.8330073892,-3.0106663,-4.025497637
39099,2013,2399,3077,-905,210,-678,-695,10.209966102,13.095483824,-3.851612889,0.8937444274,-2.885517723,-2.957868462
39099,2014,2420,2968,-725,304,-548,-421,10.351745467,12.69585973,-3.101246059,1.3003845545,-2.344114263,-1.800861505
39099,2015,2433,3229,-1026,320,-796,-706,10.463571032,13.886917741,-4.412504677,1.3762197823,-3.423346708,-3.036284895
39099,2016,2405,2999,-1325,329,-594,-996,10.412765488,12.984567026,-5.736762691,1.4244490002,-2.571801538,-4.312313691
39099,2017,2382,2920,-147,326,-538,179,10.357309795,12.696618221,-0.639179068,1.4174991575,-2.339308426,0.7783200896
40093,2010,28,13,-23,-1,15,-24,NA,NA,NA,NA,NA,NA
40093,2011,87,82,110,-1,5,109,11.484390469,10.824368029,14.520493697,-0.132004488,0.6600224408,14.388489209
40093,2012,113,86,22,9,27,31,14.748107544,11.22422344,2.8713129731,1.1746280345,3.5238841034,4.0459410076
40093,2013,115,92,-15,3,23,-12,14.943798324,11.955038659,-1.949191086,0.3898382171,2.9887596647,-1.559352869
40093,2014,104,80,45,5,24,50,13.442771279,10.340593292,5.8165837265,0.6462870807,3.1021779875,6.4628708072
40093,2015,107,95,-43,5,12,-38,13.790436912,12.243845856,-5.541951282,0.6444129398,1.5465910555,-4.897538343
40093,2016,104,86,-27,5,18,-22,13.431486504,11.106806147,-3.487020535,0.6457445435,2.3246803565,-2.841275991
40093,2017,101,74,-80,5,27,-75,13.08798756,9.5892186083,-10.36672282,0.6479201762,3.4987689517,-9.718802644
41045,2010,138,54,-56,4,84,-52,NA,NA,NA,NA,NA,NA
41045,2011,441,320,-638,-12,121,-650,14.185537828,10.293360782,-20.52238806,-0.386001029,3.8921770458,-20.90838909
41045,2012,402,295,-289,-15,107,-304,13.080614984,9.598958757,-9.403725698,-0.488082649,3.4816562271,-9.891808346
41045,2013,456,280,-135,-16,176,-151,14.879107254,9.1362939276,-4.404998858,-0.522073939,5.7428133259,-4.927072797
41045,2014,432,329,-391,-11,103,-402,14.157899912,10.782289516,-12.81421034,-0.360502081,3.3756103956,-13.17471242
41045,2015,388,316,-231,-3,72,-234,12.811411401,10.43403609,-7.627412458,-0.099057305,2.3773753116,-7.726469763
41045,2016,456,285,20,-2,171,18,15.050250012,9.4064062577,0.6600986848,-0.066009868,5.6438437546,0.5940888163
41045,2017,443,257,-96,-2,186,-98,14.554892974,8.4438092422,-3.154107732,-0.065710578,6.1110837317,-3.21981831
51683,2010,148,26,205,81,122,286,NA,NA,NA,NA,NA,NA
51683,2011,595,186,238,275,409,513,15.370903783,4.805022023,6.1483615133,7.1041992276,10.56588176,13.252560741
51683,2012,668,186,420,256,482,676,16.802072591,4.6784214101,10.564177378,6.4391176397,12.123651181,17.003295017
51683,2013,671,191,115,248,480,363,16.46161206,4.685794193,2.8212896974,6.0841725648,11.775817867,8.9054622622
51683,2014,699,220,-702,244,479,-458,16.967460828,5.3402594881,-17.04028255,5.9228332504,11.62720134,-11.1174493
51683,2015,755,216,-492,279,539,-213,18.247293117,5.2204176334,-11.89095128,6.7430394432,13.026875483,-5.147911833
51683,2016,756,190,-938,286,566,-652,18.217086953,4.5783684141,-22.60268196,6.891649297,13.638718539,-15.71103266
51683,2017,752,163,-833,284,589,-549,18.12965597,3.9296993659,-20.08245136,6.8468381591,14.199956605,-13.2356132
51685,2010,35,1,143,22,34,165,NA,NA,NA,NA,NA,NA
51685,2011,297,53,299,86,244,385,20.102883444,3.5873832408,20.238256396,5.8210369568,16.515500203,26.059293353
51685,2012,238,26,28,88,212,116,15.599396998,1.7041358065,1.8352231762,5.7678442682,13.895261192,7.6030674445
51685,2013,279,27,134,136,252,270,17.788262297,1.7214447384,8.5434664796,8.6709809047,16.066817559,17.214447384
51685,2014,237,52,-345,140,185,-205,14.865924416,3.2617218128,-21.64026972,8.7815587267,11.604202603,-12.85871099
51685,2015,128,18,-176,155,110,-21,8.0090101364,1.1262670504,-11.01238894,9.6984107121,6.882743086,-1.313978226
51685,2016,11,33,-79,160,-22,81,0.6851234779,2.0553704338,-4.920432251,9.9654324063,-1.370246956,5.0450001557
51685,2017,10,42,373,160,-32,533,0.6120700208,2.5706940874,22.830211776,9.793120333,-1.958624067,32.623332109
12081,2010,779,847,421,218,-68,639,NA,NA,NA,NA,NA,NA
12081,2011,3326,3439,3217,963,-113,4180,10.218408497,10.565576314,9.8835298057,2.9586071504,-0.347167817,12.842136956
12081,2012,3441,3506,5363,1059,-65,6422,10.402763187,10.599269902,16.213315597,3.2015478683,-0.196506715,19.414863466
12081,2013,3365,3390,7042,957,-25,7999,9.9537365706,10.027687065,20.830375314,2.8308249326,-0.073950495,23.661200246
12081,2014,3413,3552,8087,1111,-139,9198,9.8425849691,10.243440319,23.321706606,3.2039589513,-0.40085535,26.525665557
12081,2015,3577,3834,10498,1241,-257,11739,10.01315679,10.73258125,29.387229516,3.4739523556,-0.71942446,32.861181872
12081,2016,3463,4086,11842,1271,-623,13113,9.3769208066,11.063845918,32.065115851,3.4415438479,-1.686925112,35.506659699
12081,2017,3558,4100,9219,1279,-542,10498,9.3492078924,10.773398639,24.224380989,3.3607748439,-1.424190747,27.585155833
26101,2010,67,89,-157,4,-22,-153,NA,NA,NA,NA,NA,NA
26101,2011,175,290,281,9,-115,290,7.090474454,11.749929095,11.385276123,0.3646529719,-4.659454641,11.749929095
26101,2012,179,299,8,3,-120,11,7.2424187251,12.097671502,0.3236835184,0.1213813194,-4.855252777,0.4450648379
26101,2013,181,342,-38,4,-161,-34,7.3698568782,13.92536493,-1.54726277,0.1628697653,-6.555508052,-1.384393005
26101,2014,186,304,49,10,-118,59,7.6143690513,12.444990277,2.0059359329,0.4093746802,-4.830621226,2.415310613
26101,2015,177,310,168,11,-133,179,7.248899355,12.69581243,6.8803112522,0.4504965701,-5.446913075,7.3308078223
26101,2016,232,295,51,11,-63,62,9.4930234461,12.07087033,2.08682843,0.4501002496,-2.577846884,2.5369286796
26101,2017,219,301,63,11,-82,74,8.9634707869,12.319656196,2.5785326921,0.4502199939,-3.356185409,3.028752686
55071,2010,200,188,-135,7,12,-128,NA,NA,NA,NA,NA,NA
55071,2011,840,821,-362,52,19,-310,10.347057556,10.113016968,-4.459089089,0.6405321344,0.2340405876,-3.818556955
55071,2012,854,772,-450,58,82,-392,10.558460987,9.5446509155,-5.563591855,0.7170851724,1.0138100713,-4.846506682
55071,2013,820,868,-238,51,-48,-187,10.172561377,10.768028384,-2.952523912,0.6326836954,-0.595467007,-2.319840216
55071,2014,817,858,-552,46,-41,-506,10.184810048,10.695920466,-6.881291489,0.5734409574,-0.511110419,-6.307850531
55071,2015,786,920,-404,50,-134,-354,9.8617968294,11.54307008,-5.068913383,0.6273407652,-1.681273251,-4.441572618
55071,2016,797,864,-107,51,-67,-56,10.038541955,10.882434441,-1.347708895,0.6423659219,-0.843892486,-0.705342973
55071,2017,780,820,-166,53,-40,-113,9.8418987294,10.346611485,-2.094557935,0.6687444008,-0.504712755,-1.425813534
55073,2010,406,299,-142,21,107,-121,NA,NA,NA,NA,NA,NA
55073,2011,1659,1148,-265,66,511,-199,12.362146051,8.5543964232,-1.97466468,0.4918032787,3.8077496274,-1.482861401
55073,2012,1624,1139,-497,57,485,-440,12.085581395,8.4762790698,-3.698604651,0.4241860465,3.6093023256,-3.274418605
55073,2013,1603,1162,23,84,441,107,11.903833658,8.6289798571,0.1707973638,0.6237816764,3.2748538012,0.7945790402
55073,2014,1594,1124,-245,80,470,-165,11.801157165,8.3215186031,-1.813854144,0.5922789041,3.4796385618,-1.22157524
55073,2015,1622,1098,-424,88,524,-336,11.987775721,8.1150294336,-3.133672568,0.6503848726,3.8727462871,-2.483287696
55073,2016,1611,1213,-689,93,398,-596,11.907357653,8.9656268363,-5.092594304,0.6873893617,2.9417308168,-4.405204942
55073,2017,1605,1138,-14,92,467,78,11.848210034,8.4007869278,-0.103348873,0.6791497341,3.4474231066,0.5758008615
01091,2010,48,100,-41,1,-52,-40,NA,NA,NA,NA,NA,NA
01091,2011,234,247,-298,11,-13,-287,11.251893347,11.876998533,-14.32933426,0.5289351574,-0.625105186,-13.80039911
01091,2012,251,225,-335,13,26,-322,12.241215343,10.973201005,-16.33787705,0.6340071692,1.2680143383,-15.70386988
01091,2013,234,269,-236,13,-35,-223,11.565550476,13.295440504,-11.66440133,0.642530582,-1.729890028,-11.02187075
01091,2014,256,254,-139,6,2,-133,12.774451098,12.674650699,-6.936127745,0.2994011976,0.0998003992,-6.636726547
01091,2015,255,273,-208,7,-18,-201,12.836001208,13.742071882,-10.47015001,0.3523608175,-0.906070674,-10.11778919
01091,2016,235,246,-246,7,-11,-239,11.970862411,12.531200652,-12.53120065,0.3565788803,-0.560338241,-12.17462177
01091,2017,237,271,-103,7,-34,-96,12.191358025,13.940329218,-5.298353909,0.3600823045,-1.748971193,-4.938271605
04013,2010,13121,6306,-458,1344,6815,886,NA,NA,NA,NA,NA,NA
04013,2011,53379,25939,10408,7217,27440,17625,13.875000487,6.7424200087,2.705389855,1.8759414473,7.1325804787,4.5813313024
04013,2012,54289,26034,33926,7557,28255,41483,13.903497348,6.6673478968,8.6885013731,1.9353594552,7.2361494516,10.623860828
04013,2013,54625,27393,31023,8048,27232,39071,13.748912515,6.8947178125,7.8083755229,2.0256521358,6.854194702,9.8340276587
04013,2014,54614,27073,33095,9452,27541,42547,13.51327444,6.6987380328,8.1887760941,2.3387312779,6.8145364075,10.527507372
04013,2015,55660,28493,39116,10842,27167,49958,13.524835544,6.9235202868,9.5048053746,2.6344999456,6.6013152575,12.13930532
04013,2016,54627,30913,44514,11023,23714,55537,13.025875894,7.3712431858,10.614418503,2.6284480198,5.6546327082,13.242866523
04013,2017,55050,31286,38852,10918,23764,49770,12.891643686,7.3265751926,9.0983858398,2.5567841192,5.5650684932,11.655169959
29125,2010,30,33,10,2,-3,12,NA,NA,NA,NA,NA,NA
29125,2011,88,109,22,6,-21,28,9.5761466892,11.861363513,2.3940366723,0.6529190924,-2.285216824,3.0469557647
29125,2012,89,95,-150,5,-6,-145,9.7614477653,10.419522896,-16.45187826,0.5483959419,-0.65807513,-15.90348231
29125,2013,70,99,41,2,-29,43,7.7348066298000004,10.939226519,4.5303867403,0.2209944751,-3.20441989,4.7513812155
29125,2014,77,99,-11,6,-22,-5,8.5144026096,10.947089069,-1.21634323,0.6634599436,-2.43268646,-0.552883286
29125,2015,84,108,-44,6,-24,-38,9.3343704856,12.001333481,-4.889432159,0.666740749,-2.666962996,-4.22269141
29125,2016,88,83,-102,5,5,-97,9.8643649815,9.3038896985,-11.43369577,0.560475283,0.560475283,-10.87322049
29125,2017,88,98,-1,5,-10,4,9.9205230821,11.047855251,-0.112733217,0.5636660842,-1.127332168,0.4509328674
06041,2010,588,473,225,205,115,430,NA,NA,NA,NA,NA,NA
06041,2011,2384,1832,1221,807,552,2028,9.3776121311,7.2062858323,4.8028793675,3.1743846434,2.1713262988,7.9772640109
06041,2012,2325,1875,-366,808,450,442,9.0840538714,7.3258498963,-1.4300059,3.1569529153,1.7582039751,1.7269470155
06041,2013,2323,1892,1325,730,431,2055,9.017209556,7.3441930607,5.1432641678,2.8336474283,1.6730164953,7.976911596
06041,2014,2427,1865,852,773,562,1625,9.3370753449,7.174967251,3.2777866476,2.9738604209,2.1621080939,6.2516470686
06041,2015,2303,1922,-507,865,381,358,8.8115165718,7.3537711034,-1.939834521,3.3095796069,1.4577454685,1.3697450858
06041,2016,2246,1917,-1379,868,329,-511,8.5848064978,7.3272814142,-5.27090301,3.3177257525,1.2575250836,-1.953177258
06041,2017,2202,1944,-1705,872,258,-833,8.4289178487,7.4413334686,-6.526478171,3.3378820908,0.9875843801,-3.18859608
55075,2010,82,129,-38,1,-47,-37,NA,NA,NA,NA,NA,NA
55075,2011,392,508,-142,6,-116,-136,9.4379371366,12.230796085,-3.418844575,0.1444582215,-2.792858949,-3.2743863540000002
55075,2012,364,500,79,2,-136,81,8.7973704563,12.084300077,1.9093194122,0.0483372003,-3.286929621,1.9576566125
55075,2013,404,533,73,-1,-129,72,9.778767488,12.901195721,1.7669555114,-0.02420487,-3.122428233,1.7427506414
55075,2014,379,467,-152,2,-88,-150,9.2075215004,11.345415675,-3.692726301,0.048588504,-2.137894174,-3.644137797
55075,2015,358,503,-259,2,-145,-257,8.7659157689,12.316356513,-6.341821743,0.0489715965,-3.550440744,-6.292850147
55075,2016,381,470,-262,1,-89,-261,9.415776987,11.61526295,-6.474891261,0.0247133254,-2.199485963,-6.450177936
55075,2017,367,465,121,2,-98,123,9.1068127396,11.538604697,3.0025186417,0.0496284073,-2.431791958,3.052147049
01093,2010,74,77,43,2,-3,45,NA,NA,NA,NA,NA,NA
01093,2011,290,427,-37,11,-137,-26,9.4361110207,13.89386002,-1.203917613,0.3579214525,-4.457748999,-0.84599616
01093,2012,326,412,-91,10,-86,-81,10.665794209,13.479469982,-2.977261574,0.3271716015,-2.813675773,-2.650089972
01093,2013,302,418,-153,9,-116,-144,9.9505766063,13.772652389,-5.041186161,0.2965403624,-3.822075783,-4.744645799
01093,2014,314,373,45,0,-59,45,10.393909302,12.346904998,1.4895729891,0,-1.952995697,1.4895729891
01093,2015,318,404,7,0,-86,7,10.544465813,13.396113801,0.2321108827,0,-2.851647987,0.2321108827
01093,2016,287,418,-63,1,-131,-62,9.5606116126,13.924514474,-2.098670842,0.0333122356,-4.363902862,-2.065358606
01093,2017,300,388,1,1,-88,2,10.041000753,12.986360974,0.0334700025,0.0334700025,-2.945360221,0.066940005
05089,2010,40,35,14,1,5,15,NA,NA,NA,NA,NA,NA
05089,2011,158,236,82,2,-78,84,9.4781043791,14.157168566,4.9190161968,0.1199760048,-4.679064187,5.0389922016
05089,2012,154,225,18,2,-71,20,9.2514718251,13.516760783,1.0813408627,0.1201489847,-4.265288958,1.2014898474
05089,2013,142,259,-60,3,-117,-57,8.5901817852,15.668007622,-3.629654275,0.1814827138,-7.077825837,-3.448171562
05089,2014,155,254,76,5,-99,81,9.4328140214,15.457643622,4.6251217137,0.3042843233,-6.024829601,4.929406037
05089,2015,148,262,-102,6,-114,-96,9.0711286813,16.058349422,-6.251723821,0.3677484601,-6.987220741,-5.883975361
05089,2016,169,252,236,6,-83,242,10.375099761,15.470562957,14.488304991,0.3683467371,-5.095463196,14.856651728
05089,2017,164,265,154,6,-101,160,10.000914718,16.160014635,9.3911028448,0.3658871238,-6.159099918,9.7569899686
12083,2010,763,995,204,112,-232,316,NA,NA,NA,NA,NA,NA
12083,2011,3356,4351,1479,483,-995,1962,10.113749546,13.11231355,4.4571619722,1.4555843357,-2.998564004,5.9127463079
12083,2012,3391,4424,2236,492,-1033,2728,10.178430193,13.279084392,6.7115806283,1.4767878663,-3.100654199,8.1883684946
12083,2013,3259,4654,2184,492,-1395,2676,9.7388529131,13.907524228,6.5264359504,1.4702410657,-4.168671314,7.9966770161
12083,2014,3383,4714,3748,632,-1331,4380,10.043910564,13.99556441,11.127572212,1.8763675662,-3.951653846,13.003939778
12083,2015,3478,4790,4983,679,-1312,5662,10.212516058,14.064966049,14.631675537,1.993760323,-3.852449991,16.62543586
12083,2016,3553,5033,6156,714,-1480,6870,10.285194877,14.56948658,17.820337649,2.0668812672,-4.284291702,19.887218916
12083,2017,3533,4945,6889,717,-1412,7606,10.058477534,14.078452139,19.613034739,2.041304385,-4.019974605,21.654339124
13197,2010,24,32,8,4,-8,12,NA,NA,NA,NA,NA,NA
13197,2011,102,75,-92,30,27,-62,11.685856676,8.5925416738,-10.54018445,3.4370166695,3.0933150026,-7.103167784
13197,2012,98,88,-62,25,10,-37,11.265015231,10.115523881,-7.12684637,2.8737283752,1.1494913501,-4.253117995
13197,2013,81,60,-113,0,21,-113,9.3728303633,6.9428373062,-13.07567693,0,2.4299930572,-13.07567693
13197,2014,93,77,41,1,16,42,10.781358683,8.9265012752,4.7530721076,0.115928588,1.8548574078,4.8690006956
13197,2015,86,87,-81,2,-1,-79,9.9820091695,10.098079044,-9.401659799,0.2321397481,-0.116069874,-9.169520051
13197,2016,87,55,-100,3,32,-97,10.183180195,6.4376426523,-11.70480482,0.3511441447,3.7455375432,-11.35366068
13197,2017,85,81,-68,3,4,-65,10.022993927,9.5513236248,-8.018395142,0.3537527268,0.4716703025,-7.664642415
17121,2010,122,165,31,0,-43,31,NA,NA,NA,NA,NA,NA
17121,2011,490,553,-218,0,-63,-218,12.47485934,14.078769826,-5.550039461,0,-1.603910487,-5.550039461
17121,2012,502,493,-146,7,9,-139,12.848075348,12.617731368,-3.736691237,0.1791564292,0.2303439803,-3.557534808
17121,2013,475,497,-325,10,-22,-315,12.230132472,12.796580712,-8.367985375,0.2574764731,-0.566448241,-8.110508902
17121,2014,489,496,-131,14,-7,-117,12.665768753,12.847078326,-3.393079155,0.3626191463,-0.181309573,-3.030460008
17121,2015,528,533,-213,16,-5,-197,13.734620087,13.864682777,-5.540670603,0.4162006087,-0.13006269,-5.124469995
17121,2016,484,475,-300,17,9,-283,12.668996296,12.433415787,-7.852683655,0.4449854071,0.2355805096,-7.407698248
17121,2017,483,409,-255,17,74,-238,12.715880371,10.76769166,-6.713352991,0.447556866,1.948188711,-6.265796125
18097,2010,3568,1862,-1152,588,1706,-564,NA,NA,NA,NA,NA,NA
18097,2011,14531,7413,-3108,2763,7118,-345,16.005956934,8.1654503307,-3.423474926,3.0434559913,7.8405066038,-0.380018935
18097,2012,14418,7592,-1156,2694,6826,1538,15.751799363,8.2943307506,-1.262940773,2.9432201057,7.4574686122,1.6802793328
18097,2013,14610,7755,824,2642,6855,3466,15.801641272,8.3875241662,0.8912082415,2.8574905025,7.4141171063,3.748698744
18097,2014,14422,7676,-3367,2800,6746,-567,15.462080005,8.2295746856,-3.609819954,3.0019292756,7.232505319,-0.607890678
18097,2015,14592,7937,-5249,3145,6655,-2104,15.556669048,8.4617106792,-5.596008486,3.3529142102,7.0949583684,-2.243094276
18097,2016,14312,8064,-5660,3212,6248,-2448,15.191036949,8.5592874478,-6.007634791,3.4092796729,6.6317495007,-2.598355118
18097,2017,14323,7915,-3527,3203,6408,-324,15.123677747,8.3574606835,-3.724164729,3.3820526304,6.7662170638,-0.342112099
19125,2010,84,101,-77,7,-17,-70,NA,NA,NA,NA,NA,NA
19125,2011,385,312,-44,10,73,-34,11.581211365,9.3852933656,-1.323567013,0.3008106848,2.195917999,-1.022756328
19125,2012,335,325,-17,14,10,-3,10.070947571,9.7703222703,-0.511063011,0.4208754209,0.3006253006,-0.09018759
19125,2013,380,356,-293,8,24,-285,11.467197779,10.742953709,-8.841813024,0.2414146901,0.7242440703,-8.600398334
19125,2014,380,324,185,13,56,198,11.468236004,9.778180172,5.58322016,0.3923343896,1.6900558322,5.9755545496
19125,2015,364,353,-180,15,11,-165,10.96897648,10.637496422,-5.424219138,0.4520182615,0.3314800585,-4.972200877
19125,2016,378,329,-23,15,49,-8,11.40994295,9.9308762715,-0.694255788,0.4527755139,1.4790666787,-0.241480274
19125,2017,371,318,-111,15,53,-96,11.199323814,9.5994204124,-3.350741087,0.4528028496,1.5999034021,-2.897938238
20115,2010,34,19,-5,0,15,-5,NA,NA,NA,NA,NA,NA
20115,2011,119,172,-79,4,-53,-75,9.4395748225,13.643755206,-6.266608496,0.3172966327,-4.204180383,-5.949311863
20115,2012,108,174,-114,8,-66,-106,8.669128271,13.966928881,-9.150746508,0.6421576497,-5.29780061,-8.508588859
20115,2013,111,151,-143,7,-40,-136,9.0343059455,12.289911692,-11.63879054,0.5697310056,-3.255605746,-11.06905954
20115,2014,120,169,22,9,-49,31,9.8433270445,13.862685588,1.8046099582,0.7382495283,-4.019358543,2.5428594865
20115,2015,115,191,-70,9,-76,-61,9.493932139,15.768182944,-5.778915215,0.7430033848,-6.274250805,-5.03591183
20115,2016,107,150,13,9,-43,22,8.8922130807,12.465719272,1.0803623369,0.7479431563,-3.573506191,1.8283054932
20115,2017,104,140,-8,9,-36,1,8.6637787404,11.662779074,-0.666444518,0.7497500833,-2.999000333,0.0833055648
21155,2010,66,72,4,10,-6,14,NA,NA,NA,NA,NA,NA
21155,2011,258,194,65,29,64,94,12.961567445,9.7462949008,3.2655111781,1.4569203718,3.2152725446,4.7224315499
21155,2012,228,203,-114,3,25,-111,11.433729502,10.180031092,-5.716864751,0.1504438092,1.2536984103,-5.566420942
21155,2013,227,200,-44,17,27,-27,11.409041791,10.052019199,-2.211444224,0.8544216319,1.3570225919,-1.357022592
21155,2014,226,207,-909,10,19,-899,11.605813177,10.63010322,-46.68001849,0.5135315565,0.9757099574,-46.16648693
21155,2015,271,201,62,10,70,72,14.172898907,10.51200251,3.242508237,0.5229851995,3.6608963966,3.7654934365
21155,2016,243,203,-100,12,40,-88,12.678040382,10.591120154,-5.217300569,0.6260760682,2.0869202275,-4.5912245
21155,2017,241,190,189,12,51,201,12.507135814,9.8603975297,9.8085007006,0.6227619492,2.6467382843,10.43126265
28091,2010,70,127,-30,0,-57,-30,NA,NA,NA,NA,NA,NA
28091,2011,370,343,-343,-8,27,-351,13.789505069,12.783243888,-12.78324389,-0.298151461,1.0062611807,-13.08139535
28091,2012,337,336,-336,-9,1,-345,12.716261344,12.678527631,-12.67852763,-0.339603419,0.0377337132,-13.01813105
28091,2013,317,371,-210,-6,-54,-216,12.101084135,14.162467552,-8.016491067,-0.229042602,-2.061383417,-8.245533669
28091,2014,318,309,-393,-3,9,-396,12.29199281,11.944106221,-15.19104772,-0.115962196,0.347886589,-15.30700991
28091,2015,303,343,-230,-2,-40,-232,11.861885374,13.427810836,-9.004071406,-0.078296273,-1.565925462,-9.082367679
28091,2016,308,349,-252,-2,-41,-254,12.192949467,13.816036896,-9.976049564,-0.079174997,-1.623087429,-10.05522456
28091,2017,293,332,-2,-2,-39,-4,11.677493922,13.231836117,-0.079709856,-0.079709856,-1.554342194,-0.159419712
29127,2010,95,62,-29,3,33,-26,NA,NA,NA,NA,NA,NA
29127,2011,393,335,-72,11,58,-61,13.654367313,11.639218956,-2.501563477,0.382183309,2.0151483566,-2.119380168
29127,2012,336,313,-62,5,23,-57,11.68309602,10.883360281,-2.155809385,0.1738555955,0.7997357395,-1.981953789
29127,2013,356,309,-31,11,47,-20,12.381532041,10.746891575,-1.078167116,0.3825754282,1.634640466,-0.695591688
29127,2014,386,324,-72,10,62,-62,13.420018774,11.264471717,-2.503215937,0.3476688802,2.155547057,-2.155547057
29127,2015,379,343,-117,11,36,-106,13.194311476,11.941025953,-4.073177949,0.3829483542,1.2532855228,-3.690229595
29127,2016,372,341,-63,11,31,-52,12.971842036,11.8908552,-2.196844216,0.3835759742,1.0809868364,-1.813268242
29127,2017,370,302,-110,11,68,-99,12.914259786,10.540828258,-3.839374531,0.3839374531,2.3734315282,-3.455437078
39101,2010,192,186,-52,5,6,-47,NA,NA,NA,NA,NA,NA
39101,2011,806,623,-51,2,183,-49,12.116747721,9.365674727,-0.766692474,0.0300663715,2.7510729936,-0.736626102
39101,2012,778,694,-392,-6,84,-398,11.712369497,10.447794898,-5.901348127,-0.090326757,1.2645745986,-5.991674884
39101,2013,780,717,-387,7,63,-380,11.798606857,10.845642457,-5.853924171,0.1058849333,0.9529644,-5.748039238
39101,2014,746,681,-238,9,65,-229,11.325681666,10.338859537,-3.61328718,0.1366369102,0.9868221291,-3.47665027
39101,2015,763,797,-377,8,-34,-369,11.634378598,12.152817487,-5.748572387,0.1219856209,-0.518438889,-5.626586766
39101,2016,702,726,-31,10,-24,-21,10.741089257,11.108305983,-0.474321605,0.1530069695,-0.367216727,-0.321314636
39101,2017,729,716,-389,10,13,-379,11.189476673,10.98993868,-5.970790708,0.1534907637,0.1995379928,-5.817299944
41047,2010,1200,624,-16,48,576,32,NA,NA,NA,NA,NA,NA
41047,2011,4460,2534,-425,260,1926,-165,14.079460561,7.999406516,-1.341652632,0.8207757278,6.0800540449,-0.520876904
41047,2012,4326,2571,-4,275,1755,271,13.577366035,8.0692112982,-0.012554199,0.8631011696,5.5081547368,0.8505469708
41047,2013,4301,2681,103,139,1620,242,13.419217155,8.364780561,0.3213623267,0.4336831399,5.0544365941,0.7550454665
41047,2014,4334,2577,1114,213,1757,1327,13.420470398,7.9798228461,3.4495625342,0.6595662655,5.4406475516,4.1091287997
41047,2015,4405,2850,2998,303,1555,3301,13.47515127,8.7183158049,9.1710564152,0.9268946277,4.7568354655,10.097951043
41047,2016,4537,2803,4376,317,1734,4693,13.643040681,8.4287950251,13.158903685,0.953238681,5.2142456559,14.112142366
41047,2017,4583,2840,3445,324,1743,3769,13.538103425,8.3893113084,10.176470936,0.957090445,5.1487921164,11.133561381
45067,2010,113,145,-80,3,-32,-77,NA,NA,NA,NA,NA,NA
45067,2011,408,379,-214,9,29,-205,12.41347836,11.53114779,-6.510991101,0.2738267285,0.8823305697,-6.237164372
45067,2012,422,421,-385,17,1,-368,12.945380922,12.914704664,-11.81035937,0.5214963879,0.0306762581,-11.28886298
45067,2013,365,425,-281,16,-60,-265,11.315548804,13.175639018,-8.711422504,0.4960240572,-1.860090214,-8.215398447
45067,2014,401,442,-133,21,-41,-112,12.525183114,13.805812809,-4.154237791,0.6559322828,-1.280629695,-3.498305508
45067,2015,391,445,-160,27,-54,-133,12.279572256,13.975472261,-5.024888903,0.8479500024,-1.695900005,-4.1769389
45067,2016,389,409,-4,30,-20,26,12.251968504,12.881889764,-0.125984252,0.9448818898,-0.62992126,0.8188976378
45067,2017,369,442,-418,30,-73,-388,11.705738667,14.021508105,-13.26015925,0.9516860705,-2.315769438,-12.30847318
47115,2010,69,100,33,-2,-31,31,NA,NA,NA,NA,NA,NA
47115,2011,285,314,-98,3,-29,-95,10.121996697,11.151954256,-3.480546233,0.1065473337,-1.029957559,-3.373998899
47115,2012,310,331,145,0,-21,145,11.011064344,11.756975154,5.1503365479,0,-0.74591081,5.1503365479
47115,2013,279,371,175,5,-92,180,9.8734849155,13.129257719,6.193046094,0.1769441741,-3.255772804,6.3699902681
47115,2014,332,403,118,4,-71,122,11.720887539,14.227462887,4.1658576195,0.1412155125,-2.506575347,4.307073132
47115,2015,353,387,60,5,-34,65,12.445792053,13.644536897,2.115432077,0.1762860064,-1.198744844,2.2917180834
47115,2016,302,383,23,5,-81,28,10.653120976,13.510415013,0.8113304055,0.1763761751,-2.857294037,0.9877065806
47115,2017,316,358,141,5,-42,146,11.137348888,12.617629436,4.9695132697,0.1762238748,-1.480280548,5.1457371445
48315,2010,24,60,-11,0,-36,-11,NA,NA,NA,NA,NA,NA
48315,2011,87,154,56,0,-67,56,8.2987551867,14.68975056,5.3417274765,0,-6.390995374,5.3417274765
48315,2012,111,153,-57,-3,-42,-60,10.64390852,14.671333365,-5.465790862,-0.287673203,-4.027424845,-5.753464065
48315,2013,109,162,-49,-3,-53,-52,10.556389521,15.689312866,-4.745532904,-0.290542831,-5.132923345,-5.036075735
48315,2014,79,171,-26,-5,-92,-31,7.7371333431,16.747465844,-2.546398315,-0.489691984,-9.010332501,-3.036090299
48315,2015,102,182,65,-5,-80,60,10.061652281,17.953144266,6.411837238,-0.493218249,-7.891491985,5.9186189889
48315,2016,97,161,29,-5,-64,24,9.5973087959,15.929553775,2.869298506,-0.494706639,-6.332244979,2.374591867
48315,2017,96,145,32,-5,-49,27,9.5280631234,14.391345343,3.1760210411,-0.496253288,-4.863282219,2.6797677535
54049,2010,172,116,59,5,56,64,NA,NA,NA,NA,NA,NA
54049,2011,685,658,73,21,27,94,12.10429128,11.627187829,1.28994637,0.3710804626,0.4771034519,1.6610268327
54049,2012,640,633,73,6,7,79,11.289867344,11.16638442,1.2877504939,0.1058425064,0.1234829241,1.3935930003
54049,2013,663,657,-84,10,6,-74,11.69539064,11.589550001,-1.48176895,0.1764010655,0.1058406393,-1.305367884
54049,2014,646,636,61,9,10,70,11.396011396,11.219602551,1.0760939554,0.1587679606,0.1764088451,1.234861916
54049,2015,630,710,43,11,-80,54,11.109935457,12.520720911,0.758297182,0.193983,-1.410785455,0.952280182
54049,2016,633,690,-167,13,-57,-154,11.187006813,12.194367616,-2.951390423,0.2297489551,-1.007360803,-2.721641468
54049,2017,616,686,-81,13,-70,-68,10.920630418,12.161611148,-1.435991987,0.2304678497,-1.240980729,-1.205524137
06043,2010,31,22,20,1,9,21,NA,NA,NA,NA,NA,NA
06043,2011,147,155,-103,4,-8,-99,8.0649585779,8.5038678883,-5.650957371,0.2194546552,-0.43890931,-5.431502716
06043,2012,141,156,-287,14,-15,-273,7.8187817118,8.6505670003,-15.91482519,0.7763329359,-0.831785288,-15.13849225
06043,2013,136,204,-19,18,-68,-1,7.6162741859,11.424411279,-1.064038305,1.0080362893,-3.808137093,-0.056002016
06043,2014,158,185,-79,19,-27,-60,8.8888888889,10.407876231,-4.444444444,1.0689170183,-1.518987342,-3.375527426
06043,2015,146,190,-62,26,-44,-36,8.253483705,10.740834959,-3.504904039,1.469798468,-2.487351254,-2.035105571
06043,2016,160,170,-142,27,-10,-115,9.0978875842,9.6665055582,-8.074375231,1.5352685298,-0.568617974,-6.539106701
06043,2017,158,156,17,27,2,44,9.004644801,8.8906619554,0.9688541874,1.5387684154,0.1139828456,2.5076226028
45069,2010,77,52,-43,1,25,-42,NA,NA,NA,NA,NA,NA
45069,2011,284,303,-364,12,-19,-352,9.8841053841,10.545365956,-12.66836042,0.4176382557,-0.661260571,-12.25072217
45069,2012,306,318,-316,8,-12,-308,10.776924702,11.199549201,-11.12911178,0.2817496654,-0.422624498,-10.84736212
45069,2013,304,372,-115,11,-68,-104,10.799673168,13.215389534,-4.085402679,0.3907776475,-2.415716366,-3.694625031
45069,2014,318,350,-11,7,-32,-4,11.340132658,12.481278083,-0.39226874,0.2496255617,-1.141145425,-0.142643178
45069,2015,301,362,-394,7,-61,-387,10.826948671,13.021114348,-14.17215208,0.251789504,-2.194165677,-13.92036258
45069,2016,320,324,-549,11,-4,-538,11.718392383,11.864872288,-20.10436693,0.4028197382,-0.146479905,-19.70154719
45069,2017,302,304,-222,11,-2,-211,11.214050983,11.288316221,-8.243441451,0.4084588106,-0.074265238,-7.834982641
26103,2010,157,170,26,2,-13,28,NA,NA,NA,NA,NA,NA
26103,2011,638,652,370,5,-14,375,9.4849437668,9.6930773291,5.5006727174,0.0743334151,-0.208133562,5.5750061325
26103,2012,691,589,244,21,102,265,10.217661324,8.7094103034,3.6079730289,0.3105222689,1.5082510203,3.9184952978
26103,2013,649,639,-104,39,10,-65,9.5750958985,9.4275597521,-1.534375922,0.5753909708,0.1475361464,-0.958984951
26103,2014,626,665,-1,37,-39,36,9.2409435801,9.8166573175,-0.014761891,0.546189956,-0.575713737,0.5314280653
26103,2015,621,683,-430,40,-62,-390,9.1990460249,10.117469299,-6.369709808,0.5925311449,-0.918423275,-5.777178663
26103,2016,630,668,-825,43,-38,-782,9.4211946972,9.9894572345,-12.33727877,0.6430339238,-0.568262537,-11.69424485
26103,2017,630,659,32,41,-29,73,9.4763204801,9.9125320578,0.4813369133,0.6167129201,-0.436211578,1.0980498334
55077,2010,38,55,-7,0,-17,-7,NA,NA,NA,NA,NA,NA
55077,2011,172,197,15,3,-25,18,11.187719526,12.813841551,0.9756732145,0.1951346429,-1.626122024,1.1708078574
55077,2012,140,150,-117,2,-10,-115,9.1467398406,9.8000784006,-7.644061152,0.130667712,-0.65333856,-7.51339344
55077,2013,149,160,-52,1,-11,-51,9.7948987641,10.518012096,-3.418353931,0.0657375756,-0.723113332,-3.352616356
55077,2014,162,185,-86,2,-23,-84,10.709327692,12.229787797,-5.685198651,0.1322139221,-1.520460104,-5.552984729
55077,2015,155,196,85,2,-41,87,10.267620562,12.983571807,5.6306306306,0.1324854266,-2.715951245,5.7631160572
55077,2016,134,185,70,2,-51,72,8.8577472237,12.228979376,4.6271813855,0.1322051824,-3.371232152,4.759386568
55077,2017,141,160,187,2,-19,189,9.262604697,10.510757103,12.284447364,0.1313844638,-1.248152406,12.415831828
01095,2010,323,269,39,24,54,63,NA,NA,NA,NA,NA,NA
01095,2011,1310,1015,313,161,295,474,14.009271785,10.854512108,3.3472534876,1.7217501965,3.1547596768,5.0690036841
01095,2012,1291,1054,-1,108,237,107,13.726230284,11.206387854,-0.010632247,1.1482826264,2.5198424301,1.1376503798
01095,2013,1210,1102,-105,84,108,-21,12.837651452,11.691811488,-1.114011076,0.8912088612,1.1458399644,-0.222802215
01095,2014,1299,1095,-303,52,204,-251,13.78081189,11.616619723,-3.214461896,0.551656827,2.1641921675,-2.662805069
01095,2015,1331,1068,20,78,263,98,14.098904184,11.313020036,0.2118543078,0.8262318004,2.7858841475,1.0380861082
01095,2016,1345,1161,207,78,184,285,14.186267271,12.245543719,2.1833139964,0.8226980276,1.9407235524,3.006012024
01095,2017,1335,1146,244,78,189,322,14.009056041,12.025751478,2.5604566847,0.8185066451,1.9833045632,3.3789633299
17123,2010,27,25,-12,2,2,-10,NA,NA,NA,NA,NA,NA
17123,2011,121,170,-105,0,-49,-105,9.6375945838,13.540422143,-8.363201912,0,-3.902827559,-8.363201912
17123,2012,96,164,-157,-1,-68,-158,7.7625940002,13.261098084,-12.6950756,-0.080860354,-5.498504083,-12.77593596
17123,2013,134,153,-116,1,-19,-115,10.993969726,12.552816179,-9.517167822,0.0820445502,-1.558846454,-9.435123272
17123,2014,115,164,-114,1,-49,-113,9.5510983763,13.620696815,-9.468045347,0.0830530294,-4.069598439,-9.384992318
17123,2015,142,159,-23,1,-17,-22,11.894291578,13.318256062,-1.926540185,0.0837626167,-1.423964485,-1.842777568
17123,2016,143,153,-10,0,-10,-10,12.008733624,12.848505207,-0.839771582,0,-0.839771582,-0.839771582
17123,2017,138,141,-164,0,-3,-164,11.681056374,11.934992382,-13.88183511,0,-0.253936008,-13.88183511
18099,2010,149,111,-105,13,38,-92,NA,NA,NA,NA,NA,NA
18099,2011,542,425,-211,25,117,-186,11.541246114,9.0498701077,-4.492994336,0.5323453005,2.4913760061,-3.960649035
18099,2012,655,432,-241,22,223,-219,13.95695717,9.2051992329,-5.135307905,0.4687832943,4.7517579374,-4.666524611
18099,2013,567,468,-145,26,99,-119,12.084141429,9.9742119733,-3.090300718,0.5541228874,2.1099294559,-2.536177831
18099,2014,543,471,-77,41,72,-36,11.571903504,10.037507459,-1.640951326,0.8737533032,1.5343960447,-0.767198022
18099,2015,581,458,-350,45,123,-305,12.401413035,9.7759848024,-7.470730744,0.9605225243,2.625428233,-6.51020822
18099,2016,614,458,-309,45,156,-264,13.145921874,9.8059156648,-6.615781529,0.9634633295,3.340006209,-5.6523182
18099,2017,591,476,-316,45,115,-271,12.68921095,10.220075148,-6.78475577,0.9661835749,2.4691358025,-5.818572195
19127,2010,147,139,2,34,8,36,NA,NA,NA,NA,NA,NA
19127,2011,538,459,42,151,79,193,13.179813817,11.244487996,1.0289073983,3.699167075,1.9353258207,4.7280744733
19127,2012,555,460,-195,154,95,-41,13.543191801,11.224987799,-4.758418741,3.7579306979,2.318204002,-1.000488043
19127,2013,590,499,-304,118,91,-186,14.404296875,12.182617188,-7.421875,2.880859375,2.2216796875,-4.541015625
19127,2014,553,449,-493,139,104,-354,13.556413556,11.006925293,-12.08555494,3.4074891218,2.5494882638,-8.678065821
19127,2015,515,511,-492,158,4,-334,12.713224222,12.614480733,-12.14544916,3.9003678195,0.0987434891,-8.24508134
19127,2016,505,466,-390,165,39,-225,12.545648772,11.576776886,-9.688718853,4.099073361,0.9688718853,-5.589645492
19127,2017,506,452,-91,167,54,76,12.579554495,11.237072395,-2.262330947,4.1517501989,1.3424821002,1.8894192522
20117,2010,28,24,-12,1,4,-11,NA,NA,NA,NA,NA,NA
20117,2011,106,136,-102,2,-30,-100,10.551988453,13.538400279,-10.15380021,0.1990941217,-2.986411826,-9.954706087
20117,2012,128,123,36,1,5,37,12.799360032,12.299385031,3.599820009,0.0999950002,0.4999750012,3.6998150092
20117,2013,118,137,-33,1,-19,-32,11.806493571,13.707539147,-3.301815999,0.1000550303,-1.901045575,-3.201760969
20117,2014,130,128,-33,3,2,-30,13.060076351,12.8591521,-3.315250151,0.3013863773,0.2009242516,-3.013863773
20117,2015,120,128,-97,3,-8,-94,12.134081602,12.943020375,-9.808382628,0.30335204,-0.80893877300000006,-9.505030588
20117,2016,142,107,-75,3,35,-72,14.460285132,10.896130346,-7.637474542,0.3054989817,3.5641547862,-7.33197556
20117,2017,129,112,-76,3,17,-73,13.199631638,11.460145298,-7.776527167,0.3069681776,1.7394863399,-7.469558989
21157,2010,86,116,30,1,-30,31,NA,NA,NA,NA,NA,NA
21157,2011,291,409,-81,8,-118,-73,9.2818525429,13.045627801,-2.58360844,0.2551712039,-3.763775258,-2.328437236
21157,2012,299,392,88,6,-93,94,9.5664693649,12.541993281,2.8155495121,0.1919692849,-2.975523916,3.007518797
21157,2013,308,417,53,9,-109,62,9.8626276858,13.352973198,1.6971404784,0.2881936661,-3.490345512,1.9853341445
21157,2014,334,405,-150,4,-71,-146,10.741967645,13.02543981,-4.824236967,0.1286463191,-2.283472164,-4.695590647
21157,2015,345,428,146,5,-83,151,11.124008512,13.800219256,4.7075514284,0.1612175147,-2.676210744,4.8687689431
21157,2016,327,415,312,4,-88,316,10.494560159,13.3187843,10.013158317,0.1283738246,-2.824224141,10.141532142
21157,2017,335,424,193,4,-89,197,10.693480169,13.534434602,6.1607214109,0.1276833453,-2.840954433,6.2884047562
27089,2010,33,13,-19,0,20,-19,NA,NA,NA,NA,NA,NA
27089,2011,94,84,7,1,10,8,9.947616276,8.8893592254,0.7407799354,0.1058257051,1.0582570506,0.8466056405
27089,2012,111,73,-29,1,38,-28,11.729275638,7.7138479421,-3.064405347,0.1056691499,4.0154276959,-2.958736197
27089,2013,106,81,-64,1,25,-63,11.217524737,8.5718821102,-6.772845124,0.1058257051,2.6456426266,-6.667019419
27089,2014,111,72,-50,0,39,-50,11.777188329,7.6392572944,-5.305039788,0,4.1379310345,-5.305039788
27089,2015,116,87,-42,2,29,-40,12.322073508,9.2415551307,-4.461440408,0.2124495432,3.0805183769,-4.248990865
27089,2016,115,73,-81,2,42,-79,12.247723521,7.7746418872,-8.626657436,0.2130038873,4.4730816337,-8.413653549
27089,2017,111,82,-46,2,29,-44,11.854541571,8.7574090885,-4.912692903,0.2135953436,3.0971324825,-4.69909756
28093,2010,102,138,-53,1,-36,-52,NA,NA,NA,NA,NA,NA
28093,2011,459,372,-392,-9,87,-401,12.44037294,10.082393755,-10.62445794,-0.243928881,2.3579791847,-10.86838682
28093,2012,466,416,-245,-5,50,-250,12.71747288,11.352937163,-6.686225012,-0.136453572,1.3645357167,-6.822678584
28093,2013,448,402,-135,0,46,-135,12.274981505,11.01460394,-3.6989341590000002,0,1.2603775653,-3.6989341590000002
28093,2014,455,428,-309,-3,27,-312,12.531500888,11.787873363,-8.5104039,-0.082625281,0.7436275252,-8.59302918
28093,2015,440,430,-291,1,10,-290,12.213231926,11.935658474,-8.077387479,0.0277573453,0.2775734529,-8.049630133
28093,2016,398,377,-130,2,21,-128,11.106925084,10.520881298,-3.627890103,0.0558136939,0.5860437858,-3.572076409
28093,2017,405,411,-155,2,-6,-153,11.344696704,11.512766285,-4.341797504,0.0560231936,-0.168069581,-4.285774311
40095,2010,30,62,27,2,-32,29,NA,NA,NA,NA,NA,NA
40095,2011,183,183,84,17,0,101,11.521390122,11.521390122,5.2885069412,1.0702930714,0,6.3588000126
40095,2012,201,200,55,12,1,67,12.588463706,12.525834534,3.4446044968,0.751550072,0.0626291727,4.1961545688
40095,2013,201,175,11,12,26,23,12.542901716,10.920436817,0.6864274571,0.7488299532,1.6224648986,1.4352574103
40095,2014,177,203,104,16,-26,120,10.996179294,12.611437269,6.4610319013,0.9940049079,-1.615257975,7.4550368092
40095,2015,176,220,137,19,-44,156,10.865203568,13.58150446,8.4575732321,1.1729481125,-2.716300892,9.6305213446
40095,2016,187,178,-36,22,9,-14,11.506630157,10.952835123,-2.215180137,1.353721195,0.5537950343,-0.861458942
40095,2017,187,151,126,22,36,148,11.443257963,9.2402778203,7.710430499,1.3462656427,2.2029801426,9.0566961417
46091,2010,14,28,1,0,-14,1,NA,NA,NA,NA,NA,NA
46091,2011,60,56,-61,7,4,-54,12.994044396,12.12777477,-13.2106118,1.5159718462,0.8662696264,-11.69463996
46091,2012,50,68,48,7,-18,55,10.84245907,14.745744335,10.408760707,1.5179442698,-3.903285265,11.926704977
46091,2013,63,47,88,12,16,100,13.438566553,10.02559727,18.771331058,2.5597269625,3.4129692833,21.33105802
46091,2014,70,44,-93,11,26,-82,14.835223058,9.3249973509,-19.70965349,2.3312493377,5.5102257073,-17.37840415
46091,2015,63,49,50,11,14,61,13.323464101,10.362694301,10.574177858,2.3263191287,2.9607698001,12.900496986
46091,2016,75,39,-22,11,36,-11,15.696944328,8.1624110506,-4.604437003,2.3022185015,7.5345332775,-2.302218501
46091,2017,72,60,-9,11,12,2,15.009380863,12.507817386,-1.876172608,2.2930998541,2.5015634772,0.4169272462
47117,2010,94,51,32,4,43,36,NA,NA,NA,NA,NA,NA
47117,2011,370,327,108,9,43,117,12.028413062,10.630516409,3.5109962452,0.2925830204,1.3978966532,3.8035792656
47117,2012,356,279,-9,12,77,3,11.529430815,9.0357056109,-0.291474375,0.3886324994,2.4937252044,0.0971581248
47117,2013,356,302,89,16,54,105,11.486649996,9.7442929741,2.871662499,0.5162539324,1.7423570219,3.3879164314
47117,2014,342,320,145,16,22,161,10.975609756,10.26957638,4.6534017972,0.513478819,0.7060333761,5.1668806162
47117,2015,407,334,206,16,73,222,12.963228385,10.638128454,6.5612409026,0.5096109439,2.3250999315,7.0708518465
47117,2016,377,332,367,18,45,385,11.871024624,10.45405882,11.556143334,0.5667863216,1.4169658039,12.122929656
47117,2017,377,324,884,18,53,902,11.617157648,9.9839763343,27.240231727,0.5546653519,1.6331813139,27.794897079
54051,2010,76,107,3,-2,-31,1,NA,NA,NA,NA,NA,NA
54051,2011,321,410,-78,2,-89,-76,9.7309586965,12.42895036,-2.36453202,0.0606290261,-2.697991664,-2.303902994
54051,2012,293,403,5,3,-110,8,8.9193302892,12.267884323,0.1522070015,0.0913242009,-3.348554033,0.2435312024
54051,2013,351,428,-100,1,-77,-99,10.731811719,13.086083806,-3.057496216,0.0305749622,-2.354272087,-3.026921254
54051,2014,328,410,-200,-1,-82,-201,10.10023249,12.625290613,-6.158678348,-0.030793392,-2.525058123,-6.189471739
54051,2015,331,404,-69,-1,-73,-70,10.261020522,12.524025048,-2.139004278,-0.031000062,-2.263004526,-2.17000434
54051,2016,307,408,-378,-1,-101,-379,9.6104180688,12.772151701,-11.8330229,-0.031304293,-3.161733632,-11.86432719
54051,2017,299,388,-425,-1,-89,-426,9.5079100087,12.33802369,-13.51458781,-0.03179903,-2.830113682,-13.54638684
12085,2010,299,452,181,51,-153,232,NA,NA,NA,NA,NA,NA
12085,2011,1200,1676,1201,234,-476,1435,8.1413335504,11.370729192,8.1481179951,1.5875600423,-3.229395642,9.7356780374
12085,2012,1134,1682,1552,142,-548,1694,7.638832754,11.330261633,10.454557702,0.9565381403,-3.691428879,11.411095842
12085,2013,1197,1809,2610,153,-612,2763,7.973435205,12.050078768,17.385685785,1.0191608909,-4.076643563,18.404846676
12085,2014,1201,1863,2464,180,-662,2644,7.8892483537,12.237859853,16.185768479,1.1824019181,-4.348611499,17.368170397
12085,2015,1261,1910,2884,212,-649,3096,8.1626840407,12.363779951,18.668660407,1.3723148427,-4.20109591,20.04097525
12085,2016,1273,1935,3206,222,-662,3428,8.1029900861,12.316799542,20.407059086,1.41309018,-4.213809456,21.820149266
12085,2017,1291,2018,1943,225,-727,2168,8.1091182041,12.675600725,12.204505554,1.4132855119,-4.566482521,13.617791066
18101,2010,23,42,-1,0,-19,-1,NA,NA,NA,NA,NA,NA
18101,2011,113,100,-36,-1,13,-37,10.92367925,9.6669727875,-3.480110203,-0.096669728,1.2567064624,-3.576779931
18101,2012,139,95,-67,3,44,-64,13.466382484,9.2036427049,-6.490990118,0.2906413486,4.2627397791,-6.20034877
18101,2013,138,121,-100,0,17,-100,13.436541551,11.781315418,-9.736624312,0,1.6552261331,-9.736624312
18101,2014,148,97,-46,0,51,-46,14.464425332,9.4800625489,-4.495699765,0,4.9843627834,-4.495699765
18101,2015,124,107,-37,0,17,-37,12.127139364,10.464547677,-3.618581907,0,1.662591687,-3.618581907
18101,2016,131,97,-47,0,34,-47,12.832443552,9.5018856835,-4.604006465,0,3.3305578684,-4.604006465
18101,2017,124,95,-15,0,29,-15,12.146740461,9.3059705148,-1.469363765,0,2.8407699466,-1.469363765
21159,2010,40,20,-38,0,20,-38,NA,NA,NA,NA,NA,NA
21159,2011,156,128,-93,-1,28,-94,12.111801242,9.9378881988,-7.220496894,-0.077639752,2.1739130435,-7.298136646
21159,2012,150,162,-95,-2,-12,-97,11.723787565,12.66169057,-7.425065458,-0.156317168,-0.937903005,-7.581382625
21159,2013,135,147,-61,0,-12,-61,10.626156086,11.570703294,-4.801448306,0,-0.944547208,-4.801448306
21159,2014,131,129,-159,-3,2,-162,10.406323232,10.247448068,-12.63057553,-0.238312746,0.1588751638,-12.86888827
21159,2015,118,119,-212,-3,-1,-215,9.513443786,9.594066191,-17.09194985,-0.241867215,-0.080622405,-17.33381707
21159,2016,102,148,-302,-3,-46,-305,8.4144530606,12.209206402,-24.91338063,-0.247483914,-3.794753341,-25.16086454
21159,2017,95,153,-438,-3,-58,-441,8.1200051284,13.077481944,-37.43749733,-0.256421215,-4.957476815,-37.69391854
27091,2010,47,82,-2,0,-35,-2,NA,NA,NA,NA,NA,NA
27091,2011,219,251,-151,-1,-32,-152,10.57511227,12.120334154,-7.291515766,-0.048288184,-1.545221884,-7.33980395
27091,2012,217,238,-144,1,-21,-143,10.566552236,11.589121808,-7.011905631,0.0486937891,-1.022569571,-6.963211842
27091,2013,223,218,-36,-2,5,-38,10.910781124,10.666144776,-1.761381706,-0.097854539,0.2446363481,-1.859236245
27091,2014,223,276,-127,-2,-53,-129,10.969281094,13.576329964,-6.247079367,-0.098379203,-2.60704887,-6.34545857
27091,2015,217,282,-151,-2,-65,-153,10.780465994,14.009637836,-7.501614586,-0.099359134,-3.229171842,-7.60097372
27091,2016,236,252,-112,-2,-16,-114,11.826609872,12.628413931,-5.612628414,-0.100225507,-0.801804059,-5.712853921
27091,2017,228,221,-43,-2,7,-45,11.474584801,11.122294917,-2.164066432,-0.100654253,0.3522898842,-2.264720684
37117,2010,64,82,3,2,-18,5,NA,NA,NA,NA,NA,NA
37117,2011,241,324,-244,3,-83,-241,9.902210535,13.312515408,-10.02547457,0.1232640316,-3.410304873,-9.902210535
37117,2012,231,310,-279,-2,-79,-281,9.6254010584,12.917204884,-11.6254844,-0.083336806,-3.291803825,-11.7088212
37117,2013,243,320,-131,-3,-77,-134,10.246895359,13.493853971,-5.524046469,-0.126504881,-3.246958612,-5.65055135
37117,2014,253,314,-119,-1,-61,-120,10.758174937,13.352043203,-5.060169239,-0.042522431,-2.593868266,-5.10269167
37117,2015,254,335,-111,-1,-81,-112,10.888436395,14.36073304,-4.75833244,-0.04286786,-3.472296646,-4.8012003
37117,2016,237,299,-85,-1,-62,-86,10.235149317,12.912698927,-3.670834143,-0.043186284,-2.67754961,-3.714020427
37117,2017,245,302,-235,-1,-57,-236,10.6823632,13.1676477,-10.24634838,-0.043601482,-2.4852845,-10.28994986
48317,2010,20,19,10,0,1,10,NA,NA,NA,NA,NA,NA
48317,2011,73,37,44,0,36,44,15.054650443,7.6304392658,9.0740358837,0,7.4242111776,9.0740358837
48317,2012,88,37,33,7,51,40,17.831813576,7.4974670719,6.6869300912,1.4184397163,10.334346505,8.1053698075
48317,2013,82,45,223,26,37,249,15.992198927,8.7762067284,43.49098001,5.0706972209,7.2159921989,48.561677231
48317,2014,106,36,101,25,70,126,19.728270985,6.7001675042,18.797692165,4.6528941001,13.02810348,23.450586265
48317,2015,114,50,108,29,64,137,20.452099031,8.9702188733,19.375672766,5.2027269465,11.481880158,24.578399713
48317,2016,101,28,-91,31,73,-60,17.775431186,4.927842309,-16.0154875,5.4558254136,12.847588877,-10.55966209
48317,2017,95,41,-149,31,54,-118,16.793353368,7.2476577691,-26.33904897,5.479936362,9.5456955984,-20.8591126
51690,2010,37,27,-68,-1,10,-69,NA,NA,NA,NA,NA,NA
51690,2011,205,233,-138,1,-28,-137,14.990859232,17.038391225,-10.09140768,0.0731261426,-2.047531993,-10.01828154
51690,2012,184,257,-45,12,-73,-33,13.589866686,18.981498578,-3.3236087,0.8862956535,-5.391631892,-2.437313047
51690,2013,159,229,-6,7,-70,1,11.821561338,17.026022305,-0.446096654,0.5204460967,-5.204460967,0.0743494424
51690,2014,172,201,-68,4,-29,-64,12.86702824,15.036469048,-5.086964653,0.2992332149,-2.169440808,-4.787731438
51690,2015,221,289,26,5,-68,31,16.614667519,21.726872909,1.9546667669,0.3758974552,-5.11220539,2.3305642221
51690,2016,250,255,-163,5,-5,-158,18.938676565,19.317450097,-12.34801712,0.3787735313,-0.378773531,-11.96924359
51690,2017,255,200,-37,5,55,-32,19.420433342,15.231712425,-2.817866799,0.3807928106,4.1887209169,-2.437073988
17125,2010,48,35,-29,1,13,-28,NA,NA,NA,NA,NA,NA
17125,2011,155,205,-133,-2,-50,-135,10.6463356,14.080637406,-9.135242805,-0.137372072,-3.434301806,-9.272614877
17125,2012,129,187,-95,2,-58,-93,8.9630015633,12.992878235,-6.600660066,0.1389612645,-4.029876672,-6.461698801
17125,2013,140,213,-103,0,-73,-103,9.8387153449,14.968902632,-7.238483432,0,-5.130187287,-7.238483432
17125,2014,143,174,-8,0,-31,-8,10.127120144,12.322509826,-0.566552176,0,-2.195389682,-0.566552176
17125,2015,123,183,-183,0,-60,-183,8.798597947,13.090596946,-13.09059695,0,-4.291998999,-13.09059695
17125,2016,143,173,-123,0,-30,-123,10.375476147,12.552149465,-8.924360602,0,-2.176673318,-8.924360602
17125,2017,137,164,37,0,-27,37,9.992341636,11.961635243,2.6986616097,0,-1.969293607,2.6986616097
21161,2010,49,32,0,1,17,1,NA,NA,NA,NA,NA,NA
21161,2011,222,205,34,-7,17,27,12.666533535,11.69657376,1.9399195504,-0.399395202,0.9699597752,1.5405243488
21161,2012,199,171,-104,-4,28,-108,11.36655719,9.7672426103,-5.940311295,-0.228473511,1.5993145795000001,-6.168784807
21161,2013,241,227,-152,1,14,-151,13.851768831,13.047101762,-8.736385321,0.0574762192,0.804667069,-8.678909101
21161,2014,208,222,-180,-1,-14,-181,12.069515769,12.881887022,-10.44477326,-0.058026518,-0.812371254,-10.50279978
21161,2015,182,242,-39,-1,-60,-40,10.651684078,14.16322828,-2.282503731,-0.058525737,-3.511544202,-2.341029468
21161,2016,217,192,99,-2,25,97,12.692285196,11.230040358,5.7904895596,-0.116979587,1.4622448383,5.6735099725
21161,2017,201,189,7,-2,12,5,11.70919259,11.010136316,0.4077828265,-0.116509379,0.699056274,0.2912734475
26105,2010,79,52,3,2,27,5,NA,NA,NA,NA,NA,NA
26105,2011,300,355,-36,11,-55,-25,10.462439841,12.380553812,-1.255492781,0.3836227942,-1.918113971,-0.871869987
26105,2012,278,354,80,9,-76,89,9.7073818004,12.361198408,2.7934911656,0.3142677561,-2.653816607,3.1077589217
26105,2013,280,327,50,6,-47,56,9.7748298132,11.415604818,1.7455053238,0.2094606389,-1.640775004,1.9549659626
26105,2014,278,363,141,10,-85,151,9.6935039576,12.657345096,4.9164894173,0.3486871927,-2.963841138,5.2651766101
26105,2015,320,349,32,11,-29,43,11.143613317,12.153503273,1.1143613317,0.3830617078,-1.009889957,1.4974230394
26105,2016,305,275,84,11,30,95,10.596348602,9.5540848055,2.9183386315,0.3821633922,1.042263797,3.3005020237
26105,2017,293,291,216,11,2,227,10.117577997,10.048516031,7.4586923117,0.3798408122,0.0690619658,7.8385331238
48319,2010,8,20,7,1,-12,8,NA,NA,NA,NA,NA,NA
48319,2011,34,37,7,12,-3,19,8.4692987919,9.2165898618,1.743679163,2.9891642795,-0.74729107,4.7328434425
48319,2012,42,45,14,8,-3,22,10.419250806,11.163483007,3.4730836021,1.9846192012,-0.7442322,5.4577028033
48319,2013,31,41,61,12,-10,73,7.6120319214,10.06752609,14.978514426,2.9465930018,-2.455494168,17.925107428
48319,2014,44,47,-37,13,-3,-24,10.7540022,11.487229622,-9.043138213,3.1773188317,-0.733227423,-5.865819382
48319,2015,42,51,-44,18,-9,-26,10.34355375,12.560029553,-10.83610393,4.4329516069,-2.216475803,-6.403152321
48319,2016,34,31,93,22,3,115,8.288639688,7.5572891273,22.671867382,5.3632374451,0.7313505607,28.035104827
48319,2017,45,42,35,22,3,57,10.73601336,10.020279136,8.3502326136,5.2487176428,0.715734224,13.598950256
53045,2010,160,165,36,13,-5,49,NA,NA,NA,NA,NA,NA
53045,2011,605,622,82,67,-17,149,9.9513944289,10.231020388,1.3487840383,1.1020552508,-0.279625959,2.4508392891
53045,2012,655,637,-282,80,18,-202,10.779763668,10.483525888,-4.641058556,1.3166123564,0.2962377802,-3.3244462
53045,2013,684,607,-343,68,77,-275,11.293837924,10.022455584,-5.663430421,1.1227792088,1.2713823393,-4.540651212
53045,2014,573,638,77,99,-65,176,9.468726762,10.542840618,1.2724117987,1.6359580269,-1.074113856,2.9083698257
53045,2015,626,655,336,115,-29,451,10.300118468,10.777280505,5.5284980914,1.8921942872,-0.477162038,7.4206923786
53045,2016,651,662,1034,116,-11,1150,10.57616545,10.754871778,16.798394892,1.8845394657,-0.178706329,18.682934358
53045,2017,649,661,1479,115,-12,1594,10.315259113,10.505988095,23.507347039,1.8278194114,-0.190728982,25.335166451
54053,2010,83,73,13,0,10,13,NA,NA,NA,NA,NA,NA
54053,2011,278,330,8,-7,-52,1,10.176626704,12.08016839,0.292852567,-0.256245996,-1.903541686,0.0366065709
54053,2012,301,314,-71,-10,-13,-81,11.049318136,11.526531212,-2.606317567,-0.367086981,-0.477213076,-2.973404548
54053,2013,274,343,6,-8,-69,-2,10.089665458,12.63049362,0.2209415794,-0.294588772,-2.540828163,-0.073647193
54053,2014,280,356,89,-9,-76,80,10.324293431,13.126601648,3.281650412,-0.331852289,-2.802308217,2.9497981232
54053,2015,289,340,-11,-9,-51,-20,10.670506572,12.553537144,-0.406143849,-0.332299513,-1.883030572,-0.738443361
54053,2016,272,360,-40,-9,-88,-49,10.082289273,13.34420639,-1.482689599,-0.33360516,-3.261917118,-1.816294759
54053,2017,273,342,-29,-9,-69,-38,10.16570471,12.735058648,-1.079873394,-0.335133122,-2.569353938,-1.415006516
17127,2010,41,81,-11,0,-40,-11,NA,NA,NA,NA,NA,NA
17127,2011,182,217,-66,0,-35,-66,11.874082531000001,14.157559941,-4.305985973,0,-2.28347741,-4.305985973
17127,2012,170,203,-186,3,-33,-183,11.207067045,13.38255653,-12.26184983,0.1977717714,-2.175489485,-12.064078050000001
17127,2013,145,227,-141,2,-82,-139,9.6980236097,15.182423168,-9.430491924,0.1337658429,-5.484399559,-9.296726081
17127,2014,158,176,-73,1,-18,-72,10.678561773,11.895106786,-4.933765883,0.067585834,-1.216545012,-4.866180049
17127,2015,158,231,-114,1,-73,-113,10.779464438,15.759849906,-7.777588265,0.0682244585,-4.980385468,-7.709363807
17127,2016,171,199,-68,1,-28,-67,11.779293242,13.708066405,-4.684163395,0.0688847558,-1.928773162,-4.615278639
17127,2017,154,182,-98,1,-28,-97,10.689619269,12.633186409,-6.802484989,0.0694131121,-1.94356714,-6.733071877
48321,2010,121,101,-15,2,20,-13,NA,NA,NA,NA,NA,NA
48321,2011,549,340,-232,-3,209,-235,14.961981849,9.2660725479,-6.322731856,-0.081759464,5.6959093015,-6.40449132
48321,2012,522,331,-338,7,191,-331,14.257620452,9.0407516661,-9.23194581,0.191194144,5.2168687862,-9.040751666
48321,2013,483,386,-136,6,97,-130,13.224000329,10.56824871,-3.723528043,0.164273296,2.6557516188,-3.559254747
48321,2014,545,373,-191,5,172,-186,14.931506849,10.219178082000001,-5.232876712,0.1369863014,4.7123287671,-5.095890411
48321,2015,538,387,107,12,151,119,14.688216665,10.565687452,2.9212624222,0.3276182156,4.1225292126,3.2488806378
48321,2016,574,389,157,14,185,171,15.53892175,10.530732685,4.250192883,0.3789980915,5.0081890659,4.6291909744
48321,2017,552,389,-456,15,163,-441,14.927593061,10.519626269,-12.33148992,0.4056411158,4.4079667915,-11.9258488
02170,2010,321,101,481,11,220,492,NA,NA,NA,NA,NA,NA
02170,2011,1338,519,1138,9,819,1147,14.747132961,5.7203004535,12.542778258,0.0991959616,9.0268325076,12.64197422
02170,2012,1312,519,1090,61,793,1151,14.153029633,5.5986451063,11.75823346,0.658029579,8.5543845266,12.416263039
02170,2013,1348,558,1292,60,790,1352,14.224360801,5.8881256133,13.6334378,0.6331317864,8.3362351874,14.266569586
02170,2014,1378,522,1300,78,856,1378,14.209335059,5.3826363575,13.405033074,0.8043019845,8.8266987013,14.209335059
02170,2015,1511,588,1927,87,923,2014,15.17312018,5.904562982,19.350498072,0.8736343188,9.2685571979,20.224132391
02170,2016,1517,593,2056,78,924,2134,14.786511816,5.7800932808,20.040255962,0.7602820841,9.0064185353,20.800538046
02170,2017,1568,589,1361,69,979,1430,14.886900382,5.59208184,12.921601671,0.6550995704,9.2948185422,13.576701241
51115,2010,13,19,4,1,-6,5,NA,NA,NA,NA,NA,NA
51115,2011,48,109,27,6,-61,33,5.3583389149,12.167894619,3.0140656397,0.6697923644,-6.809555704,3.683858004
51115,2012,69,114,3,10,-45,13,7.729793312,12.770962863,0.3360779701,1.1202599003,-5.041169551,1.4563378704
51115,2013,61,126,45,8,-65,53,6.8504688641,14.150148801,5.0536245718,0.8984221461,-7.299679937,5.952046718
51115,2014,52,92,-53,10,-40,-43,5.8710624365,10.387264311,-5.983967483,1.1290504686,-4.516201874,-4.854917015
51115,2015,59,123,85,13,-64,98,6.6802536232,13.926630435,9.6240942029,1.4719202899,-7.246376812,11.096014493
51115,2016,72,137,10,12,-65,22,8.1563296517,15.519682809,1.1328235627,1.3593882753,-7.363353158,2.492211838
51115,2017,64,125,26,11,-61,37,7.278930907,14.216661928,2.957065681,1.2510662496,-6.937731021,4.2081319306
15009,2010,477,260,-209,146,217,-63,NA,NA,NA,NA,NA,NA
15009,2011,2031,1030,226,639,1001,865,13.026495546,6.6062483565,1.4495263384,4.0984395143,6.4202471891,5.5479658528
15009,2012,2031,1088,202,730,943,932,12.87353699,6.8963112975,1.2803813254,4.6271206316,5.9772256926,5.907501957
15009,2013,2040,1124,712,687,916,1399,12.76200426,7.031614112,4.4541897222,4.2977926112,5.7303901482,8.7519823334
15009,2014,2030,1115,739,754,915,1493,12.514410066,6.8736784351,4.5557384427,4.648209453,5.6407316306,9.2039478957
15009,2015,1951,1217,-555,807,734,252,11.903272942,7.4250554439,-3.386118136,4.923598803,4.4782174986,1.5374806671
15009,2016,1877,1263,-440,825,614,385,11.383588105,7.6598144784,-2.668502273,5.0034417615,3.7237736261,2.3349394887
15009,2017,1878,1310,-501,820,568,319,11.325397113,7.9000373895,-3.021312009,4.945061572,3.4253597231,1.9237495628
47119,2010,312,155,67,22,157,89,NA,NA,NA,NA,NA,NA
47119,2011,1140,743,-176,83,397,-93,14.018346819,9.1365190231,-2.164236,1.0206340228,4.8818277957,-1.143601977
47119,2012,1043,730,142,67,313,209,12.762234553,8.9323405791,1.7375237839,0.81981756,3.8298939743,2.5573413439
47119,2013,1066,793,1221,44,273,1265,12.880385203,9.5817499683,14.75323671,0.5316481697,3.298635235,15.28488488
47119,2014,1089,839,1468,52,250,1520,12.896196865,9.9356374381,17.384404957,0.6157963609,2.9605594273,18.000201318
47119,2015,1136,940,1756,66,196,1822,13.153095783,10.883723623,20.331722002,0.7641763395,2.2693721597,21.095898341
47119,2016,1186,922,1864,68,264,1932,13.402795828,10.41937416,21.064765112,0.7684570964,2.9834216682,21.833222208
47119,2017,1181,939,2254,68,242,2322,12.995801949,10.332817976,24.803164769,0.7482764882,2.6629839726,25.551441258
48323,2010,233,96,64,-10,137,54,NA,NA,NA,NA,NA,NA
48323,2011,1021,324,8,81,697,89,18.619325072,5.9085811199,0.1458908918,1.47714528,12.710743952,1.6230361718
48323,2012,1037,341,-322,59,696,-263,18.704568821,6.1506827077,-5.807976047,1.0641943688,12.553886113,-4.743781678
48323,2013,1139,352,-176,196,787,20,20.317516946,6.2789867999,-3.1394934,3.4962540136,14.038530146,0.3567606136
48323,2014,1092,365,-394,235,727,-159,19.243477571,6.432114756,-6.94315949,4.1412245689,12.811362815,-2.801934921
48323,2015,1191,406,-457,299,785,-158,20.769210648,7.0800163922,-7.969378057,5.214100742,13.689194256,-2.755277315
48323,2016,1118,410,-692,315,708,-377,19.33469956,7.0905427724,-11.96745268,5.44761213,12.244156787,-6.519840549
48323,2017,1113,385,-820,316,728,-504,19.155802246,6.6262209027,-14.11298997,5.4386644292,12.529581343,-8.674325545
40097,2010,132,77,-4,-1,55,-5,NA,NA,NA,NA,NA,NA
40097,2011,500,494,9,-6,6,3,12.103313887,11.958074121,0.21785965,-0.145239767,0.1452397666,0.0726198833
40097,2012,495,531,-132,-1,-36,-133,12.006112203,12.879283999,-3.201629921,-0.024254772,-0.873171797,-3.225884693
40097,2013,515,461,-237,3,54,-234,12.544912003,11.229523172,-5.773095427,0.0730771573,1.3153888314,-5.700018269
40097,2014,526,440,-131,5,86,-126,12.848698031,10.74796033,-3.199960917,0.1221359128,2.1007377009,-3.077825004
40097,2015,473,515,4,5,-42,9,11.565640512,12.592610705,0.0978066851,0.1222583564,-1.026970193,0.2200650414
40097,2016,475,508,123,5,-33,128,11.606597434,12.412950519,3.0054978619,0.1221747098,-0.806353085,3.1276725718
40097,2017,466,548,29,5,-82,34,11.380704089,13.383317255,0.7082412416,0.1221105589,-2.002613166,0.8303518005
40087,2010,111,55,162,3,56,165,NA,NA,NA,NA,NA,NA
40087,2011,427,320,332,16,107,348,12.213085449,9.1526635681,9.4958884519,0.4576331784,3.0604218806,9.9535216303
40087,2012,395,332,309,17,63,326,11.16307988,9.3826392912,8.7326371716,0.4804363492,1.7804405884,9.2130735209
40087,2013,421,315,744,11,106,755,11.689249223,8.7461128387,20.657485562,0.3054198134,2.9431363838,20.962905375
40087,2014,430,340,675,11,90,686,11.670353232,9.22772116,18.319740538,0.2985439199,2.4426320718,18.618284458
40087,2015,406,348,650,11,58,661,10.797585171,9.2550730034,17.286774288,0.292545411,1.5425121672,17.579319699
40087,2016,458,354,521,12,104,533,11.964159766,9.24740733,13.609884799,0.3134714349,2.7167524359,13.923356234
40087,2017,452,352,633,12,100,645,11.598368017,9.032357394,16.242847245,0.3079212748,2.5660106233,16.55076852
30055,2010,5,1,6,0,4,6,NA,NA,NA,NA,NA,NA
30055,2011,13,22,-26,0,-9,-26,7.5275043428,12.738853503,-15.05500869,0,-5.21134916,-15.05500869
30055,2012,8,21,4,0,-13,4,4.6934584922000004,12.320328542,2.3467292461000002,0,-7.62687005,2.3467292461000002
30055,2013,15,12,10,0,3,10,8.7873462214,7.0298769772,5.8582308143,0,1.7574692443,5.8582308143
30055,2014,17,26,11,0,-9,11,9.91831972,15.169194866,6.4177362894,0,-5.250875146,6.4177362894
30055,2015,21,15,-21,0,6,-21,12.305889247,8.7899208907,-12.30588925,0,3.5159683563,-12.30588925
30055,2016,21,13,32,0,8,32,12.216404887,7.5625363583,18.615474113,0,4.6538685282,18.615474113
30055,2017,21,13,-26,0,8,-26,12.149262366,7.520971941,-15.04194388,0,4.6282904252,-15.04194388
46087,2010,19,32,2,3,-13,5,NA,NA,NA,NA,NA,NA
46087,2011,83,67,-93,11,16,-82,14.883887743,12.014704564,-16.67712723,1.9725634358,2.8691831794,-14.70456379
46087,2012,62,85,34,2,-23,36,11.171171171,15.315315315,6.1261261261,0.3603603604,-4.144144144,6.4864864865
46087,2013,78,59,9,2,19,11,14.001077006,10.590558248,1.6155088853,0.3590019745,3.4105187579,1.9745108598
46087,2014,74,80,-40,1,-6,-39,13.300979599,14.379437405,-7.189718702,0.1797429676,-1.078457805,-7.009975735
46087,2015,77,92,-59,1,-15,-58,13.988554819,16.713597965,-10.71850304,0.1816695431,-2.725043147,-10.5368335
46087,2016,77,73,6,2,4,8,14.065211435,13.334551101,1.0959905014,0.3653301671,0.7306603343,1.4613206686
46087,2017,73,69,12,2,4,14,13.296903461,12.568306011,2.1857923497,0.364298725,0.7285974499,2.5500910747
45065,2010,18,50,14,0,-32,14,NA,NA,NA,NA,NA,NA
45065,2011,56,109,-142,-4,-53,-146,5.5363321799,10.776075136,-14.0385566,-0.395452299,-5.239742956,-14.4340089
45065,2012,52,114,-22,-4,-62,-26,5.2143394334,11.43143645,-2.206066683,-0.401103033,-6.217097017,-2.607169717
45065,2013,56,123,23,-4,-67,19,5.6545665674,12.419851568,2.3224112687,-0.403897612,-6.765285,1.9185136568
45065,2014,51,114,2,-3,-63,-1,5.1797684339,11.578305911,0.2031281739,-0.304692261,-6.398537477,-0.101564087
45065,2015,83,131,-99,-3,-48,-102,8.5237483954,13.453145058,-10.16688062,-0.308087291,-4.929396662,-10.47496791
45065,2016,49,136,-2,-3,-87,-5,5.0959388487,14.143830274,-0.207997504,-0.311996256,-9.047891425,-0.51999376
45065,2017,50,149,78,-3,-99,75,5.231767291,15.590666527,8.1615569739,-0.313906037,-10.35889924,7.8476509365
21145,2010,168,144,-36,-1,24,-37,NA,NA,NA,NA,NA,NA
21145,2011,790,798,318,-21,-8,297,12.026915933,12.148707487,4.8412142618,-0.319702829,-0.121791554,4.5215114332
21145,2012,789,810,-161,-5,-21,-166,12.003651301,12.323140119,-2.449414271,-0.076068766,-0.319488818,-2.525483037
21145,2013,784,845,-205,11,-61,-194,11.96937428,12.90066488,-3.129747101,0.1679376493,-0.931290601,-2.961809452
21145,2014,775,806,16,10,-31,26,11.857223727,12.331512676,0.2447942963,0.1529964352,-0.474288949,0.3977907315
21145,2015,755,817,-323,14,-62,-309,11.586151863,12.537597446,-4.956724572,0.2148425511,-0.951445583,-4.741882021
21145,2016,846,805,314,13,41,327,12.983624672,12.354394635,4.8189812612,0.199511963,0.6292300373,5.0184932243
21145,2017,819,830,46,13,-11,59,12.529928783,12.698218425,0.7037566838,0.1988877585,-0.168289642,0.9026444422
21147,2010,70,67,16,0,3,16,NA,NA,NA,NA,NA,NA
21147,2011,243,178,-92,-9,65,-101,13.274698861,9.7238534867,-5.025811914,-0.491655513,3.5508453743,-5.517467428
21147,2012,248,204,-275,-7,44,-282,13.648496189,11.226988801,-15.13442118,-0.385239812,2.4215073883,-15.51966099
21147,2013,232,212,-144,-3,20,-147,12.894978184,11.783342134,-8.003779563,-0.166745408,1.1116360504,-8.17052497
21147,2014,216,178,-42,-1,38,-43,12.050209205,9.930264993,-2.343096234,-0.055788006,2.119944212,-2.39888424
21147,2015,202,238,-16,0,-36,-16,11.288384699,13.300176032,-0.894129481,0,-2.011791333,-0.894129481
21147,2016,226,170,-369,0,56,-369,12.76007114,9.5982836011,-20.83392146,0,3.1617875392,-20.83392146
21147,2017,213,162,-141,0,51,-141,12.164477441,9.2518560822,-8.052541405,0,2.9126213592,-8.052541405
48307,2010,30,41,-44,0,-11,-44,NA,NA,NA,NA,NA,NA
48307,2011,96,118,50,-4,-22,46,11.647658335,14.316913371,6.0664887163,-0.485319097,-2.669255035,5.581169619
48307,2012,103,103,-11,-2,0,-13,12.488632919,12.488632919,-1.333737496,-0.242497727,0,-1.576235223
48307,2013,101,108,8,3,-7,11,12.253563846,13.102820746,0.9705793145,0.3639672429,-0.8492569,1.3345465575
48307,2014,68,113,-53,7,-45,-46,8.2947060259,13.783849718999999,-6.464991461,0.8538667968,-5.489143694,-5.611124665
48307,2015,96,112,108,7,-16,115,11.703748857,13.654373667,13.166717464,0.8533983542,-1.95062481,14.020115818
48307,2016,83,87,-134,7,-4,-127,10.138023696,10.626603151,-16.36741175,0.8550140467,-0.488579455,-15.5123977
48307,2017,88,100,-160,7,-12,-153,10.946635154,12.439358129,-19.90297301,0.870755069,-1.492722975,-19.03221794
40089,2010,101,62,11,0,39,11,NA,NA,NA,NA,NA,NA
40089,2011,432,326,-1,0,106,-1,12.991699747,9.8039215686,-0.030073379,0,3.1877781788,-0.030073379
40089,2012,454,401,-43,-1,53,-44,13.631177566,12.039872696,-1.291058668,-0.03002462,1.59130487,-1.321083288
40089,2013,495,417,-203,4,78,-199,14.888113571,12.542107796,-6.105630414,0.1203079885,2.3460057748,-5.985322425
40089,2014,487,430,-120,20,57,-100,14.684597757,12.965866602,-3.618381377,0.6030635629,1.7187311543,-3.015317814
40089,2015,450,430,-104,21,20,-83,13.592086385,12.987993657,-3.141282187,0.6342973646,0.6040927282,-2.506984822
40089,2016,448,404,-221,22,44,-199,13.577197582,12.243722819,-6.697680057,0.6667373812,1.3334747625,-6.030942676
40089,2017,432,438,-124,22,-6,-102,13.145282761,13.327856132,-3.773183015,0.6694356961,-0.182573372,-3.103747318
29119,2010,76,37,-53,6,39,-47,NA,NA,NA,NA,NA,NA
29119,2011,288,194,-318,23,94,-295,12.532909767,8.4423072739,-13.8384212,1.0008920995,4.0906024935,-12.8375291
29119,2012,319,209,-53,30,110,-23,13.915850546,9.1172813925,-2.312037865,1.3087006783,4.7985691539,-1.003337187
29119,2013,316,218,-447,14,98,-433,13.858433471,9.5605648627,-19.60354355,0.6139812297,4.297868608,-18.98956232
29119,2014,293,241,91,52,52,143,12.88761821,10.600395865,4.0026391027,2.2872223444,2.2872223444,6.2898614471
29119,2015,315,232,-275,57,83,-218,13.836726626,10.190858975,-12.07968197,2.5037886275,3.6458676506,-9.575893347
29119,2016,353,220,-134,67,133,-67,15.528086922,9.6775612546,-5.894514582,2.9472572912,5.8505256675,-2.947257291
29119,2017,350,212,-144,67,138,-77,15.352560588,9.2992652703,-6.31648207,2.9389187411,6.0532953175,-3.377563329
17109,2010,77,52,-18,13,25,-5,NA,NA,NA,NA,NA,NA
17109,2011,305,300,-152,19,5,-133,9.3654522285,9.2119202248,-4.667372914,0.5834216142,0.1535320037,-4.0839513
17109,2012,294,286,-9,40,8,31,9.0404514076,8.7944527298,-0.276748512,1.2299933888,0.2459986778,0.9532448763
17109,2013,304,328,-377,69,-24,-308,9.389526354,10.13080475,-11.64424814,2.1311753896,-0.741278396,-9.513072753
17109,2014,303,291,-419,77,12,-342,9.4529458561,9.0785717628,-13.07189542,2.4022337654,0.3743740933,-10.66966166
17109,2015,264,329,-239,83,-65,-156,8.3068500047,10.352097165,-7.520216482,2.6116232969,-2.04524716,-4.908593185
17109,2016,259,303,-325,84,-44,-241,8.2147897934,9.6103525382,-10.30813391,2.6642561492,-1.395562745,-7.643877761
17109,2017,250,274,-629,84,-24,-545,8.0372930397,8.8088731715,-20.22182929,2.7005304613,-0.771580132,-17.52129883
37111,2010,126,56,35,1,70,36,NA,NA,NA,NA,NA,NA
37111,2011,461,489,-8,4,-28,-4,10.226604701,10.847743381,-0.177468194,0.0887340972,-0.62113868,-0.088734097
37111,2012,442,500,4,24,-58,28,9.8137170008,11.10148982,0.0888119186,0.5328715114,-1.287772819,0.6216834299
37111,2013,444,524,83,50,-80,133,9.8570286831,11.633069887,1.8426427493,1.1100257526,-1.776041204,2.9526685019
37111,2014,480,518,7,52,-38,59,10.649036595,11.492085325,0.1552984503,1.1536456311,-0.84304873,1.3089440815
37111,2015,461,525,-16,55,-64,39,10.229781757,11.649968379,-0.355046655,1.2204728778,-1.420186621,0.8654262224
37111,2016,466,490,-94,59,-24,-35,10.351185055,10.884293298,-2.088007286,1.3105577645,-0.533108243,-0.777449521
37111,2017,469,501,146,60,-32,206,10.405111594,11.115055242,3.239117895,1.3311443404,-0.709943648,4.5702622354
54047,2010,69,54,-30,1,15,-29,NA,NA,NA,NA,NA,NA
54047,2011,270,382,-266,3,-112,-263,12.32173417,17.432972048,-12.13918996,0.1369081574,-5.111237878,-12.0022818
54047,2012,272,394,-296,2,-122,-294,12.639405204,18.308550186,-13.75464684,0.092936803,-5.669144981,-13.661710040000001
54047,2013,279,384,-315,7,-105,-308,13.216172047,18.190000237,-14.92148457,0.331588546,-4.97382819,-14.58989602
54047,2014,252,322,-537,17,-70,-520,12.222330003,15.61742167,-26.04520322,0.8245222621,-3.395091667,-25.22068096
54047,2015,221,342,-532,19,-121,-513,11.040891265,17.085904129,-26.57807309,0.9492168961,-6.045012864,-25.62885619
54047,2016,196,331,-449,19,-135,-430,10.091908452,17.042967845,-23.11870865,0.97829724790000006,-6.951059393,-22.1404114
54047,2017,191,335,-562,19,-144,-543,10.160925655,17.821518819,-29.89759276,1.0107727091,-7.660593164,-28.88682006
13189,2010,83,114,-32,0,-31,-32,NA,NA,NA,NA,NA,NA
13189,2011,304,240,-257,-4,64,-261,14.003408724,11.055322677,-11.83840803,-0.184255378,2.9480860473,-12.02266341
13189,2012,301,188,-86,-10,113,-96,13.921328307,8.6950489097,-3.977522374,-0.462502602,5.2262793978,-4.440024975
13189,2013,298,246,-171,-11,52,-182,13.818046926,11.406844106,-7.929147733,-0.510062135,2.4112028193,-8.439209867
13189,2014,307,210,-61,-11,97,-72,14.270441129,9.7615395342,-2.835494817,-0.511318738,4.5089015944,-3.346813555
13189,2015,265,240,-76,-10,25,-86,12.329595682,11.166426278,-3.536034988,-0.465267762,1.163169404,-4.00130275
13189,2016,298,223,-69,-10,75,-79,13.886947202,10.391910154,-3.215434084,-0.46600494,3.4950370474,-3.681439023
13189,2017,283,248,15,-8,35,7,13.176886902,11.547236579,0.6984215673,-0.372491503,1.6296503236,0.3259300647
17111,2010,875,493,-172,39,382,-133,NA,NA,NA,NA,NA,NA
17111,2011,3369,1912,-2378,201,1457,-2177,10.912695199,6.1932541469,-7.702697888,0.6510690813,4.7194410523,-7.051628806
17111,2012,3331,1901,-1853,183,1430,-1670,10.80516481,6.1665020428,-6.010798677,0.5936190814,4.6386627676,-5.417179596
17111,2013,3141,1967,-2014,252,1174,-1762,10.201745112,6.3886764202,-6.541329085,0.8184781179,3.8130686921,-5.722850967
17111,2014,3176,2001,-1549,300,1175,-1249,10.325735335,6.505603402,-5.036071799,0.9753528339,3.8201319327,-4.060718965
17111,2015,3331,2066,-1203,342,1265,-861,10.82345678,6.7130776667,-3.908921797,1.1112645508,4.1103791134,-2.797657246
17111,2016,3269,2003,-1603,347,1266,-1256,10.614808128,6.5039647234,-5.205120046,1.1267477579,4.1108434048,-4.078372288
17111,2017,3256,2015,-431,346,1241,-85,10.552687273,6.5306095992,-1.396869845,1.1213850726,4.0220776737,-0.275484772
38049,2010,14,4,1,0,10,1,NA,NA,NA,NA,NA,NA
38049,2011,57,61,97,3,-4,100,10.452961672,11.186502842,17.788373372,0.5501558775,-0.73354117,18.33852925
38049,2012,68,56,279,2,12,281,12.03220384,9.9088737503,49.367424578,0.3538883482,2.1233300894,49.721312926
38049,2013,87,71,92,0,16,92,14.857825976,12.125352233,15.71172402,0,2.7324737426,15.71172402
38049,2014,63,67,73,-1,-4,72,10.598031794,11.270922702,12.280259063,-0.168222727,-0.672890908,12.112036336
38049,2015,65,69,3,-1,-4,2,10.874111251,11.543287327,0.5018820577,-0.167294019,-0.669176077,0.3345880385
38049,2016,71,41,-18,-1,30,-19,11.868940154,6.8538950184,-3.009027081,-0.167168171,5.0150451354,-3.176195252
38049,2017,65,55,-96,-1,10,-97,10.935397039,9.2530282638,-16.15074024,-0.168236878,1.6823687752,-16.31897712
13191,2010,24,11,-32,0,13,-32,NA,NA,NA,NA,NA,NA
13191,2011,133,124,-99,-1,9,-100,9.3218854039,8.6910811284,-6.93884703,-0.070089364,0.6308042755,-7.008936394
13191,2012,109,105,-353,0,4,-353,7.7566269347,7.4719800747,-25.12008539,0,0.28464686,-25.12008539
13191,2013,138,116,120,0,22,120,9.889283027,8.3127306604,8.5993765452,0,1.5765523666,8.5993765452
13191,2014,125,121,33,0,4,33,8.8993307703,8.6145521857,2.3494233234,0,0.2847785847,2.3494233234
13191,2015,114,146,2,0,-32,2,8.1144565449,10.392198733,0.1423588868,0,-2.277742188,0.1423588868
13191,2016,110,120,50,0,-10,50,7.8277886497,8.5394057997,3.5580857499,0,-0.71161715,3.5580857499
13191,2017,107,119,46,0,-12,46,7.5945773298,8.4463056285,3.2649584782,0,-0.851728299,3.2649584782
38051,2010,2,7,-8,0,-5,-8,NA,NA,NA,NA,NA,NA
38051,2011,24,54,-13,1,-30,-12,8.6470906143,19.455953882,-4.683840749,0.3602954423,-10.80886327,-4.323545307
38051,2012,22,55,20,3,-33,23,7.998545719,19.996364297,7.2714051991,1.0907107799,-11.99781858,8.3621159789
38051,2013,30,60,15,1,-30,16,10.952902519,21.905805038,5.4764512596,0.3650967506,-10.95290252,5.8415480102
38051,2014,24,52,35,1,-28,36,8.7703270601,19.002375297,12.790060296,0.3654302942,-10.23204824,13.15549059
38051,2015,30,50,-8,1,-20,-7,10.997067449,18.328445748,-2.93255132,0.366568915,-7.331378299,-2.565982405
38051,2016,21,39,-93,1,-18,-92,7.8962210942,14.664410603,-34.96897913,0.3760105283,-6.768189509,-34.5929686
38051,2017,18,42,24,1,-24,25,6.9097888676,16.122840691,9.2130518234,0.3838771593,-9.213051823,9.5969289827
40091,2010,49,93,52,0,-44,52,NA,NA,NA,NA,NA,NA
40091,2011,210,370,155,1,-160,156,10.365251728,18.262586377,7.6505429418,0.0493583416,-7.89733465,7.6999012833
40091,2012,192,307,51,1,-115,52,9.492732127,15.178483141,2.5215069712,0.0494413132,-5.685751014,2.5709482844
40091,2013,215,300,-1,3,-85,2,10.670239956,14.888706916,-0.049629023,0.1488870692,-4.218466959,0.0992580461
40091,2014,237,337,-52,4,-100,-48,11.832251623,16.824762856,-2.596105841,0.1997004493,-4.992511233,-2.396405392
40091,2015,201,301,-47,4,-100,-43,10.110155425,15.140083496999999,-2.364066194,0.2011971229,-5.029928072,-2.162869071
40091,2016,228,277,-5,5,-49,0,11.524755478,14.001566962,-0.252735866,0.2527358657,-2.476811484,0
40091,2017,235,310,53,5,-75,58,11.898432951,15.695805169,2.6834763677,0.2531581479,-3.797372218,2.9366345156
42083,2010,115,157,-75,1,-42,-74,NA,NA,NA,NA,NA,NA
42083,2011,440,527,-146,13,-87,-133,10.179647645,12.192441612,-3.377792173,0.3007623168,-2.012793966,-3.077029856
42083,2012,428,516,66,13,-88,79,9.9288970341,11.970352499,1.5310915987,0.3015786482,-2.041455465,1.8326702469
42083,2013,422,529,-278,16,-107,-262,9.833391588,12.326692299,-6.477921473,0.3728300128,-2.493300711,-6.10509146
42083,2014,413,539,-87,15,-126,-72,9.6883540354,12.644123063,-2.040888138,0.3518772652,-2.955769028,-1.689010873
42083,2015,404,548,-145,16,-144,-129,9.5313366284,12.928644734,-3.420900523,0.3774786784,-3.397308105,-3.043421844
42083,2016,394,492,-650,18,-98,-632,9.4072703396,11.747149764,-15.51960843,0.4297737719,-2.339879425,-15.08983466
42083,2017,394,515,-84,18,-121,-66,9.5113943608,12.432406334,-2.027809965,0.4345307068,-2.921011974,-1.593279258
38053,2010,10,3,40,1,7,41,NA,NA,NA,NA,NA,NA
38053,2011,87,56,552,-3,31,549,12.97152229,8.349485612,82.302072462,-0.447293872,4.6220366781,81.85477859
38053,2012,102,68,905,1,34,906,13.618157543,9.0787716956,120.82777036,0.1335113485,4.5393858478,120.96128171
38053,2013,153,73,1184,2,80,1186,17.739130435,8.4637681159,137.27536232,0.231884058,9.2753623188,137.50724638
38053,2014,191,61,1525,7,130,1532,18.855817168,6.022014907,150.55037267,0.691050891,12.833802261,151.24142356
38053,2015,235,57,1592,7,178,1599,19.765339165,4.7941460953,133.89965936,0.5887547836,14.97119307,134.48841415
38053,2016,248,59,-375,7,189,-368,19.519105899,4.6436582582,-29.51477707,0.5509425052,14.875447641,-28.96383456
38053,2017,220,63,-58,7,157,-51,17.363851618,4.9723756906,-4.577742699,0.5524861878,12.391475927,-4.025256511
35031,2010,299,149,39,-1,150,38,NA,NA,NA,NA,NA,NA
35031,2011,1297,490,-202,25,807,-177,18.017767714,6.8070209559,-2.806159659,0.3472969875,11.210746758,-2.458862672
35031,2012,1246,542,-707,22,704,-685,17.230769231,7.4952463267,-9.777009507,0.3042350908,9.7355229041,-9.472774417
35031,2013,1195,526,-483,90,669,-393,16.490605875,7.2586265188,-6.665240701,1.2419703169,9.2319793557,-5.423270384
35031,2014,1192,570,-600,98,622,-502,16.403255881,7.8438388022,-8.256672423,1.3485898292,8.5594170789,-6.908082594
35031,2015,1118,620,65,100,498,165,15.302595829,8.4862338231,0.889685804,1.3687473908,6.8163620063,2.2584331949
35031,2016,968,632,-870,105,336,-765,13.229104029,8.6371836222,-11.88979391,1.4349751271,4.5919204067,-10.45481878
35031,2017,938,617,-823,104,321,-719,12.891521557,8.4798174846,-11.31100452,1.4293371449,4.4117040722,-9.881667377
17113,2010,527,327,-68,117,200,49,NA,NA,NA,NA,NA,NA
17113,2011,2148,1098,-585,511,1050,-74,12.613739463,6.4478053679,-3.435306139,3.0007545929,6.165934095,-0.434551546
17113,2012,2079,1040,197,534,1039,731,12.111890801,6.058858313,1.1476875843,3.1109907107,6.0530324877,4.258678295
17113,2013,2219,1181,635,546,1038,1181,12.780159939,6.8018787238,3.6572336915,3.1446450324,5.9782812154,6.8018787238
17113,2014,2055,1116,-2601,598,939,-2003,11.794754061,6.4053262928,-14.92854273,3.432244734,5.3894277679,-11.496298
17113,2015,2091,1181,-2599,644,910,-1955,12.071214973,6.81784069,-15.00386787,3.7177725693,5.2533742827,-11.2860953
17113,2016,2092,1187,-1588,649,905,-939,12.113281182,6.8730711105,-9.194976347,3.7578965044,5.2402100716,-5.437079842
17113,2017,2078,1181,-1947,642,897,-1305,12.047145035,6.84681342,-11.28767632,3.7219764739,5.2003316153,-7.565699842
21149,2010,20,38,-8,1,-18,-7,NA,NA,NA,NA,NA,NA
21149,2011,131,115,-27,6,16,-21,13.783670034,12.10016835,-2.840909091,0.6313131313,1.6835016835,-2.20959596
21149,2012,124,117,-22,4,7,-18,13.058129739,12.320977254,-2.316764954,0.4212299916,0.7371524853,-1.895534962
21149,2013,118,134,-20,0,-16,-20,12.457112695,14.146212721,-2.111375033,0,-1.689100026,-2.111375033
21149,2014,123,107,-60,0,16,-60,13.040021203,11.343758283,-6.360985953,0,1.6962629208,-6.360985953
21149,2015,87,126,31,0,-39,31,9.2508905311,13.397841459,3.2962943272,0,-4.146950928,3.2962943272
21149,2016,86,115,-28,0,-29,-28,9.1777386479,12.272557494,-2.988100955,0,-3.094818846,-2.988100955
21149,2017,82,114,-109,0,-32,-109,8.8443078251,12.295745025,-11.75645796,0,-3.4514372,-11.75645796
38055,2010,24,22,32,1,2,33,NA,NA,NA,NA,NA,NA
38055,2011,106,114,77,5,-8,82,11.729556269,12.614805798,8.5205267235,0.5532809561,-0.88524953,9.0738076795
38055,2012,133,121,282,8,12,290,14.410314752,13.110135977,30.554201203,0.8667858497,1.3001787746,31.420987052
38055,2013,93,123,105,4,-30,109,9.8689446596,13.052475195,11.142356874,0.424470738,-3.183530535,11.566827612
38055,2014,120,94,58,4,26,62,12.620287112,9.8858915707,6.0998054372,0.4206762371,2.7343955408,6.5204816743
38055,2015,121,92,83,4,29,87,12.589740922,9.5723649984,8.6359379877,0.4161897825,3.0173759234,9.0521277703
38055,2016,118,86,-39,4,32,-35,12.206475639,8.8962449571,-4.034343643,0.4137788352,3.3102306817,-3.620564808
38055,2017,120,96,-9,4,24,-5,12.403100775,9.9224806202,-0.930232558,0.4134366925,2.480620155,-0.516795866
48309,2010,849,412,514,40,437,554,NA,NA,NA,NA,NA,NA
48309,2011,3403,1960,343,164,1443,507,14.366621142,8.2746333936,1.4480608439,0.692367284,6.0919877485,2.1404281278
48309,2012,3439,1952,-175,185,1487,10,14.415721059,8.1824622001,-0.73357115,0.7754895015,6.2332588584,0.0419183514
48309,2013,3411,2165,625,260,1246,885,14.191862666,9.007734586,2.6003852731,1.0817602736,5.1841280804,3.6821455467
48309,2014,3595,2032,-176,327,1563,151,14.840133169,8.3880808343,-0.726526686,1.3498535595,6.4520523347,0.623326873
48309,2015,3630,2184,470,395,1446,865,14.863069367,8.9424086771,1.9244194497,1.6173312397,5.92066069,3.5417506894
48309,2016,3446,2083,329,420,1363,749,13.984084278,8.4529447332,1.3351026487,1.70438636,5.5311395446,3.0394890087
48309,2017,3500,2107,1962,426,1393,2388,14.035453556,8.4493430405,7.8678742504,1.7083152042,5.5861105152,9.5761894546
27085,2010,112,105,-65,2,7,-63,NA,NA,NA,NA,NA,NA
27085,2011,432,295,-410,23,137,-387,11.843566229,8.0876204576,-11.24042165,0.6305602391,3.7559457718,-10.60986141
27085,2012,394,323,-502,8,71,-494,10.899634835,8.9354874405,-13.887352,0.2213123824,1.964147394,-13.66603961
27085,2013,463,340,-189,20,123,-169,12.889755011,9.4654788419,-5.26169265,0.5567928731,3.4242761693,-4.704899777
27085,2014,393,333,-208,12,60,-196,10.968921389,9.2942769025,-5.805434221,0.3349288974,1.6746444869,-5.470505324
27085,2015,426,310,-98,17,116,-81,11.907756813,8.6652690426,-2.739343117,0.4751921733,3.2424877708,-2.264150943
27085,2016,425,361,-122,15,64,-107,11.881630998,10.092397154,-3.410727016,0.4193516823,1.7892338445,-2.991375334
27085,2017,418,341,46,15,77,61,11.670761671,9.5208845209,1.2843421934,0.418807237,2.1498771499,1.7031494304
47107,2010,105,171,-45,7,-66,-38,NA,NA,NA,NA,NA,NA
47107,2011,569,663,182,55,-94,237,10.892453769,12.691910104,3.484053754,1.0528733872,-1.799456334,4.5369271412
47107,2012,599,587,-3,54,12,51,11.445167331,11.215881842,-0.057321372,1.0317847009,0.2292854891,0.9744633287
47107,2013,543,642,0,71,-99,71,10.372988204,12.264195998,0,1.3563207412,-1.891207794,1.3563207412
47107,2014,584,718,297,48,-134,345,11.137811344,13.693405043,5.6642636457,0.9154365488,-2.555593699,6.5797001945
47107,2015,574,672,-49,57,-98,8,10.935728779,12.802804424,-0.933537823,1.0859521609,-1.867075645,0.1524143384
47107,2016,564,652,248,61,-88,309,10.732839826,12.407467316,4.719404746,1.1608213287,-1.674627491,5.8802260747
47107,2017,569,641,233,61,-72,294,10.783050334,12.147513645,4.4155548817,1.1560036386,-1.364463311,5.5715585203
48311,2010,1,1,3,0,0,3,NA,NA,NA,NA,NA,NA
48311,2011,10,7,-18,1,3,-17,14.204545455,9.9431818182,-25.56818182,1.4204545455,4.2613636364,-24.14772727
48311,2012,6,6,31,1,0,32,8.4092501752,8.4092501752,43.447792572,1.4015416959,0,44.849334268
48311,2013,7,18,37,3,-11,40,9.3959731544,24.161073826,49.66442953,4.0268456376,-14.76510067,53.691275168
48311,2014,7,8,29,6,-1,35,9.0032154341,10.289389068,37.29903537,7.7170418006,-1.286173633,45.01607717
48311,2015,13,5,18,6,8,24,16.009852217,6.157635468,22.167487685,7.3891625616,9.8522167488,29.556650246
48311,2016,10,5,-24,6,5,-18,12.165450122,6.0827250608,-29.19708029,7.299270073,6.0827250608,-21.89781022
48311,2017,10,8,-46,6,2,-40,12.554927809,10.043942247,-57.75266792,7.5329566855,2.5109855618,-50.21971124
47109,2010,73,111,23,0,-38,23,NA,NA,NA,NA,NA,NA
47109,2011,294,345,38,7,-51,45,11.283173105,13.240458235,1.4583693128,0.2686469787,-1.95728513,1.7270162915
47109,2012,295,314,96,-5,-19,91,11.308747987,12.037108027,3.6801349383,-0.191673695,-0.72836004,3.4884612436
47109,2013,284,346,-28,-1,-62,-29,10.892076398,13.269924062,-1.073866687,-0.038352382,-2.377847664,-1.112219069
47109,2014,267,332,69,-2,-65,67,10.25877471,12.756229228,2.6511440263,-0.076844754,-2.497454518,2.5742992719
47109,2015,265,382,-44,-2,-117,-46,10.214898333,14.724872314,-1.696058591,-0.077093572,-4.509973981,-1.773152163
47109,2016,267,334,21,-2,-67,19,10.334817109,12.928198181,0.8128507838,-0.07741436,-2.593381072,0.7354364235
47109,2017,278,355,272,-2,-77,270,10.730690547,13.702860231,10.499092909,-0.077199213,-2.972169684,10.421893697
20113,2010,76,99,-36,5,-23,-31,NA,NA,NA,NA,NA,NA
20113,2011,318,345,34,14,-27,48,10.925770043,11.853429764,1.1681640927,0.4810087441,-0.927659721,1.6491728367
20113,2012,340,364,86,10,-24,96,11.664808303,12.488206536,2.9505103354,0.3430825971,-0.823398233,3.2935929325
20113,2013,365,384,202,10,-19,212,12.467124364,13.116097961,6.8996140315,0.3415650511,-0.648973597,7.2411790826
20113,2014,317,412,-434,11,-95,-423,10.886736726,14.149323443,-14.90486984,0.3777731987,-3.262586716,-14.52709664
20113,2015,345,370,-238,14,-25,-224,12.004593062,12.87449111,-8.281429416,0.4871429069,-0.869898048,-7.79428651
20113,2016,331,381,-177,14,-50,-163,11.610572285,13.364435168,-6.208674606,0.4910816072,-1.753862883,-5.717592999
20113,2017,331,351,313,14,-20,327,11.591665207,12.292067939,10.961302749,0.4902819121,-0.700402732,11.451584661
31117,2010,1,1,1,0,0,1,NA,NA,NA,NA,NA,NA
31117,2011,2,5,15,0,-3,15,3.663003663,9.1575091575,27.472527473,0,-5.494505495,27.472527473
31117,2012,4,3,-44,0,1,-44,7.5329566855,5.6497175141,-82.86252354,0,1.8832391714,-82.86252354
31117,2013,2,2,20,0,0,20,3.8498556304,3.8498556304,38.498556304,0,0,38.498556304
31117,2014,3,1,-20,0,2,-20,5.7692307692,1.9230769231,-38.46153846,0,3.8461538462,-38.46153846
31117,2015,3,4,-22,0,-1,-22,5.994005994,7.992007992,-43.95604396,0,-1.998001998,-43.95604396
31117,2016,5,6,17,0,-1,17,10.050251256,12.060301508,34.170854271,0,-2.010050251,34.170854271
31117,2017,5,5,-7,0,0,-7,9.9601593625,9.9601593625,-13.94422311,0,0,-13.94422311
46089,2010,3,4,-2,0,-1,-2,NA,NA,NA,NA,NA,NA
46089,2011,25,36,5,0,-11,5,10.19160212,14.675907053,2.038320424,0,-4.484304933,2.038320424
46089,2012,25,37,-11,0,-12,-11,10.24800164,15.167042427,-4.509120721,0,-4.919040787,-4.509120721
46089,2013,21,41,18,-2,-20,16,8.6562242374,16.900247321,7.4196207749,-0.824402308,-8.244023083,6.5952184666
46089,2014,29,38,4,-1,-9,3,11.978521272,15.695993391,1.6522098306,-0.413052458,-3.717472119,1.239157373
46089,2015,26,42,-3,-1,-16,-4,10.797342193,17.441860465,-1.245847176,-0.415282392,-6.644518272,-1.661129568
46089,2016,26,31,30,-1,-5,29,10.788381743,12.863070539,12.44813278,-0.414937759,-2.074688797,12.033195021
46089,2017,24,25,8,-1,-1,7,9.900990099,10.313531353,3.300330033,-0.412541254,-0.412541254,2.8877887789
20119,2010,9,4,17,0,5,17,NA,NA,NA,NA,NA,NA
20119,2011,53,50,-83,2,3,-81,11.629182666,10.970927043,-18.21173889,0.4388370817,0.6582556226,-17.77290181
20119,2012,61,56,-149,2,5,-147,13.707865169,12.584269663,-33.48314607,0.4494382022,1.1235955056,-33.03370787
20119,2013,62,41,-126,7,21,-119,14.308792984,9.4622663282,-29.07915994,1.6155088853,4.8465266559,-27.46365105
20119,2014,58,56,49,9,2,58,13.443040909,12.979487774,11.357051802,2.0859891065,0.4635531348,13.443040909
20119,2015,64,45,-84,12,19,-72,14.819960634,10.420284821,-19.45119833,2.778742619,4.3996758134,-16.67245571
20119,2016,65,35,-86,14,30,-72,15.215355805,8.1928838951,-20.13108614,3.2771535581,7.0224719101,-16.85393258
20119,2017,68,34,4,14,34,18,15.898994622,7.9494973112,0.9352349778,3.2733224223,7.9494973112,4.2085574
21163,2010,77,67,53,36,10,89,NA,NA,NA,NA,NA,NA
21163,2011,273,234,818,53,39,871,9.3536395251,8.0174053072,28.02665616,1.8159080397,1.3362342179,29.842564199
21163,2012,267,202,-577,114,65,-463,9.0639056268,6.8573368412,-19.58754137,3.8699821777,2.2065687855,-15.7175592
21163,2013,273,228,-136,68,45,-68,9.3326952003,7.7943388486,-4.649254752,2.3246273759,1.5383563517,-2.324627376
21163,2014,257,212,-226,40,45,-186,8.8101196394,7.2674916869,-7.747420383,1.3712248466,1.5426279524,-6.376195537
21163,2015,291,249,-1470,48,42,-1422,10.237286943,8.759740374,-51.71412992,1.6886246504,1.4775465691,-50.02550527
21163,2016,260,231,210,25,29,235,9.3251797787,8.2850635726,7.5318759751,0.8966519018,1.0401162061,8.4285278769
21163,2017,264,220,83,14,44,97,9.4003703176,7.8336419313,2.9554194559,0.4985044865,1.5667283863,3.4539239425
46093,2010,79,24,-24,18,55,-6,NA,NA,NA,NA,NA,NA
46093,2011,310,178,-121,5,132,-116,12.160200839,6.9823088691,-4.746400973,0.1961322716,5.1778919703,-4.550268701
46093,2012,316,160,64,118,156,182,12.311048777,6.2334424186,2.4933769674,4.5971637837,6.0776063581,7.0905407511
46093,2013,346,196,362,63,150,425,13.24351221,7.5021051826,13.85592896,2.4113909515,5.7414070275,16.267319911
46093,2014,310,194,151,50,116,201,11.664220943,7.2995447191,5.6816043948,1.8813259585,4.3646762238,7.5629303533
46093,2015,307,197,-115,69,110,-46,11.468489671,7.3592588442,-4.296014046,2.5776084277,4.1092308267,-1.718405618
46093,2016,283,174,414,38,109,452,10.450516987,6.4254062038,15.288035451,1.4032496307,4.0251107829,16.691285081
46093,2017,289,194,540,18,95,558,10.437357796,7.0063924302,19.502329445,0.6500776482,3.4309653653,20.152407093
30059,2010,3,11,-3,-1,-8,-4,NA,NA,NA,NA,NA,NA
30059,2011,25,31,3,1,-6,4,13.315579228,16.511318242,1.5978695073,0.5326231691,-3.195739015,2.1304926764
30059,2012,22,24,10,2,-2,12,11.689691817,12.752391073,5.3134962806,1.0626992561,-1.062699256,6.3761955367
30059,2013,20,28,23,0,-8,23,10.55408971,14.775725594,12.137203166,0,-4.221635884,12.137203166
30059,2014,16,30,-35,0,-14,-35,8.517434123,15.970188981,-18.63188714,0,-7.452754858,-18.63188714
30059,2015,17,31,-22,0,-14,-22,9.256738361,16.879934658,-11.97930847,0,-7.623196297,-11.97930847
30059,2016,17,14,18,1,3,19,9.2870800328,7.6481835564,9.8333788582,0.5462988255,1.6388964764,10.379677684
30059,2017,19,18,8,1,1,9,10.289737341,9.7481722177,4.3325209856,0.5415651232,0.5415651232,4.8740861089
37119,2010,3391,1124,474,850,2267,1324,NA,NA,NA,NA,NA,NA
37119,2011,13727,5232,9140,3927,8495,13067,14.695861403,5.6012782734,9.785107687,4.2041704472,9.0945831293,13.989278134
37119,2012,13792,5134,10494,3864,8658,14358,14.418128874,5.3670732045,10.970406351,4.0394177761,9.051055669,15.009824127
37119,2013,13854,5476,10668,4162,8378,14830,14.138011443,5.5882597561,10.886697421,4.2473223347,8.5497516868,15.134019756
37119,2014,14032,5653,6701,4524,8379,11225,14.01144521,5.6447191969,6.691184033,4.5173730138,8.3667260129,11.208557047
37119,2015,14593,5916,9289,5042,8677,14331,14.266601556,5.7836781201,9.0812349658,4.9292266872,8.4829234362,14.010461653
37119,2016,14990,6186,8802,5148,8804,13950,14.332983216,5.9148655219,8.4162053546,4.922361414,8.418117694,13.338566769
37119,2017,14983,6411,5855,5126,8572,10981,14.041687402,6.0082265189,5.4871574275,4.8039571261,8.0334608828,10.291114554
51117,2010,71,63,-13,5,8,-8,NA,NA,NA,NA,NA,NA
51117,2011,284,448,-4,23,-164,19,8.7004472765,13.724649225,-0.122541511,0.7046136879,-5.024201948,0.5820721769
51117,2012,316,444,-796,22,-128,-774,9.8351981824,13.819075927,-24.77473973,0.6847289874,-3.983877745,-24.09001074
51117,2013,271,451,-280,14,-180,-266,8.6112390969,14.330881302,-8.897221207,0.4448610604,-5.719642205,-8.452360147
51117,2014,301,403,-31,13,-102,-18,9.6519215661,12.922672396,-0.994051723,0.4168603999,-3.27075083,-0.577191323
51117,2015,284,467,2,16,-183,18,9.1505163275,15.046799736,0.0644402558,0.5155220466,-5.896283408,0.5799623025
51117,2016,260,448,10,16,-188,26,8.4228258581,14.513176863,0.3239548407,0.5183277451,-6.090351005,0.8422825858
51117,2017,263,461,83,16,-198,99,8.5567412806,14.998698594,2.7004164498,0.5205622072,-6.441957314,3.2209786569
26107,2010,114,81,14,9,33,23,NA,NA,NA,NA,NA,NA
26107,2011,411,364,465,52,47,517,9.5278940109,8.4383294889,10.7797341,1.2054756413,1.0895645219,11.985209741
26107,2012,429,370,-71,50,59,-21,9.8755769386,8.5173973596,-1.634419493,1.1509996432,1.358179579,-0.48341985
26107,2013,444,392,-373,64,52,-309,10.246705592,9.046640973,-8.608155824,1.4770026078,1.2000646189,-7.131153216
26107,2014,418,393,-143,67,25,-76,9.6811923153,9.1021736361,-3.311986845,1.5517700601,0.5790186791,-1.760216785
26107,2015,412,390,-248,68,22,-180,9.5663783596,9.0555523306,-5.758402508,1.5789168166,0.5108260289,-4.179485691
26107,2016,425,357,44,73,68,117,9.8654812614,8.2870042596,1.0213674718,1.6945414873,1.5784770018,2.715908959
26107,2017,409,348,89,71,61,160,9.4497649111,8.0403867703,2.056305812,1.6404237376,1.4093781408,3.6967295496
39103,2010,447,382,94,38,65,132,NA,NA,NA,NA,NA,NA
39103,2011,1809,1286,390,90,523,480,10.456738064,7.4335904647,2.2543548065,0.5202357246,3.0231475995,2.7745905311
39103,2012,1757,1417,-284,70,340,-214,10.124146117,8.165005719,-1.63645845,0.403352435,1.9591403983,-1.233106015
39103,2013,1669,1414,694,61,255,755,9.5866648286,8.1219557026,3.9863064057,0.3503813988,1.464709126,4.3366878044
39103,2014,1821,1323,684,79,498,763,10.393657643,7.5512405609,3.904042739,0.450905521,2.8424170819,4.35494826
39103,2015,1805,1486,-78,85,319,7,10.257284519,8.4445012715,-0.443251076,0.4830300189,1.8127832474,0.0397789427
39103,2016,1774,1421,342,85,353,427,10.050108914,8.0502845359,1.9375069045,0.4815441137,1.999824378,2.4190510182
39103,2017,1759,1419,1058,84,340,1142,9.9022163175,7.9882006564,5.9559663809,0.4728744575,1.9140156612,6.4288408383
48325,2010,120,67,60,10,53,70,NA,NA,NA,NA,NA,NA
48325,2011,547,348,187,10,199,197,11.807496789,7.5118992369,4.036566544,0.2158591735,4.2955975522,4.2524257175
48325,2012,483,352,165,3,131,168,10.349260767,7.5423184058,3.5354617527,0.0642811228,2.8069423613,3.5997428755
48325,2013,495,397,349,1,98,350,10.522959184,8.4396258503,7.4192176871,0.0212585034,2.0833333333,7.4404761905
48325,2014,574,418,414,0,156,414,12.071884497,8.7910239019,8.7068992713,0,3.280860595,8.7068992713
48325,2015,603,427,367,5,176,372,12.53455838,8.8760471449,7.6288274056,0.1039349783,3.6585112354,7.7327623839
48325,2016,591,421,640,7,170,647,12.1136345,8.6291711076,13.117979831,0.1434779044,3.4844633926,13.261457736
48325,2017,595,431,698,7,164,705,11.988474945,8.6840885737,14.063790776,0.1410408817,3.3043863714,14.204831658
27093,2010,78,32,-15,0,46,-15,NA,NA,NA,NA,NA,NA
27093,2011,277,207,-224,15,70,-209,11.907576572,8.898441698,-9.629231596,0.6448146158,3.0091348737,-8.98441698
27093,2012,286,215,-243,14,71,-229,12.371847558,9.3005147727,-10.5117446,0.6056149154,3.0713327854,-9.906129688
27093,2013,258,231,7,24,27,31,11.184567032,10.014089086,0.303457245,1.0404248401,1.1704779452,1.3438820852
27093,2014,287,225,-44,26,62,-18,12.415105766,9.7330968551,-1.903361163,1.1247134144,2.6820089112,-0.778647748
27093,2015,269,246,-134,30,23,-104,11.645777864,10.650042211,-5.801242505,1.2987856354,0.9957356538,-4.502456869
27093,2016,273,202,-62,32,71,-30,11.828935396,8.7525456042,-2.686424888,1.3865418779,3.0763897916,-1.299883011
27093,2017,270,202,-67,32,68,-35,11.680726801,8.738914125,-2.898550725,1.3843824356,2.9418126758,-1.514168289
39105,2010,62,71,-24,0,-9,-24,NA,NA,NA,NA,NA,NA
39105,2011,259,257,-86,-1,2,-87,10.93334459,10.848917219,-3.630376968,-0.042213686,0.0844273714,-3.672590654
39105,2012,252,259,-65,-2,-7,-67,10.674121609,10.970624987,-2.753245653,-0.084715251,-0.296503378,-2.837960904
39105,2013,263,285,-105,-1,-22,-106,11.188394699,12.124306043,-4.466849595,-0.042541425,-0.935911344,-4.50939102
39105,2014,255,266,-148,1,-11,-147,10.915161373,11.386011472,-6.335074052,0.0428045544,-0.470850098,-6.292269497
39105,2015,212,295,-10,1,-83,-9,9.1243624782,12.696636467,-0.430394457,0.0430394457,-3.572273989,-0.387355011
39105,2016,231,281,39,1,-50,40,9.9646277284,12.121473557,1.6823397464,0.0431369166,-2.156845829,1.7254766629
39105,2017,228,290,-35,1,-62,-34,9.8579674428,12.5386428,-1.513284476,0.0432366993,-2.680675357,-1.470047777
47121,2010,35,25,17,0,10,17,NA,NA,NA,NA,NA,NA
47121,2011,92,151,-62,-5,-59,-67,7.8424686727,12.87187793,-5.285141932,-0.426221124,-5.029409258,-5.711363055
47121,2012,104,148,50,-3,-44,47,8.9128851181,12.68372113,4.2850409221,-0.257102455,-3.770836011,4.0279384668
47121,2013,143,160,3,-4,-17,-1,12.264150943,13.72212693,0.2572898799,-0.343053173,-1.457975986,-0.085763293
47121,2014,108,140,84,-3,-32,81,9.2505353319,11.99143469,7.1948608137,-0.256959315,-2.740899358,6.9379014989
47121,2015,126,148,112,-3,-22,109,10.730710271,12.60432635,9.5384091296,-0.255493102,-1.873616079,9.2829160279
47121,2016,129,169,204,-3,-40,201,10.870939199,14.241773059,17.191252686,-0.25281254,-3.37083386,16.938440147
47121,2017,133,155,145,-3,-22,142,11.075949367,12.908061292,12.075283145,-0.249833444,-1.832111925,11.8254497
46095,2010,5,17,-5,0,-12,-5,NA,NA,NA,NA,NA,NA
46095,2011,42,19,22,0,23,22,20.497803807,9.2728160078,10.736944851,0,11.224987799,10.736944851
46095,2012,23,27,-19,1,-4,-18,11.159631247,13.100436681,-9.218825813,0.4852013586,-1.940805434,-8.733624454
46095,2013,32,22,-15,1,10,-14,15.621186234,10.739565536,-7.322431047,0.4881620698,4.8816206981,-6.834268977
46095,2014,27,16,7,1,11,8,13.125911522000001,7.7783179387,3.4030140982,0.4861448712,5.3475935829,3.8891589694
46095,2015,49,25,-66,1,24,-65,23.94331786,12.2159785,-32.25018324,0.48863914,11.72733936,-31.7615441
46095,2016,37,20,38,1,17,39,18.018018018,9.7394691989,18.504991478,0.4869734599,8.2785488191,18.991964938
46095,2017,45,18,-21,1,27,-20,21.58791077,8.635164308,-10.07435836,0.4797313504,12.952746462,-9.594627009
17129,2010,40,42,-7,0,-2,-7,NA,NA,NA,NA,NA,NA
17129,2011,133,116,-12,-4,17,-16,10.475740391,9.1367359798,-0.945179584,-0.315059861,1.3390044108,-1.260239445
17129,2012,113,118,1,-4,-5,-3,8.9025447097,9.2964626172,0.0787835815,-0.315134326,-0.393917908,-0.236350745
17129,2013,113,138,-89,-4,-25,-93,8.9465975219,10.925933257,-7.046435216,-0.316693718,-1.979335735,-7.363128934
17129,2014,132,136,-59,-3,-4,-62,10.527155276,10.846159981,-4.705319403,-0.239253529,-0.319004705,-4.944572932
17129,2015,97,125,-119,-3,-28,-122,7.80275912,10.055101959,-9.572457065,-0.241322447,-2.252342839,-9.813779512
17129,2016,123,125,48,-3,-2,45,9.9373863866,10.098969905,3.8780044435,-0.242375278,-0.161583518,3.6356291658
17129,2017,113,143,-121,-3,-30,-124,9.1705891901,11.605258887,-9.819834442,-0.24346697,-2.434669696,-10.06330141
48327,2010,3,16,1,0,-13,1,NA,NA,NA,NA,NA,NA
48327,2011,11,42,12,1,-31,13,4.9527239982,18.91040072,5.4029716344,0.4502476362,-13.95767672,5.8532192706
48327,2012,18,34,4,2,-16,6,8.1558676937,15.405527866,1.812415043,0.9062075215,-7.249660172,2.7186225646
48327,2013,26,30,-67,2,-4,-65,11.989854738,13.834447775,-30.89693336,0.9222965183,-1.844593037,-29.97463685
48327,2014,23,29,-7,2,-6,-5,10.798122066,13.615023474,-3.286384977,0.9389671362,-2.816901408,-2.34741784
48327,2015,16,42,30,2,-26,32,7.5187969925000004,19.736842105,14.097744361,0.9398496241,-12.21804511,15.037593985000001
48327,2016,17,24,-24,2,-7,-22,8.0321285141,11.339475549,-11.33947555,0.9449562958,-3.307347035,-10.39451925
48327,2017,15,27,31,2,-12,33,7.0989115002,12.7780407,14.671083767,0.9465215334,-5.6791292,15.617605301
06045,2010,305,178,-195,24,127,-171,NA,NA,NA,NA,NA,NA
06045,2011,1014,838,-670,52,176,-618,11.577589258,9.5680668623,-7.649886393,0.5937225261,2.0095223959,-7.056163867
06045,2012,1124,812,-306,12,312,-294,12.86460688,9.2936483865,-3.502286215,0.1373445574,3.5709584933,-3.364941657
06045,2013,1061,850,-446,29,211,-417,12.157671594,9.7398877048,-5.110576372,0.3323020511,2.4177838891,-4.778274321
06045,2014,1059,858,-17,45,201,28,12.134823736,9.8316135649,-0.19479887,0.5156440681,2.3032101708,0.3208451979
06045,2015,1022,861,-275,69,161,-206,11.700526066,9.8572925074,-3.148380301,0.7899572393,1.8432335583,-2.358423062
06045,2016,1043,870,41,79,173,120,11.924974418,9.9470064656,0.4687669714,0.9032339204,1.9779679523,1.3720008918
06045,2017,1035,861,158,81,174,239,11.786342647,9.8048705495,1.7992677663,0.9224094245,1.9814720971,2.7216771909
21165,2010,18,10,48,0,8,48,NA,NA,NA,NA,NA,NA
21165,2011,75,68,43,-1,7,42,11.736170879,10.64079493,6.7287379704,-0.156482278,1.0953759487,6.572255692
21165,2012,75,69,-83,-2,6,-85,11.765628677,10.824378383,-13.02062907,-0.313750098,0.9412502941,-13.33437917
21165,2013,70,64,1,-2,6,-1,11.046236389,10.099416128,0.157803377,-0.315606754,0.946820262,-0.157803377
21165,2014,60,72,-26,-1,-12,-27,9.4951732869,11.394207944,-4.114575091,-0.158252888,-1.899034657,-4.272827979
21165,2015,78,88,77,-1,-10,76,12.316437707,13.895468183,12.15853466,-0.157903048,-1.579030475,12.000631612
21165,2016,70,77,87,-1,-7,86,10.926402872,12.019043159,13.579957855,-0.15609147,-1.092640287,13.423866386
21165,2017,72,93,32,-1,-21,31,11.161925432,14.417487017,4.9608557476,-0.155026742,-3.255561584,4.8058290055
26109,2010,48,80,-29,0,-32,-29,NA,NA,NA,NA,NA,NA
26109,2011,186,253,-38,3,-67,-35,7.7775454736,10.579134434,-1.588960903,0.1254442818,-2.801588961,-1.463516621
26109,2012,205,287,-65,5,-82,-60,8.6174282231,12.064399512,-2.73235529,0.21018117619999999,-3.446971289,-2.522174114
26109,2013,188,257,67,-2,-69,65,7.9283078545,10.838165525,2.8255139694,-0.084343701,-2.90985767,2.7411702688
26109,2014,213,280,-134,-1,-67,-135,9.0221742169,11.860135121,-5.675921808,-0.042357625,-2.837960904,-5.718279433
26109,2015,248,286,-5,-1,-38,-6,10.560381536,12.178504514,-0.212910918,-0.042582184,-1.618122977,-0.255493102
26109,2016,183,245,-175,-1,-62,-176,7.8404490049,10.49677599,-7.497697136,-0.042843984,-2.656326985,-7.54054112
26109,2017,193,237,-130,-1,-44,-131,8.3428793741,10.244882962,-5.619556055,-0.043227354,-1.902003588,-5.662783409
55078,2010,30,12,13,4,18,17,NA,NA,NA,NA,NA,NA
55078,2011,100,39,23,18,61,41,23.156188491,9.0309135116,5.325923353,4.1681139284,14.12527498,9.4940372815
55078,2012,101,35,-89,9,66,-80,23.146556663,8.0210839922,-20.39647072,2.0625644551,15.125472671,-18.33390627
55078,2013,88,34,-62,16,54,-46,20.171919771,7.7936962751,-14.21203438,3.6676217765,12.378223496,-10.54441261
55078,2014,90,45,61,16,45,77,20.320614134,10.160307067,13.772860691,3.6125536238,10.160307067,17.385414315
55078,2015,97,35,-60,17,62,-43,21.55316076,7.7769136763,-13.33185202,3.7773580713,13.776247084,-9.554493945
55078,2016,100,60,-28,15,40,-13,22.106775727,13.264065436,-6.189897203,3.316016359,8.8427102907,-2.873880844
55078,2017,99,67,31,15,32,46,21.634615385,14.641608392,6.7744755245,3.277972028,6.993006993,10.052447552
06047,2010,1066,433,265,76,633,341,NA,NA,NA,NA,NA,NA
06047,2011,4301,1461,-351,369,2840,18,16.658307174,5.6586344526,-1.359466593,1.4291828289,10.999672721,0.0697162356
06047,2012,4304,1571,-1116,190,2733,-926,16.521628977,6.0305481235,-4.283953982,0.7293470041,10.491080854,-3.554606978
06047,2013,4190,1615,-1508,226,2575,-1282,15.988735383,6.1627225878,-5.754418367,0.8623995696,9.8260127948,-4.892018797
06047,2014,4210,1621,-288,301,2589,13,15.947181118,6.1402329198,-1.090923554,1.140166631,9.8069481982,0.0492430771
06047,2015,4106,1677,-708,418,2429,-290,15.416182486,6.296380426,-2.658221432,1.569401919,9.1198020601,-1.088819513
06047,2016,4105,1728,-1317,410,2377,-907,15.309052666,6.4443466521,-4.911576702,1.529040583,8.864706014,-3.382536119
06047,2017,4073,1703,1021,414,2370,1435,15.041981272,6.2893430166,3.7706513329,1.5289418725,8.7526382557,5.2995932054
17131,2010,40,58,-4,0,-18,-4,NA,NA,NA,NA,NA,NA
17131,2011,148,164,-84,4,-16,-80,9.0450725745,10.022918258,-5.13368984,0.2444614209,-0.977845684,-4.889228419
17131,2012,151,172,-137,3,-21,-134,9.2986021307,10.591785208,-8.436480079,0.1847404397,-1.293183078,-8.251739639
17131,2013,148,189,-50,3,-41,-47,9.1817110243,11.725293132,-3.1019294,0.186115764,-2.543582108,-2.915813636
17131,2014,159,189,-149,4,-30,-145,9.9446477155,11.820996341,-9.319198174,0.2501798167,-1.876348626,-9.069018357
17131,2015,137,175,-122,4,-38,-118,8.6574615312,11.058801226,-7.709564283,0.2527725995,-2.401339695,-7.456791684
17131,2016,139,174,-85,5,-35,-80,8.8599929885,11.090926475,-5.417981324,0.3187047838,-2.230933486,-5.09927654
17131,2017,123,180,40,5,-57,45,7.8725038402,11.520737327,2.5601638505,0.3200204813,-3.648233487,2.8801843318
21167,2010,66,85,15,0,-19,15,NA,NA,NA,NA,NA,NA
21167,2011,250,229,-81,14,21,-67,11.734885468,10.749155088,-3.802102891,0.6571535862,0.9857303793,-3.144949305
21167,2012,293,241,-37,20,52,-17,13.75812927,11.316413495,-1.737374686,0.9391214519,2.4417157749,-0.798253234
21167,2013,211,260,-23,23,-49,0,9.9114545412,12.213166733,-1.080395519,1.0803955187,-2.301712192,0
21167,2014,248,232,48,19,16,67,11.641006384,10.889973714,2.2530980098,0.8918512955,0.7510326699,3.1449493053
21167,2015,247,294,57,20,-47,77,11.565023996,13.765656093,2.6688516914,0.93643919,-2.200632096,3.6052908814
21167,2016,227,253,29,20,-26,49,10.616654585,11.832659074,1.3563127002,0.9353880691,-1.21600449,2.2917007694
21167,2017,238,268,138,20,-30,158,11.091951345,12.490096472,6.4314675863,0.9320967516,-1.398145127,7.363564338
29129,2010,10,17,-8,0,-7,-8,NA,NA,NA,NA,NA,NA
29129,2011,42,49,9,2,-7,11,11.136152724,12.992178178,2.3863184409,0.5302929869,-1.856025454,2.9166114278
29129,2012,39,48,-57,1,-9,-56,10.426413581,12.832509023,-15.23860446,0.267343938,-2.406095442,-14.97126053
29129,2013,40,45,-40,1,-5,-39,10.851871948,12.208355941,-10.85187195,0.2712967987,-1.356483993,-10.58057515
29129,2014,42,36,11,1,6,12,11.433238056,9.799918334,2.9944194909,0.2722199537,1.6333197223,3.2666394447
29129,2015,50,52,-21,1,-2,-20,13.618412093,14.163148577,-5.719733079,0.2723682419,-0.544736484,-5.447364837
29129,2016,43,32,-15,1,11,-14,11.751844766,8.7455588959,-4.099480732,0.2732987155,3.0062858705,-3.826182017
29129,2017,49,39,9,1,10,10,13.358778626,10.632497274,2.453653217,0.2726281352,2.7262813522,2.7262813522
34021,2010,1053,720,-492,574,333,82,NA,NA,NA,NA,NA,NA
34021,2011,4385,2951,-3611,2383,1434,-1228,11.913640371,8.0175946944,-9.810753792,6.474391107,3.8960456767,-3.336362685
34021,2012,4180,2811,-1537,2414,1369,877,11.318404592,7.6114917007,-4.161815277,6.5365140397,3.7069128916,2.3746987626
34021,2013,4220,2814,-2148,2660,1406,512,11.363085589,7.5771855091,-5.783864418,7.1625136653,3.7859000802,1.3786492469
34021,2014,4161,2838,-3673,2932,1323,-741,11.165808636,7.6156128113,-9.85628818,7.8678565055,3.5501958243,-1.988431675
34021,2015,4189,3017,-4260,3177,1172,-1083,11.229388884,8.0876262267,-11.41971751,8.5165358046,3.1417626575,-2.903181705
34021,2016,4078,2859,-3899,3226,1219,-673,10.921790552,7.6570375647,-10.44238876,8.63994515,3.2647529876,-1.80244361
34021,2017,4039,2941,-3261,3218,1098,-43,10.79379417,7.8595069703,-8.714672639,8.5997597519,2.9342871994,-0.114912887
38057,2010,32,29,-8,0,3,-8,NA,NA,NA,NA,NA,NA
38057,2011,98,71,-27,4,27,-23,11.636881791,8.4308021136,-3.206079677,0.474974767,3.206079677,-2.73110491
38057,2012,102,76,18,4,26,22,12.072434608,8.9951473547,2.1304296366,0.4734288081,3.0772872529,2.6038584448
38057,2013,96,80,92,5,16,97,11.253077013,9.3775641777,10.784198804,0.5860977611,1.8755128355,11.370296565
38057,2014,108,90,107,-1,18,106,12.486270883,10.405225736,12.370657263,-0.115613619,2.0810451471,12.255043644
38057,2015,97,87,65,-1,10,64,11.08761502,9.9445619249,7.4298451163,-0.114305309,1.1430530948,7.3155398068
38057,2016,107,77,-177,-1,30,-178,12.282614934,8.8388911209,-20.3179705,-0.114790794,3.4437238134,-20.43276129
38057,2017,94,78,-188,-1,16,-189,10.992866331,9.1217401474,-21.98573266,-0.116945387,1.8711261841,-22.10267805
39107,2010,145,119,-55,1,26,-54,NA,NA,NA,NA,NA,NA
39107,2011,516,384,-215,2,132,-213,12.663819761,9.424237962,-5.276591567,0.0490845727,3.2395817994,-5.227506995
39107,2012,519,424,-113,11,95,-102,12.750902882,10.416922586,-2.776208142,0.2702503501,2.3339802963,-2.505957792
39107,2013,564,413,-252,6,151,-246,13.873344239,10.159026898,-6.198728277,0.1475887685,3.7143173405,-6.051139508
39107,2014,565,404,-52,11,161,-41,13.894353728,9.93507771,-1.278772379,0.2705095416,3.9592760181,-1.008262837
39107,2015,572,406,-193,12,166,-181,14.049393936,9.972122269,-4.740442359,0.2947425301,4.0772716666,-4.445699829
39107,2016,597,427,-176,12,170,-164,14.66542203,10.489338705,-4.323474501,0.2947823524,4.1760833251,-4.028692149
39107,2017,596,394,-49,12,202,-37,14.610887072,9.6588750107,-1.201230649,0.2941789343,4.9520120613,-0.907051714
42085,2010,309,305,-50,2,4,-48,NA,NA,NA,NA,NA,NA
42085,2011,1147,1402,-218,3,-255,-215,9.855857017,12.047002213,-1.873214324,0.0257781788,-2.191145196,-1.847436145
42085,2012,1103,1336,-276,21,-233,-255,9.5176460437,11.528173268,-2.381568729,0.1812063163,-2.010527224,-2.200362413
42085,2013,1113,1402,-210,35,-289,-175,9.64425439,12.148467794,-1.81967064,0.3032784399,-2.504213404,-1.5163922
42085,2014,1159,1337,-247,44,-178,-203,10.080583787,11.628766629,-2.148321135,0.3826968823,-1.548182842,-1.765624253
42085,2015,1135,1431,-782,47,-296,-735,9.9333546295,12.523903502,-6.843950062,0.4113371521,-2.590548873,-6.43261291
42085,2016,1155,1437,-839,50,-282,-789,10.20232401,12.693281041,-7.411038826,0.441659048,-2.490957031,-6.969379778
42085,2017,1110,1442,-641,50,-332,-591,9.8920342389000009,12.850732768,-5.712426979,0.4455871279,-2.958698529,-5.266839852
54055,2010,194,165,46,4,29,50,NA,NA,NA,NA,NA,NA
54055,2011,761,898,275,24,-137,299,12.191409942,14.386184137,4.4055686388,0.3844859903,-2.194774195,4.7900546291
54055,2012,803,951,19,0,-148,19,12.862199869,15.23281703,0.3043359869,0,-2.370617161,0.3043359869
54055,2013,736,928,-322,2,-192,-320,11.851661004,14.943398657,-5.185101689,0.0322056006,-3.091737653,-5.152896089
54055,2014,732,893,18,-1,-161,17,11.851564018,14.458260475,0.2914319021,-0.016190661,-2.606696457,0.2752412409
54055,2015,752,902,-496,0,-150,-496,12.255141619,14.69965125,-8.083178514,0,-2.444509631,-8.083178514
54055,2016,696,883,-354,-1,-187,-355,11.453773492,14.531152289,-5.825626173,-0.016456571,-3.077378797,-5.842082744
54055,2017,701,883,-559,0,-182,-559,11.659334536,14.686437084,-9.297529252,0,-3.027102547,-9.297529252
13199,2010,59,87,-142,1,-28,-141,NA,NA,NA,NA,NA,NA
13199,2011,245,252,-219,2,-7,-217,11.280705389,11.603011258,-10.08356931,0.0920873909,-0.322305868,-9.991481916
13199,2012,283,228,-320,1,55,-319,13.176886902,10.616007822,-14.8996601,0.0465614378,2.5608790799,-14.85309866
13199,2013,208,240,-83,0,-32,-83,9.7703039128,11.273427592000001,-3.898727042,0,-1.503123679,-3.898727042
13199,2014,260,257,-10,2,3,-8,12.249128427,12.10779233,-0.471120324,0.094224064799999993,0.1413360972,-0.376896259
13199,2015,280,263,-52,2,17,-50,13.205367038,12.403612611,-2.452425307,0.0943240503,0.8017544273,-2.358101257
13199,2016,243,289,-68,2,-46,-66,11.500780917,13.677883478,-3.218325524,0.0946566331,-2.17710256,-3.123668891
13199,2017,248,271,-1,2,-23,1,11.77559887,12.867690701,-0.047482254,0.094964507,-1.092091831,0.0474822535
31121,2010,23,32,2,0,-9,2,NA,NA,NA,NA,NA,NA
31121,2011,86,83,-97,0,3,-97,11.023521118,10.638979683,-12.43350638,0,0.3845414343,-12.43350638
31121,2012,76,82,90,0,-6,90,9.7467136903,10.516191087,11.542160949,0,-0.769477397,11.542160949
31121,2013,99,85,-27,0,14,-27,12.638835695,10.851525597,-3.44695519,0,1.7873100983,-3.44695519
31121,2014,94,84,-49,-1,10,-50,12.04279034,10.761642432,-6.277624752,-0.128114791,1.2811479085,-6.405739543
31121,2015,100,90,7,0,10,7,12.831205492,11.548084943,0.8981843844,0,1.2831205492,0.8981843844
31121,2016,97,64,14,0,33,14,12.395374098,8.1783911571,1.7890230656,0,4.2169829404,1.7890230656
31121,2017,97,67,4,0,30,4,12.332337423,8.5182124468,0.5085499968,0,3.8141249762,0.5085499968
33013,2010,355,340,-120,44,15,-76,NA,NA,NA,NA,NA,NA
33013,2011,1425,1240,-10,163,185,153,9.7242078183,8.4617668033,-0.068240055,1.1123128943,1.262441015,1.0440728394
33013,2012,1299,1266,-142,191,33,49,8.8528142954,8.6279160107,-0.967744134,1.3016840111,0.2248982846,0.3339398772
33013,2013,1390,1240,-92,247,150,155,9.461575114,8.4405418283,-0.626233749,1.6813014771,1.0210332857,1.0550677285
33013,2014,1330,1358,209,314,-28,523,9.0291921249,9.2192803802,1.4188730482,2.1317040054,-0.190088255,3.5505770536
33013,2015,1319,1440,102,340,-121,442,8.9307175381,9.7499873047,0.6906241007,2.3020803358,-0.819269767,2.9927044366
33013,2016,1380,1367,-59,339,13,280,9.3250804119,9.2372354515,-0.398680974,2.2907262751,0.0878449604,1.892045301
33013,2017,1361,1316,708,335,45,1043,9.1542261787,8.8515515438,4.7620809217,2.2532445039,0.3026746349,7.0153254257
08077,2010,477,330,-451,4,147,-447,NA,NA,NA,NA,NA,NA
08077,2011,1907,1305,258,10,602,268,12.986040177,8.886618999,1.7568947906,0.0680966973,4.0994211781,1.8249914879
08077,2012,1817,1307,-332,-25,510,-357,12.331937478,8.8705791328,-2.253276413,-0.169674429,3.4613583456,-2.422950842
08077,2013,1854,1385,-574,-35,469,-609,12.584165943,9.4007927889,-3.896068636,-0.237565161,3.1833731538,-4.133633797
08077,2014,1761,1383,-350,-47,378,-397,11.960674443,9.393306505,-2.377192536,-0.319222998,2.5673679385,-2.696415533
08077,2015,1827,1489,609,-41,338,568,12.372558248,10.083601112,4.1241860827,-0.277654564,2.2889571362,3.8465315189
08077,2016,1705,1499,1510,-39,206,1471,11.44640999,10.063441979,10.137289786,-0.261824041,1.3829680105,9.8754657447
08077,2017,1762,1451,1546,-40,311,1506,11.691715603,9.628081351,10.258451943,-0.265419196,2.0636342523,9.9930327461
21169,2010,33,18,16,0,15,16,NA,NA,NA,NA,NA,NA
21169,2011,139,136,-84,1,3,-83,13.774650679,13.47735606,-8.324249331,0.0990982063,0.297294619,-8.225151125
21169,2012,137,114,-109,1,23,-108,13.686997353,11.389180279,-10.88965483,0.0999050902,2.2978170738,-10.78974974
21169,2013,131,134,-17,-2,-3,-19,13.158555572,13.45989654,-1.707598815,-0.200893978,-0.301340967,-1.908492793
21169,2014,130,114,22,1,16,23,13.048278631,11.442336646,2.2081702299,0.1003713741,1.6059419853,2.3085416039
21169,2015,136,135,-76,1,1,-75,13.675213675,13.574660633,-7.642031171,0.1005530417,0.1005530417,-7.54147813
21169,2016,136,136,102,1,0,103,13.655989557,13.655989557,10.241992168,0.1004116879,0,10.342403856
21169,2017,144,144,96,1,0,97,14.316249938,14.316249938,9.5441666252,0.0994184023,0,9.6435850276
18103,2010,85,72,-112,0,13,-112,NA,NA,NA,NA,NA,NA
18103,2011,400,336,-224,-7,64,-231,10.890132179,9.1477110303,-6.09847402,-0.190577313,1.7424211486,-6.289051333
18103,2012,358,363,-103,-2,-5,-105,9.7834255653,9.9200655872,-2.81478445,-0.054656009,-0.136640022,-2.869440459
18103,2013,353,370,-368,13,-17,-355,9.7102067201,10.177837072,-10.12282174,0.3575996809,-0.467630352,-9.765222056
18103,2014,402,338,-173,17,64,-156,11.128181705,9.3565308862,-4.788993619,0.4705947487,1.7716508187,-4.318398871
18103,2015,365,387,-59,17,-22,-42,10.1262311,10.736579276,-1.636842835,0.4716326814,-0.610348176,-1.165210154
18103,2016,365,374,44,20,-9,64,10.127776467,10.377502463,1.2208826427,0.5549466558,-0.249725995,1.7758292984
18103,2017,370,353,-262,20,17,-242,10.290354878,9.8175547892,-7.286683725,0.5562353988,0.472800089,-6.730448326
20121,2010,112,46,40,-1,66,39,NA,NA,NA,NA,NA,NA
20121,2011,345,280,-206,-11,65,-217,10.515247108,8.5341135951,-6.278669288,-0.335268748,1.9811335132,-6.613938036
20121,2012,385,236,-216,-6,149,-222,11.772980246,7.2166839949,-6.605100605,-0.183475017,4.556296251,-6.788575622
20121,2013,333,259,88,6,74,94,10.167473246,7.9080347465,2.6868998366,0.1831977161,2.259438499,2.8700975528
20121,2014,368,270,-69,8,98,-61,11.201241877,8.218302464,-2.100232852,0.2435052582,2.9829394128,-1.856727594
20121,2015,347,334,-144,9,13,-135,10.575399244,10.179202731,-4.388638303,0.2742898939,0.3961965135,-4.114348409
20121,2016,377,282,108,11,95,119,11.47396293,8.5826460115,3.2869708129,0.3347840643,2.8913169188,3.6217548772
20121,2017,352,281,419,9,71,428,10.598578827,8.4607973022,12.615921956,0.2709863905,2.1377815248,12.886908346
39109,2010,291,211,-111,16,80,-95,NA,NA,NA,NA,NA,NA
39109,2011,1138,1005,60,50,133,110,11.091780094,9.795464846,0.5848038714,0.4873365595,1.2963152483,1.0721404309
39109,2012,1171,1014,-5,57,157,52,11.389831827,9.8627578761,-0.048632928,0.5544153836,1.5270739512,0.5057824552
39109,2013,1095,1009,148,46,86,194,10.626837861,9.7922186314,1.4363214643,0.4464242389,0.8346192292,1.8827457032
39109,2014,1211,1038,400,49,173,449,11.703309978,10.031408553,3.8656680358,0.4735443344,1.6719014255,4.3392123701
39109,2015,1218,1046,-31,51,172,20,11.726817151,10.070813416,-0.29846579,0.4910243635,1.6560037356,0.1925585739
39109,2016,1199,1100,285,50,99,335,11.510307918,10.559915521,2.7359781122,0.47999616,0.9503923969,3.2159742722
39109,2017,1197,1048,547,50,149,597,11.426989461,10.004582251,5.2218573392,0.4773178555,1.4224072094,5.6991751947
12086,2010,7274,4333,-2173,8637,2941,6464,NA,NA,NA,NA,NA,NA
12086,2011,31320,18396,12742,38228,12924,50970,12.333719254,7.2442879758,5.0177602407,15.054068316,5.0894312785,20.071828557
12086,2012,31132,18157,-16071,39423,12975,23352,12.021627499,7.0113288741,-6.205819592,15.223198667,5.0102986254,9.0173790751
12086,2013,30756,18779,-17147,41389,11977,24242,11.71270289,7.1515427095,-6.530033699,15.762032121,4.5611601806,9.2319984219
12086,2014,31516,18532,-28438,46021,12984,17583,11.851042964,6.9686358741,-10.69361467,17.305395616,4.8824070899,6.6117809505
12086,2015,32085,19255,-32268,50399,12830,18131,11.925877798,7.1570134643,-11.99389823,18.733124985,4.7688643338,6.7392267526
12086,2016,32708,20723,-34057,52599,11985,18542,12.019421133,7.6152153642,-12.51514692,19.328896055,4.4042057685,6.813749133
12086,2017,32043,21604,-47871,52501,10439,4630,11.676756848,7.8726915375,-17.44462213,19.131835697,3.8040653101,1.6872135632
09007,2010,357,346,-136,88,11,-48,NA,NA,NA,NA,NA,NA
09007,2011,1537,1458,211,375,79,586,9.2621049143,8.7860435687,1.2715056193,2.2597848685,0.4760613456,3.5312904878
09007,2012,1481,1428,-1099,301,53,-798,8.9274949967,8.6080100306,-6.624792033,1.8144334868,0.3194849661,-4.810358547
09007,2013,1364,1490,-382,298,-126,-84,8.2463755849000009,9.0081375524,-2.309468822,1.8016275105,-0.761761968,-0.507841312
09007,2014,1380,1495,-774,322,-115,-452,8.3633829278,9.0603315051,-4.690766946,1.9514560165,-0.696948577,-2.73931093
09007,2015,1379,1522,-1218,344,-143,-874,8.3979111795,9.2687605621,-7.417444392,2.094910403,-0.870849383,-5.322533989
09007,2016,1333,1454,-491,349,-121,-142,8.1496403581,8.8894051618,-3.001855526,2.1337017892,-0.739764804,-0.868153737
09007,2017,1321,1447,-240,349,-126,109,8.0833917202,8.8544041023,-1.468595014,2.1355819155,-0.771012382,0.666986902
25017,2010,4698,2522,-246,2287,2176,2041,NA,NA,NA,NA,NA,NA
25017,2011,17635,11051,107,10678,6584,10785,11.635582912,7.2914560116,0.0705986601,7.0453504019,4.3441269008,7.1159490621
25017,2012,17369,10696,-37,10829,6673,10792,11.331479874,6.9780360834,-0.024138681,7.0648048567,4.3534437906,7.0406661754
25017,2013,17640,10879,-151,11194,6761,11043,11.378975021,7.0176796631,-0.097405058,7.2208756457,4.3612953583,7.1234705874
25017,2014,17659,11002,-4592,12196,6657,7604,11.276101007,7.0252938034,-2.932207703,7.7877188899,4.2508072032,4.8555111872
25017,2015,17504,11469,-7177,13101,6035,5924,11.085504171,7.2634624848,-4.545284703,8.2970286872,3.8220416859,3.7517439846
25017,2016,17147,11537,-9569,13340,5610,3771,10.786895435,7.2577367839,-6.01970038,8.3919744038,3.5291586511,2.3722740238
25017,2017,17193,11702,-10137,13269,5491,3132,10.754830463,7.3200154757,-6.341052545,8.3002294777,3.434814987,1.959176933
34023,2010,2488,1383,-1403,1619,1105,216,NA,NA,NA,NA,NA,NA
34023,2011,10101,5754,-5348,7320,4347,1972,12.402950382,7.0652981386,-6.566773452,8.988179071,5.3376522434,2.4214056186
34023,2012,9962,5471,-4370,7044,4491,2674,12.131456177,6.6624369346,-5.32166869,8.5779941084,5.469019242,3.2563254182
34023,2013,9757,5834,-5674,6957,3923,1283,11.792760693,7.0512417631,-6.857858376,8.4085514134,4.7415189298,1.5506930377
34023,2014,9465,5711,-6041,7592,3754,1551,11.36714373,6.8587171521,-7.255035951,9.1177343055,4.5084265783,1.8626983546
34023,2015,9502,5828,-8963,8204,3674,-759,11.354707956,6.9643483441,-10.71061328,9.8036228234,4.3903596116,-0.906990459
34023,2016,9116,5882,-9962,8359,3234,-1603,10.863257142,7.0093986956,-11.87140935,9.9611634982,3.8538584464,-1.910245853
34023,2017,9025,6170,-8384,8298,2855,-86,10.726272653,7.3330861239,-9.964439881,9.8622283074,3.393186529,-0.102211573
51119,2010,18,26,29,0,-8,29,NA,NA,NA,NA,NA,NA
51119,2011,73,137,-65,1,-64,-64,6.6880439762,12.551534585,-5.95510765,0.0916170408,-5.863490609,-5.863490609
51119,2012,92,175,78,0,-83,78,8.4808259587,16.1320059,7.1902654867,0,-7.651179941,7.1902654867
51119,2013,89,137,-22,2,-48,-20,8.2327366912,12.672864345,-2.035058508,0.1850053189,-4.440127654,-1.850053189
51119,2014,78,168,-34,0,-90,-34,7.2808737048,15.681881826,-3.173714179,0,-8.401008121,-3.173714179
51119,2015,96,144,78,0,-48,78,9.0022505626,13.503375844,7.3143285821,0,-4.501125281,7.3143285821
51119,2016,94,140,138,0,-46,138,8.7662034878,13.056047748,12.86953278,0,-4.28984426,12.86953278
51119,2017,95,135,-49,0,-40,-49,8.8590478855,12.589173311,-4.569403646,0,-3.730125425,-4.569403646
26111,2010,222,135,-88,27,87,-61,NA,NA,NA,NA,NA,NA
26111,2011,862,691,-166,109,171,-57,10.297947578,8.2550832676,-1.983131436,1.3021766659,2.0428643108,-0.68095477
26111,2012,864,694,-424,146,170,-278,10.322025698,8.2910715672,-5.065438537,1.7442311943,2.0309541303,-3.321207342
26111,2013,825,740,-336,150,85,-186,9.8684800746,8.8517275821,-4.019162794,1.7942691045,1.0167524925,-2.22489369
26111,2014,863,675,-478,161,188,-317,10.337186321,8.0852847817,-5.725579445,1.9284901479,2.2519015392,-3.797089297
26111,2015,892,700,-152,171,192,19,10.679373365,8.3806741654,-1.819803533,2.0472789747,2.2986991996,0.2274754416
26111,2016,828,755,-450,181,73,-269,9.9124282456,9.0385064317,-5.387189264,2.1668472373,0.8739218139,-3.220342027
26111,2017,824,736,-290,181,88,-109,9.8774903503,8.82261274,-3.476301216,2.1696914483,1.0548776102,-1.306609767
48329,2010,547,228,-226,17,319,-209,NA,NA,NA,NA,NA,NA
48329,2011,2260,1027,1848,73,1233,1921,16.308799174,7.4111224567,13.335690652,0.5267886459,8.8976767177,13.862479298
48329,2012,2406,981,5366,148,1425,5514,16.740768572,6.8257248419,37.33622783,1.0297729629,9.9150437306,38.366000793
48329,2013,2638,1056,3087,300,1582,3387,17.610793454,7.0496580315,20.60823328,2.0027437589,10.561135422,22.610977039
48329,2014,2753,1032,2099,361,1721,2460,17.825519695,6.6821417818,13.590906589,2.3374546349,11.143377913,15.928361224
48329,2015,2916,1078,3140,409,1838,3549,18.306463764,6.7676158907,19.712721611,2.5676761589,11.538847873,22.28039777
48329,2016,3020,1129,-867,434,1891,-433,18.556922746,6.9373396624,-5.327434444,2.6667895602,11.619583084,-2.660644884
48329,2017,2955,1083,-728,433,1872,-295,17.989662793,6.5931657545,-4.43197107,2.6360487273,11.396497038,-1.795922343
42087,2010,133,164,-13,3,-31,-10,NA,NA,NA,NA,NA,NA
42087,2011,543,515,41,17,28,58,11.634135367,11.034216785,0.8784522101,0.3642362822,0.5999185825,1.2426884923
42087,2012,580,483,-89,21,97,-68,12.41305511,10.337078652,-1.904761905,0.4494382022,2.075976458,-1.455323703
42087,2013,605,516,-203,14,89,-189,12.958778234,11.052445568,-4.348152035,0.2998725542,1.9063326658,-4.048279481
42087,2014,552,533,-181,23,19,-158,11.854778958,11.44673403,-3.887164839,0.4939491232,0.4080449279,-3.393215716
42087,2015,584,575,-91,24,9,-67,12.570087926,12.376370818,-1.958695208,0.5165789559,0.1937171084,-1.442116252
42087,2016,582,533,-180,21,49,-159,12.55081246,11.494128937,-3.881694575,0.4528643671,1.0566835233,-3.428830208
42087,2017,590,517,-17,21,73,4,12.728684846,11.153779772,-0.366758716,0.4530548844,1.5749050742,0.0862961685
48331,2010,70,85,-66,2,-15,-64,NA,NA,NA,NA,NA,NA
48331,2011,299,284,-119,25,15,-94,12.136956830999999,11.528079398,-4.830427635,1.0147957216,0.608877433,-3.815631913
48331,2012,299,269,-551,17,30,-534,12.278756519,11.04677426,-22.6274075,0.6981232804,1.2319822595,-21.92928422
48331,2013,304,285,-60,19,19,-41,12.617510947,11.828916513,-2.490298213,0.7885944342,0.7885944342,-1.701703779
48331,2014,320,291,20,22,29,42,13.270024259,12.067428311,0.8293765162,0.9123141678,1.2025959485,1.741690684
48331,2015,327,304,188,24,23,212,13.477033404,12.529107507,7.7482638531,0.9891400664,0.9479258969,8.7374039195
48331,2016,320,291,302,25,29,327,13.03064237,11.849740405,12.297668737,1.0180189352,1.1809019648,13.315687672
48331,2017,321,282,255,25,39,280,12.894673415,11.328030851,10.243432152,1.0042580541,1.5666425645,11.247690206
49027,2010,41,24,2,7,17,9,NA,NA,NA,NA,NA,NA
49027,2011,192,90,-87,10,102,-77,15.306732571,7.1750308925,-6.935863196,0.7972256547,8.1317016782,-6.138637541
49027,2012,183,96,-206,11,87,-195,14.633561233,7.6766222862,-16.47275199,0.8796129703,6.9569389469,-15.59313902
49027,2013,193,109,-6,13,84,7,15.44,8.72,-0.48,1.04,6.72,0.56
49027,2014,200,105,-120,12,95,-108,15.947055775,8.3722042818,-9.568233465,0.9568233465,7.574851493,-8.611410118
49027,2015,196,88,-32,16,108,-16,15.577190542,6.9938406517,-2.543214782,1.2716073912,8.5833498907,-1.271607391
49027,2016,202,104,-64,19,98,-45,15.962070328,8.2180956144,-5.057289609,1.5013828526,7.7439747136,-3.555906756
49027,2017,207,95,51,19,112,70,16.206694069,7.4378547661,3.9929536113,1.4875709532,8.7688393032,5.4805245645
27095,2010,95,88,-26,1,7,-25,NA,NA,NA,NA,NA,NA
27095,2011,296,281,-266,9,15,-257,11.403035673,10.825179136,-10.2473226,0.3467139225,0.5778565375,-9.900608676
27095,2012,339,279,-279,1,60,-278,13.173745774,10.842109354,-10.84210935,0.038860607,2.3316364202,-10.80324875
27095,2013,346,295,-29,6,51,-23,13.494539782,11.505460218,-1.131045242,0.2340093604,1.9890795632,-0.897035881
27095,2014,313,287,-129,8,26,-121,12.224891128,11.209404964,-5.03837366,0.3124572812,1.015486164,-4.725916379
27095,2015,312,304,-86,8,8,-78,12.226903106,11.91339277,-3.370236112,0.313510336,0.313510336,-3.056725776
27095,2016,329,286,83,9,43,92,12.877972404,11.194833154,3.248850181,0.3522849594,1.6831392504,3.6011351404
27095,2017,318,295,226,9,23,235,12.352872626,11.459425863,8.7790855767,0.3496096026,0.8934467622,9.1286951793
05091,2010,162,76,15,-2,86,13,NA,NA,NA,NA,NA,NA
05091,2011,635,447,21,-12,188,9,14.546037636,10.23949421,0.4810500636,-0.274885751,4.3065434262,0.206164313
05091,2012,598,437,-235,-21,161,-256,13.683584275,9.999542355,-5.377328269,-0.480527207,3.6840419203,-5.857855476
05091,2013,605,437,-326,-39,168,-365,13.890642758,10.033406422,-7.484875271,-0.895429864,3.8572363361,-8.380305135
05091,2014,604,360,-97,-26,244,-123,13.881068658,8.2734846309,-2.22924447,-0.597529446,5.6075840276,-2.826773916
05091,2015,611,422,188,-23,189,165,13.967629846,9.647037308,4.2977322604,-0.525786394,4.3205925384,3.7719458669
05091,2016,605,497,-129,-22,108,-151,13.782420011,11.322087182,-2.938730878,-0.501178909,2.4603328284,-3.439909788
05091,2017,608,449,-26,-22,159,-48,13.840515377,10.221038494,-0.591864144,-0.500808122,3.6194768832,-1.092672267
13201,2010,10,10,6,1,0,7,NA,NA,NA,NA,NA,NA
13201,2011,90,88,-65,2,2,-63,14.740807469,14.413233969,-10.64613873,0.3275734993,0.3275734993,-10.31856523
13201,2012,74,71,-75,4,3,-71,12.246586678,11.750103434,-12.41208109,0.6619776583,0.4964832437,-11.75010343
13201,2013,66,86,-86,0,-20,-86,11.08033241,14.438008898,-14.4380089,0,-3.357676488,-14.4380089
13201,2014,68,63,42,0,5,42,11.473888467,10.630220197,7.0868134649,0,0.8436682696,7.0868134649
13201,2015,64,91,-75,0,-27,-75,10.850216157,15.427651098,-12.71509706,0,-4.577434941,-12.71509706
13201,2016,60,85,59,0,-25,59,10.231051241,14.493989257,10.06053372,0,-4.262938017,10.06053372
13201,2017,61,77,-26,0,-16,-26,10.410444577,13.141052991,-4.437238672,0,-2.730608414,-4.437238672
29131,2010,72,84,-24,4,-12,-20,NA,NA,NA,NA,NA,NA
29131,2011,286,245,-39,-1,41,-40,11.57238812,9.9134094036,-1.578052925,-0.040462896,1.6589787165,-1.618515821
29131,2012,273,302,-97,-3,-29,-100,11.076174054,12.252763972,-3.935490415,-0.121716198,-1.176589918,-4.057206613
29131,2013,309,270,196,-5,39,191,12.512401045,10.933165961,7.9366686238,-0.202466036,1.5792350833,7.7342025875
29131,2014,314,267,-17,-2,47,-19,12.650323308,10.756803578,-0.684890115,-0.080575308,1.8935197309,-0.765465423
29131,2015,304,306,42,-2,-2,40,12.232908132,12.313387791,1.6900728341,-0.080479659,-0.080479659,1.6095931753
29131,2016,306,275,99,-2,31,97,12.273629746,11.030222811,3.9708802118,-0.080219802,1.243406935,3.8906604095
29131,2017,308,256,185,-2,52,183,12.265540998,10.194735375,7.3672892358,-0.07964637,2.070805623,7.2876428657
19129,2010,30,18,3,3,12,6,NA,NA,NA,NA,NA,NA
19129,2011,157,143,-60,-2,14,-62,10.430507574,9.5003986181,-3.986181238,-0.132872708,0.9301089556,-4.119053946
19129,2012,152,157,-150,-2,-5,-152,10.166884051,10.501321026,-10.03310926,-0.13377479,-0.334436975,-10.16688405
19129,2013,155,152,33,-2,3,31,10.40967092,10.208193418,2.2162525185,-0.134318334,0.2014775017,2.081934184
19129,2014,153,127,-169,-2,26,-171,10.313447927,8.5608358611,-11.39197843,-0.134816313,1.7526120661,-11.52679474
19129,2015,166,128,84,-2,38,82,11.19919042,8.6355203238,5.6670602125,-0.134930005,2.5636700961,5.5321302075
19129,2016,142,107,129,-2,35,127,9.4900755196,7.1509723986,8.6212657889,-0.133663035,2.339103121,8.4876027535
19129,2017,150,122,0,-2,28,-2,9.962805526,8.1030818278,0,-0.132837407,1.8597236982,-0.132837407
48333,2010,14,7,19,0,7,19,NA,NA,NA,NA,NA,NA
48333,2011,40,65,-68,4,-25,-64,8.1226520459,13.199309575,-13.80850848,0.8122652046,-5.076657529,-12.99624327
48333,2012,39,72,-19,0,-33,-19,8.0346106304,14.833127318,-3.914297487,0,-6.798516687,-3.914297487
48333,2013,41,66,65,1,-25,66,8.4579680248,13.615265601,13.408973698,0.206291903,-5.157297576,13.615265601
48333,2014,47,68,17,3,-21,20,9.6558808423,13.97021058,3.4925526451,0.6163328197,-4.314329738,4.1088854648
48333,2015,56,57,17,4,-1,21,11.482468731,11.687512815,3.4857494361,0.8201763379,-0.205044084,4.305925774
48333,2016,33,56,26,4,-23,30,6.747776301,11.450771905,5.3164298129,0.8179122789,-4.702995604,6.1343420918
48333,2017,35,66,55,4,-31,59,7.1319409068,13.448802853,11.207335711,0.8150789608,-6.316861946,12.022414671
55079,2010,3596,2012,-1359,367,1584,-992,NA,NA,NA,NA,NA,NA
55079,2011,14180,8267,-4362,1933,5913,-2429,14.926064403,8.7019587039,-4.591501617,2.0347025734,6.2241056993,-2.556799043
55079,2012,14250,8017,-4846,2175,6233,-2671,14.945198318,8.4081161342,-5.082416214,2.2811092169,6.5370821834,-2.801306997
55079,2013,14004,8265,-5405,2234,5739,-3171,14.640970043,8.6409324052,-5.650845693,2.3356131873,6.0000376375,-3.315232505
55079,2014,13965,8159,-7311,2634,5806,-4677,14.572566739,8.5139686374,-7.629075219,2.7485958317,6.0585981013,-4.880479387
55079,2015,13982,8104,-8772,2891,5878,-5881,14.581876528,8.4516898426,-9.148349371,3.0150339752,6.1301866849,-6.133315395
55079,2016,13660,8181,-11958,2983,5479,-8975,14.272072083,8.5475711357,-12.49380951,3.1166611292,5.7245009476,-9.377148386
55079,2017,13448,8130,-11588,2975,5318,-8613,14.100471099,8.5244519658,-12.15022748,3.119341279,5.5760191334,-9.030886197
46097,2010,3,12,-7,0,-9,-7,NA,NA,NA,NA,NA,NA
46097,2011,19,36,-33,0,-17,-33,8.0868269845,15.322409023,-14.0455416,0,-7.235582039,-14.0455416
46097,2012,23,40,-10,0,-17,-10,9.9502487562,17.304780446,-4.326195111,0,-7.354531689,-4.326195111
46097,2013,25,25,15,1,0,16,10.843634786,10.843634786,6.5061808718,0.4337453915,0,6.9399262633
46097,2014,23,35,-21,1,-12,-20,10.010881393,15.233949946,-9.140369967,0.4352557127,-5.223068553,-8.705114255
46097,2015,28,31,-71,1,-3,-70,12.466607302,13.802315227,-31.61175423,0.4452359751,-1.335707925,-31.16651825
46097,2016,25,25,31,1,0,32,11.23343069,11.23343069,13.929454055,0.4493372276,0,14.378791283
46097,2017,29,27,-16,1,2,-15,12.978294921,12.083240098,-7.160438577,0.4475274111,0.8950548221,-6.712911166
08079,2010,1,4,-5,0,-3,-5,NA,NA,NA,NA,NA,NA
08079,2011,5,3,4,0,2,4,7.0671378092,4.2402826855,5.6537102473,0,2.8268551237,5.6537102473
08079,2012,6,5,7,0,1,7,8.3916083916,6.993006993,9.7902097902,0,1.3986013986,9.7902097902
08079,2013,4,4,13,0,0,13,5.5134390076,5.5134390076,17.918676775,0,0,17.918676775
08079,2014,6,4,-31,0,2,-31,8.362369338,5.574912892,-43.20557491,0,2.787456446,-43.20557491
08079,2015,4,7,41,0,-3,41,5.5325034578,9.6818810512,56.708160443,0,-4.149377593,56.708160443
08079,2016,8,5,10,0,3,10,10.680907877,6.6755674232,13.351134846,0,4.0053404539,13.351134846
08079,2017,8,2,6,0,6,6,10.519395135,2.6298487837,7.8895463511,0,7.8895463511,7.8895463511
30061,2010,16,16,0,0,0,0,NA,NA,NA,NA,NA,NA
30061,2011,45,49,-5,-1,-4,-6,10.669828097,11.618257261,-1.185536455,-0.237107291,-0.948429164,-1.422643746
30061,2012,48,45,-96,-1,3,-97,11.520460818,10.800432017,-23.04092164,-0.2400096,0.7200288012,-23.28093124
30061,2013,44,49,104,0,-5,104,10.54902901,11.747782306,24.934068569,0,-1.198753297,24.934068569
30061,2014,40,58,-13,-1,-18,-14,9.5158796241,13.798025455,-3.092660878,-0.237896991,-4.282145831,-3.330557868
30061,2015,43,54,8,-1,-11,7,10.27479092,12.903225806,1.9115890084,-0.238948626,-2.628434886,1.6726403823
30061,2016,44,52,-51,-1,-8,-52,10.590925502,12.516548321,-12.27584547,-0.240702852,-1.925622819,-12.51654832
30061,2017,39,46,139,-1,-7,138,9.307875895,10.978520286,33.174224344,-0.238663484,-1.670644391,32.935560859
32021,2010,10,4,6,2,6,8,NA,NA,NA,NA,NA,NA
32021,2011,48,74,-147,22,-26,-125,10.184595799,15.701251857,-31.19032463,4.6679397411,-5.516656058,-26.52238489
32021,2012,66,87,37,19,-21,56,14.173735638,18.683560614,7.9458821003,4.0803178353,-4.509824976,12.026199936
32021,2013,46,76,-86,11,-30,-75,9.9513250406,16.441319632,-18.60465116,2.3796646836,-6.489994592,-16.22498648
32021,2014,51,66,-82,11,-15,-71,11.262007287,14.574362372,-18.10754113,2.4290603953,-3.312355084,-15.67848073
32021,2015,45,67,-33,11,-22,-22,10.079516183,15.007279651,-7.391645201,2.4638817337,-4.927763467,-4.927763467
32021,2016,46,93,-12,12,-47,0,10.408417242,21.043104424,-2.71523928,2.7152392805,-10.63468718,0
32021,2017,47,100,102,12,-53,114,10.617869649,22.591212019,23.043036259,2.7109454422,-11.97334237,25.753981701
54057,2010,75,104,16,-2,-29,14,NA,NA,NA,NA,NA,NA
54057,2011,277,312,-107,-11,-35,-118,9.8551962145,11.100437613,-3.806880848,-0.391361583,-1.245241399,-4.198242431
54057,2012,281,303,-148,0,-22,-148,10.055646013,10.842920789,-5.296212135,0,-0.787274777,-5.296212135
54057,2013,325,350,-169,1,-25,-168,11.70686022,12.607387929,-6.087567314,0.0360211084,-0.900527709,-6.051546206
54057,2014,283,281,-137,5,2,-132,10.254552043,10.18208171,-4.964217773,0.1811758311,0.0724703325,-4.783041942
54057,2015,276,323,-125,7,-47,-118,10.055194273,11.767491848,-4.553982913,0.2550230432,-1.712297575,-4.29895987
54057,2016,290,354,14,8,-64,22,10.60561732,12.946167349,0.5119953189,0.2925687537,-2.340550029,0.8045640726
54057,2017,277,340,-44,8,-63,-36,10.156937518,12.46699912,-1.613376357,0.2933411558,-2.310061602,-1.320035201
54059,2010,95,114,-47,0,-19,-47,NA,NA,NA,NA,NA,NA
54059,2011,355,341,-225,7,14,-218,13.311834408,12.786860657,-8.437078146,0.2624868757,0.5249737513,-8.17459127
54059,2012,364,359,-426,4,5,-422,13.80722983,13.617570079,-16.15901073,0.1517278003,0.1896597504,-16.00728293
54059,2013,350,378,-163,3,-28,-160,13.42796854,14.502206023,-6.253596777,0.1150968732,-1.074237483,-6.138499904
54059,2014,325,385,-214,0,-60,-214,12.580563996,14.903129657,-8.283817524,0,-2.322565661,-8.283817524
54059,2015,342,354,-412,0,-12,-412,13.418605564,13.889433829,-16.16510378,0,-0.470828265,-16.16510378
54059,2016,295,355,-541,0,-60,-541,11.810629567,14.212791512,-21.65949354,0,-2.402161946,-21.65949354
54059,2017,293,356,-490,0,-63,-490,12.007212524,14.588968117,-20.08032129,0,-2.581755594,-20.08032129
16067,2010,98,27,-47,2,71,-45,NA,NA,NA,NA,NA,NA
16067,2011,319,176,-63,39,143,-24,15.830872683,8.7342745838,-3.126473289,1.9354358453,7.0965980993,-1.191037443
16067,2012,320,200,-260,30,120,-230,15.874590733,9.9216192083,-12.89810497,1.4882428812,5.952971525,-11.40986209
16067,2013,335,170,8,25,165,33,16.582106175,8.4148001485,0.3959905952,1.2374706101,8.1673060265,1.6334612053
16067,2014,332,186,-212,17,146,-195,16.372423316,9.1725022192,-10.45467995,0.838346977,7.1999210968,-9.616332972
16067,2015,306,166,-49,26,140,-23,15.063132245,8.1715031135,-2.412070196,1.2798739816,6.8916291319,-1.132196215
16067,2016,321,145,6,29,176,35,15.675741668,7.0809424979,0.2930045172,1.4161884996,8.5947991698,1.7091930167
16067,2017,307,151,-39,29,156,-10,14.862509682,7.3102246321,-1.888071263,1.403950426,7.5522850503,-0.484120837
46099,2010,740,352,11,126,388,137,NA,NA,NA,NA,NA,NA
46099,2011,2755,1308,-354,558,1447,204,16.130826566,7.6584831753,-2.072708749,3.2671510794,8.4723433905,1.1944423301
46099,2012,2788,1283,990,579,1505,1569,16.101785462,7.4098245148,5.7176354401,3.3439504241,8.6919609468,9.0615858642
46099,2013,2761,1241,1587,595,1520,2182,15.637876398,7.0288318036,8.9885222178,3.3699878511,8.6090445943,12.358510069
46099,2014,2962,1295,602,639,1667,1241,16.466853647,7.1993840218,3.3467406804,3.5524373667,9.267469625,6.8991780472
46099,2015,2973,1377,262,710,1596,972,16.281088363,7.5408875466,1.4347948709,3.8881845738,8.7402008165,5.3229794446
46099,2016,3024,1343,-236,728,1681,492,16.348994813,7.2608135031,-1.275913616,3.9358691215,9.0881813095,2.6599555052
46099,2017,2968,1374,252,723,1594,975,15.843402275,7.3345130476,1.3451945327,3.8594271713,8.508889227,5.2046217041
26113,2010,36,55,-18,1,-19,-17,NA,NA,NA,NA,NA,NA
26113,2011,164,160,64,12,4,76,11.042283867,10.772959871,4.3091839483,0.8079719903,0.2693239968,5.1171559386
26113,2012,191,134,33,10,57,43,12.783615555,8.9686098655,2.2086875042,0.6692992437,3.815005689,2.8779867479
26113,2013,181,155,16,11,26,27,12.05380927,10.322322856,1.0655301012,0.7325519446,1.7314864145,1.7980820458
26113,2014,184,181,-93,11,3,-82,12.264622563,12.064655891,-6.198966839,0.7332111315,0.1999666722,-5.465755707
26113,2015,161,178,-83,12,-17,-71,10.791969702,11.931494452999999,-5.56356202,0.8043704126,-1.139524751,-4.759191608
26113,2016,189,163,120,12,26,132,12.639604093,10.900822577,8.0251454558,0.8025145456,1.7387815154,8.8276600013
26113,2017,174,165,-55,12,9,-43,11.588411588,10.989010989,-3.663003663,0.7992007992,0.5994005994,-2.863802864
05093,2010,178,124,-152,4,54,-148,NA,NA,NA,NA,NA,NA
05093,2011,651,522,-515,0,129,-515,14.090604099,11.298456743,-11.14694487,0,2.7921473561,-11.14694487
05093,2012,687,510,-658,-3,177,-661,15.008520121,11.141696159,-14.37497269,-0.065539389,3.8668239612,-14.44051208
05093,2013,602,500,-983,4,102,-979,13.346191791,11.084876902,-21.79286799,0.0886790152,2.2613148881,-21.70418897
05093,2014,671,481,-643,0,190,-643,15.094254735,10.820173663,-14.46439016,0,4.2740810726,-14.46439016
05093,2015,674,500,-705,8,174,-697,15.327064549,11.370225926,-16.03201856,0.1819236148,3.9568386224,-15.85009494
05093,2016,643,511,-977,12,132,-965,14.849541581,11.801113138,-22.56298931,0.2771298584,3.0484284428,-22.28585945
05093,2017,626,501,-866,12,125,-854,14.721791073,11.782136306,-20.36592823,0.2822068576,2.9396547669,-20.08372137
29133,2010,45,74,-20,0,-29,-20,NA,NA,NA,NA,NA,NA
29133,2011,171,202,-54,-9,-31,-63,11.987801886,14.161029128,-3.785621648,-0.630936941,-2.173227242,-4.41655859
29133,2012,196,186,44,-9,10,35,13.765494961,13.063173789,3.0902131545,-0.632089054,0.7023211715,2.4581241002
29133,2013,171,197,-70,-6,-26,-76,12.034625941,13.864452108,-4.926455064,-0.422267577,-1.829826167,-5.348722641
29133,2014,150,154,9,-6,-4,3,10.595465141,10.878010878,0.6357279085,-0.423818606,-0.282545737,0.2119093028
29133,2015,139,139,-209,-5,0,-214,9.8935905192,9.8935905192,-14.87597423,-0.355884551,0,-15.23185879
29133,2016,154,153,-203,-5,1,-208,11.12716763,11.054913295,-14.66763006,-0.361271676,0.0722543353,-15.02890173
29133,2017,140,172,-113,-5,-32,-118,10.247776598,12.590125535,-8.271419683,-0.365992021,-2.342348937,-8.637411704
30063,2010,323,215,23,7,108,30,NA,NA,NA,NA,NA,NA
30063,2011,1201,803,285,66,398,351,10.937869984,7.3131636947,2.595581137,0.6010819475,3.6247062895,3.1966630845
30063,2012,1216,760,336,54,456,390,10.995171528,6.8719822052,3.0381395012,0.4882724198,4.1231893231,3.5264119211
30063,2013,1220,830,122,62,390,184,10.961808878,7.4576240729,1.0961808878,0.5570755332,3.5041848053,1.653256421
30063,2014,1255,843,406,79,412,485,11.203506564,7.5255426559,3.6244013266,0.7052406522,3.6779639077,4.3296419788
30063,2015,1245,863,843,88,382,931,11.005914021,7.6289990364,7.4521972048,0.7779280593,3.3769149848,8.2301252641
30063,2016,1254,890,1652,96,364,1748,10.919730403,7.7500478936,14.385482157,0.8359602222,3.1696825093,15.22144238
30063,2017,1252,888,1080,94,364,1174,10.731259937,7.6113089651,9.25699739,0.8057016247,3.1199509722,10.062699015
13205,2010,78,75,-2,2,3,0,NA,NA,NA,NA,NA,NA
13205,2011,300,233,-160,-4,67,-164,12.793176972,9.9360341151,-6.823027719,-0.170575693,2.8571428571,-6.993603412
13205,2012,294,220,-397,0,74,-397,12.648697485,9.4650117237,-17.08004388,0,3.1836857616,-17.08004388
13205,2013,291,235,-147,4,56,-143,12.628563989,10.198324871,-6.379377685,0.1735885084,2.4302391182,-6.205789177
13205,2014,245,217,-311,5,28,-306,10.715535339,9.4909027292,-13.60216935,0.2186843947,1.2246326102,-13.38348495
13205,2015,281,262,-320,6,19,-314,12.443263589,11.601904129,-14.17026459,0.265692461,0.8413594598,-13.90457212
13205,2016,265,249,-48,6,16,-42,11.817695326,11.104174099,-2.140563682,0.2675704602,0.7135212273,-1.872993222
13205,2017,249,224,-151,6,25,-145,11.140191933,10.021698767,-6.755698723,0.2684383598,1.118493166,-6.487260363
19131,2010,48,40,9,1,8,10,NA,NA,NA,NA,NA,NA
19131,2011,120,134,-77,5,-14,-72,11.167985109,12.470916705,-7.166123779,0.4653327129,-1.302931596,-6.700791066
19131,2012,115,133,25,3,-18,28,10.741138561,12.422360248,2.3350301219,0.2802036146,-1.681221688,2.6152337365
19131,2013,123,139,-31,0,-16,-31,11.509310377,13.006456442,-2.900720502,0,-1.497146065,-2.900720502
19131,2014,132,125,22,4,7,26,12.361865518,11.706312043,2.0603109196,0.3746019854,0.6555534744,2.434912905
19131,2015,116,136,-6,4,-20,-2,10.859389627,12.731698184,-0.561692567,0.3744617113,-1.872308556,-0.187230856
19131,2016,120,116,-22,4,4,-18,11.252813203,10.87771943,-2.063015754,0.3750937734,0.3750937734,-1.68792198
19131,2017,109,119,-18,4,-10,-14,10.240511086,11.180007516,-1.691093574,0.375798572,-0.93949643,-1.315295002
20123,2010,10,29,-19,0,-19,-19,NA,NA,NA,NA,NA,NA
20123,2011,81,91,-44,0,-10,-44,12.837784294,14.422695935,-6.973611221,0,-1.584911641,-6.973611221
20123,2012,70,93,36,3,-23,39,11.125238398,14.780673872,5.7215511761,0.4767959313,-3.655435474,6.1983471074
20123,2013,82,95,13,8,-13,21,13.007614213,15.069796954,2.0621827411,1.269035533,-2.062182741,3.3312182741
20123,2014,76,86,-64,8,-10,-56,12.110588798,13.704087324,-10.19839057,1.2747988208,-1.593498526,-8.923591746
20123,2015,93,73,14,8,20,22,14.844373504,11.652035116,2.2346368715,1.2769353551,3.1923383879,3.5115722267
20123,2016,69,94,-83,8,-25,-75,11.064785119,15.073765234,-13.30981398,1.2828736369,-4.008980115,-12.02694035
20123,2017,75,98,-44,8,-23,-36,12.181257106,15.916842618,-7.146337502,1.2993340913,-3.735585512,-5.847003411
37121,2010,33,68,-34,2,-35,-32,NA,NA,NA,NA,NA,NA
37121,2011,135,226,-74,7,-91,-67,8.7491898898,14.646791964,-4.795852236,0.453661698,-5.897602074,-4.342190538
37121,2012,154,190,7,7,-36,14,10.039767912,12.386726645,0.4563530869,0.4563530869,-2.346958733,0.9127061738
37121,2013,139,220,55,10,-81,65,9.0739954956,14.36171949,3.5904298724,0.6528054313,-5.287723994,4.2432353037
37121,2014,137,186,-51,17,-49,-34,8.9730154572,12.182342154,-3.340319623,1.1134398742,-3.209326696,-2.226879748
37121,2015,146,228,-60,19,-82,-41,9.6283839483,15.03610644,-3.956870116,1.25300887,-5.407722492,-2.703861246
37121,2016,148,233,33,20,-85,53,9.8113958036,15.446319069,2.1876760914,1.3258642978,-5.634923266,3.5135403891
37121,2017,143,219,61,20,-76,81,9.4890510949,14.532183145,4.0477770405,1.3271400133,-5.04313205,5.3749170537
48335,2010,31,29,8,0,2,8,NA,NA,NA,NA,NA,NA
48335,2011,89,105,2,-4,-16,-2,9.4645610677,11.166055192,0.2126867656,-0.425373531,-1.701494125,-0.212686766
48335,2012,101,86,-79,-3,15,-82,10.790021901,9.1875434005,-8.4397201,-0.3204957,1.6024785001,-8.7602158
48335,2013,103,105,-336,-2,-2,-338,11.24085998,11.459129106,-36.66921314,-0.218269126,-0.218269126,-36.88748227
48335,2014,98,100,70,-2,-2,68,10.849709383,11.071132023,7.7497924163,-0.22142264,-0.22142264,7.5283697758
48335,2015,99,104,-210,0,-5,-210,11.047874121,11.605847562,-23.4348845,0,-0.55797344,-23.4348845
48335,2016,88,92,-374,0,-4,-374,10.152869916,10.614364003,-43.14969714,0,-0.461494087,-43.14969714
48335,2017,92,78,-24,0,14,-24,10.857378887,9.2051690565,-2.83235971,0,1.6522098306,-2.83235971
01097,2010,1346,951,-315,126,395,-189,NA,NA,NA,NA,NA,NA
01097,2011,5605,4134,-2148,593,1471,-1555,13.562365102,10.003000416,-5.197495136,1.4348764506,3.5593646861,-3.762618686
01097,2012,5676,4050,-1594,510,1626,-1084,13.727237659,9.7948048839,-3.855041725,1.2334198743,3.9324327756,-2.62162185
01097,2013,5391,4379,-1274,490,1012,-784,13.026993981,10.581563094,-3.078536511,1.1840525043,2.4454308864,-1.894484007
01097,2014,5653,4286,-1401,471,1367,-930,13.650583223,10.349619616,-3.383065115,1.1373473727,3.3009636061,-2.245717742
01097,2015,5691,4144,-1759,523,1547,-1236,13.731418189,9.9987694565,-4.244168792,1.2619103344,3.7326487329,-2.982258458
01097,2016,5585,4461,-1368,514,1124,-854,13.466917438,10.756655092999999,-3.298611111,1.2393904321,2.7102623457,-2.059220679
01097,2017,5475,4481,-2378,493,994,-1885,13.211761001,10.813132611,-5.738368522,1.1896617669,2.39862839,-4.548706756
06049,2010,27,17,4,0,10,4,NA,NA,NA,NA,NA,NA
06049,2011,100,101,-196,9,-1,-187,10.409076715,10.513167482,-20.40179036,0.9368169043,-0.104090767,-19.46497346
06049,2012,74,124,-114,7,-50,-107,7.841475045,13.139768994,-12.0801102,0.7417611529,-5.298293949,-11.33834905
06049,2013,80,112,-186,10,-32,-176,8.6425754875,12.099605682,-20.09398801,1.0803219359,-3.457030195,-19.01366607
06049,2014,74,104,-52,11,-30,-41,8.1153698525,11.405384658,-5.702692329,1.2063387619,-3.290014805,-4.496353567
06049,2015,58,107,6,11,-49,17,6.3971764187,11.801687531,0.6617768709,1.2132575966,-5.404511112,1.8750344675
06049,2016,51,93,-80,14,-42,-66,5.6695014174,10.338502585,-8.893335557,1.5563337224,-4.669001167,-7.337001834
06049,2017,80,106,-71,15,-26,-56,8.9887640449,11.91011236,-7.97752809,1.6853932584,-2.921348315,-6.292134831
08081,2010,58,44,-16,4,14,-12,NA,NA,NA,NA,NA,NA
08081,2011,186,68,-528,11,118,-517,13.671444322,4.9981624403,-38.8092613,0.8085262771,8.6732818817,-38.00073502
08081,2012,164,120,-313,7,44,-306,12.344285123,9.0324037484,-23.55951978,0.5268902187,3.3118813744,-23.03262956
08081,2013,190,91,-151,6,99,-145,14.462967192,6.9270000761,-11.49425287,0.4567252797,7.5359671158,-11.03752759
08081,2014,176,93,-278,5,83,-273,13.514551179,7.1412117024,-21.34684788,0.383936113,6.3733394763,-20.96291177
08081,2015,192,96,-92,5,96,-87,14.842874261,7.4214371304,-7.112210583,0.3865331839,7.4214371304,-6.725677399
08081,2016,181,87,122,6,94,128,13.869200414,6.6664112486,9.3483008314,0.4597524999,7.2027891652,9.8080533313
08081,2017,187,85,-139,6,102,-133,14.224859273,6.465845124,-10.5735585,0.456412597,7.7590141488,-10.1171459
04015,2010,491,570,258,-47,-79,211,NA,NA,NA,NA,NA,NA
04015,2011,2011,2374,2815,-107,-363,2708,9.9789603223,11.780234612,13.968559576,-0.53095413,-1.80127429,13.437605446
04015,2012,1871,2577,1381,-163,-706,1218,9.2168622766,12.69473762,6.8030394463,-0.802965554,-3.477875343,6.0000738925
04015,2013,1746,2643,806,-138,-897,668,8.5948883551,13.010475328,3.9676288741,-0.679321073,-4.415586973,3.2883078014
04015,2014,1785,2524,1153,-124,-739,1029,8.785616199,12.422910525,5.674966654,-0.610317316,-3.637294326,5.0646493382
04015,2015,1856,2861,2299,-107,-1005,2192,9.1015192083,14.029874168,11.273918459,-0.524710428,-4.928354959,10.749208031
04015,2016,1842,3174,2301,-105,-1332,2196,8.9873606093,15.486364047,11.226882064,-0.51230883,-6.499003437,10.714573235
04015,2017,1798,3169,3276,-105,-1371,3171,8.7157797787,15.361683047,15.880364046,-0.508986027,-6.645903268,15.371378019
29135,2010,46,21,-3,2,25,-1,NA,NA,NA,NA,NA,NA
29135,2011,200,139,10,11,61,21,12.763241863,8.8704530951,0.6381620932,0.7019783025,3.8927887683,1.3401403957
29135,2012,215,142,-120,11,73,-109,13.70081249,9.0489087144,-7.646965111,0.7009718018,4.6519037757,-6.945993309
29135,2013,224,152,-3,6,72,3,14.256619145,9.6741344196,-0.190936864,0.3818737271,4.5824847251,0.1909368635
29135,2014,194,142,17,9,52,26,12.289370328,8.995312302,1.0769035855,0.5701254276,3.2940580261,1.647029013
29135,2015,206,151,-14,14,55,0,12.996845426,9.5268138801,-0.883280757,0.8832807571,3.4700315457,0
29135,2016,208,136,42,17,72,59,13.04729645,8.5309246017,2.6345502446,1.0663655752,4.5163718479,3.7009158198
29135,2017,203,158,-5,17,45,12,12.659806673,9.8534455878,-0.311817898,1.0601808544,2.8063610851,0.748362956
34025,2010,1610,1349,-343,330,261,-13,NA,NA,NA,NA,NA,NA
34025,2011,6241,5396,-2970,1196,845,-1774,9.9031974745,8.5623543618,-4.712785851,1.8978087133,1.3408431126,-2.814977138
34025,2012,6232,5130,-2948,1100,1102,-1848,9.901540681,8.1506584874,-4.683848191,1.747704549,1.7508821936,-2.936143642
34025,2013,6008,5483,-1732,1142,525,-590,9.5516313528,8.7169764826,-2.753566162,1.8155730701,0.8346548702,-0.937993092
34025,2014,6001,5171,-2686,1125,830,-1561,9.5465811436,8.2261908171000009,-4.272973996,1.7896856835,1.3203903265,-2.483288313
34025,2015,5802,5494,-2436,1324,308,-1112,9.2413993027,8.7508182987,-3.880049759,2.108861199,0.490581004,-1.77118856
34025,2016,5942,5520,-2395,1339,422,-1056,9.4753627811,8.8024238558,-3.819167597,2.1352256418,0.6729389252,-1.683941955
34025,2017,5857,5725,-1888,1335,132,-553,9.3477707474,9.1370987756,-3.013247596,2.1306597145,0.2106719718,-0.882587882
06051,2010,31,20,-13,4,11,-9,NA,NA,NA,NA,NA,NA
06051,2011,154,38,-5,16,116,11,10.794518628,2.6635825185,-0.350471384,1.1215084288,8.1309361091,0.7710370448
06051,2012,147,49,-214,32,98,-182,10.287993841,3.4293312804,-14.97707947,2.2395632852,6.8586625608,-12.73751618
06051,2013,136,52,-377,35,84,-342,9.6300230129,3.6820676226,-26.69499026,2.478314746,5.9479553903,-24.21667552
06051,2014,155,49,-77,47,106,-30,11.044212476,3.4913962022,-5.486479746,3.3488902348,7.5528162742,-2.137589512
06051,2015,148,36,-288,55,112,-233,10.561621352,2.5690430315,-20.55234425,3.9249268536,7.9925783201,-16.6274174
06051,2016,134,49,16,47,85,63,9.5526644092,3.493138478,1.1406166459,3.3505613973,6.0595259312,4.4911780431
06051,2017,146,45,-79,45,101,-34,10.329336022,3.1836994588,-5.589161272,3.1836994588,7.145636563,-2.405461813
19133,2010,21,20,5,2,1,7,NA,NA,NA,NA,NA,NA
19133,2011,77,144,52,2,-67,54,8.3319807391,15.581886057,5.6267921874,0.2164150841,-7.249905318,5.8432072715
19133,2012,84,145,-87,1,-61,-86,9.1683038638,15.826238812,-9.495743287,0.1091464746,-6.657934949,-9.386596813
19133,2013,94,162,5,2,-68,7,10.376993984,17.883755589,0.5519677651,0.220787106,-7.506761605,0.7727548711
19133,2014,77,168,-46,2,-91,-44,8.5927909831,18.7479076,-5.133355652,0.2231893762,-10.15511662,-4.910166276
19133,2015,94,135,11,2,-41,13,10.587373993,15.205271161,1.2389480205,0.2252632765,-4.617897167,1.464211297
19133,2016,88,138,-14,1,-50,-13,9.9648963877,15.626769335,-1.585324425,0.113237459,-5.661872948,-1.472086966
19133,2017,92,140,-12,1,-48,-11,10.490905981,15.964422145,-1.368379041,0.1140315867,-5.473516164,-1.254347454
54061,2010,225,124,402,54,101,456,NA,NA,NA,NA,NA,NA
54061,2011,1072,640,1158,259,432,1417,10.96938906,6.5488889912,11.849396018,2.6502535136,4.4205000691,14.499649532
54061,2012,1045,650,1130,251,395,1381,10.494812851,6.5278740221,11.348457915,2.5207636608,3.9669388288,13.869221576
54061,2013,1034,673,692,340,361,1032,10.21936045,6.651479287,6.8392625061,3.3603312891,3.5678811629,10.199593795
54061,2014,1123,656,232,375,467,607,10.964976518,6.4051866389,2.2652489333,3.6615015085,4.5597898786,5.9267504418
54061,2015,1204,695,84,409,509,493,11.638978979,6.7185136134,0.8120217893,3.9537727596,4.9204653658,4.7657945488
54061,2016,1058,698,54,414,360,468,10.13842107,6.6886747704,0.517461945,3.9672082449,3.4497462999,4.4846701899
54061,2017,1082,689,-547,412,393,-135,10.314536156,6.5681288459,-5.214465136,3.9275313273,3.7464073098,-1.286933809
01099,2010,56,37,-82,0,19,-82,NA,NA,NA,NA,NA,NA
01099,2011,257,263,-206,-3,-6,-209,11.220257586,11.482209125,-8.993669504,-0.130975769,-0.261951539,-9.124645274
01099,2012,246,288,-171,-2,-42,-173,10.840108401,12.690858616,-7.535197303,-0.088130963,-1.850750215,-7.623328266
01099,2013,227,264,-379,-3,-37,-382,10.142305029,11.795456069,-16.93362822,-0.134039274,-1.65315104,-17.06766749
01099,2014,226,245,-226,-2,-19,-228,10.247806471,11.109347723,-10.24780647,-0.090688553,-0.861541252,-10.33849502
01099,2015,215,279,-144,-2,-64,-146,9.8508625232,12.783212298,-6.597786992,-0.09163593,-2.932349774,-6.689422923
01099,2016,220,231,-135,-2,-11,-137,10.163540608,10.671717638,-6.2367181,-0.092395824,-0.50817703,-6.329113924
01099,2017,212,247,-207,-2,-35,-209,9.8836802723,11.51541994,-9.650574605,-0.093242267,-1.631739668,-9.743816872
05095,2010,30,9,-39,0,21,-39,NA,NA,NA,NA,NA,NA
05095,2011,107,105,-43,-1,2,-44,13.180586351,12.934220251,-5.296871151,-0.12318305,0.2463661,-5.420054201
05095,2012,83,110,-222,-1,-27,-223,10.406871043,13.792238731,-27.83524544,-0.125383988,-3.385367689,-27.96062943
05095,2013,86,111,-139,-1,-25,-140,11.06607476,14.282956958,-17.88586502,-0.128675288,-3.216882198,-18.01454031
05095,2014,102,116,-41,0,-14,-41,13.311582382,15.138662316,-5.350734095,0,-1.827079935,-5.350734095
05095,2015,98,126,-155,0,-28,-155,12.990455992,16.702014846,-20.54612937,0,-3.711558855,-20.54612937
05095,2016,96,94,-221,0,2,-221,13.071895425,12.79956427,-30.09259259,0,0.2723311547,-30.09259259
05095,2017,94,111,-134,0,-17,-134,13.12849162,15.502793296,-18.7150838,0,-2.374301676,-18.7150838
12087,2010,154,127,27,81,27,108,NA,NA,NA,NA,NA,NA
12087,2011,720,678,398,316,42,714,9.7826086957,9.2119565217,5.4076086957,4.2934782609,0.5706521739,9.7010869565
12087,2012,716,634,169,400,82,569,9.636089578,8.5325150732,2.2744401378,5.383290267,1.1035745047,7.6577304048
12087,2013,704,656,774,437,48,1211,9.3529337523,8.7152337237,10.282912961,5.8057273434,0.6377000286,16.088640304
12087,2014,772,668,8,467,104,475,10.130834744,8.766059079,0.1049827435,6.1283676496,1.364775665,6.233350393
12087,2015,743,742,-11,523,1,512,9.6810971041,9.6680673638,-0.143327144,6.81455422,0.0130297404,6.6712270758
12087,2016,738,784,-182,529,-46,347,9.5653470031,10.161561044,-2.358933814,6.8564614697,-0.596214041,4.4975276559
12087,2017,737,761,-775,509,-24,-266,9.5517668177,9.8628148551,-10.04425954,6.5968104616,-0.311048037,-3.447449082
13207,2010,75,86,27,0,-11,27,NA,NA,NA,NA,NA,NA
13207,2011,274,235,126,7,39,133,10.435312488,8.9499942872,4.7987203412,0.2665955745,1.4853182009,5.0653159158
13207,2012,298,227,-38,1,71,-37,11.305650929,8.6120226872,-1.441660186,0.0379384259,2.6936282414,-1.40372176
13207,2013,262,255,244,-7,7,237,9.8877252571,9.6235493915,9.2084158883,-0.264175866,0.2641758656,8.9442400226
13207,2014,279,250,24,-7,29,17,10.472972973,9.3843843844,0.9009009009,-0.262762763,1.0885885886,0.6381381381
13207,2015,259,253,48,-7,6,41,9.7067366251,9.4818701396,1.7989318842,-0.262344233,0.2248664855,1.5365876511
13207,2016,276,299,206,-7,-23,199,10.301582562,11.160047775,7.688862347,-0.261272021,-0.858465213,7.4275903255
13207,2017,261,312,293,-7,-51,286,9.6680989776,11.557267743,10.853459772,-0.259297674,-1.889168766,10.594162098
17133,2010,85,49,16,-1,36,15,NA,NA,NA,NA,NA,NA
17133,2011,308,266,182,-7,42,175,9.3021851074,8.0337053201,5.4967457453,-0.211413298,1.2684797874,5.2853324474
17133,2012,320,267,5,-9,53,-4,9.6266658644,8.0322493306,0.1504166541,-0.270749977,1.5944165338,-0.120333323
17133,2013,335,298,171,-8,37,163,10.041364427,8.9323182063,5.1255919909,-0.239793777,1.1090462203,4.8857982135
17133,2014,318,267,32,-6,51,26,9.4933874675,7.9708630624,0.9553094307,-0.179120518,1.5225244052,0.7761889124
17133,2015,356,322,164,-6,34,158,10.586101282,9.5750691368,4.876743287,-0.178417437,1.0110321449,4.6983258497
17133,2016,371,311,99,-5,60,94,10.976006627,9.2009112156,2.9289074288,-0.147924618,1.7750954114,2.7809828112
17133,2017,357,314,183,-5,43,178,10.503861714,9.2386906951,5.3843324752,-0.147112909,1.2651710188,5.237219566
18105,2010,376,228,227,164,148,391,NA,NA,NA,NA,NA,NA
18105,2011,1244,871,436,781,373,1217,8.9299494281,6.2524002828,3.1297893494,5.6063428483,2.6775491452,8.7361321977
18105,2012,1310,853,-139,869,457,730,9.3113840555,6.0630615262,-0.98800182,6.1767883544,3.2483225293,5.1887865347
18105,2013,1288,907,-628,851,381,223,9.097747813,6.4065662006,-4.435858406,6.0110119479,2.6911816124,1.5751535422
18105,2014,1291,817,147,936,474,1083,9.0508206031,5.7277462686,1.030573686,6.5620202049,3.3230743345,7.5925938909
18105,2015,1349,928,-586,988,421,402,9.3801063867,6.4527344157,-4.074679275,6.8699370719,2.9273719709,2.7952577965
18105,2016,1346,911,23,1006,435,1029,9.2854161708,6.2845573043,0.158666101,6.9399172867,3.0008588665000002,7.0985833877
18105,2017,1352,894,-157,994,458,837,9.2388221868,6.1091028366,-1.072851393,6.7924476729,3.1297193503,5.7195962799
19135,2010,21,7,10,2,14,12,NA,NA,NA,NA,NA,NA
19135,2011,105,123,80,3,-18,83,13.080852124,15.323283917,9.9663635231,0.3737386321,-2.242431793,10.340102155
19135,2012,72,77,17,3,-5,20,8.9263575502,9.5462434912,2.1076121994,0.3719315646,-0.619885941,2.4795437639
19135,2013,91,108,-84,7,-17,-77,11.338857392,13.457105476,-10.46663759,0.8722197994,-2.118248084,-9.594417793
19135,2014,88,121,9,4,-33,13,11.044869783,15.186695952000001,1.1295889551,0.5020395356,-4.141826169,1.6316284907
19135,2015,84,120,1,5,-36,6,10.578012845,15.111446921,0.1259287243,0.6296436217,-4.533434076,0.7555723461
19135,2016,95,95,-78,5,0,-73,12.042083913999999,12.042083913999999,-9.887184688,0.6337938902,0,-9.253390797
19135,2017,84,89,-7,5,-5,-2,10.702000255,11.33902408,-0.891833355,0.6370238247,-0.637023825,-0.25480953
21171,2010,19,27,15,0,-8,15,NA,NA,NA,NA,NA,NA
21171,2011,117,161,-16,5,-44,-11,10.693720866,14.715291107,-1.462389178,0.4569966182,-4.02157024,-1.00539256
21171,2012,132,163,-45,3,-31,-42,12.136257068,14.986438652,-4.137360364,0.2758240243,-2.850181584,-3.86153634
21171,2013,131,152,-126,8,-21,-118,12.162287624,14.11196732,-11.69807817,0.7427351221,-1.949679695,-10.95534305
21171,2014,124,148,-19,8,-24,-11,11.606140022,13.852489704,-1.778360165,0.7487832273,-2.246349682,-1.029576937
21171,2015,139,151,-46,8,-12,-38,13.062068317,14.189728892,-4.322698868,0.7517737161,-1.127660574,-3.570925152
21171,2016,154,157,-45,10,-3,-35,14.531043593,14.814115871,-4.246084167,0.9435742593,-0.283072278,-3.302509908
21171,2017,139,148,80,10,-9,90,13.089744797,13.93728223,7.5336660703,0.9417082588,-0.847537433,8.475374329
26115,2010,428,355,-191,16,73,-175,NA,NA,NA,NA,NA,NA
26115,2011,1595,1288,-837,45,307,-792,10.514969823,8.4910853493,-5.517886985,0.2966605906,2.0238844738,-5.221226395
26115,2012,1535,1387,-921,41,148,-880,10.159171382,9.1796551838,-6.095502829,0.2713524604,0.9795161984,-5.824150369
26115,2013,1522,1421,-827,44,101,-783,10.11988271,9.4483267618,-5.498779896,0.2925590271,0.6715559486,-5.206220869
26115,2014,1546,1450,-414,67,96,-347,10.311719409,9.6714056554,-2.761353063,0.4468856406,0.6403137537,-2.314467422
26115,2015,1502,1412,-583,73,90,-510,10.041281567,9.4396069059,-3.897514749,0.4880250029,0.6016746611,-3.409489746
26115,2016,1447,1379,-293,79,68,-214,9.6921551817,9.236684171,-1.962544207,0.5291501447,0.4554710106,-1.433394063
26115,2017,1493,1406,270,78,87,348,9.990899114,9.4087100832,1.8067935437,0.5219625793,0.5821890308,2.328756123
28095,2010,103,64,-103,0,39,-103,NA,NA,NA,NA,NA,NA
28095,2011,408,418,-305,-5,-10,-310,11.096303952,11.368272186,-8.29503114,-0.135984117,-0.271968234,-8.431015257
28095,2012,426,404,-213,-3,22,-216,11.667077479,11.064552351,-5.83353874,-0.082162517,0.602525128,-5.915701257
28095,2013,441,428,-269,-3,13,-272,12.153112685,11.794857663,-7.413123157,-0.082674236,0.3582550225,-7.495797393
28095,2014,442,424,-106,0,18,-106,12.239868186,11.741412016,-2.935353004,0,0.4984561705,-2.935353004
28095,2015,410,428,-214,0,-18,-214,11.405521942,11.906252173,-5.953126087,0,-0.500730232,-5.953126087
28095,2016,406,457,129,0,-51,129,11.318966238,12.740806825,3.5964203072,0,-1.421840587,3.5964203072
28095,2017,394,416,-12,0,-22,-12,10.977988298,11.590972416,-0.334354974,0,-0.612984118,-0.334354974
29137,2010,22,34,-49,0,-12,-49,NA,NA,NA,NA,NA,NA
29137,2011,99,83,-122,0,16,-122,11.340206186,9.5074455899,-13.97479954,0,1.8327605956,-13.97479954
29137,2012,86,94,18,0,-8,18,9.9044109179,10.825751468,2.0730162386,0,-0.921340551,2.0730162386
29137,2013,82,79,74,0,3,74,9.3961269623,9.0523662198,8.4794316489,0,0.3437607425,8.4794316489
29137,2014,98,94,-36,0,4,-36,11.200640037,10.743471055,-4.11452083,0,0.4571689811,-4.11452083
29137,2015,94,98,-97,0,-4,-97,10.825751468,11.286421744,-11.17125417,0,-0.460670275,-11.17125417
29137,2016,101,93,-3,0,8,-3,11.696583671,10.770121598,-0.347423277,0,0.926462073,-0.347423277
29137,2017,103,91,-36,0,12,-36,11.942721317,10.551336309,-4.174155023,0,1.3913850078,-4.174155023
36055,2010,2210,1536,-631,514,674,-117,NA,NA,NA,NA,NA,NA
36055,2011,8609,6428,-2013,2443,2181,430,11.53737653,8.6145030009,-2.697727838,3.2739935954,2.9228735291,0.5762657577
36055,2012,8304,6528,-3262,2577,1776,-685,11.101715592,8.7273602342,-4.361006294,3.4452217101,2.3743553578,-0.915784583
36055,2013,8523,6484,-3064,2642,2039,-422,11.374236813,8.6531211424,-4.089013445,3.5258399226,2.7211156708,-0.563173523
36055,2014,8252,6423,-4993,2828,1829,-2165,11.003187484,8.5644053819,-6.657648462,3.7708451533,2.4387821024,-2.886803309
36055,2015,8439,6817,-5956,3013,1622,-2943,11.264714107,9.0996037528,-7.950306579,4.021872687,2.1651103546,-3.928433892
36055,2016,8062,6597,-5739,3094,1465,-2645,10.779299787,8.8205210485,-7.673331863,4.1368337311,1.9587787382,-3.536498131
36055,2017,8065,6657,-4168,3074,1408,-1094,10.789528605,8.9058762462,-5.576039086,4.1124626079,1.8836523591,-1.463576478
39111,2010,37,23,-37,0,14,-37,NA,NA,NA,NA,NA,NA
39111,2011,178,186,15,-1,-8,14,12.174269886,12.721428083,1.0259216196,-0.068394775,-0.547158197,0.9575268449
39111,2012,139,159,-90,1,-20,-89,9.5414607359,10.914332784,-6.177924217,0.0686436024,-1.372872048,-6.109280615
39111,2013,150,178,33,-1,-28,32,10.334493093,12.26359847,2.2735884805,-0.068896621,-1.929105377,2.2046918599
39111,2014,154,172,-132,-1,-18,-133,10.663343027,11.909707797,-9.140008309,-0.069242487,-1.246364769,-9.209250796
39111,2015,165,186,-79,-1,-21,-80,11.524760774,12.991548509,-5.517915764,-0.069847035,-1.466787735,-5.587762799
39111,2016,125,167,-127,-1,-42,-128,8.8143003208,11.775905229,-8.955329126,-0.070514403,-2.961604908,-9.025843529
39111,2017,135,189,-95,-1,-54,-96,9.6280711764,13.479299647,-6.775309346,-0.071319046,-3.851228471,-6.846628392
42089,2010,371,343,-10,33,28,23,NA,NA,NA,NA,NA,NA
42089,2011,1451,1265,-325,225,186,-100,8.5393880007,7.4447455692,-1.912681668,1.3241642317,1.0946424315,-0.588517436
42089,2012,1336,1280,-1529,260,56,-1269,7.8881488829,7.5575079118,-9.027679373,1.5351187946,0.3306409711,-7.492560578
42089,2013,1402,1361,-1527,271,41,-1256,8.3362319875,8.0924477425,-9.079476637,1.6113543999,0.243784245,-7.468122237
42089,2014,1462,1366,-445,313,96,-132,8.7248422278,8.1519387709,-2.655646232,1.867903979,0.5729034568,-0.787742253
42089,2015,1436,1415,-1067,333,21,-734,8.5889790718,8.4633742247,-6.381922472,1.9917340048,0.1256048472,-4.390188467
42089,2016,1417,1538,-542,344,-121,-198,8.5015494179,9.2275109419,-3.251827653,2.0638906138,-0.725961524,-1.187937039
42089,2017,1408,1517,1308,342,-109,1650,8.41697503,9.068573239,7.819178508,2.0444641053,-0.651598209,9.8636426133
47123,2010,130,95,75,4,35,79,NA,NA,NA,NA,NA,NA
47123,2011,500,527,293,27,-27,320,11.169565169,11.772721688,6.5453651889,0.6031565191,-0.603156519,7.148521708
47123,2012,451,470,170,21,-19,191,10.022890415000001,10.445140787,3.7780296464,0.4666977799,-0.422250372,4.2447274263
47123,2013,500,481,73,31,19,104,11.076405042,10.65550165,1.6171551361,0.6867371126,0.4209033916,2.3038922487
47123,2014,550,528,116,56,22,172,12.142888683,11.657173136,2.5610456131,1.2363668477,0.4857155473,3.7974124608
47123,2015,494,548,301,61,-54,362,10.847487401,12.033245133,6.6095014328,1.3394670678,-1.185757732,7.9489685006
47123,2016,487,551,273,67,-64,340,10.626227362,12.022692559,5.956796858,1.4619245036,-1.396465197,7.4187213616
47123,2017,474,539,274,66,-65,340,10.281215092,11.69108636,5.9431496524,1.4315615951,-1.409871268,7.3747112475
54063,2010,41,29,15,-1,12,14,NA,NA,NA,NA,NA,NA
54063,2011,119,174,84,-2,-55,82,8.7913711584,12.854609929,6.2056737589,-0.147754137,-4.063238771,6.0579196217
54063,2012,146,169,-24,0,-23,-24,10.79402632,12.494455123,-1.774360491,0,-1.700428804,-1.774360491
54063,2013,151,182,54,-4,-31,50,11.175665174,13.470007031,3.9965954927,-0.296044111,-2.294341857,3.7005513822
54063,2014,119,169,131,8,-50,139,8.7725764836,12.458532989,9.657206045,0.5897530409,-3.685956506,10.246959086
54063,2015,119,187,24,10,-68,34,8.7554721701,13.758599124,1.7658095133,0.7357539639,-5.003126954,2.5015634772
54063,2016,130,169,-69,11,-39,-58,9.611474622,12.494917009,-5.101474992,0.8132786219,-2.883442387,-4.28819637
54063,2017,124,154,-55,11,-30,-44,9.2265337252,11.458759626,-4.092414152,0.8184828305,-2.232225901,-3.273931322
55081,2010,164,62,34,6,102,40,NA,NA,NA,NA,NA,NA
55081,2011,616,430,35,17,186,52,13.710826211,9.5708689459,0.7790242165,0.3783831909,4.139957265,1.1574074074
55081,2012,662,429,-318,40,233,-278,14.703759231,9.5285690488,-7.063135099,0.8884446666,5.1751901827,-6.174690433
55081,2013,570,432,-27,11,138,-16,12.650081005,9.5874298142,-0.599214363,0.2441243703,3.0626511907,-0.355089993
55081,2014,620,411,-190,8,209,-182,13.738394381,9.1072259523,-4.210153117,0.1772696049,4.6311684283,-4.032883512
55081,2015,605,386,-103,23,219,-80,13.382439143,8.5382173706,-2.278332614,0.5087538848,4.8442217725,-1.76957873
55081,2016,629,414,-139,5,215,-134,13.880307176,9.1358460588,-3.067349281,0.1103363051,4.7444611175,-2.957012976
55081,2017,616,416,66,6,200,72,13.541288841,9.1447664897,1.4508523758,0.1318956705,4.3965223508,1.5827480463
48337,2010,65,51,-16,-1,14,-17,NA,NA,NA,NA,NA,NA
48337,2011,249,276,64,6,-27,70,12.616857946,13.984950977,3.242887183,0.3040206734,-1.36809303,3.5469078564
48337,2012,212,256,-250,11,-44,-239,10.80805506,13.051236299,-12.74534795,0.5607953097,-2.243181239,-12.18455264
48337,2013,229,298,-19,8,-69,-11,11.783472265,15.333950808,-0.977668005,0.4116496861,-3.550478543,-0.566018318
48337,2014,220,234,-5,11,-14,6,11.34751773,12.069632495,-0.25789813,0.5673758865,-0.722114765,0.3094777563
48337,2015,231,287,-55,12,-56,-43,11.950027159,14.84700344,-2.845244562,0.6207806316,-2.896976281,-2.22446393
48337,2016,241,260,161,14,-19,175,12.449633227,13.431139581,8.3169748941,0.7232152082,-0.981506354,9.0401901023
48337,2017,251,258,97,14,-7,111,12.880051315,13.239255933,4.9775497114,0.7184092367,-0.359204618,5.695958948
26117,2010,214,150,-99,8,64,-91,NA,NA,NA,NA,NA,NA
26117,2011,752,597,-248,24,155,-224,11.883785428,9.4343349742,-3.919120726,0.3792697477,2.4494504539,-3.539850979
26117,2012,716,541,-362,11,175,-351,11.336827272,8.5659546844,-5.731747866,0.1741691341,2.7708725874,-5.557578732
26117,2013,713,641,-391,5,72,-386,11.332390292,10.188025494,-6.214536612,0.0794697776,1.1443647981,-6.135066834
26117,2014,735,575,-154,8,160,-146,11.70969515,9.1606458654,-2.453459936,0.1274524642,2.5490492843,-2.326007472
26117,2015,680,590,-138,8,90,-130,10.836653386,9.4023904382,-2.199203187,0.1274900398,1.4342629482,-2.071713147
26117,2016,726,595,97,9,131,106,11.552139771,9.4676627603,1.5434677105,0.1432083443,2.0844770111,1.6866760548
26117,2017,707,588,461,9,119,470,11.176717017,9.2954874203,7.2877886067,0.1422778687,1.881229597,7.4300664754
06053,2010,1672,522,97,196,1150,293,NA,NA,NA,NA,NA,NA
06053,2011,6866,2329,-538,731,4537,193,16.393736189,5.5608813842,-1.284565987,1.7453861279,10.832854805,0.4608201405
06053,2012,6811,2381,-368,940,4430,572,16.077785227,5.6204972287,-0.868686678,2.2189279273,10.457287998,1.3502412494
06053,2013,6565,2461,-2591,761,4104,-1830,15.366142525,5.760255408,-6.064535458,1.7812086004,9.6058871168,-4.283326858
06053,2014,6459,2347,-2916,826,4112,-2090,15.041953987,5.4657789142,-6.790886798,1.9236188254,9.5761750726,-4.867267972
06053,2015,6455,2419,-2857,1186,4036,-1671,14.956151021,5.6047915291,-6.619631831,2.7479465703,9.3513594921,-3.87168526
06053,2016,6379,2623,-1286,1127,3756,-159,14.678928638,6.0358723653,-2.959257286,2.5933771086,8.6430562731,-0.365880178
06053,2017,6316,2600,-3205,1029,3716,-2176,14.448625711,5.9478193235,-7.331831128,2.3539638784,8.500806387,-4.977867249
08083,2010,84,40,-11,4,44,-7,NA,NA,NA,NA,NA,NA
08083,2011,308,290,-135,6,18,-129,12.069438458,11.364081665,-5.290175947,0.235118931,0.705356793,-5.055057016
08083,2012,294,273,-15,-1,21,-16,11.545711593,10.721017908,-0.589066918,-0.039271128,0.8246936852,-0.628338046
08083,2013,292,251,52,-21,41,31,11.450980392,9.8431372549,2.0392156863,-0.823529412,1.6078431373,1.2156862745
08083,2014,323,268,-63,-21,55,-84,12.657483786,10.50218469,-2.468797147,-0.822932382,2.1552990967,-3.29172953
08083,2015,330,257,145,-21,73,124,12.890876775,10.039258579,5.6641731284,-0.820328522,2.8516181957,4.8438446063
08083,2016,292,266,273,-21,26,252,11.302059142,10.29571141,10.566651184,-0.812819322,1.0063477318,9.7538318625
08083,2017,297,275,165,-21,22,144,11.397870095,10.553583421,6.3321500528,-0.805910007,0.8442866737,5.5262400461
01101,2010,713,457,-184,85,256,-99,NA,NA,NA,NA,NA,NA
01101,2011,3145,1914,-1956,355,1231,-1601,13.713353842,8.3457422107,-8.52887762,1.5479302429,5.3676116308,-6.980947377
01101,2012,3120,1951,-2110,457,1169,-1653,13.62850104,8.5221812591,-9.216710639,1.9962259536,5.1063197805,-7.220484685
01101,2013,3090,2086,-2184,378,1004,-1806,13.53396302,9.1365200195,-9.565752504,1.6556110103,4.3974430008,-7.910141493
01101,2014,3208,2072,-2142,367,1136,-1775,14.093850635,9.1030107593,-9.410544907,1.6123576007,4.9908398758,-7.798187306
01101,2015,3230,2229,-1728,427,1001,-1301,14.21939693,9.8127045689,-7.607157243,1.8797778604,4.4066923614,-5.727379383
01101,2016,3112,2171,-1620,391,941,-1229,13.717771832,9.569820902,-7.140999475,1.7235375277,4.1479509299,-5.417461948
01101,2017,3038,2158,-1301,356,880,-945,13.402093691,9.5199862362,-5.739342953,1.570488925,3.882107455,-4.168854028
05097,2010,25,8,-2,0,17,-2,NA,NA,NA,NA,NA,NA
05097,2011,95,132,-70,-2,-37,-72,10.051314606,13.966037137,-7.406231815,-0.211606623,-3.914722531,-7.617838438
05097,2012,68,133,6,-2,-65,4,7.2599156569,14.199540917,0.6405807933,-0.213526931,-6.93962526,0.4270538622
05097,2013,89,114,-67,5,-25,-62,9.5776163573,12.267958031,-7.210115685,0.5380683347,-2.690341673,-6.67204735
05097,2014,90,120,-74,11,-30,-63,9.7804825038,13.040643338,-8.041730059,1.195392306,-3.260160835,-6.846337753
05097,2015,85,147,-83,12,-62,-71,9.3524784068,16.174286186,-9.132420091,1.3203498927,-6.821807779,-7.812070199
05097,2016,87,132,-41,15,-45,-26,9.6822658728,14.690334428,-4.562906906,1.669356185,-5.008068555,-2.893550721
05097,2017,85,144,14,15,-59,29,9.5142153571,16.118200134,1.5670472353,1.6789791807,-6.603984777,3.2460264159
13209,2010,34,34,-37,3,0,-34,NA,NA,NA,NA,NA,NA
13209,2011,111,86,-142,5,25,-137,12.212564639,9.4619870173,-15.62328089,0.5501155243,2.7505776213,-15.07316536
13209,2012,103,75,-181,5,28,-176,11.492329149,8.3682008368,-20.19525802,0.5578800558,3.1241283124,-19.63737796
13209,2013,109,90,40,10,19,50,12.212200997,10.083468713,4.4815416503,1.1203854126,2.1287322839,5.6019270629
13209,2014,95,65,-62,7,30,-55,10.616897631,7.2641931158,-6.928922664,0.7822977202,3.352704515,-6.146624944
13209,2015,79,108,-13,8,-29,-5,8.8579918148,12.109659696,-1.457644223,0.8970118293,-3.251667881,-0.560632393
13209,2016,97,54,32,8,43,40,10.847685082,6.0389174681,3.5786177589,0.8946544397,4.8087676135,4.4732721986
13209,2017,88,78,31,8,10,39,9.7701787499,8.6599311646,3.4417675142,0.8881980682,1.1102475852,4.3299655823
17135,2010,73,66,-14,0,7,-14,NA,NA,NA,NA,NA,NA
17135,2011,301,365,-175,0,-64,-175,10.041701418,12.176814012,-5.838198499,0,-2.135112594,-5.838198499
17135,2012,311,332,-225,-4,-21,-229,10.459582626,11.165856694,-7.567222157,-0.134528394,-0.706274068,-7.701750551
17135,2013,303,355,-237,-1,-52,-238,10.282165702,12.046761796,-8.042486044,-0.03393454,-1.764596094,-8.076420585
17135,2014,280,354,187,-1,-74,186,9.5289953716,12.04737272,6.3640076232,-0.034032126,-2.518377348,6.3299754969
17135,2015,279,359,-131,-1,-80,-132,9.5104990455,12.237523861,-4.465503136,-0.03408781,-2.727024816,-4.499590946
17135,2016,332,382,-98,-1,-50,-99,11.387607402,13.102608517,-3.361402185,-0.034300022,-1.715001115,-3.395702207
17135,2017,315,378,-226,-1,-63,-227,10.886657796,13.063989355,-7.810744958,-0.034560818,-2.177331559,-7.845305777
18107,2010,106,59,-71,0,47,-71,NA,NA,NA,NA,NA,NA
18107,2011,476,365,134,-3,111,131,12.455516014,9.5509734143,3.5063847603,-0.078501151,2.9045426,3.427883609
18107,2012,442,420,-177,-4,22,-181,11.554045223,10.978956999,-4.626846164,-0.104561495,0.5750882238,-4.731407659
18107,2013,495,391,-163,20,104,-143,12.973738009,10.247942549,-4.272160193,0.5241914347,2.7257954605,-3.747968758
18107,2014,432,387,-58,43,45,-15,11.324612683,10.144965528,-1.52043411,1.127218392,1.1796471544,-0.393215718
18107,2015,458,399,32,52,59,84,11.980277011,10.436966217,0.8370499222,1.3602061235,1.543310794,2.1972560457
18107,2016,470,388,-112,55,82,-57,12.268177132,10.12777176,-2.923480508,1.4356377494,2.1404053719,-1.487842759
18107,2017,467,378,61,56,89,117,12.153862169,9.8376014991,1.5875494483,1.4574224443,2.3162606704,3.0449718926
19137,2010,27,52,-25,0,-25,-25,NA,NA,NA,NA,NA,NA
19137,2011,106,147,-18,-3,-41,-21,9.9441812468,13.790515503,-1.688634551,-0.281439092,-3.846334256,-1.970073643
19137,2012,121,144,-70,1,-23,-69,11.431270666,13.604156826,-6.61313179,0.0944733113,-2.17288616,-6.518658479
19137,2013,107,148,-102,1,-41,-101,10.221139609,14.137651048,-9.743516263,0.0955246692,-3.916511439,-9.647991594
19137,2014,115,153,14,7,-38,21,11.070998797,14.729241877,1.3477737665,0.6738868833,-3.658243081,2.0216606498
19137,2015,127,164,-202,9,-37,-193,12.373946509,15.978954548,-19.68139524,0.8768938471,-3.605008038,-18.80450139
19137,2016,123,129,-17,9,-6,-8,12.128383375,12.720011833,-1.676280629,0.887442686,-0.591628457,-0.788837943
19137,2017,120,118,-7,9,2,2,11.839573775,11.642247546,-0.690641804,0.8879680332,0.1973262296,0.1973262296
20125,2010,114,135,-106,8,-21,-98,NA,NA,NA,NA,NA,NA
20125,2011,426,452,-597,36,-26,-561,12.14869316,12.890162696,-17.02528126,1.0266501262,-0.741469536,-15.99863113
20125,2012,516,446,-419,40,70,-379,14.90166633,12.880122448,-12.10038409,1.1551679325,2.0215438819,-10.94521616
20125,2013,451,433,-101,52,18,-49,13.088017644,12.565657738,-2.931019472,1.5090397284,0.522359906,-1.421979744
20125,2014,424,416,-443,53,8,-390,12.377935746,12.144389788,-12.93260739,1.5472419682,0.2335459575,-11.38536543
20125,2015,448,441,-758,57,7,-701,13.283717069,13.076158989,-22.47557486,1.6901157878,0.2075580792,-20.78545907
20125,2016,444,404,-615,59,40,-556,13.403571267,12.196042324,-18.5657575,1.7811051909,1.207528943,-16.78465231
20125,2017,415,348,-438,59,67,-379,12.686669826,10.638460480000001,-13.38978647,1.8036470354,2.0482093453,-11.58613943
21173,2010,118,71,-5,1,47,-4,NA,NA,NA,NA,NA,NA
21173,2011,393,246,63,-6,147,57,14.746993377,9.2309424192,2.3640218391,-0.225144937,5.5160509578,2.138876902
21173,2012,386,270,9,-7,116,2,14.398418412,10.071432568,0.3357144189,-0.261111215,4.326985844,0.0746032042
21173,2013,408,236,200,-8,172,192,15.084015749,8.7250679335,7.3941253674,-0.295765015,6.358947816,7.0983603527
21173,2014,373,242,9,-7,131,2,13.665005862,8.8657678781,0.3297186401,-0.256447831,4.7992379836,0.0732708089
21173,2015,374,312,154,-6,62,148,13.617579057,11.360119427,5.6072384351,-0.218463835,2.2574596297,5.3887745999
21173,2016,338,290,49,-6,48,43,12.239724787,10.501539019,1.7743979721,-0.217273221,1.7381857686,1.557124751
21173,2017,344,283,212,-5,61,207,12.376549317,10.181870514,7.6274083002,-0.179891705,2.1946788034,7.447516595
24031,2010,3421,1477,311,2036,1944,2347,NA,NA,NA,NA,NA,NA
24031,2011,13192,5668,554,9242,7524,9796,13.396524743,5.7558749428,0.562589047,9.3852851484,7.6406498005,9.9478741953
24031,2012,13030,5659,-2473,9354,7371,6881,13.024698948,5.656697724,-2.471993898,9.3501944709,7.3680012235,6.8782005724
24031,2013,13110,5922,-4939,9578,7188,4639,12.936782945,5.8437550419,-4.873743018,9.4514498127,7.0930279029,4.5777067949
24031,2014,13162,5605,-6741,10019,7557,3278,12.844239926,5.4696827828,-6.578257206,9.7771189654,7.3745571435,3.1988617595
24031,2015,13176,6111,-8855,10941,7065,2086,12.733153649,5.9056088305,-8.557382784,10.573272167,6.8275448187,2.0158893831
24031,2016,13109,6023,-9324,11181,7086,1857,12.558305735,5.7699805815,-8.932309305,10.711298835,6.7883251537,1.7789895301
24031,2017,12906,6168,-7367,11090,6738,3723,12.249767695,5.8543752628,-6.992409624,10.526105977,6.395392432,3.5336963527
28097,2010,35,63,-4,0,-28,-4,NA,NA,NA,NA,NA,NA
28097,2011,115,144,-96,0,-29,-96,10.618651893,13.296398892,-8.864265928,0,-2.677746999,-8.864265928
28097,2012,126,163,-136,0,-37,-136,11.793887771,15.257172275,-12.72991061,0,-3.463284504,-12.72991061
28097,2013,147,147,-23,2,0,-21,13.884953245,13.884953245,-2.172475678,0.1889109285,0,-1.983564749
28097,2014,121,143,-204,4,-22,-200,11.561245939,13.663290655,-19.49168737,0.3821899484,-2.102044716,-19.10949742
28097,2015,124,152,-151,4,-28,-147,12.074001947,14.800389484,-14.7030185,0.3894839338,-2.726387537,-14.31353457
28097,2016,136,100,38,4,36,42,13.305938754,9.7837784953,3.7178358282,0.3913511398,3.5221602583,4.109186968
28097,2017,129,129,-90,4,0,-86,12.62725137,12.62725137,-8.809710258,0.3915426782,0,-8.41816758
29139,2010,32,51,3,0,-19,3,NA,NA,NA,NA,NA,NA
29139,2011,167,169,-10,4,-2,-6,13.674513818,13.83828045,-0.818833163,0.3275332651,-0.163766633,-0.491299898
29139,2012,141,155,-231,7,-14,-224,11.660602051,12.818392326,-19.10353953,0.5788951373,-1.157790275,-18.52464439
29139,2013,145,145,-124,6,0,-118,12.16800235,12.16800235,-10.40573994,0.5035035455,0,-9.902236395
29139,2014,125,168,-89,5,-43,-84,10.598160159,14.243927254,-7.545890033,0.4239264064,-3.645767095,-7.121963627
29139,2015,129,148,-131,5,-19,-126,11.064888279,12.694600506,-11.23643693,0.4288716387,-1.629712227,-10.8075653
29139,2016,121,161,-74,5,-40,-69,10.492997442,13.961756927,-6.417205047,0.4335949356,-3.468759485,-5.983610111
29139,2017,119,149,-13,5,-30,-8,10.386209906,13.004582151,-1.134627973,0.4363953742,-2.618372245,-0.698232599
36057,2010,148,110,-1,12,38,11,NA,NA,NA,NA,NA,NA
36057,2011,565,594,-451,83,-29,-368,11.276882391,11.855695824,-9.001546829,1.6566039619,-0.578813432,-7.344942867
36057,2012,554,565,-162,96,-11,-66,11.109551407,11.330138168,-3.248641386,1.9251208214,-0.220586761,-1.323520565
36057,2013,590,627,-164,127,-37,-37,11.849412048,12.59251077,-3.293734874,2.5506361528,-0.743098722,-0.743098722
36057,2014,608,580,-252,138,28,-114,12.230693408,11.66743779,-5.069300557,2.7760455432,0.5632556175,-2.293255014
36057,2015,604,602,-251,138,2,-113,12.174596616,12.134283382,-5.059310845,2.7816131341,0.0403132338,-2.277697711
36057,2016,671,556,-549,144,115,-405,13.579972071,11.252555099,-11.11088624,2.914330817,2.3274169719,-8.196555423
36057,2017,629,551,-229,144,78,-85,12.768462507,11.185091957,-4.648613536,2.9231456295,1.5833705493,-1.725467906
37123,2010,81,99,-35,1,-18,-34,NA,NA,NA,NA,NA,NA
37123,2011,357,266,-101,-1,91,-102,12.876697506,9.5944020632,-3.64298725,-0.036069181,3.2822954427,-3.67905643
37123,2012,333,273,-241,2,60,-239,12.052117264,9.8805646037,-8.722403185,0.0723850887,2.1715526602,-8.650018096
37123,2013,326,289,-100,6,37,-94,11.849374818,10.504507124,-3.634777552,0.2180866531,1.3448676941,-3.416690899
37123,2014,284,279,-152,18,5,-134,10.358536674,10.176168071,-5.544005544,0.6565269723,0.1823686034,-4.887478572
37123,2015,335,276,89,22,59,111,12.210457254,10.059958812,3.2439722258,0.8018807749,2.1504984418,4.0458530007
37123,2016,299,277,-125,23,22,-102,10.88123442,10.080608476,-4.549011045,0.8370180323,0.8006259439,-3.711993013
37123,2017,306,274,-59,25,32,-34,11.153026078,9.9866965539,-2.150420061,0.911194941,1.1663295245,-1.23922512
39113,2010,1719,1289,-184,219,430,35,NA,NA,NA,NA,NA,NA
39113,2011,6560,5693,-2782,775,867,-2007,12.261922898,10.641330344,-5.200102058,1.4486265618,1.6205925537,-3.751475496
39113,2012,6775,5630,-2264,902,1145,-1362,12.68034397,10.537319048,-4.237387269,1.6882170126,2.1430249218,-2.549170256
39113,2013,6708,5877,-2176,916,831,-1260,12.563197585,11.006844396,-4.075360457,1.715546957,1.5563531892,-2.3598135
39113,2014,6631,5867,-3571,1093,764,-2478,12.444344354,11.010551701,-6.701666972,2.0512243069,1.4337926537,-4.650442665
39113,2015,6646,6047,-2463,1205,599,-1258,12.500881702,11.37418472,-4.632812463,2.2665607057,1.1266969815,-2.366251758
39113,2016,6660,6067,-1656,1177,593,-479,12.534252763,11.418214942,-3.116625011,2.2151374627,1.1160378211,-0.901487549
39113,2017,6576,5883,-1656,1131,693,-525,12.373263891,11.069329603,-3.115894921,2.1280659155,1.3039342877,-0.987829006
42091,2010,2276,1723,148,461,553,609,NA,NA,NA,NA,NA,NA
42091,2011,9162,7205,349,2022,1957,2371,11.408527258,8.9716698201,0.434574985,2.5177954721,2.4368574376,2.9523704571
42091,2012,8916,7042,-177,2150,1874,1973,11.047656338,8.7256164124,-0.219317538,2.6640265957000002,2.3220399257,2.4447090573
42091,2013,8866,7457,303,2322,1409,2625,10.933867735,9.1962386311,0.3736704178,2.8635733004,1.7376291044,3.2372437182
42091,2014,9037,7205,-1273,2648,1832,1375,11.096614961,8.8470854042,-1.563128344,3.2515034213,2.2495295573,1.6883750771
42091,2015,8712,7561,-2001,2839,1151,838,10.664603603,9.2556322132,-2.449480235,3.4752995441,1.4089713897,1.0258193089
42091,2016,8918,7587,-1432,2902,1331,1470,10.885399979,9.2607680688,-1.74791352,3.5422102196,1.6246319098,1.7942966998
42091,2017,8814,7803,1586,2879,1011,4465,10.704844932,9.4769576816,1.9262405335,3.4966245246,1.2278872506,5.4228650581
47125,2010,775,312,183,137,463,320,NA,NA,NA,NA,NA,NA
47125,2011,2996,1031,1094,234,1965,1328,17.13748023,5.8974439643,6.2578115392,1.3385081354,11.240036266,7.5963196746
47125,2012,3499,1090,4152,1502,2409,5654,19.377204787,6.0363398736,22.993470785,8.3179655873,13.340864913,31.311436372
47125,2013,3405,1098,-3643,714,2307,-2929,18.466544641,5.9548505186,-19.75730459,3.8722798454,12.511694122,-15.88502474
47125,2014,3289,1127,2048,612,2162,2660,17.631465384,6.0415510758,10.978790242,3.2807713029,11.589914309,14.259561545
47125,2015,3447,1175,438,856,2272,1294,18.069778597,6.1595560926,2.2960728243,4.4873021406,11.910222504,6.7833749649
47125,2016,3484,1262,-484,516,2222,32,17.989502681,6.5162894327,-2.499115757,2.6643465509,11.473213248,0.1652307939
47125,2017,3455,1255,2905,257,2200,3162,17.494689564,6.3548004061,14.709717275,1.3013415971,11.139889158,16.011058872
48339,2010,1521,768,2226,300,753,2526,NA,NA,NA,NA,NA,NA
48339,2011,6353,2922,7261,1441,3431,8702,13.653219402,6.2796642679,15.604600359,3.0968501746,7.3735551346,18.701450534
48339,2012,6401,2992,8316,1143,3409,9459,13.392740386,6.2601279853,17.399473371,2.3914860586,7.1326124004,19.790959429
48339,2013,6418,3125,9574,992,3293,10566,13.059048549,6.3586049729,19.480730883,2.0184755626,6.7004435763,21.499206446
48339,2014,6776,3323,13411,1165,3453,14576,13.34823913,6.5460741777,26.418718266,2.2949673238,6.802164952,28.713685589
48339,2015,7100,3428,13170,1394,3672,14564,13.49794489,6.5170359273,25.037737212,2.6501598841,6.980908963,27.687897096
48339,2016,7551,3765,14090,1425,3786,15515,13.858402402,6.9099304786,25.859474221,2.6153123325,6.9484719235,28.474786554
48339,2017,7612,3889,11230,1434,3723,12664,13.526961516,6.9109765286,19.956355468,2.5483004222,6.6159849874,22.504655891
51121,2010,226,147,-10,106,79,96,NA,NA,NA,NA,NA,NA
51121,2011,859,618,-524,541,241,17,9.0695525934,6.5250098984,-5.532532665,5.7120232282,2.544542695,0.1794905635
51121,2012,925,583,-123,618,342,495,9.7106743932,6.1203493743,-1.291257244,6.4877802973,3.5903250189,5.1965230537
51121,2013,918,611,151,600,307,751,9.5427683384,6.3514503864,1.5696710448,6.2371034891,3.1913179519,7.8067745339
51121,2014,838,565,-388,642,273,254,8.6402441539,5.8254629439,-4.000494907,6.6193755929,2.81478121,2.6188806863
51121,2015,896,621,-728,682,275,-46,9.2022492105,6.3778981693,-7.476827484,7.0043905821,2.8243510412,-0.472436901
51121,2016,878,617,3,689,261,692,8.9626132449,6.298328442,0.0306239633,7.03330356,2.6642848029,7.0639275233
51121,2017,850,627,-790,679,223,-111,8.6294854289,6.3655145458,-8.020345281,6.8934360073,2.2639708831,-1.126909274
26119,2010,15,19,21,0,-4,21,NA,NA,NA,NA,NA,NA
26119,2011,61,153,-60,-1,-92,-61,6.2854198867,15.765069552,-6.182380216,-0.10303967,-9.479649665,-6.285419887
26119,2012,76,156,-29,0,-80,-29,7.9394097676,16.296683207,-3.029511622,0,-8.35727344,-3.029511622
26119,2013,55,164,-25,1,-109,-24,5.8204137785,17.35541563,-2.645642627,0.1058257051,-11.53500185,-2.539816922
26119,2014,64,180,54,1,-116,55,6.8430900829,19.246190858,5.7738572574000004,0.1069232825,-12.40310078,5.88078054
26119,2015,61,134,37,1,-73,38,6.5549108102,14.399312272,3.9759295078,0.1074575543,-7.844401461,4.0833870621
26119,2016,77,158,-3,2,-81,-1,8.3265747499,17.085698838,-0.324412003,0.2162746688,-8.759124088,-0.108137334
26119,2017,74,154,122,2,-80,124,8.0190723884,16.688339835,13.220632857,0.2167316862,-8.669267447,13.437364543
42093,2010,49,38,18,10,11,28,NA,NA,NA,NA,NA,NA
42093,2011,219,198,-36,70,21,34,11.945997545,10.800490931,-1.963725624,3.8183553798,1.1455066139,1.8546297559
42093,2012,210,222,27,55,-12,82,11.418007829,12.07046542,1.4680295781,2.990430622,-0.65245759,4.4584602001
42093,2013,222,222,-75,21,0,-54,12.06685691,12.06685691,-4.076640848,1.1414594374,0,-2.935181411
42093,2014,182,220,7,41,-38,48,9.9058400914,11.974092418,0.3809938497,2.2315354052,-2.068252327,2.6125292549
42093,2015,230,233,-152,41,-3,-111,12.555270484,12.719034882,-8.297396146,2.2381134341,-0.163764398,-6.059282712
42093,2016,217,224,-68,43,-7,-25,11.893017648,12.276663378,-3.72684424,2.3566809164,-0.383645731,-1.370163323
42093,2017,213,219,7,43,-6,50,11.670593392,11.999342502,0.3835406279,2.3560352857,-0.32874911,2.7395759136
08085,2010,123,67,-157,5,56,-152,NA,NA,NA,NA,NA,NA
08085,2011,497,399,-380,13,98,-367,12.105416991,9.7184333593,-9.255650818,0.3166406859,2.3869836321,-8.939010133
08085,2012,399,457,-248,-13,-58,-261,9.7878081688,11.210597326,-6.08365019,-0.318901018,-1.422789157,-6.402551208
08085,2013,455,384,-157,-8,71,-165,11.218778509,9.4681559287,-3.871095002,-0.197253249,1.7506225806,-4.068348251
08085,2014,480,391,-32,-6,89,-38,11.842787003,9.6469369125,-0.789519134,-0.148034838,2.1958500901,-0.937553971
08085,2015,452,464,3,-4,-12,-1,11.148519491,11.444497885,0.0739945984,-0.098659465,-0.295978394,-0.024664866
08085,2016,442,414,604,-4,28,600,10.820868118,10.135383259,14.786887654,-0.097926408,0.6854848581,14.688961246
08085,2017,447,434,614,-4,13,610,10.778356481,10.464891975,14.805169753,-0.096450617,0.3134645062,14.708719136
46101,2010,16,14,-2,0,2,-2,NA,NA,NA,NA,NA,NA
46101,2011,92,48,-65,12,44,-53,14.176747053,7.3965636798,-10.01617998,1.8491409199,6.7801833731,-8.167039063
46101,2012,81,42,-86,25,39,-61,12.50965251,6.4864864865,-13.28185328,3.861003861,6.0231660232,-9.420849421
46101,2013,88,74,-66,33,14,-33,13.63389883,11.464869471,-10.22542412,5.1127120614,2.1690293594,-5.112712061
46101,2014,106,51,-97,28,55,-69,16.463461986,7.921099635,-15.06562087,4.3488390153,8.5423623515,-10.71678186
46101,2015,90,50,-34,29,40,-5,13.954570122,7.7525389565,-5.27172649,4.4964725948,6.2020311652,-0.775253896
46101,2016,90,42,9,32,48,41,13.821700069,6.4501266989,1.3821700069,4.9143822468,7.3715733702,6.2965522537
46101,2017,94,44,-60,32,50,-28,14.312904454,6.6996574039,-9.13589646,4.8724781119,7.6132470499,-4.263418348
37125,2010,257,220,275,21,37,296,NA,NA,NA,NA,NA,NA
37125,2011,930,987,716,11,-57,727,10.457428147,11.098367292,8.0510952188,0.1236900103,-0.640939145,8.1747852292
37125,2012,973,1001,859,103,-28,962,10.841890032,11.153886868,9.5716172022,1.1477026447,-0.311996835,10.719319847
37125,2013,991,1091,1169,113,-100,1282,10.912474467,12.013632334,12.872535471,1.2443083903,-1.101157867,14.116843861
37125,2014,976,1051,1380,104,-75,1484,10.593841244,11.40791716,14.978996841,1.1288519359,-0.814075915,16.107848777
37125,2015,1060,1161,1151,136,-101,1287,11.343753177,12.424620225,12.317603686,1.4554249359,-1.080867048,13.773028622
37125,2016,1100,1112,1255,111,-12,1366,11.613666118,11.740360657,13.250137252,1.1719244901,-0.126694539,14.422061742
37125,2017,1104,1152,1842,76,-48,1918,11.460842123,11.959139606,19.122165933,0.7889710157,-0.498297484,19.911136949
47127,2010,17,28,-1,0,-11,-1,NA,NA,NA,NA,NA,NA
47127,2011,46,65,57,1,-19,58,7.2406736975,10.231386746,8.9721391469,0.1574059499,-2.990713049,9.1295450968
47127,2012,48,68,-42,0,-20,-42,7.5691871008,10.72301506,-6.623038713,0,-3.153827959,-6.623038713
47127,2013,52,70,-12,-1,-18,-13,8.2605242256,11.119936458,-1.906274821,-0.158856235,-2.859412232,-2.065131056
47127,2014,57,58,22,-1,-1,21,9.0634441088,9.2224519001,3.4981714104,-0.159007791,-0.159007791,3.339163619
47127,2015,48,71,-17,-1,-23,-18,7.6469651107,11.311135893,-2.708300143,-0.159311773,-3.664170782,-2.867611917
47127,2016,50,55,42,-1,-5,41,7.9687624512,8.7656386963,6.693760459,-0.159375249,-0.796876245,6.53438521
47127,2017,48,45,91,-1,3,90,7.5727695827,7.0994714838,14.356709001,-0.157766033,0.4732980989,14.198942968
48341,2010,93,19,-14,48,74,34,NA,NA,NA,NA,NA,NA
48341,2011,406,140,-389,194,266,-195,18.412698413,6.3492063492,-17.64172336,8.798185941,12.063492063,-8.843537415
48341,2012,412,148,-102,186,264,84,18.5056258,6.6476519864,-4.581489883,8.3544815505,11.857973814,3.772991668
48341,2013,428,129,-749,143,299,-606,19.200574223,5.7870889597,-33.60100489,6.4151451258,13.413485263,-27.18585976
48341,2014,433,142,-603,177,291,-426,19.607843137,6.4302857402,-27.30607254,8.015215324,13.177557397,-19.29085722
48341,2015,431,168,-607,193,263,-414,19.635088039,7.6535842008,-27.65312863,8.7925104212,11.981503838,-18.86061821
48341,2016,445,127,-455,193,318,-262,20.312678307,5.7971014493,-20.76914299,8.8097683442,14.515576857,-11.95937464
48341,2017,449,125,-356,193,324,-163,20.394258721,5.6776889535,-16.17005814,8.7663517442,14.716569767,-7.403706395
35033,2010,11,3,5,-1,8,4,NA,NA,NA,NA,NA,NA
35033,2011,42,44,-110,-3,-2,-113,8.6839656777,9.0974878528,-22.74371963,-0.620283263,-0.413522175,-23.36400289
35033,2012,45,50,-90,-1,-5,-91,9.5087163233,10.565240359,-19.01743265,-0.211304807,-1.0565240360000001,-19.22873745
35033,2013,40,47,19,0,-7,19,8.5269665317,10.019185675,4.0503091025,0,-1.492219143,4.0503091025
35033,2014,39,45,-77,0,-6,-77,8.3753892408,9.6639106625,-16.53602491,0,-1.288521422,-16.53602491
35033,2015,48,52,2,0,-4,2,10.401993715,11.268826525,0.4334164048,0,-0.86683281,0.4334164048
35033,2016,41,41,-66,0,0,-66,8.9519650655,8.9519650655,-14.41048035,0,0,-14.41048035
35033,2017,48,31,-11,0,17,-11,10.55176962,6.8146845461,-2.418113871,0,3.7370850736,-2.418113871
22067,2010,91,135,-67,1,-44,-66,NA,NA,NA,NA,NA,NA
22067,2011,382,383,-407,5,-1,-402,13.803570138,13.839705138,-14.70694515,0.1806750018,-0.036135,-14.52627015
22067,2012,366,364,-108,7,2,-101,13.344757807,13.271835633,-3.937797386,0.2552276083,0.0729221738,-3.682569777
22067,2013,338,377,-410,4,-39,-406,12.446604802,13.88275151,-15.09795257,0.1472970982,-1.436146708,-14.95065547
22067,2014,374,381,-284,5,-7,-279,13.958348884,14.219601403,-10.59938792,0.1866089423,-0.261252519,-10.41277898
22067,2015,375,389,-338,5,-14,-333,14.161096635,14.689777576,-12.76386843,0.1888146218,-0.528680941,-12.57505381
22067,2016,355,346,-408,4,9,-404,13.595542194,13.250866476,-15.6252992,0.1531892078,0.3446757176,-15.47210999
22067,2017,334,354,-256,4,-20,-252,12.957036175,13.732906605,-9.931141499,0.1551740859,-0.77587043,-9.775967413
01103,2010,384,295,26,21,89,47,NA,NA,NA,NA,NA,NA
01103,2011,1506,1238,15,134,268,149,12.57026956,10.33332916,0.125201888,1.1184701999,2.2369403997,1.2436720879
01103,2012,1395,1220,-158,65,175,-93,11.621029482,10.163194242,-1.316216959,0.5414816604,1.4578352396,-0.774735299
01103,2013,1394,1231,-698,0,163,-698,11.635380237,10.274858731,-5.826036876,0,1.3605215054,-5.826036876
01103,2014,1412,1230,-373,66,182,-307,11.818520425000001,10.295170059,-3.122031245,0.5524237592,1.5233503664,-2.569607486
01103,2015,1359,1254,-391,86,105,-305,11.391115935,10.51100764,-3.277355652,0.7208506037,0.8801082952,-2.556505048
01103,2016,1422,1363,-534,97,59,-437,11.948676151,11.452915326,-4.487055601,0.8150644069,0.4957608248,-3.671991194
01103,2017,1398,1280,-214,97,118,-117,11.765844544,10.772733202,-1.801066332,0.816371188,0.9931113421,-0.984695144
08087,2010,126,39,-38,27,87,-11,NA,NA,NA,NA,NA,NA
08087,2011,461,279,-146,125,182,-21,16.28112308,9.8534345753,-5.156277591,4.4146212255,6.4276885043,-0.741656366
08087,2012,427,271,-427,67,156,-360,15.089938863,9.5769869597,-15.08993886,2.3677421635,5.512951903,-12.7221967
08087,2013,414,232,-279,66,182,-213,14.689445952,8.2317668139,-9.899409229,2.3417957315,6.4576791385,-7.557613497
08087,2014,431,240,-396,75,191,-321,15.334531158,8.5389500649,-14.08926761,2.6684218953,6.7955810933,-11.42084571
08087,2015,455,264,-174,85,191,-89,16.195340725,9.3968570361,-6.193383047,3.0255032124,6.798483689,-3.167879834
08087,2016,428,273,-331,95,155,-236,15.229148876,9.7139197267,-11.77768289,3.3803017364,5.5152291489,-8.397381156
08087,2017,443,250,-156,94,193,-62,15.749711137,8.8880988357,-5.546173673,3.3419251622,6.8616123011,-2.204248511
13211,2010,59,24,-2,0,35,-2,NA,NA,NA,NA,NA,NA
13211,2011,196,192,4,-2,4,2,10.949414821,10.725957375,0.2234574453,-0.111728723,0.2234574453,0.1117287227
13211,2012,184,170,-108,-3,14,-111,10.305525218,9.5214091686,-6.048895236,-0.168024868,0.7841160492,-6.216920104
13211,2013,150,185,-86,-2,-35,-88,8.453323565,10.42576573,-4.846572177,-0.112710981,-1.972442165,-4.959283158
13211,2014,209,175,178,0,34,178,11.748173131,9.8369870714,10.005621135,0,1.9111860596,10.005621135
13211,2015,188,189,55,0,-1,55,10.488730194,10.544521312,3.068511493,0,-0.055791118,3.068511493
13211,2016,195,174,149,0,21,149,10.811709914,9.6473719228,8.2612552672,0,1.1643379907,8.2612552672
13211,2017,199,152,245,0,47,245,10.894259984,8.321243807,13.412531136,0,2.5730161772,13.412531136
17137,2010,79,87,-33,3,-8,-30,NA,NA,NA,NA,NA,NA
17137,2011,369,381,-30,23,-12,-7,10.394951828,10.732999042,-0.845118035,0.6479238267,-0.338047214,-0.197194208
17137,2012,376,411,-153,26,-35,-127,10.620568878,11.609185662,-4.321667655,0.7344010395,-0.988616784,-3.587266616
17137,2013,390,421,-323,27,-31,-296,11.092938918,11.974685345,-9.187228899,0.7679726943,-0.881746427,-8.419256204
17137,2014,351,373,-319,27,-22,-292,10.075205236,10.706699581,-9.156668006,0.7750157874,-0.631494345,-8.381652219
17137,2015,386,394,-160,30,-8,-130,11.152201549,11.383335259,-4.622674217,0.8667514157,-0.231133711,-3.755922801
17137,2016,359,385,-352,30,-26,-322,10.445763501,11.202281192,-10.24208566,0.8729050279,-0.756517691,-9.369180633
17137,2017,351,367,-409,30,-16,-379,10.324744088,10.795387693,-12.03082716,0.8824567596,-0.470643605,-11.1483704
18109,2010,205,116,117,7,89,124,NA,NA,NA,NA,NA,NA
18109,2011,804,631,-94,16,173,-78,11.620512228,9.1200786264,-1.358617101,0.2312539747,2.5004336012,-1.127363127
18109,2012,751,633,-186,16,118,-170,10.851895469,9.1468040373,-2.687686494,0.2311988382,1.7050914319,-2.456487656
18109,2013,750,678,90,18,72,108,10.8284485,9.7889174439,1.29941382,0.259882764,1.039531056,1.559296584
18109,2014,715,639,66,22,76,88,10.299254564,9.2045086247,0.9507004213,0.3169001404,1.0947459397,1.2676005618
18109,2015,768,663,-67,23,105,-44,11.046465634,9.536206661,-0.963689059,0.3308186323,1.5102589735,-0.632870427
18109,2016,772,703,-85,24,69,-61,11.09928976,10.107254795,-1.222072059,0.3450556402,0.9920349656,-0.877016419
18109,2017,753,657,42,24,96,66,10.81352768,9.4349106053,0.6031449702,0.3446542687,1.3786170747,0.9477992389
21175,2010,24,51,-191,0,-27,-191,NA,NA,NA,NA,NA,NA
21175,2011,140,140,-6,3,0,-3,10.201107549,10.201107549,-0.437190324,0.2185951618,0,-0.218595162
21175,2012,144,149,-197,10,-5,-187,10.567256183,10.9341748,-14.45659353,0.7338372349,-0.366918617,-13.72275629
21175,2013,112,129,-149,0,-17,-149,8.326827999,9.5907215345,-11.07765511,0,-1.263893536,-11.07765511
21175,2014,145,133,-29,1,12,-28,10.853699615,9.955462405,-2.170739923,0.0748531008,0.8982372095,-2.095886822
21175,2015,141,172,-58,1,-31,-57,10.596325104,12.926013602,-4.358772029,0.0751512419,-2.329688498,-4.283620787
21175,2016,127,148,-8,1,-21,-7,9.5859908669,11.171075971,-0.603841944,0.075480243,-1.585085104,-0.528361701
21175,2017,125,160,-12,1,-35,-11,9.4614540363,12.110661166,-0.908299587,0.0756916323,-2.64920713,-0.832607955
29141,2010,62,86,2,1,-24,3,NA,NA,NA,NA,NA,NA
29141,2011,233,302,-97,0,-69,-97,11.390579551,14.763755469,-4.742000929,0,-3.373175918,-4.742000929
29141,2012,269,303,-263,-1,-34,-264,13.301686199,14.982940217,-13.00499431,-0.049448648,-1.681254018,-13.05444296
29141,2013,243,294,96,-4,-51,92,12.092259461,14.630141076,4.7771889229,-0.199049538,-2.537881615,4.5781393844
29141,2014,245,285,-4,-4,-40,-8,12.193908023,14.184750149,-0.199084213,-0.199084213,-1.990842126,-0.398168425
29141,2015,266,282,13,-4,-16,9,13.258236555,14.055724468,0.6479589294,-0.199371978,-0.797487913,0.4485869511
29141,2016,287,309,66,-4,-22,62,14.293896456,15.389595836,3.2870981398,-0.199218069,-1.09569938,3.0878800707
29141,2017,273,307,85,-4,-34,81,13.567239837,15.25693271,4.2242321837,-0.198787397,-1.689692873,4.0254447868
39115,2010,49,53,-4,0,-4,-4,NA,NA,NA,NA,NA,NA
39115,2011,147,162,16,1,-15,17,9.769389247,10.766265701,1.063334884,0.0664584303,-0.996876454,1.1297933143
39115,2012,138,177,-64,0,-39,-64,9.2030676892,11.803934645,-4.268089363,0,-2.600866956,-4.268089363
39115,2013,138,183,9,1,-45,10,9.2468507103,12.262128116,0.6030554811,0.0670061646,-3.015277406,0.6700616457
39115,2014,134,161,-139,2,-27,-137,9.0393955747,10.860766325,-9.376686454,0.1349163519,-1.82137075,-9.241770103
39115,2015,146,156,12,2,-10,14,9.9019973549,10.580216352,0.8138627963,0.1356437994,-0.678218997,0.9495065957
39115,2016,159,171,26,2,-12,28,10.776738512,11.590077267,1.7622339704,0.1355564593,-0.813338756,1.8977904297
39115,2017,139,152,-42,2,-13,-40,9.4330019341,10.315225137,-2.850259577,0.1357266465,-0.882223202,-2.714532931
47129,2010,55,33,12,0,22,12,NA,NA,NA,NA,NA,NA
47129,2011,195,226,13,-2,-31,11,8.8606156992,10.2692264,0.5907077133,-0.09087811,-1.408610701,0.4998296035
47129,2012,166,204,-63,-3,-38,-66,7.5645378113,9.296178997,-2.870878808,-0.136708515,-1.731641186,-3.007587323
47129,2013,216,227,-221,-3,-11,-224,9.9189493261,10.424081005,-10.14855463,-0.137763185,-0.505131679,-10.28631782
47129,2014,182,234,80,0,-52,80,8.3969641745,10.796096796,3.6909732635,0,-2.399132621,3.6909732635
47129,2015,228,242,-188,0,-14,-188,10.561667632,11.210191083,-8.708743486,0,-0.648523451,-8.708743486
47129,2016,213,244,268,0,-31,268,9.8586008192,11.293420657,12.404248918,0,-1.434819838,12.404248918
47129,2017,215,231,-71,0,-16,-71,9.9169741697,10.65498155,-3.274907749,0,-0.73800738,-3.274907749
49029,2010,45,18,22,2,27,24,NA,NA,NA,NA,NA,NA
49029,2011,153,50,21,7,103,28,15.959943671,5.2156678663,2.1905805038,0.7301935013,10.744275805,2.9207740051
49029,2012,134,46,47,15,88,62,13.77537908,4.7288614752,4.8316628116,1.5420200463,9.0465176047,6.3736828579000004
49029,2013,188,64,268,8,124,276,18.791543805,6.3971212954,26.787945425,0.7996401619,12.39442251,27.587585586
49029,2014,145,53,284,7,92,291,13.944989421,5.0971340642,27.312944797,0.6732063858,8.8478553568,27.986151183
49029,2015,177,49,301,8,128,309,16.37372803,4.532839963,27.844588344,0.7400555042,11.840888067,28.584643848
49029,2016,166,48,217,8,118,225,14.819443824,4.285140383,19.372405481,0.7141900638,10.534303442,20.086595545
49029,2017,168,42,367,8,126,375,14.45409963,3.6135249075,31.575324787,0.6882904586,10.840574723,32.263615246
54065,2010,42,72,-17,-1,-30,-18,NA,NA,NA,NA,NA,NA
54065,2011,132,202,24,-8,-70,16,7.5588386875,11.567313749,1.3743343068,-0.458111436,-4.008475062,0.9162228712
54065,2012,147,198,29,-1,-51,28,8.4376076225,11.364940879,1.664562048,-0.057398691,-2.927333257,1.6071633567
54065,2013,136,208,61,-5,-72,56,7.8156427792,11.953336015,3.5055456583,-0.287339808,-4.137693236,3.2182058502
54065,2014,158,211,118,-3,-53,115,9.0676920428,12.109386209,6.7720738041,-0.172171368,-3.041694166,6.5999024362
54065,2015,140,214,54,-2,-74,52,8.0254521482,12.267476855,3.0955315429,-0.114649316,-4.242024707,2.9808822265
54065,2016,129,216,240,-2,-87,238,7.3680603153,12.337217272,13.708019191,-0.114233493,-4.969156957,13.593785698
54065,2017,129,219,194,-2,-90,192,7.3152059883,12.418838073,11.001162494,-0.113414046,-5.103632085,10.887748448
31123,2010,15,22,3,0,-7,3,NA,NA,NA,NA,NA,NA
31123,2011,51,57,-46,-2,-6,-48,10.176593834,11.373840168,-9.178888556,-0.399082111,-1.197246333,-9.577970667
31123,2012,55,56,-50,1,-1,-49,11.088709677,11.290322581,-10.08064516,0.2016129032,-0.201612903,-9.879032258
31123,2013,50,61,-2,3,-11,1,10.140959335,12.371970388,-0.405638373,0.6084575601,-2.231011054,0.2028191867
31123,2014,57,59,-5,5,-2,0,11.573604061,11.979695431,-1.015228426,1.0152284264,-0.406091371,0
31123,2015,59,69,15,6,-10,21,11.968759509,13.997362816,3.0429049599,1.217161984,-2.028603307,4.2600669439
31123,2016,51,50,-50,6,1,-44,10.3795665,10.176045589,-10.17604559,1.2211254706,0.2035209118,-8.954920118
31123,2017,49,44,-69,6,5,-63,10.074013158,9.0460526316,-14.18585526,1.2335526316,1.0279605263,-12.95230263
20127,2010,11,6,-9,0,5,-9,NA,NA,NA,NA,NA,NA
20127,2011,55,87,-22,0,-32,-22,9.3331070762,14.763278466,-3.73324283,0,-5.43017139,-3.73324283
20127,2012,67,83,0,2,-16,2,11.437350632,14.168658245,0,0.3414134517,-2.731307614,0.3414134517
20127,2013,76,73,-136,1,3,-135,13.136288998,12.617751275,-23.50704347,0.1728459079,0.51853772359999994,-23.33419756
20127,2014,48,66,-39,2,-18,-37,8.4299262381,11.591148577,-6.849315068,0.3512469266,-3.161222339,-6.498068142
20127,2015,66,87,-23,2,-21,-21,11.690727128,15.410503941,-4.074041272,0.3542644584,-3.719776813,-3.719776813
20127,2016,51,64,-56,2,-13,-54,9.1234347048,11.4490161,-10.01788909,0.3577817531,-2.325581395,-9.660107335
20127,2017,53,75,-82,2,-22,-80,9.6267368994999991,13.622740895,-14.89419671,0.3632730905,-3.996003996,-14.53092362
34027,2010,1269,887,-327,553,382,226,NA,NA,NA,NA,NA,NA
34027,2011,4821,3611,-474,2079,1210,1605,9.753452704,7.3054797167,-0.958958013,4.2060626782,2.4479729873,3.247104665
34027,2012,4625,3635,-1204,2027,990,823,9.3140996337,7.3203788472,-2.424686694,4.0820929638,1.9937207865,1.6574062699
34027,2013,4602,3775,-1463,1887,827,424,9.23978569,7.5793548413,-2.937376459,3.7886735326,1.6604308487,0.8512970736
34027,2014,4672,3806,-3092,2002,866,-1090,9.3706031423,7.6336719948,-6.20160636,4.0153997198,1.7369311475,-2.186206641
34027,2015,4718,3736,-3129,2191,982,-938,9.4642128184,7.4943406294,-6.276710875,4.3951017985,1.969872189,-1.881609077
34027,2016,4670,3753,-2849,2232,917,-617,9.3645163037,7.5257022886,-5.71295652,4.4757174282,1.8388140151,-1.237239092
34027,2017,4666,3792,-2254,2228,874,-26,9.3456727192,7.5951116483,-4.514604867,4.4625286795,1.7505610708,-0.052076187
48343,2010,40,54,0,2,-14,2,NA,NA,NA,NA,NA,NA
48343,2011,150,164,-139,4,-14,-135,11.677695601,12.767613858,-10.82133126,0.311405216,-1.089918256,-10.50992604
48343,2012,162,172,-63,8,-10,-55,12.717352907,13.502374691,-4.945637241,0.6280174275,-0.785021784,-4.317619814
48343,2013,160,172,-16,5,-12,-11,12.603883572,13.549174839,-1.260388357,0.3938713616,-0.945291268,-0.866516996
48343,2014,154,152,-77,11,2,-66,12.173913043,12.015810277,-6.086956522,0.8695652174,0.1581027668,-5.217391304
48343,2015,138,172,-208,13,-34,-195,11.03602703,13.755048183,-16.63401176,1.0396257347,-2.719021152,-15.59438602
48343,2016,162,157,81,14,5,95,13.021984647,12.620071541,6.5109923235,1.1253566979,0.4019131064,7.6363490213
48343,2017,155,155,-36,14,0,-22,12.421364747,12.421364747,-2.884962135,1.1219297191,0,-1.763032416
27097,2010,105,46,-16,3,59,-13,NA,NA,NA,NA,NA,NA
27097,2011,387,286,-105,15,101,-90,11.640673174,8.6026680303,-3.158322179,0.4511888827,3.0380051436,-2.707133296
27097,2012,370,321,-210,6,49,-204,11.153985289,9.6768358857,-6.330640299,0.1808754371,1.4771494031,-6.149764862
27097,2013,366,361,-254,8,5,-246,11.099149368,10.947521645,-7.70268836,0.2426043578,0.1516277236,-7.460084002
27097,2014,391,307,-140,5,84,-135,11.909657179,9.3510607514,-4.264327379,0.1522974064,2.5585964271,-4.112029972
27097,2015,386,332,-105,5,54,-100,11.775472849,10.128126907,-3.203172666,0.1525320317,1.6473459426,-3.050640635
27097,2016,396,298,63,4,98,67,12.059199708,9.0748523053,1.9185090444,0.1218100981,2.9843474024,2.0403191425
27097,2017,397,336,82,4,61,86,12.033220175,10.1842871,2.4854510184,0.1212415131,1.8489330747,2.6066925315
39117,2010,93,95,-34,0,-2,-34,NA,NA,NA,NA,NA,NA
39117,2011,368,308,-47,2,60,-45,10.57516847,8.8509562194,-1.35063293,0.0574737417,1.7242122505,-1.293159188
39117,2012,412,301,-89,3,111,-86,11.83279004,8.6448296164,-2.556112412,0.0861610925,3.1879604233,-2.469951319
39117,2013,394,316,-68,3,78,-65,11.309976605,9.0709457035,-1.951975658,0.0861165731,2.2390309015,-1.865859085
39117,2014,382,304,18,4,78,22,10.949009717,8.7133480467,0.5159219238,0.1146493164,2.2356616699,0.6305712402
39117,2015,366,328,-25,4,38,-21,10.474200841,9.3867155081,-0.715450877,0.1144721403,1.0874853333,-0.600978737
39117,2016,379,324,-54,4,55,-50,10.843442435,9.2698558022,-1.544975967,0.1144426642,1.5735866331,-1.430533303
39117,2017,379,308,-33,4,71,-29,10.83662149,8.8065420026,-0.943558072,0.1143706754,2.0300794876,-0.829187396
41049,2010,40,26,6,10,14,16,NA,NA,NA,NA,NA,NA
41049,2011,184,72,-146,25,112,-121,16.421973314,6.4259895578,-13.03047883,2.2312463742,9.9959837565,-10.79923245
41049,2012,155,76,-79,7,79,-72,13.831258645,6.7817784322,-7.049480212,0.6246374872,7.0494802124,-6.424842725
41049,2013,139,85,-75,-6,54,-81,12.412376658,7.5903022726,-6.697325535,-0.535786043,4.822074385,-7.233111577
41049,2014,149,84,-179,-2,65,-181,13.386640313,7.5468307803,-16.08193702,-0.179686447,5.8398095324,-16.26162347
41049,2015,164,66,-59,3,98,-56,14.780100937,5.9480894016,-5.317231435,0.2703677001,8.8320115357,-5.046863735
41049,2016,174,71,-5,4,103,-1,15.580229226,6.3574498567,-0.447707736,0.3581661891,9.2227793696,-0.089541547
41049,2017,174,79,-152,4,95,-148,15.546124637,7.0582979674,-13.58052267,0.3573821756,8.4878266696,-13.2231405
20129,2010,14,2,-8,3,12,-5,NA,NA,NA,NA,NA,NA
20129,2011,37,50,-58,8,-13,-50,11.530071673,15.581177937,-18.07416641,2.4929884699,-4.051106264,-15.58117794
20129,2012,41,32,-56,-3,9,-59,12.999365885,10.145846544,-17.75523145,-0.951173114,2.8535193405,-18.70640457
20129,2013,56,30,-34,-4,26,-38,17.922867659,9.6015362458,-10.88174108,-1.280204833,8.321331413,-12.16194591
20129,2014,27,39,-62,-2,-12,-64,8.7605451006,12.654120701,-20.11680727,-0.648929267,-3.8935756,-20.76573653
20129,2015,27,46,-73,-2,-19,-75,9.0045022511,15.341003835,-24.34550609,-0.667000167,-6.336501584,-25.01250625
20129,2016,28,28,-152,-2,0,-154,9.735744089,9.735744089,-52.8511822,-0.695410292,0,-53.54659249
20129,2017,17,23,-51,-2,-6,-53,6.1371841155,8.3032490975,-18.41155235,-0.722021661,-2.166064982,-19.13357401
38059,2010,103,88,79,0,15,79,NA,NA,NA,NA,NA,NA
38059,2011,374,249,28,-6,125,22,13.529890567,9.0078683187,1.0129329836,-0.217057068,4.5220222483,0.7958759157
38059,2012,395,268,232,-2,127,230,14.159736163,9.6071121308,8.3166045311,-0.071694867,4.5526240321,8.2449096645
38059,2013,439,259,661,-10,180,651,15.401887521,9.0867627969,23.190541347,-0.350840262,6.3151247237,22.839701084
38059,2014,446,272,642,5,174,647,15.197205895,9.2682511287,21.87579862,0.1703722634,5.9289547662,22.046170883
38059,2015,475,288,230,5,187,235,15.844688694,9.6068849342,7.6721650516,0.1667861968,6.2378037594,7.8389512484
38059,2016,521,268,165,6,253,171,17.136748623,8.8150645506,5.4271852644,0.1973521914,8.321684072,5.6245374558
38059,2017,511,273,-61,6,238,-55,16.64196968,8.8909153083,-1.986614776,0.1954047321,7.7510543714,-1.791210044
48345,2010,5,7,2,0,-2,2,NA,NA,NA,NA,NA,NA
48345,2011,9,22,7,0,-13,7,7.4844074844,18.295218295,5.8212058212,0,-10.81081081,5.8212058212
48345,2012,9,15,5,0,-6,5,7.5093867334,12.515644556,4.1718815186,0,-5.006257822,4.1718815186
48345,2013,11,15,-3,0,-4,-3,9.2088740059,12.557555463,-2.511511093,0,-3.348681457,-2.511511093
48345,2014,5,20,-28,0,-15,-28,4.2716787698,17.086715079,-23.92140111,0,-12.81503631,-23.92140111
48345,2015,5,12,4,0,-7,4,4.3572984749,10.45751634,3.48583878,0,-6.100217865,3.48583878
48345,2016,7,14,32,0,-7,32,6.0396893874,12.079378775,27.610008628,0,-6.039689387,27.610008628
48345,2017,8,14,64,0,-6,64,6.6611157369,11.65695254,53.288925895,0,-4.995836803,53.288925895
17139,2010,49,64,21,0,-15,21,NA,NA,NA,NA,NA,NA
17139,2011,168,214,42,1,-46,43,11.312369537,14.409804054,2.8280923844,0.067335533,-3.097434516,2.8954279173
17139,2012,183,177,11,1,6,12,12.317426129,11.913576092,0.7403917345,0.0673083395,0.403850037,0.807700074
17139,2013,176,175,-78,2,1,-76,11.869436202,11.801996223,-5.260318317,0.1348799568,0.0674399784,-5.12543836
17139,2014,199,183,-63,2,16,-61,13.47599377,12.392496783,-4.266269384,0.1354371233,1.0834969865,-4.130832261
17139,2015,194,212,7,2,-18,9,13.162804899,14.384096075,0.4749465685,0.1356990196,-1.221291176,0.6106455881
17139,2016,164,165,-135,2,-1,-133,11.182326469,11.250511387,-9.204963862,0.136369835,-0.068184917,-9.068594027
17139,2017,170,155,74,2,15,76,11.609246423,10.584901151,5.0534366784,0.1365793697,1.0243452726,5.1900160481
38061,2010,27,31,41,0,-4,41,NA,NA,NA,NA,NA,NA
38061,2011,136,76,321,-1,60,320,17.190166214,9.6062693547,40.573848196,-0.126398281,7.583896859,40.447449915
38061,2012,151,83,553,-1,68,552,17.918594992,9.8492939362,65.622404177,-0.118666192,8.0693010561,65.503737985
38061,2013,157,74,502,1,83,503,17.354778091,8.1799591002,55.491073896,0.1105399878,9.1748189908,55.601613884
38061,2014,159,74,315,7,85,322,16.637019985,7.7430155907,32.960133933,0.7324474207,8.8940043947,33.692581354
38061,2015,151,96,469,7,55,476,15.044335957,9.5646109395,46.727109694,0.6974195477,5.4797250174,47.424529242
38061,2016,184,73,-181,7,111,-174,17.905799922,7.1039314909,-17.61385753,0.6811989101,10.801868431,-16.93265862
38061,2017,175,78,-86,7,97,-79,17.064846416,7.6060458313,-8.386153096,0.6825938567,9.4588005851,-7.703559239
27099,2010,126,62,-29,16,64,-13,NA,NA,NA,NA,NA,NA
27099,2011,503,371,-33,62,132,29,12.802076838,9.4424860971,-0.839897685,1.5779895904,3.3595907408,0.7380919052
27099,2012,528,383,-169,79,145,-90,13.402545976,9.7219225546,-4.289830057,2.0053051744,3.6806234215,-2.284524882
27099,2013,478,405,-217,81,73,-136,12.135213699,10.281927925,-5.50908237,2.056385585,1.8532857741,-3.452696785
27099,2014,475,375,-169,86,100,-83,12.066709853,9.5263498838,-4.293208348,2.1847095733,2.540359969,-2.108498774
27099,2015,531,374,-317,95,157,-222,13.498398495,9.507346586,-8.058365957,2.4149677157,3.9910519091,-5.643398241
27099,2016,498,384,-190,102,114,-88,12.666276674,9.766767556,-4.832515197,2.5942976321,2.8995091182,-2.238217565
27099,2017,508,369,-2,101,139,99,12.877875658,9.354204956,-0.050700298,2.5603650421,3.5236707016,2.5096647443
21177,2010,87,68,124,0,19,124,NA,NA,NA,NA,NA,NA
21177,2011,335,376,-87,0,-41,-87,10.604118196,11.901935647,-2.753905323,0,-1.297817451,-2.753905323
21177,2012,342,356,-120,-2,-14,-122,10.871811174,11.316856076,-3.814670587,-0.063577843,-0.445044902,-3.87824843
21177,2013,341,386,-7,-2,-45,-9,10.873897862,12.30886972,-0.223217845,-0.063776527,-1.434971859,-0.286994372
21177,2014,354,370,-2,-1,-16,-3,11.303042881,11.813914876,-0.063858999,-0.0319295,-0.510871995,-0.095788499
21177,2015,362,419,5,-1,-57,4,11.573815043,13.396211334,0.1598593238,-0.031971865,-1.822396291,0.127887459
21177,2016,320,416,-87,-1,-96,-88,10.270894852,13.352163307,-2.792399538,-0.032096546,-3.081268456,-2.824496084
21177,2017,336,426,-157,-1,-90,-158,10.859728507,13.768584357,-5.074337427,-0.032320621,-2.90885585,-5.106658048
41051,2010,2492,1280,332,430,1212,762,NA,NA,NA,NA,NA,NA
41051,2011,9586,5429,4349,2008,4157,6357,12.910194286,7.3116466491,5.8571286198,2.7043261137,5.5985476368,8.5614547335
41051,2012,9409,5395,4458,2049,4014,6507,12.492365703,7.1629623729,5.9189038477,2.7204652274,5.3294033299,8.6393690751
41051,2013,9323,5647,763,2504,3676,3267,12.23498039,7.4108049195,1.0013182493,3.286108645,4.8241754709,4.2874268943
41051,2014,9538,5558,4758,3070,3980,7828,12.363770704,7.2046380343,6.1676264425,3.9795319837,5.1591326694,10.147158426
41051,2015,9464,5712,5601,3415,3752,9016,12.073561465,7.287001594,7.1453949454,4.3566369824,4.7865598706,11.502031928
41051,2016,9133,5775,4404,3446,3358,7850,11.4747425,7.2557361148,5.5332055151,4.329569983,4.219006385,9.8627754981
41051,2017,9378,5885,-896,3430,3493,2534,11.656248796,7.3146752147,-1.113670177,4.2632686468,4.3415735812,3.1495984697
13213,2010,110,84,-125,9,26,-116,NA,NA,NA,NA,NA,NA
13213,2011,500,345,-329,37,155,-292,12.665763176,8.7393765911,-8.33407217,0.937266475,3.9263865844,-7.396805695
13213,2012,487,326,-212,12,161,-200,12.363544047,8.2762122366,-5.382076669,0.3046458492,4.0873318101,-5.07743082
13213,2013,519,371,-298,29,148,-269,13.202579464,9.4376820442,-7.580671831,0.7377163862,3.7648974193,-6.842955444
13213,2014,522,367,-108,26,155,-82,13.287683437,9.3421069379,-2.749175884,0.6618386386,3.9455764996,-2.087337245
13213,2015,498,362,11,35,136,46,12.63766939,9.1864183119,0.2791453078,0.8881896158,3.4512510785,1.1673349236
13213,2016,476,379,-249,35,97,-214,12.070495753,9.6107518702,-6.314187904,0.8875364524,2.4597438823,-5.426651452
13213,2017,463,410,316,37,53,353,11.698122742,10.359028778,7.9840319361,0.9348391824,1.339093964,8.9188711185
27101,2010,32,38,-23,0,-6,-23,NA,NA,NA,NA,NA,NA
27101,2011,70,86,-60,9,-16,-51,8.0798753391000009,9.926703988,-6.925607433,1.038841115,-1.846828649,-5.886766318
27101,2012,91,123,-37,11,-32,-26,10.579550078,14.299831425,-4.301575307,1.2788467128,-3.720281346,-3.022728594
27101,2013,86,100,-64,11,-14,-53,10.070257611,11.709601874,-7.494145199,1.2880562061,-1.639344262,-6.206088993
27101,2014,84,105,-58,5,-21,-53,9.9173553719,12.396694215,-6.847697757,0.59031877210000006,-2.479338843,-6.257378985
27101,2015,84,89,-47,6,-5,-41,9.9887032523,10.583268922,-5.588917296,0.7134788037,-0.59456567,-4.875438492
27101,2016,94,96,-89,6,-2,-83,11.266930361,11.506652283,-10.66762555,0.7191657677,-0.239721923,-9.9484597870000009
27101,2017,90,87,38,6,3,44,10.813408627,10.452961672,4.5656614202,0.7208939084,0.3604469542,5.2865553286
40099,2010,38,34,31,0,4,31,NA,NA,NA,NA,NA,NA
40099,2011,151,196,113,0,-45,113,11.136925176,14.455876388,8.3342552642,0,-3.318951211,8.3342552642
40099,2012,148,180,56,0,-32,56,10.877953769,13.229943773,4.1159825071,0,-2.351990004,4.1159825071
40099,2013,164,185,86,0,-21,86,12.014652015,13.553113553,6.3003663004,0,-1.538461538,6.3003663004
40099,2014,163,176,86,2,-13,88,11.881765499,12.829390968,6.2689069505,0.1457885337,-0.947625469,6.4146954842
40099,2015,159,194,109,4,-35,113,11.525915187,14.063066328,7.9014135556,0.2899601305,-2.537151142,8.1913736861
40099,2016,166,206,63,4,-40,67,11.986857782,14.875257248,4.5492291584,0.2888399466,-2.888399466,4.838069105
40099,2017,167,199,20,4,-32,24,12.051235793,14.360454627,1.4432617716,0.2886523543,-2.309218835,1.7319141259
19139,2010,137,60,-91,5,77,-86,NA,NA,NA,NA,NA,NA
19139,2011,554,381,-183,37,173,-146,12.957245767,8.9110300309,-4.280101038,0.8653756198,4.0462157358,-3.414725419
19139,2012,534,408,-73,41,126,-32,12.472118742,9.5292592636,-1.704990015,0.9575971319,2.9428594785,-0.747392883
19139,2013,536,396,-160,92,140,-68,12.495483209,9.2317375949,-3.729994988,2.144747118,3.2637456143,-1.58524787
19139,2014,578,409,-248,84,169,-164,13.462680657,9.5263605343,-5.776375092,1.956514144,3.936320123,-3.819860948
19139,2015,523,399,-188,93,124,-95,12.176949942,9.2898719441,-4.377182771,2.1653084983,2.8870779977,-2.211874272
19139,2016,555,399,-315,99,156,-216,12.926817907,9.2933339544,-7.336842596,2.3058648158,3.6334839521,-5.03097778
19139,2017,530,366,-288,99,164,-189,12.356616618,8.533059778,-6.714538842,2.3081227268,3.8235568404,-4.406416115
13215,2010,829,389,-34,156,440,122,NA,NA,NA,NA,NA,NA
13215,2011,3025,1767,2576,306,1258,2882,15.655648196,9.1449687146,13.331884215,1.5836787927,6.510679481,14.915563008
13215,2012,3337,1755,900,1227,1582,2127,16.922636118,8.8999779402,4.5640912514,6.2223777394,8.0226581775,10.786468991
13215,2013,3177,1804,2100,678,1373,2778,15.793202013,8.967874231,10.439321444,3.3704094948,6.8253277823,13.809730939
13215,2014,3117,1841,-4567,609,1276,-3958,15.43115142,9.1141321029,-22.60958246,3.0149410379,6.3170193174,-19.59464142
13215,2015,3014,1799,-3908,799,1215,-3109,15.085236088,9.0040941351,-19.55975535,3.9990390294,6.0811419534,-15.56071632
13215,2016,3022,2023,-4124,544,999,-3580,15.293947959,10.238139219,-20.87102627,2.7531130674,5.0558087396,-18.1179132
13215,2017,2860,1961,-3552,392,899,-3160,14.652953006,10.047007288,-18.19835282,2.0083767756,4.6059457175,-16.18997605
26121,2010,548,395,-477,13,153,-464,NA,NA,NA,NA,NA,NA
26121,2011,2136,1633,-2529,40,503,-2489,12.495868349,9.5532551562,-14.79496772,0.2340050253,2.9426131926,-14.5609627
26121,2012,2147,1663,-415,56,484,-359,12.627109174,9.7805694256,-2.440731396,0.3293517065,2.8465397486,-2.11137969
26121,2013,2104,1676,1614,43,428,1657,12.293920528,9.7930659717,9.4307926482,0.2512540792,2.500854556,9.6820467274
26121,2014,2067,1631,-495,55,436,-440,12.00463459,9.4724523546,-2.874839924,0.3194266582,2.5321822358,-2.555413265
26121,2015,2099,1768,-169,62,331,-107,12.184220303,10.26284016,-0.98100678,0.3598959785,1.921380143,-0.621110802
26121,2016,2102,1708,282,59,394,341,12.168753166,9.8878355887,1.6325349157,0.3415587235,2.2809175772,1.9740936392
26121,2017,2079,1728,188,59,351,247,11.98979224,9.9655416024,1.0842140169,0.3402586542,2.024250638,1.4244726712
39119,2010,281,192,43,10,89,53,NA,NA,NA,NA,NA,NA
39119,2011,1062,906,-154,31,156,-123,12.316256415,10.507088806,-1.785973152,0.3595140761,1.8091676089,-1.426459076
39119,2012,1015,947,-560,36,68,-524,11.800404585,11.009835608,-6.510568047,0.4185365173,0.7905689771,-6.09203153
39119,2013,1024,1009,-235,48,15,-187,11.948797536,11.773766322,-2.742155684,0.5600998845,0.1750312139,-2.1820558
39119,2014,1025,943,121,57,82,178,11.955513825,10.999072719,1.4113338271,0.6648432078,0.956441106,2.0761770349
39119,2015,1058,1021,173,64,37,237,12.303899336,11.873611741,2.0118852411,0.7442812453,0.4302875949,2.7561664864
39119,2016,1009,958,-304,63,51,-241,11.729284851,11.136427044,-3.533897517,0.7323537617,0.5928578071,-2.801543755
39119,2017,1009,955,110,63,54,173,11.727239973,11.099617615,1.2784899871,0.7322260835,0.6276223573,2.0107160706
40101,2010,243,159,41,6,84,47,NA,NA,NA,NA,NA,NA
40101,2011,978,974,-410,26,4,-384,13.789116749,13.732719544,-5.780713566,0.3665818359,0.0563972055,-5.41413173
40101,2012,1003,861,-383,24,142,-359,14.201367749,12.190805216,-5.4228552820000004,0.3398133858,2.0105625327,-5.083041896
40101,2013,937,908,-381,10,29,-371,13.319781368,12.907536267,-5.416047707,0.1421534831,0.412245101,-5.273894224
40101,2014,929,923,-462,13,6,-449,13.280345375,13.194573499,-6.604434406,0.1858390634,0.0857718754,-6.418595343
40101,2015,943,988,-383,17,-45,-366,13.563661469,14.21091997,-5.5088890170000004,0.244519878,-0.647258501,-5.264369139
40101,2016,870,961,-199,20,-91,-179,12.575616314,13.890996871,-2.876491548,0.2890946279,-1.315380557,-2.58739692
40101,2017,887,897,30,23,-10,53,12.842788058,12.9875771,0.43436712709999997,0.3330147974,-0.144789042,0.7673819245
30065,2010,10,4,12,0,6,12,NA,NA,NA,NA,NA,NA
30065,2011,50,63,196,3,-13,199,10.751532093,13.546930438,42.146005806,0.6450919256,-2.795398344,42.791097731
30065,2012,43,60,-35,-1,-17,-36,9.1121000212,12.714558169,-7.416825599,-0.211909303,-3.602458148,-7.628734901
30065,2013,36,50,-22,8,-14,-14,7.694773966,10.687186064,-4.702361868,1.7099497702,-2.992412098,-2.992412098
30065,2014,37,53,-25,8,-16,-17,7.9612694997,11.403980635,-5.379236148,1.7213555675,-3.442711135,-3.657880581
30065,2015,46,47,-22,9,-1,-13,9.9491727047,10.165459068,-4.758299989,1.9465772683,-0.216286363,-2.811722721
30065,2016,41,54,24,9,-13,33,8.8619907057,11.671890198,5.1875067546,1.945315033,-2.809899492,7.1328217875
30065,2017,41,54,7,9,-13,16,8.8409703504,11.644204852,1.5094339623,1.9407008086,-2.803234501,3.4501347709
48347,2010,237,99,6,17,138,23,NA,NA,NA,NA,NA,NA
48347,2011,935,581,532,63,354,595,14.349073833,8.9163763601,8.1643928117,0.9668359909,5.4326974724,9.1312288025
48347,2012,902,542,-276,99,360,-177,13.722805416,8.2458542522,-4.198995892,1.5061615701,5.4769511639,-2.692834322
48347,2013,906,553,-1114,82,353,-1032,13.833750687,8.4437793929,-17.00971111,1.2520613205,5.3899712942,-15.75764979
48347,2014,882,574,-388,98,308,-290,13.532796318,8.807057921,-5.953202915,1.5036440353,4.7257383966,-4.44955888
48347,2015,862,618,-70,113,244,43,13.19545966,9.4603179463,-1.071557049,1.7297992361,3.7351417134,0.6582421872
48347,2016,846,539,-232,124,307,-108,12.903619419,8.2211003157,-3.538581212,1.8913106478,4.6825191038,-1.647270564
48347,2017,833,564,-476,123,269,-353,12.694107069,8.5948095884,-7.253775468,1.8743999634,4.099297481,-5.379375505
31125,2010,12,5,-1,0,7,-1,NA,NA,NA,NA,NA,NA
31125,2011,41,55,5,0,-14,5,10.975772989,14.723597912,1.3385089011,0,-3.747824923,1.3385089011
31125,2012,52,62,-49,0,-10,-49,14.046461372,16.747703944,-13.2360886,0,-2.701242572,-13.2360886
31125,2013,37,36,-118,1,1,-117,10.232300885,9.9557522124,-32.63274336,0.2765486726,0.2765486726,-32.35619469
31125,2014,37,61,-11,4,-24,-7,10.441653732,17.214618315,-3.104275434,1.1288274305,-6.772964583,-1.975448003
31125,2015,39,46,50,4,-7,54,10.981275517,12.952273687,14.078558356,1.1262846684,-1.97099817,15.204843024
31125,2016,42,35,-9,4,7,-5,11.744966443,9.7874720358,-2.516778523,1.1185682327,1.9574944072,-1.398210291
31125,2017,43,28,11,4,15,15,11.971046771,7.7951002227,3.0623608018,1.1135857461,4.1759465479,4.1759465479
25019,2010,44,9,-60,14,35,-46,NA,NA,NA,NA,NA,NA
25019,2011,132,67,-160,50,65,-110,13.012618297,6.6048895899,-15.77287066,4.929022082,6.4077287066,-10.84384858
25019,2012,136,70,60,50,66,110,13.317665492,6.8546807677,5.875440658,4.8962005484,6.4629847239,10.771641206
25019,2013,151,38,56,77,113,133,14.485801995,3.6454336147,5.3722179586,7.386799693,10.840368381,12.759017652
25019,2014,124,70,116,74,54,190,11.619734808,6.559527714,10.870074497,6.9343578691,5.0602070937,17.804432367
25019,2015,141,80,-34,80,61,46,12.997787611,7.3746312684,-3.134218289,7.3746312684,5.6231563422,4.2404129794
25019,2016,172,57,-11,84,115,73,15.643474307,5.1841746248,-1.000454752,7.6398362892,10.459299682,6.6393815371
25019,2017,165,54,-55,84,111,29,14.786271171,4.8391432924,-4.928757057,7.5275562326,9.9471278788,2.5987991756
06055,2010,390,327,137,78,63,215,NA,NA,NA,NA,NA,NA
06055,2011,1502,1156,390,396,346,786,10.935605881,8.4164849526,2.8394715671,2.883155745,2.5191209287,5.7226273121
06055,2012,1529,1131,257,335,398,592,11.048446245,8.1725262934,1.8570638881,2.420686391,2.8759199512,4.2777502791
06055,2013,1413,1247,712,234,166,946,10.13433553,8.9437483414,5.1066149311,1.6782976038,1.190587189,6.7849125349
06055,2014,1483,1168,373,271,315,644,10.559068125,8.3162451584,2.6557871953,1.9295397585,2.2428229665,4.5853269537
06055,2015,1464,1211,44,314,253,358,10.367354165,8.5757280694,0.311587147,2.2235991856,1.7916260954,2.5351863327
06055,2016,1460,1266,-371,321,194,-50,10.312336662,8.9420672703,-2.620463631,2.2673014169,1.3702693921,-0.353162214
06055,2017,1446,1314,-1129,321,132,-808,10.232749043,9.2986391718,-7.989470034,2.2715853684,0.9341098711,-5.717884666
37127,2010,263,270,-46,15,-7,-31,NA,NA,NA,NA,NA,NA
37127,2011,1119,1005,-153,19,114,-134,11.68479254,10.494384721,-1.597652599,0.1984013032,1.1904078191,-1.399251296
37127,2012,1101,969,-704,21,132,-683,11.53151266,10.148987981,-7.373464952,0.219947108,1.3825246786,-7.153517845
37127,2013,1120,991,-950,42,129,-908,11.811168937,10.450775372,-10.01840222,0.4429188351,1.360393565,-9.575483388
37127,2014,1100,957,-396,64,143,-332,11.658841111,10.143191767,-4.1971828,0.6783325737,1.5156493445,-3.518850226
37127,2015,1027,1001,-421,78,26,-343,10.9149653,10.638637064,-4.474391812,0.8289847063,0.2763282354,-3.645407106
37127,2016,1022,1072,47,85,-50,132,10.875985038,11.408078239,0.5001676094,0.9045584425,-0.532093201,1.4047260518
37127,2017,1030,1036,-95,85,-6,-10,10.957505093,11.02133522,-1.010643674,0.904260129,-0.063830127,-0.106383545
12089,2010,188,127,138,4,61,142,NA,NA,NA,NA,NA,NA
12089,2011,780,708,522,31,72,553,10.564381781,9.5892080777,7.0700093454,0.4198664554,0.9751737028,7.4898758008
12089,2012,733,661,249,63,72,312,9.8609644373,8.8923567436,3.3497682741,0.847531732,0.9686076937,4.1973000061
12089,2013,767,731,837,-10,36,827,10.232260302,9.7519977588,11.166104137,-0.133406262,0.4802625435,11.032697875
12089,2014,741,728,832,-12,13,820,9.773211377,9.6017515283,10.973430318,-0.15827063,0.1714598487,10.815159688
12089,2015,748,794,1679,-5,-46,1674,9.7059033432,10.302790447,21.786379296,-0.064879033,-0.596887104,21.721500263
12089,2016,833,814,2023,-12,19,2011,10.556798236,10.31600692,25.637938573,-0.152078726,0.2407913163,25.485859847
12089,2017,819,897,2881,-18,-78,2863,10.071137399,11.030293342,35.427285527,-0.221343679,-0.959155943,35.205941848
36059,2010,3707,2602,283,832,1105,1115,NA,NA,NA,NA,NA,NA
36059,2011,14304,10905,-1903,4194,3399,2291,10.637372248,8.1096577434,-1.41519291,3.1189275173,2.5277145044,1.7037346071
36059,2012,14170,10741,-3146,4458,3429,1312,10.497797092,7.9574339146,-2.330703575,3.3026943852,2.5403631778,0.9719908105
36059,2013,13781,11394,-2614,4603,2387,1989,10.175943172,8.4133732318,-1.93018761,3.3988728266,1.7625699407,1.4686852166
36059,2014,14232,10580,-4026,4744,3652,718,10.47580947,7.7876661182,-2.963435141,3.49193649,2.6881433519,0.528501349
36059,2015,14283,11015,-6277,5207,3268,-1070,10.488474464,8.0886750838,-4.609406582,3.8236705548,2.3997993803,-0.785736027
36059,2016,14331,10998,-5663,5331,3333,-332,10.503845217,8.0609371078,-4.150671653,3.9073336717,2.4429081088,-0.243337981
36059,2017,14176,11218,-4562,5280,2958,718,10.364955979,8.2021780592,-3.33556216,3.8605366512,2.1627779193,0.5249744916
22069,2010,116,125,-28,2,-9,-26,NA,NA,NA,NA,NA,NA
22069,2011,564,376,-356,8,188,-348,14.297121564,9.5314143757,-9.024424249,0.2027960505,4.7657071879,-8.821628199
22069,2012,529,369,-194,4,160,-190,13.442089749,9.3764293337,-4.929613254,0.1016415104,4.0656604157,-4.827971744
22069,2013,557,388,-420,21,169,-399,14.200308481,9.8917768232,-10.70759347,0.5353796734,4.3085316575,-10.17221379
22069,2014,528,375,-152,19,153,-133,13.497277538,9.5861346149,-3.885579897,0.4856974872,3.9111429229,-3.39988241
22069,2015,504,397,-250,22,107,-228,12.901739431,10.162679671,-6.399672337,0.5631711656,2.7390597601,-5.836501171
22069,2016,489,410,-107,21,79,-86,12.538783046,10.513090079,-2.743660094,0.5384753455,2.0256929665,-2.205184748
22069,2017,493,406,-80,21,87,-59,12.638433142,10.408121411,-2.050861362,0.5383511075,2.2303117309,-1.512510254
56025,2010,258,186,-63,4,72,-59,NA,NA,NA,NA,NA,NA
56025,2011,1031,666,568,20,365,588,13.576775944,8.7702548773,7.4797368924,0.2633710173,4.8065210664,7.7431079097
56025,2012,1042,657,1699,28,385,1727,13.444814327,8.4772005884,21.922014916,0.3612809992,4.967613739,22.283295915
56025,2013,1140,715,2033,10,425,2043,14.278199444,8.9551864933,25.462789008,0.1252473635,5.3230129506,25.588036372
56025,2014,1213,702,-191,28,511,-163,14.925556786,8.6378737542,-2.350190722,0.3445305771,6.2876830319,-2.005660145
56025,2015,1178,736,227,36,442,263,14.403355077,8.9990401839,2.7755191872,0.4401704438,5.404314893,3.2156896309
56025,2016,1154,740,-1694,35,414,-1659,14.157250991,9.0783065278,-20.78196116,0.4293793628,5.0789444628,-20.3525818
56025,2017,1094,721,-1761,34,373,-1727,13.637581885,8.9878396151,-21.95226846,0.423837097,4.6497422696,-21.52843137
04017,2010,456,203,-38,4,253,-34,NA,NA,NA,NA,NA,NA
04017,2011,1739,885,-1052,11,854,-1041,16.160733785,8.2244102354,-9.776361093,0.102224308,7.9363235492,-9.674136785
04017,2012,1609,914,-975,18,695,-957,14.98235453,8.5107967931,-9.078804019,0.1676086896,6.4715577365,-8.911195329
04017,2013,1626,987,-868,36,639,-832,15.171802468,9.2094520516,-8.099092584,0.3359070657,5.9623504164,-7.763185519
04017,2014,1540,895,-139,47,645,-92,14.34626671,8.3376030556,-1.294890307,0.4378406074,6.0086636546,-0.8570497
04017,2015,1572,957,-739,57,615,-682,14.612653145,8.895870903,-6.869434271,0.5298481102,5.7167822417,-6.339586161
04017,2016,1550,1019,192,59,531,251,14.360827369,9.4410858639,1.7788895838,0.546637945,4.9197415051,2.3255275288
04017,2017,1523,1029,85,59,494,144,14.018906654,9.4717366692,0.7824077909,0.5430830549,4.547169985,1.3254908458
48349,2010,168,124,-6,-2,44,-8,NA,NA,NA,NA,NA,NA
48349,2011,667,467,-10,0,200,-10,13.907132879,9.7370780426,-0.208502742,0,4.1700548362,-0.208502742
48349,2012,670,490,-86,-5,180,-91,13.93061721,10.188063332,-1.788109075,-0.10395983,3.7425538772,-1.892068905
48349,2013,687,490,-311,5,197,-306,14.28764545,10.190605925,-6.467915189,0.1039857747,4.097039525,-6.363929414
48349,2014,769,507,-390,13,262,-377,16.029683054,10.568334601,-8.129488155,0.2709829385,5.4613484528,-7.858505216
48349,2015,698,553,89,25,145,114,14.528349013,11.510282241,1.8524685705,0.52035634,3.0180667721,2.3728249105
48349,2016,697,555,43,21,142,64,14.438862707,11.497229271,0.8907763219,0.4350302968,2.9416334352,1.3258066187
48349,2017,690,560,178,21,130,199,14.215666076,11.537352178,3.6672297993,0.4326507067,2.6783138984,4.099880506
21179,2010,158,58,86,-2,100,84,NA,NA,NA,NA,NA,NA
21179,2011,591,345,198,-7,246,191,13.480070708,7.869076809,4.5161658208,-0.159662428,5.6109938986,4.3565033928
21179,2012,615,355,96,-4,260,92,13.903489437,8.0255914635,2.1703007901,-0.0904292,5.8778979733,2.0798715905
21179,2013,591,399,-48,-2,192,-50,13.28821486,8.9712313521,-1.079245877,-0.044968578,4.3169835078,-1.124214455
21179,2014,581,359,101,-4,222,97,12.997617476,8.0312300757,2.2594825561,-0.089484458,4.9663874006,2.1699980985
21179,2015,557,376,76,-5,181,71,12.383281458,8.359270787,1.6896398399,-0.111160516,4.0240106714,1.5784793241
21179,2016,571,418,262,-6,153,256,12.602769961,9.2258456106,5.7827070573,-0.132428406,3.3769243503,5.6502786514
21179,2017,552,398,-18,-6,154,-24,12.111637704,8.7326663156,-0.394944708,-0.131648236,3.3789713885,-0.526592944
38063,2010,8,15,6,0,-7,6,NA,NA,NA,NA,NA,NA
38063,2011,32,69,-25,0,-37,-25,10.344270244,22.304832714,-8.081461128,0,-11.96056247,-8.081461128
38063,2012,30,64,30,0,-34,30,9.8039215686,20.91503268,9.8039215686,0,-11.11111111,9.8039215686
38063,2013,33,46,7,5,-13,12,10.794896958,15.047432123,2.2898266274,1.6355904482,-4.252535165,3.9254170756
38063,2014,37,58,-19,7,-21,-12,12.173054779,19.082085869,-6.25102813,2.3030103635,-6.909031091,-3.948017766
38063,2015,26,69,-62,7,-43,-55,8.740964868,23.197175996,-20.8438393,2.3533366952,-14.45621113,-18.49050261
38063,2016,26,42,-17,8,-16,-9,8.923974601,14.415651279,-5.83490647,2.7458383388,-5.491676678,-3.089068131
38063,2017,27,52,53,8,-25,61,9.2497430627,17.814319973,18.156903049,2.7406646112,-8.56457691,20.89756766
51125,2010,41,68,-8,0,-27,-8,NA,NA,NA,NA,NA,NA
51125,2011,145,186,80,3,-41,83,9.6679557274,12.401653554,5.3340445393,0.2000266702,-2.733697826,5.5340712095
51125,2012,131,172,-188,11,-41,-177,8.7857550049,11.535495121,-12.60856443,0.7377351531,-2.749740116,-11.87082928
51125,2013,132,195,48,16,-63,64,8.9171113963,13.173005472,3.2425859623,1.0808619874,-4.255894076,4.3234479497
51125,2014,142,155,77,17,-13,94,9.5667991646,10.442632891,5.1876305329,1.1453210267,-0.875833726,6.3329515597
51125,2015,126,210,-23,18,-84,-5,8.4925690021,14.15428167,-1.55023085,1.2132241432,-5.661712668,-0.337006706
51125,2016,116,152,123,18,-36,141,7.8153949806,10.240862388,8.2870136433,1.2127337039,-2.425467408,9.4997473471
51125,2017,121,146,56,18,-25,74,8.1104631678,9.7861786983,3.7536027884,1.206515182,-1.675715531,4.9601179704
20131,2010,39,42,-14,0,-3,-14,NA,NA,NA,NA,NA,NA
20131,2011,126,137,-63,1,-11,-62,12.446903092,13.533537489,-6.223451546,0.0987849452,-1.086634397,-6.124666601
20131,2012,111,137,8,-2,-26,6,11.01518309,13.595316066,0.7938870696,-0.198471767,-2.580132976,0.5954153022
20131,2013,157,137,9,-1,20,8,15.575396825,13.591269841,0.8928571429,-0.099206349,1.9841269841,0.7936507937
20131,2014,142,138,-13,0,4,-13,14.077525528,13.680975513,-1.288787548,0,0.3965500149,-1.288787548
20131,2015,148,131,-17,0,17,-17,14.681083226,12.994742585,-1.686340641,0,1.6863406408,-1.686340641
20131,2016,155,85,-51,0,70,-51,15.360983103,8.4237649274,-5.054258956,0,6.9372181755,-5.054258956
20131,2017,145,87,-40,0,58,-40,14.34365417,8.6061925017,-3.956870116,0,5.7374616678,-3.956870116
31127,2010,22,34,3,0,-12,3,NA,NA,NA,NA,NA,NA
31127,2011,68,89,24,-4,-21,20,9.3955094991,12.297063903,3.3160621762,-0.552677029,-2.901554404,2.7633851468
31127,2012,82,97,-71,-1,-15,-72,11.399179815,13.484395635,-9.870021547,-0.139014388,-2.08521582,-10.00903594
31127,2013,85,87,1,0,-2,1,11.888943283,12.168683125,0.139869921,0,-0.279739842,0.139869921
31127,2014,72,76,-20,1,-4,-19,10.087565674,10.647985989,-2.802101576,0.1401050788,-0.560420315,-2.661996497
31127,2015,69,76,-124,1,-7,-123,9.7699115044,10.761061947,-17.55752212,0.1415929204,-0.991150442,-17.4159292
31127,2016,69,71,-17,1,-2,-16,9.8712446352,10.157367668,-2.43204578,0.1430615165,-0.286123033,-2.288984263
31127,2017,65,61,-36,1,4,-35,9.3323761665,8.7580760948,-5.168700646,0.1435750179,0.5743000718,-5.025125628
20133,2010,52,62,-32,4,-10,-28,NA,NA,NA,NA,NA,NA
20133,2011,226,223,-57,18,3,-39,13.728170084,13.545937737,-3.462414579,1.0933940774,0.1822323462,-2.369020501
20133,2012,221,195,-77,24,26,-53,13.449367089,11.867088608,-4.685978578,1.4605647517,1.582278481,-3.225413827
20133,2013,230,194,-80,6,36,-74,14.024390244,11.829268293,-4.87804878,0.3658536585,2.1951219512,-4.512195122
20133,2014,214,202,-73,11,12,-62,13.085083616,12.35134061,-4.46360329,0.672597756,0.7337430065,-3.791005534
20133,2015,209,204,-83,12,5,-71,12.826020252,12.519177662,-5.09358699,0.7364222154,0.3068425898,-4.357164774
20133,2016,173,174,-215,12,-1,-203,10.705445545,10.767326733,-13.30445545,0.7425742574,-0.061881188,-12.56188119
20133,2017,178,169,-63,12,9,-51,11.099678858,10.53845914,-3.928538023,0.7482929567,0.5612197175,-3.180245066
28099,2010,111,64,-45,0,47,-45,NA,NA,NA,NA,NA,NA
28099,2011,427,314,-51,-2,113,-53,14.376136287,10.571678675,-1.71705609,-0.067335533,3.8044576123,-1.784391623
28099,2012,439,329,-126,-2,110,-128,14.770203889,11.069241639,-4.239284032,-0.067290223,3.7009622502,-4.306574255
28099,2013,416,380,-242,-4,36,-246,14.049307666,12.833502195,-8.172914556,-0.135089497,1.2158054711,-8.308004053
28099,2014,412,396,-83,-6,16,-89,13.981742288,13.438762005,-2.816710218,-0.203617606,0.542980283,-3.020327824
28099,2015,445,382,-37,-6,63,-43,15.117286362,12.97708627,-1.256942911,-0.20382858,2.1402000917,-1.460771491
28099,2016,436,414,-22,-6,22,-28,14.808776578,14.061544732,-0.747231846,-0.203790503,0.7472318457,-0.951022349
28099,2017,419,388,-93,-6,31,-99,14.249761937,13.195483608,-3.162834988,-0.20405387,1.0542783295,-3.366888859
20135,2010,10,15,3,0,-5,3,NA,NA,NA,NA,NA,NA
20135,2011,29,39,23,0,-10,23,9.3232599261,12.538177142,7.3943095965,0,-3.214917216,7.3943095965
20135,2012,35,47,-27,2,-12,-25,11.297611362,15.171078115,-8.715300194,0.6455777921,-3.873466753,-8.069722402
20135,2013,39,33,-7,9,6,2,12.650016218,10.703859877,-2.270515731,2.9192345118,1.9461563412,0.6487187804
20135,2014,33,51,4,8,-18,12,10.700389105,16.536964981,1.2970168612,2.5940337224,-5.836575875,3.8910505837
20135,2015,36,50,-65,8,-14,-57,11.820719094,16.417665408,-21.34296503,2.6268264653,-4.596946314,-18.71613857
20135,2016,31,43,-50,8,-12,-42,10.392222595,14.415018438,-16.76164935,2.6818638954,-4.022795843,-14.07978545
20135,2017,31,43,-84,8,-12,-76,10.643776824,14.763948498,-28.84120172,2.7467811159,-4.120171674,-26.0944206
05099,2010,32,32,-23,0,0,-23,NA,NA,NA,NA,NA,NA
05099,2011,113,117,16,0,-4,16,12.555555556,13,1.7777777778,0,-0.444444444,1.7777777778
05099,2012,97,116,-80,0,-19,-80,10.830728004,12.952210808,-8.932559178,0,-2.121482805,-8.932559178
05099,2013,139,125,-148,0,14,-148,15.723092585,14.139471749,-16.74113455,0,1.5836208359,-16.74113455
05099,2014,84,123,-83,-1,-39,-84,9.6413199426,14.117647059,-9.526542324,-0.114777618,-4.476327116,-9.641319943
05099,2015,111,113,-134,-1,-2,-135,12.93254107,13.165559828,-15.61225679,-0.116509379,-0.233018758,-15.72876617
05099,2016,82,103,-119,-1,-21,-120,9.7104624312,12.197288176,-14.09201255,-0.118420274,-2.486825745,-14.21043283
05099,2017,93,103,-36,-1,-10,-37,11.137057661,12.334590743,-4.311119095,-0.119753308,-1.197533082,-4.430872403
06057,2010,216,192,25,11,24,36,NA,NA,NA,NA,NA,NA
06057,2011,771,942,90,19,-171,109,7.8073972811,9.5389990127,0.9113693324,0.1924001924,-1.731601732,1.1037695248
06057,2012,770,950,-369,19,-180,-350,7.8217454682,9.6502054478,-3.748342958,0.193004109,-1.82845998,-3.555338849
06057,2013,803,1005,22,13,-202,35,8.1869854459,10.246476181,0.2243009711,0.1325414829,-2.059490735,0.3568424541
06057,2014,860,965,712,18,-105,730,8.7484613898,9.8165874897,7.2429122204,0.1831073314,-1.0681261,7.4260195518
06057,2015,820,1018,287,27,-198,314,8.3109933157,10.317794141,2.9088476605,0.273654658,-2.006800825,3.1825023185
06057,2016,862,923,377,27,-61,404,8.7172848995,9.3341693297,3.8125480361,0.2730472068,-0.61688443,4.0855952429
06057,2017,858,922,804,26,-64,830,8.62888262,9.2725288761,8.0858060915,0.2614812915,-0.643646256,8.347287383
10003,2010,1699,1041,-593,315,658,-278,NA,NA,NA,NA,NA,NA
10003,2011,6841,4403,-352,1453,2438,1101,12.655476347,8.1453095097,-0.651180774,2.6879706377,4.5101668373,2.0367898638
10003,2012,6725,4253,-112,1576,2472,1464,12.357566414,7.8151271313,-0.205806311,2.8959887983,4.5424392825,2.6901824877
10003,2013,6499,4366,-345,1655,2133,1310,11.863753941,7.970018419,-0.629788446,3.0211590663,3.8937355217,2.3913706205
10003,2014,6478,4319,-1003,1909,2159,906,11.757328593,7.8388240493,-1.820407622,3.4647638597,3.9185045433,1.6443562373
10003,2015,6579,4497,-992,2090,2082,1098,11.874893958,8.1169475801,-1.790529686,3.7723861335,3.757946378,1.9818564472
10003,2016,6493,4649,-1721,2140,1844,419,11.662975397,8.3507119391,-3.091326145,3.8439499999,3.3122634579,0.7526238551
10003,2017,6531,4718,-1996,2128,1813,132,11.687084617,8.4427599486,-3.571799249,3.8080104219,3.2443246687,0.2362111728
37129,2010,533,320,346,31,213,377,NA,NA,NA,NA,NA,NA
37129,2011,2232,1691,1955,226,541,2181,10.90565291,8.2623024511,9.5522183867,1.1042462176,2.6433504589,10.656464604
37129,2012,2263,1672,2262,216,591,2478,10.900718205,8.0539111083,10.895901272,1.0404574159,2.8468070963,11.936358688
37129,2013,2197,1737,3210,156,460,3366,10.407463814,8.2283862747,15.206171527,0.7389915134,2.1790775396,15.94516304
37129,2014,2308,1752,2344,173,556,2517,10.75456708,8.1637788231,10.92231596,0.8061265619,2.5907882566,11.728442522
37129,2015,2281,1923,2895,221,358,3116,10.466759664,8.8240152711,13.284203957,1.0140963988,1.6427443926,14.298300356
37129,2016,2275,1963,3017,212,312,3229,10.272758676,8.8639232004,13.623258429,0.9572856437,1.4088354756,14.580544072
37129,2017,2290,1959,3404,210,331,3614,10.168016482,8.698316283,15.114379085,0.9324381927,1.4697001989,16.046817278
09009,2010,2259,1708,-70,783,551,713,NA,NA,NA,NA,NA,NA
09009,2011,9265,7568,-4089,3521,1697,-568,10.721251511,8.7575209319,-4.731699668,4.0744227274,1.9637305789,-0.657276941
09009,2012,9047,7581,-4407,3559,1466,-848,10.458596812,8.7638579009,-5.094620996,4.1143081743,1.6947389108,-0.980312822
09009,2013,8912,7592,-5785,3659,1320,-2126,10.303527444,8.7774214937,-6.68827494,4.2303194475,1.5261059499,-2.457955492
09009,2014,8990,7682,-5769,3954,1308,-1815,10.401294435,8.8879581588,-6.674646006,4.5747183754,1.5133362759,-2.099927631
09009,2015,8886,7882,-7783,4246,1004,-3537,10.29862656,9.1350185175,-9.020280274,4.9209957657,1.1636080426,-4.099284509
09009,2016,8723,7843,-6840,4332,880,-2508,10.133790901,9.1114664721,-7.94624897,5.0326243475,1.0223244288,-2.913624622
09009,2017,8650,7635,-4887,4323,1015,-564,10.055754216,8.875801554,-5.681210504,5.0255520783,1.1799526624,-0.655658425
51127,2010,58,66,110,2,-8,112,NA,NA,NA,NA,NA,NA
51127,2011,169,134,171,15,35,186,9.0592334495,7.1830608416,9.1664433128,0.8040739748,1.8761726079,9.9705172876
51127,2012,202,130,283,21,72,304,10.655413425,6.8574442833000004,14.928128709,1.1077409996,3.7979691415,16.035869709
51127,2013,174,144,317,10,30,327,9.0020176936,7.4499456775,16.400227637,0.5173573387,1.5520720161,16.917584976
51127,2014,175,130,434,14,45,448,8.8556030666,6.5784479923,21.961895605,0.7084482453,2.2771550743,22.67034385
51127,2015,179,166,339,14,13,353,8.8622635905,8.2186355085,16.783839984,0.6931379344,0.643628082,17.476977919
51127,2016,211,153,574,15,58,589,10.19028301,7.3891625616,27.721433401,0.7244277021,2.8011204482,28.445861103
51127,2017,214,138,559,15,76,574,10.020603109,6.461884248,26.175313729,0.7023787226,3.5587188612,26.877692452
09011,2010,658,546,-418,283,112,-135,NA,NA,NA,NA,NA,NA
09011,2011,2766,2233,-2378,998,533,-1380,10.108503788,8.1606250754,-8.690535795,3.6472475706,1.9478787126,-5.043288224
09011,2012,2864,2331,-568,1130,533,562,10.461985805,8.5149751784,-2.074863107,4.127808645,1.9470106264,2.0529455385
09011,2013,2696,2395,-2023,817,301,-1206,9.8453807781,8.7461746898,-7.387687431,2.9835593827,1.0992060884,-4.404128048
09011,2014,2680,2356,-2681,797,324,-1884,9.830316991,8.6418756832,-9.83398502,2.9234188962,1.1884413079,-6.910566124
09011,2015,2683,2424,-2839,953,259,-1886,9.8979949459,8.9425045653,-10.47350267,3.5157619021,0.9554903805,-6.957740763
09011,2016,2607,2446,-1963,841,161,-1122,9.6631966388,9.0664284536,-7.276123898,3.1172797749,0.5967681852,-4.158844123
09011,2017,2564,2521,-1034,720,43,-314,9.5255786306,9.365828287,-3.841438496,2.6748894751,0.1597503436,-1.166549021
29143,2010,62,36,-32,0,26,-32,NA,NA,NA,NA,NA,NA
29143,2011,231,259,-138,-5,-28,-143,12.2426266,13.726581339,-7.31377693,-0.264991918,-1.483954739,-7.578768848
29143,2012,208,252,-251,-1,-44,-252,11.160594516,13.52148951,-13.46783281,-0.053656704,-2.360894994,-13.52148951
29143,2013,232,251,-137,0,-19,-137,12.598767276,13.630562872,-7.439789296,0,-1.031795596,-7.439789296
29143,2014,256,231,-111,3,25,-108,13.992894233,12.626400656,-6.067231484,0.1639792293,1.3664935775,-5.903252255
29143,2015,228,261,-132,4,-33,-128,12.547465742,14.36354631,-7.264322272,0.2201309779,-1.816080568,-7.044191294
29143,2016,228,203,-229,4,25,-225,12.673707615,11.284046693,-12.72929405,0.2223457476,1.3896609227,-12.5069483
29143,2017,216,231,-296,4,-15,-292,12.178619756,13.02435724,-16.68921967,0.2255299955,-0.845737483,-16.46368967
36061,2010,5027,2289,-2610,3109,2738,499,NA,NA,NA,NA,NA,NA
36061,2011,19710,10080,-1703,14318,9630,12615,12.315798057,6.2984903306,-1.064119944,8.9466056105,6.0173077266,7.8824856667
36061,2012,19446,9488,-6383,15325,9958,8942,11.996605712,5.853326905,-3.937793596,9.4542827592,6.143278807,5.5164891637
36061,2013,19014,9889,-16560,15844,9125,-716,11.632356598,6.0498776902,-10.13105213,9.6930187201,5.5824789082,-0.438033414
36061,2014,18451,10006,-17648,16963,8445,-685,11.232422136,6.0913563434,-10.74357953,10.326571822,5.1410657926,-0.417007705
36061,2015,18428,10078,-15954,18316,8350,2362,11.155963125,6.101030843,-9.658250255,11.088160441,5.0549322821,1.4299101857
36061,2016,17823,10807,-20736,18694,7016,-2042,10.738859179,6.5115216939,-12.49402367,11.263661196,4.2273374854,-1.230362478
36061,2017,17724,11380,-22412,18650,6344,-3762,10.654992905,6.8412220298,-13.47323973,11.211668792,3.813770875,-2.261570938
26123,2010,121,137,-73,3,-16,-70,NA,NA,NA,NA,NA,NA
26123,2011,563,470,-161,5,93,-156,11.646308038,9.7224951646,-3.330471748,0.1034307996,1.923812873,-3.227040948
26123,2012,552,462,-562,14,90,-548,11.479790785,9.6080857657,-11.68775801,0.29115411410000003,1.8717050193,-11.3966039
26123,2013,551,484,-88,13,67,-75,11.51479055,10.114625456,-1.83902281,0.2716738242,1.4001650941,-1.567348986
26123,2014,532,468,-160,14,64,-146,11.129357865,9.7904877462,-3.347175298,0.2928778386,1.3388701191,-3.054297459
26123,2015,575,494,12,17,81,29,12.026521093,10.332350296,0.2509882663,0.3555667106,1.6941707975,0.6065549769
26123,2016,532,520,-102,16,12,-86,11.123772883000001,10.872860712,-2.132753447,0.3345495604,0.2509121703,-1.798203887
26123,2017,526,517,431,17,9,448,10.954909924,10.767468499,8.9763615537,0.3540560242,0.1874414246,9.3304175778
45071,2010,126,55,25,13,71,38,NA,NA,NA,NA,NA,NA
45071,2011,436,446,-129,45,-10,-84,11.606703137,11.872911925,-3.434093359,1.197939544,-0.266208788,-2.236153815
45071,2012,416,452,55,17,-36,72,11.083875093,12.043056592,1.4654161782,0.4529468187,-0.959181498,1.9183629969
45071,2013,452,399,-141,25,53,-116,12.048674513,10.635887457,-3.758546695,0.6664089885,1.4127870557,-3.092137707
45071,2014,445,407,166,37,38,203,11.835263767,10.824612029,4.4149523265,0.984055639,1.0106517374,5.3990079655
45071,2015,446,447,87,41,-1,128,11.805344168,11.83181355,2.3028361942,1.0852446433,-0.026469382,3.3880808375
45071,2016,475,464,150,44,11,194,12.518943138,12.22903077,3.9533504645,1.1596494696,0.2899123674,5.1129999341
45071,2017,455,439,382,46,16,428,11.890451053,11.472325302,9.9827523128,1.202111535,0.4181257513,11.184863848000001
44005,2010,180,158,-98,71,22,-27,NA,NA,NA,NA,NA,NA
44005,2011,739,680,-194,168,59,-26,8.8884077843,8.1787784754,-2.333357389,2.020639388,0.7096293089,-0.312718001
44005,2012,720,691,-437,375,29,-62,8.6605601698,8.3117320519,-5.256478881,4.5107084218,0.348828118,-0.745770459
44005,2013,693,678,-575,257,15,-318,8.352265537,8.1714805686,-6.930090453,3.0974491241,0.1807849683,-3.832641329
44005,2014,704,739,-230,271,-35,41,8.5000543327,8.9226422612,-2.777006387,3.2720379605,-0.422587928,0.4950315734
44005,2015,664,733,318,348,-69,666,7.9884023797,8.8185225065,3.8257710192,4.1866928134,-0.830120127,8.0124638326
44005,2016,713,766,-149,280,-53,131,8.5433217106,9.1783792851,-1.78535054,3.3550211486,-0.635057575,1.5696706088
44005,2017,736,751,-234,217,-15,-17,8.8167470276,8.9964361654,-2.80315055,2.5995028601,-0.179689138,-0.203647689
51700,2010,705,275,-710,211,430,-499,NA,NA,NA,NA,NA,NA
51700,2011,2877,1419,-2770,483,1458,-2287,15.936586014,7.8602765222,-15.34388017,2.6754852433,8.0763094922,-12.66839493
51700,2012,2898,1396,-2485,907,1502,-1578,16.089497134,7.7504962039,-13.79654947,5.03560176,8.3390009299,-8.760947715
51700,2013,2903,1481,-725,583,1422,-142,16.062457119,8.1944536662,-4.011464489,3.2257707545,7.8680034526,-0.785693734
51700,2014,2744,1415,-1603,571,1329,-1032,15.117749307,7.7957781591,-8.831542324,3.145858183,7.3219711474,-5.685684142
51700,2015,2808,1576,-2530,712,1232,-1818,15.48233426,8.6895152397,-13.94953906,3.9257200829,6.7928190199,-10.02381898
51700,2016,2798,1536,-2547,590,1262,-1957,15.481186596,8.4986070805,-14.09241682,3.2644389176,6.9825795154,-10.8279779
51700,2017,2719,1500,-2704,480,1219,-2224,15.11496042,8.3385217469,-15.0315752,2.668326959,6.776438673,-12.36324824
05101,2010,15,36,10,0,-21,10,NA,NA,NA,NA,NA,NA
05101,2011,87,91,-51,0,-4,-51,10.495837857,10.978405115,-6.152732537,0,-0.482567258,-6.152732537
05101,2012,68,90,-182,0,-22,-182,8.3312913502,11.02670914,-22.29845626,0,-2.69541779,-22.29845626
05101,2013,72,102,21,1,-30,22,8.9352196575,12.658227848,2.6061057334,0.124100273,-3.723008191,2.7302060065
05101,2014,75,95,-160,1,-20,-159,9.4150138087,11.925684158,-20.08536279,0.1255335174,-2.510670349,-19.95982927
05101,2015,67,101,15,1,-34,16,8.5144236879,12.835176007,1.9062142585,0.1270809506,-4.320752319,2.033295209
05101,2016,89,93,13,1,-4,14,11.316676203,11.825290864,1.6529976477,0.1271536652,-0.508614661,1.7801513129
05101,2017,82,101,-22,1,-19,-21,10.447856278,12.868701026,-2.803083392,0.1274128814,-2.420844747,-2.67567051
13217,2010,345,221,53,3,124,56,NA,NA,NA,NA,NA,NA
13217,2011,1378,731,-363,38,647,-325,13.736523902,7.2869368449,-3.618547298,0.3788010945,6.449587057,-3.239746203
13217,2012,1299,716,-102,55,583,-47,12.89483611,7.1075463082,-1.012527547,0.545970736,5.7872898013,-0.466556811
13217,2013,1310,823,557,53,487,610,12.900811471,8.104860947,5.485306862,0.5219412274,4.7959505239,6.0072480895
13217,2014,1345,824,836,65,521,901,13.083912138,8.0157201502,8.1324539388,0.6323080216,5.0681919882,8.7647619603
13217,2015,1304,862,936,72,442,1008,12.510433356,8.2699337062,8.9798816114,0.690760124,4.2404996498,9.6706417353
13217,2016,1366,811,991,77,555,1068,12.914937269,7.6676530931,9.3694749879,0.7280015884,5.2472841759,10.097476576
13217,2017,1407,850,866,77,557,943,13.109224907,7.9195743928,8.0686487343,0.7174202685,5.1896505138,8.7860690028
18111,2010,27,38,5,2,-11,7,NA,NA,NA,NA,NA,NA
18111,2011,139,177,-121,7,-38,-114,9.8139584142,12.496911074,-8.543086102,0.4942281216,-2.68295266,-8.04885798
18111,2012,155,149,-55,8,6,-47,11.018696239,10.592166062,-3.909859956,0.5687069027,0.426530177,-3.341153053
18111,2013,136,171,-4,18,-35,14,9.6900605629,12.183826149,-0.285001781,1.2825080157,-2.493765586,0.9975062344
18111,2014,139,138,51,16,1,67,9.8879601636,9.8168237596,3.6279566068,1.1381824649,0.0711364041,4.7661390717
18111,2015,130,172,-80,16,-42,-64,9.2609082814,12.252894034,-5.699020481,1.1398040962,-2.991985752,-4.559216385
18111,2016,178,126,-4,18,52,14,12.69931866,8.9894053437,-0.285377947,1.2842007634,3.7099133164,0.998822816
18111,2017,167,135,31,19,32,50,11.852798183,9.5816033216,2.200220022,1.348521949,2.2711948614,3.548741971
28101,2010,59,98,-19,5,-39,-14,NA,NA,NA,NA,NA,NA
28101,2011,313,235,-343,13,78,-330,14.530430342,10.909428532,-15.92312335,0.6035003018,3.6210018105,-15.31962304
28101,2012,298,231,1,14,67,15,13.888241599,10.765717481,0.0466048376,0.6524677261,3.122524118,0.6990725637
28101,2013,270,289,45,0,-19,45,12.553176651,13.436548341,2.0921961085,0,-0.88337169,2.0921961085
28101,2014,301,297,91,2,4,93,13.955860534,13.770400593,4.2192136499,0.0927299703,0.1854599407,4.3119436202
28101,2015,257,268,-128,3,-11,-125,11.927414489,12.437926393,-5.940502158,0.1392305193,-0.510511904,-5.801271639
28101,2016,299,270,-126,3,29,-123,13.951101157,12.597984323,-5.879059351,0.1399776036,1.3531168346,-5.739081747
28101,2017,277,299,-181,3,-22,-178,13.013859525,14.047451257,-8.503641062,0.140944327,-1.033591731,-8.362696735
29145,2010,182,117,-14,10,65,-4,NA,NA,NA,NA,NA,NA
29145,2011,745,573,193,16,172,209,12.766905439,9.8193782774,3.3073996641,0.2741885732,2.9475271618,3.5815882373
29145,2012,791,589,-130,18,202,-112,13.5020953,10.054025451,-2.219054853,0.3072537489,3.448069849,-1.911801104
29145,2013,687,655,-309,31,32,-278,11.742987539,11.196007042,-5.281780422,0.5298873562,0.5469804967,-4.751893065
29145,2014,718,634,-360,27,84,-333,12.325122307000001,10.883185993,-6.179727062,0.4634795297,1.4419363145,-5.716247532
29145,2015,733,651,-74,32,82,-42,12.605872995,11.195666194,-1.27262565,0.5503246055,1.4102068017,-0.722301045
29145,2016,684,638,-23,34,46,11,11.754294012,10.963800555,-0.395246728,0.5842777725,0.7904934569,0.1890310441
29145,2017,675,600,-36,34,75,-2,11.587087693,10.299633505,-0.61797801,0.5836458986,1.2874541881,-0.034332112
48351,2010,26,19,-4,1,7,-3,NA,NA,NA,NA,NA,NA
48351,2011,147,155,116,5,-8,121,10.134785756,10.686338722,7.9975180117,0.344720604,-0.551552966,8.3422386156
48351,2012,156,166,-129,7,-10,-122,10.761589404,11.451434879,-8.899006623,0.4828918322,-0.689845475,-8.41611479
48351,2013,133,168,-71,6,-35,-65,9.2479922122,11.681674373,-4.936898098,0.4172026562,-2.433682161,-4.519695442
48351,2014,140,169,-11,7,-29,-4,9.780634344,11.806622887,-0.768478413,0.4890317172,-2.025988543,-0.279446696
48351,2015,155,156,-135,8,-1,-127,10.890567363,10.960829088,-9.485332865,0.5620937994,-0.070261725,-8.923239066
48351,2016,126,138,23,8,-12,31,8.8873214601,9.7337330277,1.6222888379,0.5642743784,-0.846411568,2.1865632164
48351,2017,129,172,-200,7,-43,-193,9.1690951738,12.225460232,-14.21565143,0.4975478001,-3.056365058,-13.71810363
16069,2010,115,96,28,5,19,33,NA,NA,NA,NA,NA,NA
16069,2011,448,491,140,10,-43,150,11.379367277,12.471583332,3.556052274,0.2540037339,-1.092216056,3.8100560078
16069,2012,481,500,81,13,-19,94,12.190794809,12.672343877,2.052919708,0.3294809408,-0.481549067,2.3824006488
16069,2013,506,521,299,15,-15,314,12.764883956,13.143289606,7.5428859738,0.3784056509,-0.378405651,7.9212916246
16069,2014,496,529,68,9,-33,77,12.460276588,13.289286926,1.7082637258,0.2260937284,-0.829010338,1.9343574542
16069,2015,473,457,128,10,16,138,11.854488039,11.453490558,3.2079798499,0.2506234258,0.4009974812,3.4586032756
16069,2016,477,531,165,9,-54,174,11.914277151,13.263063243,4.1212908382,0.2247976821,-1.348786093,4.3460885203
16069,2017,488,461,254,10,27,264,12.127085896,11.456120078,6.3120488066,0.2485058585,0.670965818,6.5605546651
36063,2010,544,594,41,40,-50,81,NA,NA,NA,NA,NA,NA
36063,2011,2164,2371,-699,179,-207,-520,10.013117925,10.970934658,-3.234366649,0.8282569818,-0.957816733,-2.406109668
36063,2012,2166,2303,-1010,191,-137,-819,10.062039955,10.698466305,-4.691902288,0.8872805316,-0.63642635,-3.804621756
36063,2013,2205,2332,-580,177,-127,-403,10.279312941,10.871364072,-2.703855558,0.8251421272,-0.592051131,-1.878713431
36063,2014,2152,2407,-680,197,-255,-483,10.062893082,11.255289799,-3.17972458,0.921184915,-1.192396717,-2.258539665
36063,2015,2212,2373,-972,206,-161,-766,10.384610871,11.140452801,-4.563219605,0.9671020973,-0.75584193,-3.596117508
36063,2016,2090,2339,-695,203,-249,-492,9.8506379349,11.024230684,-3.275690605,0.9567844501,-1.173592749,-2.318906155
36063,2017,2102,2321,-446,203,-219,-243,9.9355747461,10.970727396,-2.108119095,0.9595250587,-1.03515265,-1.148594036
21181,2010,16,16,-2,0,0,-2,NA,NA,NA,NA,NA,NA
21181,2011,90,100,-29,0,-10,-29,12.665353223,14.072614692,-4.081058261,0,-1.407261469,-4.081058261
21181,2012,87,88,-78,0,-1,-78,12.345679012,12.487583369,-11.0685398,0,-0.141904356,-11.0685398
21181,2013,90,114,23,1,-24,24,12.843382091,16.268283981,3.2821976454,0.1427042455,-3.424901891,3.4249018908
21181,2014,95,95,40,1,0,41,13.518320882,13.518320882,5.691924582,0.1422981145,0,5.8342226965
21181,2015,89,100,20,1,-11,21,12.618743797,14.178363817,2.8356727634,0.1417836382,-1.55962002,2.9774564015
21181,2016,89,115,32,1,-26,33,12.605339565,16.287798315,4.5322569223,0.1416330288,-3.682458749,4.6738899511
21181,2017,94,114,85,1,-20,86,13.245966321,16.064257028,11.977735503,0.1409145353,-2.818290707,12.118650039
54067,2010,79,97,16,5,-18,21,NA,NA,NA,NA,NA,NA
54067,2011,288,338,8,15,-50,23,10.985448096,12.892643946,0.305151336,0.572158755,-1.90719585,0.877310091
54067,2012,302,298,49,-3,4,46,11.516168395,11.363636364,1.8685173887,-0.114399024,0.1525320317,1.7541183649
54067,2013,298,383,-227,-4,-85,-231,11.421781875,14.679672678,-8.700484851,-0.153312508,-3.257890803,-8.853797359
54067,2014,268,310,-189,-3,-42,-192,10.380354791,12.007126811,-7.320474088,-0.116198001,-1.62677202,-7.436672089
54067,2015,275,345,-117,-3,-70,-120,10.73967039,13.473404671,-4.569241584,-0.117160041,-2.733734281,-4.686401625
54067,2016,263,314,-162,-3,-51,-165,10.354126887,12.361961379,-6.377827208,-0.118107911,-2.007834491,-6.495935119
54067,2017,256,344,-158,-3,-88,-161,10.172050701,13.66869313,-6.278062542,-0.119203719,-3.496642429,-6.397266261
27103,2010,96,49,-18,2,47,-16,NA,NA,NA,NA,NA,NA
27103,2011,403,186,-7,-2,217,-9,12.264337558,5.6604634885,-0.213028196,-0.060865199,6.6038740699,-0.273893395
27103,2012,381,200,-146,18,181,-128,11.549304314,6.0626269363,-4.425717663,0.5456364243,5.4866773773,-3.880081239
27103,2013,370,237,-209,31,133,-178,11.21416015,7.1831242044,-6.334485058,0.9395647694,4.0310359459,-5.394920289
27103,2014,386,223,162,32,163,194,11.644393496,6.7272014239,4.8870252496,0.9653383209,4.9171920722,5.8523635705
27103,2015,405,231,-71,35,174,-36,12.127564007,6.9172031741,-2.126066776,1.048061087,5.2103608325,-1.078005689
27103,2016,381,207,-18,37,174,19,11.352800954,6.168057211,-0.536352801,1.1025029797,5.1847437426,0.5661501788
27103,2017,362,238,152,36,124,188,10.706574783,7.0391292775,4.4955783621,1.0647422436,3.6674455059,5.5603206057
56027,2010,6,3,4,0,3,4,NA,NA,NA,NA,NA,NA
56027,2011,18,21,-4,-2,-3,-6,7.2376357057,8.4439083233,-1.60836349,-0.804181745,-1.206272618,-2.412545235
56027,2012,18,29,4,0,-11,4,7.2595281307,11.695906433,1.6132284735,0,-4.436378302,1.6132284735
56027,2013,27,29,66,0,-2,66,10.756972112,11.553784861,26.294820717,0,-0.796812749,26.294820717
56027,2014,24,25,-54,0,-1,-54,9.5370554341,9.9344327439,-21.45837473,0,-0.39737731,-21.45837473
56027,2015,35,39,12,0,-4,12,14.042126379,15.646940822,4.81444333,0,-1.604814443,4.81444333
56027,2016,28,23,-31,0,5,-31,11.276681434,9.2629883206,-12.4848973,0,2.0136931132,-12.4848973
56027,2017,31,16,-89,0,15,-89,12.738853503,6.5748921307,-36.57283748,0,6.1639613725,-36.57283748
18113,2010,151,129,-112,0,22,-112,NA,NA,NA,NA,NA,NA
18113,2011,568,448,-262,-2,120,-264,11.98792765,9.4552668791,-5.529642684,-0.042211013,2.5326607712,-5.571853697
18113,2012,580,442,-233,-3,138,-236,12.272275238,9.3523200948,-4.93006919,-0.063477286,2.9199551427,-4.993546476
18113,2013,579,439,-79,-3,140,-82,12.256562235,9.2929720576,-1.6723116,-0.063505504,2.9635901778,-1.7358171040000001
18113,2014,622,419,-58,-5,203,-63,13.1407988,8.8520815068,-1.225347798,-0.105633431,4.2887172932,-1.330981229
18113,2015,653,464,-41,1,189,-40,13.755621794,9.774285624,-0.8636761,0.0210652707,3.9813361701,-0.84261083
18113,2016,635,422,-314,1,213,-313,13.370532189,8.8856135179,-6.611570248,0.0210559562,4.4849186714,-6.590514292
18113,2017,646,453,-183,0,193,-183,13.615191688,9.5474950998,-3.856935107,0,4.0676965878,-3.856935107
39121,2010,38,18,-18,0,20,-18,NA,NA,NA,NA,NA,NA
39121,2011,144,106,54,2,38,56,9.8009188361,7.2145652544,3.6753445636,0.1361238727,2.5863535818,3.8114684363
39121,2012,158,133,-120,6,25,-114,10.752688172,9.0513134613,-8.166598612,0.4083299306,1.7013747108,-7.758268681
39121,2013,140,133,9,1,7,10,9.5517500171,9.0741625162,0.6140410725,0.0682267858,0.4775875009,0.6822678584
39121,2014,134,132,-149,0,2,-149,9.1834287085,9.0463626084,-10.21142446,0,0.1370661001,-10.21142446
39121,2015,144,134,-71,0,10,-71,9.9396031061,9.2493528904,-4.900776531,0,0.6902502157,-4.900776531
39121,2016,131,129,-14,0,2,-14,9.0660576491,8.9276445552,-0.968891657,0,0.1384130939,-0.968891657
39121,2017,131,131,-37,1,0,-36,9.0817705986,9.0817705986,-2.565080245,0.0693264931,0,-2.495753752
40103,2010,45,38,-11,0,7,-11,NA,NA,NA,NA,NA,NA
40103,2011,137,127,3,-3,10,0,11.85172369,10.98663437,0.2595267961,-0.259526796,0.8650893205,0
40103,2012,123,131,-39,0,-8,-39,10.658117066,11.351327932,-3.379402972,0,-0.693210866,-3.379402972
40103,2013,144,135,-119,-1,9,-120,12.563252486,11.778049206,-10.38213226,-0.087244809,0.7852032804,-10.46937707
40103,2014,131,133,126,-1,-2,125,11.423090338,11.597488664,10.987094524,-0.087199163,-0.174398326,10.899895361
40103,2015,120,128,6,-1,-8,5,10.409889395,11.103882021,0.5204944697,-0.086749078,-0.693992626,0.4337453915
40103,2016,117,145,-133,-1,-28,-134,10.222804718,12.669287899,-11.62079511,-0.087374399,-2.44648318,-11.70816951
40103,2017,113,127,-72,-1,-14,-73,9.9818912592,11.218585752,-6.360143103,-0.088335321,-1.236694492,-6.448478424
27105,2010,103,27,-75,43,76,-32,NA,NA,NA,NA,NA,NA
27105,2011,372,164,-214,187,208,-27,17.288655482,7.6218803737,-9.94562439,8.6908026212,9.6667751081,-1.254821769
27105,2012,347,190,-234,191,157,-43,16.014399114,8.7686911575,-10.79933543,8.8148421636,7.2457079564,-1.984493262
27105,2013,347,193,-260,174,154,-86,15.946324763,8.8692814963,-11.94825487,7.9961397946,7.0770432665,-3.952115071
27105,2014,351,198,-453,197,153,-256,16.139044072,9.1040761432,-20.82902269,9.0580959606,7.0349679288,-11.77092673
27105,2015,361,187,-281,211,174,-70,16.592742399,8.5951324891,-12.91568037,9.6982510974,7.9976099097,-3.217429274
27105,2016,384,151,-254,226,233,-28,17.523444452,6.890729459,-11.59102836,10.313277204,10.632714993,-1.277751158
27105,2017,377,165,-512,226,212,-286,17.151956324,7.5068243858,-23.29390355,10.282074613,9.6451319381,-13.01182894
29147,2010,71,26,-20,2,45,-18,NA,NA,NA,NA,NA,NA
29147,2011,221,198,-23,18,23,-5,9.4424268319,8.4597308267,-0.982696005,0.7690664388,0.9826960051,-0.213629566
29147,2012,223,211,-135,22,12,-113,9.545211343,9.0315676833,-5.778491172,0.9416800428,0.5136436597,-4.836811129
29147,2013,225,181,-237,19,44,-218,9.6874192715,7.792990614,-10.20408163,0.8180487385,1.8944286575,-9.386032894
29147,2014,240,198,-219,19,42,-200,10.405827263,8.5848074922,-9.495317378,0.8237946583,1.8210197711,-8.671522719
29147,2015,221,200,-405,21,21,-384,9.6895826026,8.768853034,-17.75692739,0.9207295686,0.9207295686,-16.83619783
29147,2016,237,187,-206,19,50,-187,10.505086323,8.288823386,-9.131003302,0.8421799162,2.2162629374,-8.288823386
29147,2017,236,171,-106,19,65,-87,10.497286718,7.6060848679,-4.714883018,0.8451205409,2.8912018504,-3.869762477
48353,2010,53,23,4,0,30,4,NA,NA,NA,NA,NA,NA
48353,2011,172,202,-91,2,-30,-89,11.323984462,13.299098031,-5.991177826,0.1316742379,-1.975113569,-5.859503588
48353,2012,200,172,-273,2,28,-271,13.324006529,11.458645615,-18.18726891,0.1332400653,1.865360914,-18.05402885
48353,2013,207,181,127,7,26,134,13.824423148,12.088022173,8.4816509166,0.4674925702,1.7364009751,8.9491434868
48353,2014,234,197,17,7,37,24,15.512612284,13.059763333,1.1269846531,0.4640525042,2.4528489509,1.5910371573
48353,2015,203,178,-105,8,25,-97,13.463770519,11.805670701,-6.964019234,0.5305919416,1.6580998176,-6.433427292
48353,2016,213,158,-136,8,55,-128,14.195741278,10.530174281,-9.063947482,0.5331733813,3.6655669966,-8.530774101
48353,2017,199,181,-224,8,18,-216,13.383549667,12.172977335,-15.06490013,0.5380321474,1.2105723317,-14.52686798
02180,2010,56,29,22,0,27,22,NA,NA,NA,NA,NA,NA
02180,2011,263,89,54,3,174,57,27.228491562,9.214204369,5.5906408531,0.3105911585,18.014287193,5.9012320116
02180,2012,251,73,-143,4,178,-139,25.624011025,7.452401613,-14.59854015,0.4083507733,18.171609412,-14.19018937
02180,2013,201,64,-116,6,137,-110,20.447609359,6.510681587,-11.80061038,0.6103763988,13.936927772,-11.19023398
02180,2014,194,66,-185,6,128,-179,19.753589248,6.7202932492,-18.83718562,0.6109357499,13.033295998,-18.22624987
02180,2015,232,59,-109,6,173,-103,23.592820461,5.9998983068,-11.08455789,0.6101591498,17.592922154,-10.47439874
02180,2016,198,80,-79,7,118,-72,20.016174687,8.0873433077,-7.986251516,0.7076425394,11.928831379,-7.278608977
02180,2017,209,117,-92,7,92,-85,21.072796935,11.796733212,-9.276063723,0.7057874571,9.2760637225,-8.570276265
51710,2010,894,458,-568,341,436,-227,NA,NA,NA,NA,NA,NA
51710,2011,3701,1841,-1710,576,1860,-1134,15.206922622,7.5644270594,-7.026165275,2.3667083032,7.6424955624,-4.659456972
51710,2012,3859,1846,-1367,1818,2013,451,15.754717944,7.5364626392,-5.58090164,7.4221500965,8.2182553048,1.8412484563
51710,2013,3658,1918,-3423,1095,1740,-2328,14.877145605,7.8005372529,-13.92139678,4.4533828425,7.0766083524,-9.468013934
51710,2014,3751,1956,-1823,1035,1795,-788,15.242545842,7.9483923401,-7.40793417,4.2058211002,7.2941535023,-3.20211307
51710,2015,3670,1966,-3301,1371,1704,-1930,14.890673245,7.9768565667,-13.39349111,5.5627010951,6.9138166784,-7.830790017
51710,2016,3675,2031,-3465,999,1644,-2466,14.94254743,8.2580445796,-14.08868758,4.0619333013,6.6845028503,-10.02675428
51710,2017,3611,2067,-3017,658,1544,-2359,14.731710302,8.4326904444,-12.30838271,2.6844268565,6.2990198578,-9.623955858
25021,2010,1894,1318,865,617,576,1482,NA,NA,NA,NA,NA,NA
25021,2011,7123,5494,443,2847,1629,3290,10.546069653,8.1342280886,0.6558906158,4.2151706167,2.4118415647,4.8710612325
25021,2012,7238,5385,248,2954,1853,3202,10.639619279,7.9157709057,0.364551752,4.3422817559,2.7238483729,4.7068335079
25021,2013,7177,5683,1167,3079,1494,4246,10.46854659,8.2893618883,1.7022145563,4.4911042151,2.1791847019,6.1933187714
25021,2014,7246,5643,-1413,3432,1603,2019,10.498946266,8.1763115895,-2.04733799,4.9727275164,2.3226346762,2.9253895267
25021,2015,7336,5958,-2461,3667,1378,1206,10.582781486,8.5949035021,-3.55019428,5.2899481608,1.9878779835,1.7397538811
25021,2016,7262,5808,-2819,3706,1454,887,10.439210145,8.3490680971,-4.052345552,5.3274184518,2.0901420477,1.2750728998
25021,2017,7240,5900,-1494,3676,1340,2182,10.364029374,8.4458250426,-2.13865468,5.2621784503,1.9182043317,3.12352377
27107,2010,17,34,6,0,-17,6,NA,NA,NA,NA,NA,NA
27107,2011,65,102,8,2,-37,10,9.5224142983,14.942865514,1.1719894521,0.292997363,-5.420451216,1.4649868151
27107,2012,62,96,-181,2,-34,-179,9.2420064098,14.310203473,-26.98069613,0.298129239,-5.068197063,-26.68256689
27107,2013,69,85,12,5,-16,17,10.447422212,12.87001287,1.8169429934,0.7570595806,-2.422590658,2.574002574
27107,2014,84,93,-15,8,-9,-7,12.736921911,14.101592115,-2.274450341,1.213040182,-1.364670205,-1.061410159
27107,2015,65,82,42,8,-17,50,9.8447557743,12.419538054,6.361226808,1.2116622491,-2.574782279,7.5728890572
27107,2016,77,97,-69,8,-20,-61,11.704795926,14.74500266,-10.48871323,1.2160826936,-3.040206734,-9.272630539
27107,2017,71,91,72,8,-20,80,10.810810811,13.856109631,10.963075752,1.218119528,-3.04529882,12.18119528
02185,2010,48,6,3,2,42,5,NA,NA,NA,NA,NA,NA
02185,2011,173,45,-72,16,128,-56,18.185640702,4.7303689688,-7.56859035,1.6819089667,13.455271733,-5.886681383
02185,2012,176,33,-23,23,143,0,18.29426745,3.4301751468,-2.390728133,2.3907281326,14.864092303,0
02185,2013,176,51,-53,13,125,-40,18.080953359,5.2393671666,-5.444832546,1.335524964,12.841586193,-4.109307582
02185,2014,172,46,-154,12,126,-142,17.605814013,4.7085316546,-15.7633451,1.2283126056,12.897282358,-14.5350325
02185,2015,172,46,-124,14,126,-110,17.60221051,4.7075679271,-12.68996572,1.4327380648,12.894642583,-11.25722765
02185,2016,155,63,-200,12,92,-188,15.926021063,6.4731569484,-20.5497046,1.2329822759,9.4528641151,-19.31672232
02185,2017,154,60,-9,12,94,3,15.82164689,6.1642780089,-0.924641701,1.2328556018,9.6573688807,0.3082139004
37131,2010,47,78,-33,-1,-31,-34,NA,NA,NA,NA,NA,NA
37131,2011,184,269,-25,1,-85,-24,8.371817913,12.239233797,-1.13747526,0.0454990104,-3.867415884,-1.09197625
37131,2012,198,251,-599,7,-53,-592,9.1636969501,11.61660573,-27.72249734,0.3239690841,-2.45290878,-27.39852825
37131,2013,195,287,-347,14,-92,-333,9.2498161896,13.613832033,-16.45992932,0.6640893675,-4.364015843,-15.79583995
37131,2014,172,265,-121,19,-93,-102,8.2801781201,12.757251173,-5.825009026,0.9146708388,-4.477073053,-4.910338188
37131,2015,170,262,-46,23,-92,-23,8.246622523,12.709500594,-2.231439036,1.1157195178,-4.462878071,-1.115719518
37131,2016,186,287,-310,22,-101,-288,9.1351112421,14.095574874,-15.2251854,1.0804970286,-4.960463631,-14.14468837
37131,2017,178,291,-211,22,-113,-189,8.8937743579,14.539822125,-10.54262017,1.0992305386,-5.646047767,-9.443389627
42095,2010,760,708,112,125,52,237,NA,NA,NA,NA,NA,NA
42095,2011,2930,2826,-297,549,104,252,9.8286197331,9.4797540497,-0.996279884,1.8416082708,0.3488656834,0.8453283866
42095,2012,2980,2693,105,550,287,655,9.9757635811,9.0150105114,0.3514950255,1.8411644193,0.9607530697,2.1926594448
42095,2013,2923,2879,-570,575,44,5,9.7699564647,9.6228890393,-1.905191647,1.9219038547,0.1470674254,0.0167122074
42095,2014,2846,2899,96,693,-53,789,9.5012986666,9.6782378196,0.3204935601,2.3135628868,-0.176939153,2.6340564469
42095,2015,2784,3039,146,733,-255,879,9.27462072,10.124128006,0.4863845636,2.4419170215,-0.849507286,2.9283015851
42095,2016,2813,2942,688,744,-129,1432,9.3420078177,9.7704184143,2.2848565157,2.4708332088,-0.428410597,4.7556897245
42095,2017,2795,2914,1041,744,-119,1785,9.2371501987,9.63043137,3.4403840275,2.4588335413,-0.393281171,5.8992175688
51131,2010,34,23,4,7,11,11,NA,NA,NA,NA,NA,NA
51131,2011,166,187,-15,35,-21,20,13.379543806,15.072136697,-1.208994922,2.8209881518,-1.692592891,1.6119932296
51131,2012,135,193,-153,21,-58,-132,10.964912281,15.675763483,-12.42690058,1.7056530214,-4.710851202,-10.72124756
51131,2013,133,203,-129,7,-70,-122,10.972692022,16.747793086,-10.64268625,0.5775101064,-5.775101064,-10.06517614
51131,2014,136,197,57,11,-61,68,11.306950449,16.378450283,4.7389424676,0.9145327569,-5.071499834,5.6534752245
51131,2015,123,179,91,16,-56,107,10.200696633,14.844916238,7.5468568585,1.3269198872,-4.644219605,8.8737767457
51131,2016,120,203,-14,20,-83,6,9.9626400996,16.853466169,-1.162308012,1.6604400166,-6.890826069,0.498132005
51131,2017,107,205,-81,20,-98,-61,8.9719939628,17.189334228,-6.79188328,1.6770082173,-8.217340265,-5.114875063
42097,2010,226,309,-109,10,-83,-99,NA,NA,NA,NA,NA,NA
42097,2011,1003,1233,262,50,-230,312,10.629335057,13.066769816,2.7765561166,0.5298771215,-2.437434759,3.3064332381
42097,2012,925,1149,234,46,-224,280,9.7966013736,12.168967544,2.4782753745,0.4871823386,-2.37236617,2.9654577131
42097,2013,996,1197,-321,38,-201,-283,10.573416774,12.707208714,-3.407697575,0.4034034512,-2.133791939,-3.004294124
42097,2014,930,1078,-105,27,-148,-78,9.9114365188,11.488740395,-1.119033155,0.2877513828,-1.577303876,-0.831281773
42097,2015,973,1191,-493,27,-218,-466,10.421519957,12.756454541,-5.280379588,0.2891891458,-2.334934584,-4.991190442
42097,2016,945,1112,-401,29,-167,-372,10.188734171,11.989282961,-4.323473442,0.3126701492,-1.80054879,-4.010803293
42097,2017,911,1079,-307,29,-168,-278,9.874910573,11.695969822,-3.327768986,0.3143495133,-1.821059249,-3.013419472
51133,2010,21,27,25,4,-6,29,NA,NA,NA,NA,NA,NA
51133,2011,109,161,129,19,-52,148,8.7871337015,12.979160788,10.399451812,1.5317022048,-4.192027087,11.931154017
51133,2012,89,181,39,26,-92,65,7.1554912365,14.552178807,3.1355523396,2.0903682264,-7.39668757,5.225920566
51133,2013,103,185,-48,6,-82,-42,8.332996238,14.967032078,-3.883338053,0.4854172566,-6.63403584,-3.397920796
51133,2014,87,165,29,9,-78,38,7.0864217643,13.439765415,2.3621405881,0.7330781135,-6.353343651,3.0952187016
51133,2015,92,159,50,9,-67,59,7.5092845774,12.978002694,4.0811329225,0.734603926,-5.468718116,4.8157368485
51133,2016,76,183,46,10,-107,56,6.2188036986,14.974224695,3.7640127649,0.8182636445,-8.755420997,4.5822764095
51133,2017,77,176,169,10,-99,179,6.2934205149,14.384961177,13.812832039,0.8173273396,-8.091540662,14.630159379
02188,2010,55,2,-18,1,53,-17,NA,NA,NA,NA,NA,NA
02188,2011,214,43,-31,7,171,-24,28.039832285,5.6341719078,-4.061844864,0.9171907757,22.405660377,-3.144654088
02188,2012,180,56,-127,2,124,-125,23.358422009,7.267064625,-16.48066442,0.2595380223,16.091357384,-16.2211264
02188,2013,194,39,-144,2,155,-142,25.149079596,5.0557428053,-18.66735805,0.25926886179999997,20.09333679,-18.40808919
02188,2014,173,40,-105,4,133,-101,22.355753699,5.1689603928,-13.56852103,0.5168960393,17.186793306,-13.05162499
02188,2015,159,46,-122,4,113,-118,20.505545525,5.9324219758,-15.73381481,0.5158627805,14.573123549,-15.21795202
02188,2016,185,69,-211,4,116,-207,24.00415207,8.9528999611,-27.37770858,0.5190086934,15.051252108,-26.85869988
02188,2017,166,84,-63,4,82,-59,21.634302098,10.94747817,-8.210608628,0.5213084843,10.686823928,-7.689300143
51720,2010,16,11,12,2,5,14,NA,NA,NA,NA,NA,NA
51720,2011,53,41,52,11,12,63,13.057403301,10.101010101,12.811037201,2.7100271003,2.9563932003,15.521064302
51720,2012,47,45,27,8,2,35,11.420240554,10.934272871,6.5605637225,1.9438707326,0.4859676831,8.5044344551
51720,2013,58,42,-55,16,16,-39,14.067426631,10.186757216,-13.33980112,3.8806694155,3.8806694155,-9.4591317
51720,2014,56,32,-1,17,24,16,13.554399129,7.7453709307,-0.242042842,4.1147283069,5.809028198,3.8726854653
51720,2015,22,50,-118,19,-28,-99,5.3796307617,12.226433549,-28.85438318,4.6460447487,-6.846802788,-24.20833843
51720,2016,20,30,-47,20,-10,-27,4.9906425452,7.4859638178,-11.72800998,4.9906425452,-2.495321273,-6.737367436
51720,2017,20,26,-67,20,-6,-47,5.047955578,6.5623422514,-16.91065119,5.047955578,-1.514386673,-11.86269561
20137,2010,10,19,5,0,-9,5,NA,NA,NA,NA,NA,NA
20137,2011,48,61,9,-2,-13,7,8.4798162706,10.776433177,1.5899655507,-0.353325678,-2.296616907,1.2366398728
20137,2012,42,46,-65,-2,-4,-67,7.4713154852,8.1828693409,-11.56275016,-0.355776928,-0.711553856,-11.91852708
20137,2013,61,70,37,1,-9,38,10.891884653,12.498884028,6.6065529863,0.1785554861,-1.606999375,6.7851084725
20137,2014,55,56,-83,2,-1,-81,9.8681259532,10.047546425,-14.89189917,0.3588409438,-0.179420472,-14.53305822
20137,2015,52,69,20,3,-17,23,9.3930635838,12.463872832,3.612716763,0.5419075145,-3.070809249,4.1546242775
20137,2016,61,53,-43,3,8,-40,11.045722046,9.5971027614,-7.786328656,0.5432322318,1.4486192847,-7.243096424
20137,2017,57,66,-60,3,-9,-57,10.413812003,12.058098109,-10.96190737,0.5480953686,-1.644286106,-10.413812
51135,2010,39,57,-5,1,-18,-4,NA,NA,NA,NA,NA,NA
51135,2011,168,201,82,1,-33,83,10.597363275,12.678988204,5.1725225509,0.0630795433,-2.081624929,5.2356020942
51135,2012,164,199,-82,-4,-35,-86,10.368590757,12.58139976,-5.184295378,-0.252892457,-2.212809003,-5.437187836
51135,2013,185,209,-115,12,-24,-103,11.789071212,13.318464235,-7.328341564,0.7646965111,-1.529393022,-6.563645053
51135,2014,166,194,-109,13,-28,-96,10.663240726,12.461859643,-7.001766501,0.8350730689,-1.798618918,-6.166693432
51135,2015,183,194,94,13,-11,107,11.764705882,12.471873995,6.0430729669,0.8357441337,-0.707168113,6.8788171006
51135,2016,155,186,-77,15,-31,-62,9.9633605451,11.956032654,-4.9495404,0.9641961818,-1.992672109,-3.985344218
51135,2017,150,210,-31,16,-60,-15,9.6949327818,13.572905895,-2.003619442,1.0341261634,-3.877973113,-0.969493278
40105,2010,26,26,-15,0,0,-15,NA,NA,NA,NA,NA,NA
40105,2011,111,126,103,1,-15,104,10.50638902,11.92617132,9.7491717937,0.0946521533,-1.4197823,9.843823947
40105,2012,103,119,4,1,-16,5,9.7137737539,11.222709483,0.3772339322,0.094308483,-1.508935729,0.4715424152
40105,2013,131,167,-18,1,-36,-17,12.393566698,15.799432356,-1.702932829,0.0946073794,-3.405865658,-1.608325449
40105,2014,107,137,-22,0,-30,-22,10.17545528,13.028386667,-2.092149684,0,-2.852931387,-2.092149684
40105,2015,124,156,47,1,-32,48,11.81402439,14.862804878,4.4778963415,0.0952743902,-3.048780488,4.5731707317
40105,2016,119,129,-94,1,-10,-93,11.384836164,12.341545085,-8.99306386,0.0956708921,-0.956708921,-8.897392968
40105,2017,122,146,-72,1,-24,-71,11.78345487,14.101511566,-6.954170087,0.0965856957,-2.318056696,-6.857584392
28103,2010,32,54,-45,0,-22,-45,NA,NA,NA,NA,NA,NA
28103,2011,141,113,-221,-1,28,-222,12.383629018,9.9244686457,-19.40980151,-0.087827156,2.4591603724,-19.49762867
28103,2012,154,108,-195,5,46,-190,13.72487857,9.625239517,-17.37890468,0.4456129406,4.0996390535,-16.93329174
28103,2013,169,117,-166,13,52,-153,15.223853707,10.539591028,-14.95360778,1.1710656698,4.684262679,-13.78254211
28103,2014,165,111,-59,14,54,-45,14.923348257,10.039343373,-5.336227558,1.2662234884,4.884004884,-4.07000407
28103,2015,148,131,-157,16,17,-141,13.454545455,11.909090909,-14.27272727,1.4545454545,1.5454545455,-12.81818182
28103,2016,163,116,-88,16,47,-72,14.917860248,10.616391342,-8.053814122,1.4643298403,4.3014689059,-6.589484281
28103,2017,149,134,-204,16,15,-188,13.760620613,12.375323236,-18.84004433,1.4776505356,1.3852973772,-17.36239379
31129,2010,11,5,8,0,6,8,NA,NA,NA,NA,NA,NA
31129,2011,41,66,-42,0,-25,-42,9.1507644236,14.730498828,-9.3739538,0,-5.579734405,-9.3739538
31129,2012,37,62,8,1,-25,9,8.3361496001,13.968683114,1.8024107243,0.2253013405,-5.632533514,2.0277120649000002
31129,2013,34,67,-14,2,-33,-12,7.7149988654,15.203086,-3.176764239,0.4538234627,-7.488087134,-2.722940776
31129,2014,44,59,-23,2,-15,-21,10.079028748,13.515061276,-5.268583209,0.4581376704,-3.436032528,-4.810445539
31129,2015,51,53,-31,2,-2,-29,11.774212167,12.235945977,-7.156874062,0.4617338105,-0.46173381,-6.695140252
31129,2016,43,53,-39,2,-10,-37,10.018639329,12.348555452,-9.08667288,0.4659832246,-2.329916123,-8.620689655
31129,2017,48,58,15,2,-10,17,11.23727028,13.578368255000001,3.5116469624,0.468219595,-2.341097975,3.9798665574
48355,2010,1142,691,-536,127,451,-409,NA,NA,NA,NA,NA,NA
48355,2011,4685,2622,466,460,2063,926,13.709132301,7.6724322078,1.3635977913,1.3460407382,6.0367000933,2.7096385295
48355,2012,4655,2627,1948,649,2028,2597,13.471803992,7.6026700508,5.6376099196,1.8782386231,5.869133941,7.5158485428
48355,2013,4893,2824,2252,600,2069,2852,13.967449249,8.0613277498,6.4285092396,1.712746689,5.9061214994,8.1412559286
48355,2014,5105,2789,726,669,2316,1395,14.395833245,7.8648342646,2.0472820639,1.8865450423,6.5309989806,3.9338271062
48355,2015,5143,2857,950,777,2286,1727,14.34810689,7.9705505315,2.6503405688,2.167699602,6.3775563581,4.8180401708
48355,2016,4904,2936,-1645,771,1968,-874,13.585127277,8.1333469997,-4.557001299,2.1358346515,5.4517802777,-2.421166648
48355,2017,4887,2924,-2993,716,1963,-2277,13.523348322,8.0913178831,-8.282255275,1.9813213421,5.4320304393,-6.300933933
32023,2010,92,135,-55,5,-43,-50,NA,NA,NA,NA,NA,NA
32023,2011,417,632,339,13,-215,352,9.493562818,14.388325422,7.717788478,0.29596239,-4.894762604,8.013750868
32023,2012,387,677,-74,-1,-290,-75,8.83218842,15.450624187,-1.6888422300000001,-0.022822192,-6.618435767,-1.711664422
32023,2013,339,643,-394,-15,-304,-409,7.8330791626,14.857433338,-9.103932714,-0.346596423,-7.024354175,-9.450529137
32023,2014,366,675,302,-16,-309,286,8.5286852775,15.729132684,7.0373304749,-0.372838701,-7.200447406,6.6644917742
32023,2015,371,679,462,-9,-308,453,8.6323235144,15.798780772,10.749685886,-0.209409465,-7.166457257,10.54027642
32023,2016,349,696,703,-8,-347,695,8.0739378376,16.10160669,16.263548137,-0.185075939,-8.027668853,16.078472198
32023,2017,358,677,1125,-7,-319,1118,8.1734226778,15.456444561,25.684638303,-0.159815527,-7.283021883,25.524822776
19141,2010,55,34,-10,0,21,-10,NA,NA,NA,NA,NA,NA
19141,2011,138,189,-148,7,-51,-141,9.6415845735,13.204778872,-10.34025012,0.4890658842,-3.563194299,-9.851184238
19141,2012,153,189,-29,3,-36,-26,10.785281263,13.322994502,-2.044268998,0.2114761032,-2.537713238,-1.832792894
19141,2013,164,171,-108,3,-7,-105,11.63203064,12.128519753,-7.660117739,0.2127810483,-0.496489113,-7.447336691
19141,2014,166,183,5,4,-17,9,11.823361823,13.034188034,0.3561253561,0.2849002849,-1.210826211,0.641025641
19141,2015,179,203,-96,4,-24,-92,12.806295833,14.523341084,-6.868181005,0.2861742085,-1.717045251,-6.582006797
19141,2016,180,198,16,5,-18,21,12.931034483,14.224137931,1.1494252874,0.3591954023,-1.293103448,1.5086206897
19141,2017,184,183,-126,5,1,-121,13.274655508,13.202510641,-9.090253228,0.3607243345,0.0721448669,-8.729528894
26125,2010,3348,2257,-1410,886,1091,-524,NA,NA,NA,NA,NA,NA
26125,2011,13196,9840,874,4288,3356,5162,10.93146956,8.1513837885,0.7240151861,3.5521477322,2.7800857718,4.2761629183
26125,2012,13331,9801,2223,4527,3530,6750,10.959586576,8.0575281697,1.8275568943,3.7217049305,2.9020584062,5.5492618249
26125,2013,13244,10189,3262,4844,3055,8106,10.794395456,8.3044469421,2.6586618829,3.9480558433,2.4899485139,6.6067177262
26125,2014,13495,9989,-1897,5382,3506,3485,10.919592314,8.0826830397,-1.534973443,4.3548903914,2.8369092739,2.819916948
26125,2015,13487,10689,-6727,5732,2798,-995,10.875529736,8.6193028356,-5.424459741,4.6221202969,2.2562269,-0.802339444
26125,2016,13655,10758,-3940,5811,2897,1871,10.982157111,8.6522186893,-3.168780595,4.6735492474,2.3299384219,1.5047686529
26125,2017,13554,10727,-3498,5771,2827,2273,10.857975533,8.5932937541,-2.802213252,4.6230911024,2.264681779,1.8208778506
47131,2010,78,64,6,-1,14,5,NA,NA,NA,NA,NA,NA
47131,2011,354,382,-114,-8,-28,-122,11.151538062,12.03358062,-3.591173274,-0.25201216,-0.882042559,-3.843185434
47131,2012,376,428,-309,-7,-52,-316,11.941436148,13.59291136,-9.813573856,-0.222313971,-1.651475212,-10.03588783
47131,2013,346,393,-243,-5,-47,-248,11.104514017,12.612930661,-7.798834989,-0.160469856,-1.508416644,-7.959304845
47131,2014,331,395,-127,-5,-64,-132,10.707469349,12.777795749,-4.10830395,-0.16174425,-2.0703264,-4.2700482
47131,2015,334,373,-212,-5,-39,-217,10.884087724,12.154984195,-6.908462867,-0.162935445,-1.270896471,-7.071398312
47131,2016,360,359,-26,-5,1,-31,11.786854383,11.754113121,-0.851272817,-0.163706311,0.0327412622,-1.014979127
47131,2017,371,378,-127,-5,-7,-132,12.181707738,12.41155128,-4.170018552,-0.164173959,-0.229843542,-4.33419251
34029,2010,1956,1632,635,148,324,783,NA,NA,NA,NA,NA,NA
34029,2011,8111,7247,297,481,864,778,14.023373442,12.529575556,0.5134930233,0.8316166472,1.493797886,1.3451096705
34029,2012,7962,6985,-7,572,977,565,13.730533537,12.045689118,-0.012071557,0.9864186364,1.6848444192,0.9743470797
34029,2013,8150,7178,1055,539,972,1594,14.007299264,12.336735474,1.8132148127,0.9263723071,1.6705637895,2.7395871198
34029,2014,8148,6936,1012,594,1212,1606,13.941312345,11.867567799,1.7315424758,1.0163401489,2.0737445462,2.7478826247
34029,2015,8490,7233,1041,687,1257,1728,14.457006582,12.316552251,1.7726435633,1.1698425821,2.1404543314,2.9424861454
34029,2016,8559,7107,2123,690,1452,2813,14.486510823,12.028932401,3.5932775413,1.1678575146,2.4575784221,4.761135056
34029,2017,8511,6999,2831,681,1512,3512,14.293547583,11.754263839,4.7544393381,1.1436853371,2.539283744,5.8981246751
26127,2010,83,97,-57,0,-14,-57,NA,NA,NA,NA,NA,NA
26127,2011,342,239,-174,18,103,-156,12.917847025,9.0273843248,-6.57223796,0.6798866856,3.8904627007,-5.892351275
26127,2012,313,246,-257,13,67,-244,11.872700376,9.3312597201,-9.748511171,0.4931153511,2.5414406555,-9.25539582
26127,2013,317,240,-116,28,77,-88,12.066996574,9.1358964598,-4.415683289,1.065854587,2.9311001142,-3.349828702
26127,2014,273,253,-1,34,20,33,10.384769005,9.6239800673,-0.038039447,1.2933411948,0.7607889381,1.2553017479
26127,2015,297,296,-60,38,1,-22,11.292775665,11.254752852,-2.281368821,1.4448669202,0.0380228137,-0.836501901
26127,2016,310,263,-94,41,47,-53,11.794247451,10.006087354,-3.576320195,1.5598843403,1.7881600974,-2.016435855
26127,2017,304,250,67,41,54,108,11.53196897,9.4835271134,2.5415852664,1.5552984466,2.0484418565,4.096883713
48357,2010,32,28,-69,4,4,-65,NA,NA,NA,NA,NA,NA
48357,2011,187,63,120,9,124,129,18.163275217,6.1191782818,11.65557768,0.874168326,12.044096936,12.529746006
48357,2012,174,85,61,8,89,69,16.569061563000002,8.0940817978,5.8086939961,0.7617959339,8.4749797648,6.57048993
48357,2013,168,103,9,14,65,23,15.811764706,9.6941176471,0.8470588235,1.3176470588,6.1176470588,2.1647058824
48357,2014,198,90,-115,22,108,-93,18.544534982,8.4293340826,-10.77081577,2.0605038869,10.115200899,-8.710311885
48357,2015,196,101,-112,28,95,-84,18.333177439,9.4471985782,-10.47610139,2.6190253484,8.8859788607,-7.857076045
48357,2016,190,59,-563,30,131,-533,18.102134146,5.6211890244,-53.63948171,2.8582317073,12.480945122,-50.78125
48357,2017,178,73,-358,30,105,-328,17.478397486,7.1681068342,-35.15318146,2.9457973291,10.310290652,-32.20738413
13219,2010,98,70,61,4,28,65,NA,NA,NA,NA,NA,NA
13219,2011,308,212,215,29,96,244,9.3110432601,6.4088999063,6.4995918861,0.8766891381,2.9021433538,7.3762810242
13219,2012,315,195,115,15,120,130,9.438060853,5.8426090995,3.4456412638,0.4494314692,3.5954517535,3.895072733
13219,2013,339,222,435,8,117,443,10.03448429,6.5712551985,12.876108159,0.2368019891,3.4632290911,13.112910148
13219,2014,316,195,859,9,121,868,9.1428571429,5.6419529837,24.853526221,0.26039783,3.5009041591,25.113924051
13219,2015,341,225,652,10,116,662,9.6190462758,6.3468780412,18.391842146,0.2820834685,3.2721682346,18.673925615
13219,2016,354,239,904,10,115,914,9.7378483206,6.5744230187,24.867273678,0.275080461,3.1634253019,25.142354139
13219,2017,357,226,1022,10,131,1032,9.5334739766,6.0351964109,27.291905894,0.267044089,3.4982775656,27.558949983
45073,2010,204,226,91,3,-22,94,NA,NA,NA,NA,NA,NA
45073,2011,799,794,-101,12,5,-89,10.754352552,10.687053725,-1.359436305,0.1615171848,0.067298827,-1.19791912
45073,2012,810,812,285,32,-2,317,10.88643832,10.913318415,3.8304134831,0.4300815139,-0.026880095,4.2604949969
45073,2013,794,878,395,73,-84,468,10.621576247,11.745269452,5.2840335235,0.9765429043,-1.123693205,6.2605764279
45073,2014,747,856,277,84,-109,361,9.9505801175,11.40253893,3.6898402845,1.1189407361000001,-1.451958812,4.8087810206
45073,2015,823,876,571,97,-53,668,10.900156946,11.60211116,7.5625633249,1.2847086559,-0.701954214,8.8472719808
45073,2016,742,901,660,97,-159,757,9.7491114775,11.838206794,8.6717164086,1.2744795328,-2.089095317,9.9461959414
45073,2017,780,900,885,97,-120,982,10.151161202,11.71287831,11.517663671,1.2623879956,-1.561717108,12.780051667
55083,2010,96,53,19,0,43,19,NA,NA,NA,NA,NA,NA
55083,2011,365,379,-135,4,-14,-131,9.6961003082,10.068005525,-3.586228881,0.1062586335,-0.371905217,-3.479970248
55083,2012,347,326,-188,15,21,-173,9.2545672756,8.694492599,-5.014001867,0.4000533404,0.5600746766,-4.613948526
55083,2013,367,346,-81,9,21,-72,9.8150649212,9.2534399529,-2.166267735,0.240696415,0.5616249682,-1.92557132
55083,2014,328,342,102,16,-14,118,8.7672404576,9.1414519406,2.7263979472,0.4276702662,-0.374211483,3.1540682134
55083,2015,394,367,-26,19,27,-7,10.515640013,9.7950250881,-0.693925483,0.5070993915,0.7206149247,-0.186826092
55083,2016,336,349,-11,19,-13,8,8.9663362109,9.3132480286,-0.293540769,0.5070249643,-0.346911818,0.2134841955
55083,2017,348,382,99,19,-34,118,9.27703135,10.183407976,2.6391554702,0.5065045852,-0.906376626,3.1456600554
26129,2010,48,96,-36,1,-48,-35,NA,NA,NA,NA,NA,NA
26129,2011,184,284,-30,13,-100,-17,8.5365004987,13.175902944,-1.391820733,0.6031223178,-4.639402445,-0.788698416
26129,2012,190,272,-57,12,-82,-45,8.866075595,12.692487168,-2.659822678,0.5599626692,-3.826411573,-2.099860009
26129,2013,197,327,-79,15,-130,-64,9.2636132794,15.376657575,-3.714849995,0.7053512649,-6.113044296,-3.00949873
26129,2014,190,312,-92,12,-122,-80,9.0201291303,14.812001519,-4.367641474,0.5696923661,-5.791872389,-3.797949107
26129,2015,186,314,39,13,-128,52,8.8901634643,15.008125418,1.8640665328,0.6213555109,-6.117961954,2.4854220438
26129,2016,181,279,104,12,-98,116,8.6633959555,13.354074429,4.9778628695,0.5743687926,-4.690678473,5.5522316621
26129,2017,180,274,164,11,-94,175,8.5953728243,13.084067521,7.8313396844,0.5252727837,-4.488694697,8.3566124681
46102,2010,96,54,6,0,42,6,NA,NA,NA,NA,NA,NA
46102,2011,353,113,27,-2,240,25,25.641025641,8.2080337038,1.9612115929,-0.145274933,17.432991937,1.8159366601
46102,2012,346,126,-77,-1,220,-78,24.770018255,9.0202956652,-5.512402907,-0.071589648,15.74972259,-5.583992555
46102,2013,338,125,-124,-1,213,-125,23.998863959,8.8753195115,-8.8043169550000009,-0.071002556,15.123544448,-8.875319512
46102,2014,339,106,-146,-2,233,-148,23.91871869,7.479009384,-10.30127708,-0.141113385,16.439709306,-10.44239046
46102,2015,328,145,-34,-2,183,-36,22.952310976,10.146600889,-2.379202967,-0.139953116,12.805710087,-2.519156083
46102,2016,308,188,-89,-2,120,-91,21.421616358,13.075532063,-6.190012519,-0.139101405,8.3460842955,-6.329113924
46102,2017,304,173,-167,-2,131,-169,21.150768803,12.036457246,-11.61900786,-0.139149795,9.1143115564,-11.75815766
17141,2010,135,138,-77,2,-3,-75,NA,NA,NA,NA,NA,NA
17141,2011,546,471,-444,4,75,-440,10.254772883,8.8461502343,-8.339046081,0.0751265413,1.4086226488,-8.263919539
17141,2012,521,474,-344,19,47,-325,9.8436540551,8.9556468754,-6.499456804,0.3589816258,0.8880071796,-6.140475178
17141,2013,536,482,-582,25,54,-557,10.200877352,9.1731770214,-11.07632578,0.4757871899,1.0277003302,-10.60053859
17141,2014,548,515,-400,30,33,-370,10.511576161,9.8785797863,-7.672683329,0.5754512497,0.6329963747,-7.097232079
17141,2015,519,521,-407,37,-2,-370,10.022691064,10.061314151,-7.859798194,0.7145271086,-0.038623087,-7.145271086
17141,2016,505,489,-483,37,16,-446,9.8281532803,9.5167662456,-9.399996108,0.7200825176,0.3113870346,-8.67991359
17141,2017,520,480,-183,38,40,-145,10.173039489,9.3904979898,-3.580127359,0.7434144242,0.7825414992,-2.836712934
13221,2010,40,39,17,1,1,18,NA,NA,NA,NA,NA,NA
13221,2011,158,127,-235,9,31,-226,10.677840103,8.5828208421,-15.88159762,0.6082313983,2.0950192607,-15.27336622
13221,2012,150,123,-246,19,27,-227,10.271510254,8.4226384086,-16.84527682,1.3010579656,1.8488718458,-15.54421885
13221,2013,140,110,-124,4,30,-120,9.6808768108,7.6064032085,-8.57449089,0.2765964803,2.0744736023,-8.297894409
13221,2014,171,143,93,1,28,94,11.811023622,9.8770548418,6.4235391629,0.0690703136,1.9339687802,6.4926094764
13221,2015,159,151,177,2,8,179,10.86696511,10.320199569,12.097187575,0.136691385,0.5467655401,12.23387896
13221,2016,167,150,-34,2,17,-32,11.347035842,10.191948361,-2.310174962,0.1358926448,1.1550874809,-2.174282317
13221,2017,149,145,161,2,4,163,10.071991077,9.801602055,10.883158144,0.1351945111,0.2703890222,11.018352655
18115,2010,13,7,-18,0,6,-18,NA,NA,NA,NA,NA,NA
18115,2011,52,63,-21,-3,-11,-24,8.5554458704,10.365251728,-3.455083909,-0.493583416,-1.809805857,-3.948667325
18115,2012,53,51,4,-3,2,1,8.7429891125,8.4130649951,0.6598482349,-0.494886176,0.3299241175,0.1649620587
18115,2013,59,56,-70,-1,3,-71,9.7860341682,9.2884392105,-11.61054901,-0.165864986,0.4975949577,-11.776414
18115,2014,59,65,-23,-2,-6,-25,9.8678708814,10.871383174,-3.846797123,-0.334504098,-1.003512293,-4.181301221
18115,2015,41,65,-56,-2,-24,-58,6.9227522161,10.975094977,-9.455466442,-0.33769523,-4.052342761,-9.793161672
18115,2016,56,67,18,-2,-11,16,9.5157179269,11.384876805,3.0586236194,-0.339847069,-1.869158879,2.7187765506
18115,2017,51,75,-35,-2,-24,-37,8.7060430181,12.803004438,-5.974735405,-0.341413452,-4.09696142,-6.316148856
21183,2010,83,74,-28,1,9,-27,NA,NA,NA,NA,NA,NA
21183,2011,306,246,103,-8,60,95,12.804686683,10.293963804,4.3100742756,-0.334763051,2.510722879,3.975311225
21183,2012,298,271,9,8,27,17,12.420289251,11.29496103,0.3751094069,0.3334305839,1.1253282207,0.7085399908
21183,2013,308,292,-72,10,16,-62,12.839217975,12.172245613,-3.00137563,0.4168577265,0.6669723623,-2.584517904
21183,2014,265,277,-18,9,-12,-9,11.063332359,11.564313447,-0.751471632,0.375735816,-0.500981088,-0.375735816
21183,2015,272,285,91,11,-13,102,11.340893929,11.882921948,3.7941961308,0.4586390927,-0.542028019,4.2528352235
21183,2016,283,268,140,14,15,154,11.73713788,11.115028099,5.806357962,0.5806357962,0.6221097816,6.3869937582
21183,2017,271,258,-40,14,13,-26,11.20343958,10.666005209,-1.653644218,0.5787754765,0.537434371,-1.074868742
54069,2010,106,109,50,4,-3,54,NA,NA,NA,NA,NA,NA
54069,2011,464,583,-188,12,-119,-176,10.464355788,13.148102208,-4.239868293,0.2706298911,-2.68374642,-3.969238402
54069,2012,502,596,-114,0,-94,-114,11.386705681,13.518877661,-2.585825593,0,-2.13217198,-2.585825593
54069,2013,480,598,-143,6,-118,-137,10.946033773,13.636933742,-3.261005895,0.1368254222,-2.690899969,-3.124180473
54069,2014,454,554,-399,0,-100,-399,10.443023416,12.743248838,-9.177899434,0,-2.300225422,-9.177899434
54069,2015,476,615,-135,0,-139,-135,11.047159302,14.273115485,-3.133122911,0,-3.225956183,-3.133122911
54069,2016,442,562,-230,0,-120,-230,10.333380091,13.138822649,-5.377098237,0,-2.805442559,-5.377098237
54069,2017,458,583,-439,0,-125,-439,10.823201352,13.777131852,-10.37420392,0,-2.9539305,-10.37420392
12091,2010,612,316,-619,187,296,-432,NA,NA,NA,NA,NA,NA
12091,2011,2608,1511,1097,168,1097,1265,14.33778457,8.3068989593,6.0308856111,0.9235996196,6.0308856111,6.9544852307
12091,2012,2671,1500,4527,897,1171,5424,14.326747464,8.0457211514,24.281986435,4.8113412485,6.2810263122,29.093327683
12091,2013,2594,1620,1467,491,974,1958,13.562547709,8.4700567808,7.6701069737,2.5671591848,5.0924909287,10.237266158
12091,2014,2786,1597,304,429,1189,733,14.384440434,8.2454958269,1.5695871831,2.2149766498,6.1389446075,3.7845638329
12091,2015,2884,1794,1385,597,1090,1982,14.701646799,9.1451991528,7.060256871,3.0433020592,5.5564476458,10.10355893
12091,2016,2811,1836,834,395,975,1229,14.138985574,9.2348550389,4.1949178118,1.9868016015,4.9041305354,6.1817194133
12091,2017,2772,1829,1892,211,943,2103,13.760750586,9.0795140052,9.3922583367,1.0474453008,4.6812365812,10.439703638
53047,2010,151,133,77,16,18,93,NA,NA,NA,NA,NA,NA
53047,2011,583,407,-156,97,176,-59,14.122377792,9.8590184584,-3.778886682,2.3496923599,4.2633593334,-1.429194322
53047,2012,559,420,-321,53,139,-268,13.543143027,10.175527856,-7.777010575,1.2840547056,3.3676151712,-6.49295587
53047,2013,492,413,-245,41,79,-204,11.956257594,10.036452005,-5.953827461,0.9963547995,1.9198055893,-4.957472661
53047,2014,524,424,-1,64,100,63,12.729260294,10.300012146,-0.024292481,1.5547188145,2.4292481477,1.530426333
53047,2015,488,420,-51,80,68,29,11.81927171,10.172324013,-1.235210773,1.9375855262,1.6469476973,0.7023747533
53047,2016,510,475,28,82,35,110,12.316906766,11.471628851,0.6762223322,1.9803654016,0.8452779153,2.6565877338
53047,2017,498,483,168,82,15,250,11.968133043,11.607647108,4.0374424725,1.9706564449,0.360485935,6.0080989173
12093,2010,128,79,-20,11,49,-9,NA,NA,NA,NA,NA,NA
12093,2011,549,420,-362,52,129,-310,13.744930149,10.515247108,-9.063141555,1.3018877372,3.2296830404,-7.761253818
12093,2012,537,390,-366,64,147,-302,13.500263972,9.804660985,-9.201297232,1.6089700078,3.6956029867,-7.592327224
12093,2013,502,405,-368,36,97,-332,12.681731486,10.231277394,-9.296568101,0.9094468795,2.4504540919,-8.387121222
12093,2014,564,419,-93,50,145,-43,14.272699666,10.603299929,-2.353477073,1.2653102541,3.6693997368,-1.088166819
12093,2015,511,427,104,61,84,165,12.876401663,10.759732897,2.6206375205,1.5371046995,2.1166687665,4.15774222
12093,2016,516,435,746,64,81,810,12.819238796,10.806916427,18.533240584,1.5899831064,2.0123223691,20.123223691
12093,2017,503,418,754,64,85,818,12.223275255,10.157711842,18.322762509,1.5552477461,2.0655634128,19.878010255
40107,2010,47,29,15,1,18,16,NA,NA,NA,NA,NA,NA
40107,2011,215,181,59,5,34,64,17.518842942,14.748421267,4.8074964351,0.4074149521,2.7704216745,5.2149113872
40107,2012,180,172,-5,2,8,-3,14.607425441,13.958206533,-0.405761818,0.1623047271,0.6492189085,-0.243457091
40107,2013,152,161,-30,4,-9,-26,12.351698359,13.083048919,-2.437835202,0.3250446936,-0.731350561,-2.112790509
40107,2014,153,200,-86,8,-47,-78,12.516361257,16.361256545,-7.035340314,0.6544502618,-3.844895288,-6.380890052
40107,2015,148,184,-28,8,-36,-20,12.199142763,15.166501813,-2.307945928,0.6594131223,-2.96735905,-1.648532806
40107,2016,148,140,-15,10,8,-5,12.226352747,11.565468815,-1.239157373,0.8261049153,0.6608839323,-0.413052458
40107,2017,144,152,33,10,-8,43,11.877758073,12.537633522,2.7219862251,0.8248443106,-0.659875449,3.5468305357
40109,2010,3090,1582,495,354,1508,849,NA,NA,NA,NA,NA,NA
40109,2011,12275,6950,2588,1546,5325,4134,16.920532084,9.5802605279,3.5674408988,2.1310910469,7.3402715556,5.6985319457
40109,2012,12108,6570,4734,2206,5538,6940,16.441001206,8.9211577409,6.428121879,2.9954450497,7.5198434656,9.4235669287
40109,2013,12392,6893,5216,2190,5499,7406,16.539978511,9.2002963101,6.9619535113,2.9230594689,7.3396822007,9.8850129803
40109,2014,12331,7140,3232,2386,5191,5618,16.20149717,9.3811280347,4.2464714017,3.1349259791,6.8203691356,7.3813973808
40109,2015,12550,7030,1821,2841,5520,4662,16.265483801,9.1112630375,2.3601152192,3.6820907951,7.1542207634,6.0422060143
40109,2016,12367,7118,-528,2854,5249,2326,15.846483745,9.1206655856,-0.676554008,3.6569794298,6.7258181595,2.9804254218
40109,2017,12381,6986,-4385,2768,5395,-1617,15.750245203,8.8871022526,-5.578291351,3.5212566612,6.8631429506,-2.05703469
40111,2010,136,161,40,1,-25,41,NA,NA,NA,NA,NA,NA
40111,2011,519,518,-313,4,1,-309,12.997908814,12.972864674,-7.838815913,0.1001765612,0.0250441403,-7.738639352
40111,2012,537,492,-264,2,45,-262,13.537189458,12.402788106,-6.655154594,0.0504178378,1.1344013512,-6.604736756
40111,2013,502,531,-119,0,-29,-119,12.714171743,13.448655768,-3.013917206,0,-0.734484025,-3.013917206
40111,2014,513,470,-364,3,43,-361,13.070563206,11.974979936,-9.27423978,0.0764360421,1.0955832707,-9.197803738
40111,2015,502,533,14,4,-31,18,12.844623553,13.637817437,0.3582165931,0.102347598,-0.793193885,0.4605641911
40111,2016,476,494,45,3,-18,48,12.177183131,12.637664846,1.1512042876,0.0767469525,-0.460481715,1.2279512401
40111,2017,497,524,-150,3,-27,-147,12.738037266,13.430043314,-3.844478048,0.076889561,-0.692006049,-3.767588487
28105,2010,144,33,-60,20,111,-40,NA,NA,NA,NA,NA,NA
28105,2011,559,291,-354,65,268,-289,11.7118344,6.0968583371,-7.41679674,1.3618412093,5.614976063,-6.054955531
28105,2012,564,284,680,101,280,781,11.685607434,5.8842420413,14.08903024,2.0926353738,5.8013653928,16.181665613
28105,2013,566,285,-76,69,281,-7,11.564709248,5.8232193208,-1.552858486,1.4098320461,5.7414899269,-0.143026439
28105,2014,565,281,-436,94,284,-342,11.518858308,5.7288481142,-8.888888889,1.9164118247,5.7900101937,-6.972477064
28105,2015,553,311,109,105,242,214,11.227970438,6.3144643872,2.2131080971,2.1318931211,4.9135060505,4.3450012182
28105,2016,543,321,-232,109,222,-123,10.963163367,6.480986079,-4.684077166,2.2007086686,4.4821772883,-2.483368498
28105,2017,557,356,-88,108,201,20,11.209724486,7.1645635855,-1.771015718,2.17351929,4.0451609008,0.4025035722
21185,2010,127,121,62,16,6,78,NA,NA,NA,NA,NA,NA
21185,2011,538,309,39,59,229,98,8.8819183623,5.1013248586,0.6438565356,0.9740393743,3.7805935037,1.6178959099
21185,2012,498,336,1102,43,162,1145,8.1108152347,5.4723572668,17.948028893,0.7003314359,2.6384579679,18.648360329
21185,2013,518,377,786,4,141,790,8.2842223946,6.0292506617,12.570267958,0.0639708293,2.2549717329,12.634238787
21185,2014,498,387,810,14,111,824,7.8475866307,6.0984257552,12.76414693,0.2206148852,1.7491608755,12.984761815
21185,2015,547,413,425,20,134,445,8.5189222862,6.4320199346,6.6189067124,0.3114779629,2.0869023517,6.9303846753
21185,2016,535,406,696,20,129,716,8.2414196808,6.2542362438,10.721547846,0.3080904554,1.9871834371,11.029638302
21185,2017,538,396,925,20,142,945,8.1669209342,6.0113395724,14.041639153,0.3036030087,2.1555813618,14.345242161
48359,2010,5,5,-2,0,0,-2,NA,NA,NA,NA,NA,NA
48359,2011,15,15,22,0,0,22,7.2797864596,7.2797864596,10.677020141,0,0,10.677020141
48359,2012,20,13,-34,0,7,-34,9.7158124848,6.3152781151,-16.51688122,0,3.4005343697,-16.51688122
48359,2013,20,20,42,0,0,42,9.6735187424,9.6735187424,20.314389359,0,0,20.314389359
48359,2014,33,14,-39,0,19,-39,15.869199327,6.7323875932,-18.7545083,0,9.1368117336,-18.7545083
48359,2015,21,19,-9,0,2,-9,10.159651669,9.1920657958,-4.35413643,0,0.9675858732,-4.35413643
48359,2016,19,11,1,0,8,1,9.1831802803,5.316578057,0.4833252779,0,3.8666022233,0.4833252779
48359,2017,24,8,24,0,16,24,11.461318052,3.8204393505,11.461318052,0,7.6408787011,11.461318052
38065,2010,6,7,-7,0,-1,-7,NA,NA,NA,NA,NA,NA
38065,2011,18,10,2,-1,8,1,9.7666847531,5.425935974,1.0851871948,-0.542593597,4.3407487792,0.5425935974
38065,2012,19,13,-8,0,6,-8,10.289737341,7.0403466017,-4.332520986,0,3.2493907392,-4.332520986
38065,2013,17,10,32,0,7,32,9.1103965702,5.359056806,17.148981779,0,3.7513397642,17.148981779
38065,2014,28,18,-29,0,10,-29,14.925373134,9.5948827292,-15.45842217,0,5.3304904051,-15.45842217
38065,2015,20,12,-11,0,8,-11,10.72673639,6.4360418343,-5.899705015,0,4.2906945562,-5.899705015
38065,2016,25,11,21,0,14,21,13.294336613,5.8495081095,11.167242755,0,7.4448285031,11.167242755
38065,2017,25,6,24,0,19,24,13.027618551,3.1266284523,12.506513809,0,9.900990099,12.506513809
27109,2010,556,217,-228,134,339,-94,NA,NA,NA,NA,NA,NA
27109,2011,2184,942,-409,483,1242,74,15.045156135,6.4892569043,-2.817522371,3.3272941452,8.5558992305,0.5097717738
27109,2012,2091,925,-524,488,1166,-36,14.285226302,6.3193851409,-3.579846285,3.3339026473,7.9658411614,-0.245943638
27109,2013,2153,967,302,513,1186,815,14.554722172,6.5371185977,2.0415820233,3.4679853574,8.0176035748,5.5095673807
27109,2014,2192,988,-666,613,1204,-53,14.663384352,6.6092261586,-4.455207107,4.1006635984,8.0541581933,-0.354543509
27109,2015,2229,990,-633,678,1239,45,14.791368052,6.5695174391,-4.200509635,4.4991240643,8.2218506132,0.298614429
27109,2016,2126,1039,72,691,1087,763,13.963095656,6.8239211604,0.4728800034,4.5383344772,7.139174496,5.0112144806
27109,2017,2145,1032,-48,690,1113,642,13.923463145,6.6988410096,-0.311574,4.4788762564,7.2246221354,4.167302256
16071,2010,17,14,-1,0,3,-1,NA,NA,NA,NA,NA,NA
16071,2011,54,37,-82,3,17,-79,12.682010333,8.6895255989,-19.25786754,0.7045561296,3.9924847346,-18.55331141
16071,2012,48,36,-30,7,12,-23,11.369019422,8.5267645666,-7.105637139,1.6579819991,2.8422548555,-5.44765514
16071,2013,52,38,13,4,14,17,12.287334594,8.9792060491,3.0718336484,0.9451795841,3.3081285444,4.0170132325
16071,2014,45,42,-89,9,3,-80,10.685029087,9.9726938146,-21.13261308,2.1370058174,0.7123352725,-18.99560727
16071,2015,42,40,65,9,2,74,9.9703264095,9.4955489614,15.430267062,2.1364985163,0.4747774481,17.566765579
16071,2016,54,30,39,9,24,48,12.600630032,7.0003500175,9.1004550228,2.1001050053,5.600280014,11.200560028
16071,2017,53,29,72,9,24,81,12.117055327,6.630086877,16.46090535,2.0576131687,5.4869684499,18.518518519
36065,2010,671,638,-261,146,33,-115,NA,NA,NA,NA,NA,NA
36065,2011,2622,2516,-1249,686,106,-563,11.17801912,10.72612361,-5.324693319,2.9245313183,0.4518955098,-2.400162
36065,2012,2688,2454,-1326,725,234,-601,11.47942842,10.480103178,-5.662843038,3.0962000017,0.9993252419,-2.566643036
36065,2013,2653,2614,-1007,772,39,-235,11.343763496,11.177006324,-4.305755688,3.3009368332,0.1667571716,-1.004818855
36065,2014,2587,2352,-1623,845,235,-778,11.079229122,10.072805139,-6.950749465,3.6188436831,1.0064239829,-3.331905782
36065,2015,2541,2639,-2012,882,-98,-1130,10.92332394,11.344609161,-8.649243514,3.7915669876,-0.421285221,-4.857676526
36065,2016,2456,2464,-1637,905,-8,-732,10.602499099,10.637034927,-7.06689374,3.9068655067,-0.034535828,-3.160028233
36065,2017,2463,2474,-821,893,-11,72,10.648393338,10.695950109,-3.549464446,3.8607451281,-0.047556771,0.3112806822
55085,2010,86,122,-25,4,-36,-21,NA,NA,NA,NA,NA,NA
55085,2011,303,437,-33,7,-134,-26,8.450939923,12.188319295,-0.920399398,0.1952362358,-3.737379372,-0.725163162
55085,2012,325,424,-23,12,-99,-11,9.1000728006,11.872094977,-0.644005152,0.336002688,-2.772022176,-0.308002464
55085,2013,285,444,35,10,-159,45,8.00674252,12.473662031,0.9832841691,0.280938334,-4.466919511,1.2642225032
55085,2014,281,442,-73,14,-161,-59,7.9333709768,12.478825522,-2.060982496,0.395256917,-4.545454545,-1.665725579
55085,2015,293,480,164,14,-187,178,8.3004008555,13.597926316,4.645958158,0.3966061842,-5.297525461,5.0425643423
55085,2016,307,440,203,13,-133,216,8.6886382611,12.452771449,5.7452559186,0.3679227928,-3.764133188,6.1131787114
55085,2017,302,442,8,14,-140,22,8.551849125,12.516282494,0.2265390497,0.3964433369,-3.964433369,0.6229823866
36067,2010,1367,858,-291,323,509,32,NA,NA,NA,NA,NA,NA
36067,2011,5322,4175,-2421,1601,1147,-820,11.378164699,8.92593717,-5.175974584,3.4228563854,2.4522275291,-1.753118199
36067,2012,5438,4133,-3297,1717,1305,-1580,11.625234755,8.8354349469,-7.048252848,3.6705641916,2.7897998078,-3.377688656
36067,2013,5373,4168,-1389,1820,1205,431,11.469777361,8.8974561771,-2.965107157,3.8851656052,2.5723211837,0.9200584483
36067,2014,5162,4193,-3383,1970,969,-1413,11.005481421,8.9395551329,-7.212619846,4.2000771791,2.0659262876,-3.012542667
36067,2015,5327,4456,-3560,2086,871,-1474,11.3696028,9.5105969735,-7.598232771,4.45222291,1.8590058267,-3.146009861
36067,2016,5248,4254,-4710,2117,994,-2593,11.227253473,9.1007500524,-10.07628885,4.5289816316,2.1265034208,-5.547307213
36067,2017,5157,4188,-4324,2103,969,-2221,11.066131779,8.9868062612,-9.278641421,4.5127157515,2.0793255174,-4.76592567
37133,2010,1035,158,6675,495,877,7170,NA,NA,NA,NA,NA,NA
37133,2011,4432,864,-5869,278,3568,-5591,23.834235901,4.6463853381,-31.56207818,1.4950175046,19.187850563,-30.06706068
37133,2012,4189,924,-576,3008,3265,2432,22.297808012,4.9183992846,-3.066015138,16.01141239,17.379408727,12.945397251
37133,2013,4559,898,-3423,1394,3661,-2029,23.80082277,4.688119949,-17.87019442,7.2775492305,19.112702821,-10.59264519
37133,2014,4253,980,-4655,787,3273,-3868,22.137033075,5.1009387289,-24.22945896,4.0963661017,17.036094347,-20.13309286
37133,2015,4293,1079,-3450,1454,3214,-1996,22.30396359,5.6058645968,-17.92421952,7.5541493269,16.698098994,-10.37007019
37133,2016,4068,1163,-4418,623,2905,-3795,21.116725973,6.0370580892,-22.93355343,3.2339528715,15.079667884,-19.69960056
37133,2017,3939,1118,-1058,-56,2821,-1114,20.404463185,5.7913657885,-5.480559038,-0.290086301,14.613097396,-5.770645338
36069,2010,248,284,107,19,-36,126,NA,NA,NA,NA,NA,NA
36069,2011,1050,1044,322,122,6,444,9.6880002583,9.6326402569,2.9709867459,1.1256533634,0.0553600015,4.0966401092
36069,2012,1037,1022,-91,122,15,31,9.5475281845,9.4094250768,-0.837825521,1.1232386099,0.1381031078,0.2854130894
36069,2013,1045,1029,348,133,16,481,9.5982511894,9.4512923196,3.19635542,1.2215956059,0.1469588699,4.417951026
36069,2014,1102,1066,143,146,36,289,10.085248722,9.7557850616,1.3087028741,1.3361581792,0.3294636606,2.6448610533
36069,2015,1019,1069,-86,159,-50,73,9.3122718196,9.7692037048,-0.785922842,1.4530433948,-0.456931885,0.6671205523
36069,2016,1024,1037,14,157,-13,171,9.3508723067,9.4695845528,0.1278439573,1.4336786642,-0.118712246,1.5615226215
36069,2017,1023,1067,207,158,-44,365,9.3218215368,9.7227600975,1.8862336834,1.4397339226,-0.400938561,3.325967606
26131,2010,13,14,-1,0,-1,-1,NA,NA,NA,NA,NA,NA
26131,2011,36,103,-86,2,-67,-84,5.3723324877,15.370840173,-12.83390539,0.298462916,-9.998507685,-12.53544247
26131,2012,22,80,-161,1,-58,-160,3.3750095881,12.272762139,-24.6989338,0.1534095267,-8.89775255,-24.54552428
26131,2013,31,83,-43,3,-52,-40,4.8700023565,13.039038567,-6.755164559,0.4712905506,-8.169036211,-6.283874008
26131,2014,34,101,-66,3,-67,-63,5.4360860181,16.148373171,-10.55240227,0.4796546487,-10.71228715,-10.07274762
26131,2015,28,112,-74,4,-84,-70,4.5804024211,18.321609684,-12.10534926,0.654343203,-13.74120726,-11.45100605
26131,2016,28,105,-32,4,-77,-28,4.679144385,17.546791444,-5.347593583,0.6684491979,-12.86764706,-4.679144385
26131,2017,31,108,23,4,-77,27,5.2488994243,18.286488317,3.8943447342,0.6772773451,-13.03758889,4.5716220792
06059,2010,9301,4311,130,2087,4990,2217,NA,NA,NA,NA,NA,NA
06059,2011,38239,17673,5283,10888,20566,16171,12.59813517,5.8225069396,1.7405253303,3.5871360583,6.7756282306,5.3276613886
06059,2012,37844,17811,2097,10333,20033,12430,12.329343064,5.8027145471,0.683189737,3.3664280172,6.5266285173,4.0496177542
06059,2013,37619,18768,-1171,11007,18851,9836,12.137050363,6.055136001,-0.377800738,3.5511978881,6.0819143625,3.1733971497
06059,2014,37896,18377,-8657,12653,19519,3996,12.12594588,5.8802646039,-2.770063159,4.0487015309,6.2456812757,1.2786383717
06059,2015,38580,18952,-9671,14165,19628,4494,12.252819689,6.0190626942,-3.071462395,4.4987348598,6.2337569946,1.4272724645
06059,2016,37269,20459,-14078,14397,16810,319,11.759974592,6.4556956234,-4.442215308,4.5428735466,5.3042789691,0.1006582386
06059,2017,37171,20686,-17989,14239,16485,-3750,11.674120221,6.4967542139,-5.649720176,4.4719754062,5.1773660068,-1.17774477
12095,2010,3653,1550,-1185,1855,2103,670,NA,NA,NA,NA,NA,NA
12095,2011,15062,6835,4259,9619,8227,13878,12.987500113,5.8936106276,3.6724049251,8.2941683434,7.0938894855,11.966573269
12095,2012,15658,6839,13690,9938,8819,23628,13.189588329,5.7608631102,11.531834476,8.371320016,7.4287252185,19.903154492
12095,2013,15785,7207,5876,10313,8578,16189,12.982121107,5.9272820283,4.8326223391,8.4817621142,7.0548390784,13.314384453
12095,2014,16081,7245,8631,12428,8836,21059,12.934641892,5.8274659853,6.9422855651,9.9963764342,7.107175907,16.938661999
12095,2015,16381,7494,11609,13183,8887,24792,12.846659229,5.8771054432,9.1042590193,10.338655065,6.9695537862,19.442914084
12095,2016,16793,8180,9221,13732,8613,22953,12.840618962,6.2547646702,7.0507561154,10.500052378,6.5858542915,17.550808493
12095,2017,16839,8275,3113,13700,8564,16813,12.601339608,6.1925343106,2.3295902488,10.252292454000001,6.4088052974,12.581882703
18117,2010,47,27,-52,0,20,-52,NA,NA,NA,NA,NA,NA
18117,2011,233,227,118,3,6,121,11.725630316,11.423682754,5.9383020482,0.1509737809,0.3019475618,6.0892758291
18117,2012,209,209,-202,3,0,-199,10.536398467,10.536398467,-10.18350474,0.1512401694,0,-10.03226457
18117,2013,237,223,69,8,14,77,11.980588414,11.27287433,3.4880194116,0.4044080477,0.7077140835,3.8924274593
18117,2014,242,217,-95,7,25,-88,12.225927049,10.962918056,-4.799434172,0.3536425179,1.2630089926,-4.445791654
18117,2015,222,237,-133,8,-15,-125,11.27361365,12.035344302,-6.754011781,0.4062563478,-0.761730652,-6.347755434
18117,2016,244,221,-171,8,23,-163,12.47986088,11.303480551,-8.74613201,0.4091757666,1.1763803289,-8.336956244
18117,2017,230,212,-80,8,18,-72,11.823065258,10.89778189,-4.112370525,0.4112370525,0.925283368,-3.701133472
36071,2010,1266,521,-237,158,745,-79,NA,NA,NA,NA,NA,NA
36071,2011,4927,2598,-2166,661,2329,-1505,13.176773897,6.9480938875,-5.792752641,1.7677790838,6.2286800093,-4.024973557
36071,2012,4889,2444,-3415,755,2445,-2660,13.063041399,6.5301847369,-9.124623927,2.0173033864,6.5328566619,-7.10732054
36071,2013,4697,2653,-1812,724,2044,-1088,12.536465715,7.0809545543,-4.83629463,1.9323826224,5.4555111606,-2.903912007
36071,2014,4810,2614,-2076,748,2196,-1328,12.806432503,6.9596703875,-5.527266918,1.991520065,5.8467621159,-3.535746853
36071,2015,4906,2651,-1598,857,2255,-741,13.020549963,7.0357680293,-4.241100457,2.2744825353,5.9847819337,-1.966617921
36071,2016,4881,2715,-626,833,2166,207,12.887826272,7.1687048408,-1.652894744,2.1994589806,5.719121431,0.5465642365
36071,2017,4883,2783,-595,812,2100,217,12.81390189,7.3031105793,-1.561390871,2.1308393066,5.5107913103,0.5694484354
37135,2010,314,240,46,152,74,198,NA,NA,NA,NA,NA,NA
37135,2011,1232,749,-102,633,483,531,9.162848813,5.5705955852,-0.758612483,4.7078598203,3.5922532278,3.9492473374
37135,2012,1278,714,1762,630,564,2392,9.3657936008,5.2325325751,12.912776467,4.6169405074,4.1332610257,17.529716974
37135,2013,1282,721,274,660,561,934,9.2437701892,5.1987194278,1.9756575911,4.7588832487,4.0450507614,6.7345408399
37135,2014,1157,765,-140,725,392,585,8.2693359159,5.4676248709,-1.000611087,5.1817359888,2.801711045,4.1811249013
37135,2015,1229,778,-62,780,451,718,8.7174867535,5.5184741206,-0.439775573,5.5326604294,3.1990126329,5.0928848568
37135,2016,1192,800,-27,792,392,765,8.3859212202,5.6281350471,-0.189949558,5.5718536966,2.7577861731,5.3819041388
37135,2017,1188,798,1051,787,390,1838,8.2594926808,5.5480430634,7.3070090973,5.4715662793,2.7114496174,12.778575377
48361,2010,266,180,91,6,86,97,NA,NA,NA,NA,NA,NA
48361,2011,990,888,227,4,102,231,12.04745969,10.806206267,2.7623973228,0.0486766048,1.2412534226,2.8110739276
48361,2012,1098,894,364,-6,204,358,13.290886422,10.821541404,4.4060862092,-0.072627795,2.4693450183,4.3334584145
48361,2013,1133,954,-233,-12,179,-245,13.674904197,11.514438309,-2.812226547,-0.144835702,2.1604658882,-2.957062249
48361,2014,1127,958,287,-11,169,276,13.573325465,11.537928833,3.4565611432,-0.132481438,2.0353966314,3.3240797057
48361,2015,1200,936,436,-8,264,428,14.356385301,11.197980535,5.2161533262,-0.095709235,3.1584047663,5.1204440909
48361,2016,1208,978,362,-9,230,353,14.343726994,11.612719371,4.2983685198,-0.106865516,2.7310076231,4.1915030041
48361,2017,1179,962,335,-8,217,327,13.906991832,11.347350417,3.9515201557,-0.09436466,2.5596414143,3.8571554953
50017,2010,79,72,3,0,7,3,NA,NA,NA,NA,NA,NA
50017,2011,290,242,19,2,48,21,10.008628128,8.35202761,0.6557377049,0.0690250216,1.6566005177,0.7247627265
50017,2012,275,238,-137,5,37,-132,9.4961842605,8.2185158327,-4.730826341,0.1726578956,1.2776684278,-4.558168445
50017,2013,255,251,-76,11,4,-65,8.8296398892,8.6911357341,-2.631578947,0.3808864266,0.1385041551,-2.250692521
50017,2014,279,268,13,12,11,25,9.6661873993,9.2850832366,0.4503958286,0.4157499957,0.3811041627,0.8661458243
50017,2015,261,259,-8,15,2,7,9.0369267524,8.9676782716,-0.276993923,0.5193636065,0.0692484809,0.242369683
50017,2016,255,253,15,17,2,32,8.8232241099,8.7540223522,0.5190131829,0.5882149407,0.0692017577,1.1072281236
50017,2017,254,258,45,17,-4,62,8.7751118481,8.9133025859,1.5546457999,0.5873106355,-0.138190738,2.1419564354
51137,2010,90,110,38,7,-20,45,NA,NA,NA,NA,NA,NA
51137,2011,399,344,307,56,55,363,11.808926246,10.181129395,9.086066059,1.6573931573,1.627796851,10.743459216
51137,2012,390,337,179,51,53,230,11.423884707,9.871408067,5.2432701602,1.4938926155,1.5524766396,6.7371627757
51137,2013,353,344,289,46,9,335,10.245842162,9.9846167242,8.3882390503,1.3351522364,0.2612254376,9.7233912867
51137,2014,366,365,270,39,1,309,10.522835415,10.494084499,7.7627474376,1.121285741,0.0287509164,8.8840331786
51137,2015,399,405,230,49,-6,279,11.376272346,11.547344111,6.5577509765,1.3970860776,-0.171071765,7.9548370541
51137,2016,377,343,189,49,34,238,10.666289433,9.7043429056,5.3472909888,1.3863347008,0.9619465271,6.7336256896
51137,2017,380,320,482,50,60,532,10.621348911,8.9442938201,13.472342566,1.3975459094,1.6770550913,14.869888476
45075,2010,304,271,-232,5,33,-227,NA,NA,NA,NA,NA,NA
45075,2011,1196,1056,-784,5,140,-779,13.000989206,11.479134282,-8.522387573,0.0543519616,1.5218549237,-8.468035611
45075,2012,1144,957,-431,15,187,-416,12.494470869,10.452105438,-4.707270056,0.1638261041,2.0423654305,-4.543443952
45075,2013,1066,1059,-831,22,7,-809,11.708174305,11.631291359,-9.127103984,0.2416321151,0.0768829457,-8.885471869
45075,2014,1060,1036,-715,42,24,-673,11.734945228,11.469248355,-7.915552677,0.4649695279,0.2656968731,-7.450583149
45075,2015,995,1061,-878,46,-66,-832,11.109870478,11.84680661,-9.803483698,0.5136221527,-0.736936132,-9.289861545
45075,2016,977,1112,-690,47,-135,-643,11.011614605,12.533178547,-7.776882372,0.5297296688,-1.521563942,-7.247152703
45075,2017,955,1104,-755,47,-149,-708,10.86400091,12.55901257,-8.588817473,0.5346681076,-1.69501166,-8.054149366
29149,2010,33,32,52,0,1,52,NA,NA,NA,NA,NA,NA
29149,2011,129,143,130,-7,-14,123,11.737943585,13.011828935,11.828935396,-0.636942675,-1.27388535,11.191992721
29149,2012,142,127,-88,-7,15,-95,12.903812077,11.540733336,-7.996728611,-0.636103412,1.3630787405,-8.632832023
29149,2013,124,134,-21,-4,-10,-25,11.328339119,12.241914855,-1.918509044,-0.365430294,-0.913575735,-2.283939339
29149,2014,133,142,-95,-3,-9,-98,12.230447377,13.058071635,-8.736033841,-0.275874753,-0.827624259,-9.011908593
29149,2015,142,147,36,-3,-5,33,13.10567605,13.567143516,3.3225657591,-0.27688048,-0.461467467,3.0456852792
29149,2016,111,142,-75,-3,-31,-78,10.283967202,13.156066151,-6.948626488,-0.27794506,-2.872098948,-7.226571548
29149,2017,117,144,-149,-3,-27,-152,10.987463023,13.523031413,-13.99258111,-0.281729821,-2.53556839,-14.27431094
36073,2010,112,118,-43,10,-6,-33,NA,NA,NA,NA,NA,NA
36073,2011,431,412,-249,29,19,-220,10.084702139,9.6401329028,-5.826196827,0.6785530441,0.4445692358,-5.147643783
36073,2012,401,422,-262,34,-21,-228,9.4318542649,9.9257917701,-6.162458398,0.7997083417,-0.493937505,-5.362750056
36073,2013,411,423,-165,30,-12,-135,9.7125234837,9.9961008117,-3.89918826,0.70894332,-0.283577328,-3.19024494
36073,2014,404,417,-376,32,-13,-344,9.6040698435,9.9131116949,-8.93844124,0.7607184034,-0.309041851,-8.177722837
36073,2015,447,447,-417,34,0,-383,10.719167406,10.719167406,-9.999760198,0.8153281696,0,-9.184432028
36073,2016,447,396,-308,37,51,-271,10.796579875,9.5647553258,-7.439254142,0.893676634,1.2318245495,-6.545577508
36073,2017,431,411,-367,37,20,-330,10.477058645,9.9908842297,-8.921300517,0.8994226679,0.4861744151,-8.021877849
50019,2010,74,53,-9,2,21,-7,NA,NA,NA,NA,NA,NA
50019,2011,264,285,-65,18,-21,-47,9.70267191,10.474475357,-2.388915432,0.661545812,-0.771803447,-1.72736962
50019,2012,296,310,-20,17,-14,-3,10.897176306,11.412583293,-0.736295696,0.6258513419,-0.515406987,-0.110444354
50019,2013,259,317,31,9,-58,40,9.5424066023,11.679316189,1.1421413308,0.3315894186,-2.136909587,1.4737307494
50019,2014,262,295,-75,5,-33,-70,9.6762875556,10.895056599,-2.769929644,0.1846619763,-1.218769043,-2.585267668
50019,2015,279,350,54,6,-71,60,10.32759578,12.955765316,1.9988895058,0.222098834,-2.628169535,2.2209883398
50019,2016,262,312,-211,6,-50,-205,9.7472051191,11.607358768,-7.849848397,0.2232184378,-1.860153649,-7.62662996
50019,2017,269,292,109,6,-23,115,10.038811763,10.897148828,4.0677713092,0.223914017,-0.858337065,4.2916853262
22071,2010,1035,647,3090,205,388,3295,NA,NA,NA,NA,NA,NA
22071,2011,4668,2861,10000,720,1807,10720,13.177413777,8.0763883498,28.229249737,2.0325059811,5.1010254275,30.261755718
22071,2012,4698,2990,6570,956,1708,7526,12.858180942,8.1834740353,17.981747295,2.616522133,4.6747069071,20.598269428
22071,2013,4730,3115,6394,863,1615,7257,12.626717654,8.3154810766,17.068759552,2.3037753352,4.3112365774,19.372534887
22071,2014,4972,3165,2821,943,1807,3764,13.017615148,8.2865550971,7.3858995036,2.4689483275,4.7310600507,9.8548478311
22071,2015,5046,3187,2982,1063,1859,4045,13.013975968,8.2194889835,7.6907800906,2.7415490397,4.7944869847,10.43232913
22071,2016,5057,3331,-457,1042,1726,585,12.90492158,8.5003547131,-1.166214982,2.6590722339,4.4045668672,1.4928572522
22071,2017,4938,3437,-2210,991,1501,-1219,12.559883914,8.7420658186,-5.621171213,2.5206247385,3.8178180953,-3.100546474
20139,2010,47,55,-10,0,-8,-10,NA,NA,NA,NA,NA,NA
20139,2011,182,166,47,1,16,48,11.160166789,10.179053225,2.8820210939,0.0613195977,0.9811135639,2.9433406917
20139,2012,156,171,-155,4,-15,-151,9.5952761717,10.517898881,-9.533767991,0.2460327224,-0.922622709,-9.287735269
20139,2013,156,188,-64,1,-32,-63,9.6726190476,11.656746032,-3.968253968,0.0620039683,-1.984126984,-3.90625
20139,2014,172,195,-91,1,-23,-90,10.733899151,12.169246131,-5.678981528,0.0624063904,-1.43534698,-5.616575137
20139,2015,158,215,-52,1,-57,-51,9.9286769095,13.510541364,-3.2676658180000002,0.0628397273,-3.581864455,-3.204826091
20139,2016,161,206,-26,1,-45,-25,10.174418605,13.018200202,-1.643073812,0.0631951466,-2.843781598,-1.579878665
20139,2017,155,204,34,1,-49,35,9.8222489782,12.927347042,2.1545578404,0.0633693482,-3.105098064,2.2179271886
29151,2010,38,19,-22,0,19,-22,NA,NA,NA,NA,NA,NA
29151,2011,148,137,-10,1,11,-9,10.661287999,9.8688949719,-0.720357297,0.0720357297,0.7923930269,-0.648321567
29151,2012,155,123,-97,2,32,-95,11.190123813,8.8799047035,-7.002851677,0.1443886944,2.3102191098,-6.858462982
29151,2013,143,135,-179,3,8,-176,10.409084292,9.8267578978,-13.02955306,0.2183723977,0.5823263939,-12.81118067
29151,2014,137,123,-56,3,14,-53,10.046934585,9.0202405397,-4.106776181,0.2200058668,1.0266940452,-3.886770314
29151,2015,158,136,-121,3,22,-118,11.644618049,10.023215536,-8.917713822,0.2211003427,1.6214025132,-8.69661348
29151,2016,161,115,27,3,46,30,11.874907804,8.4820770025,1.9914441658,0.221271574,3.392830801,2.2127157398
29151,2017,164,125,25,3,39,28,12.033164576,9.1716193411,1.8343238682,0.2201188642,2.8615452344,2.0544427324
40113,2010,114,73,-25,6,41,-19,NA,NA,NA,NA,NA,NA
40113,2011,531,482,205,20,49,225,11.145978737,10.117442092,4.3030614708,0.4198108752,1.0285366442,4.722872346
40113,2012,405,478,-261,10,-73,-251,8.5055443548,10.038642473,-5.481350806,0.2100134409,-1.533098118,-5.271337366
40113,2013,424,435,-60,3,-11,-57,8.9413749473,9.1733445803,-1.265288908,0.0632644454,-0.231969633,-1.202024462
40113,2014,449,448,102,6,1,108,9.465584484,9.4445030041,2.1503109518,0.1264888795,0.0210814799,2.2767998313
40113,2015,443,464,-138,6,-21,-132,9.344512999,9.7874808838,-2.910931815,0.1265622528,-0.442967885,-2.784369562
40113,2016,455,518,43,7,-63,50,9.6146734709,10.945935951,0.9086394709,0.1479180534,-1.331262481,1.0565575243
40113,2017,456,554,10,7,-98,17,9.6456901111,11.718667372,0.2115282919,0.1480698043,-2.072977261,0.3595980962
20141,2010,12,6,-18,0,6,-18,NA,NA,NA,NA,NA,NA
20141,2011,38,53,-5,2,-15,-3,9.9022801303,13.811074919,-1.302931596,0.5211726384,-3.908794788,-0.781758958
20141,2012,40,57,-9,3,-17,-6,10.480807022,14.935150007,-2.35818158,0.7860605267,-4.454342984,-1.572121053
20141,2013,43,67,7,7,-24,14,11.31430075,17.629259308,1.8418629128,1.8418629128,-6.314958558,3.6837258255
20141,2014,53,60,-44,6,-7,-38,14.047177312,15.902464882,-11.66180758,1.5902464882,-1.85528757,-10.07156109
20141,2015,39,75,-79,6,-36,-73,10.551948052,20.292207792,-21.37445887,1.6233766234,-9.74025974,-19.75108225
20141,2016,56,50,-29,6,6,-23,15.414258189,13.762730526,-7.982383705,1.6515276631,1.6515276631,-6.330856042
20141,2017,54,37,-37,5,17,-32,14.929499585,10.229471938,-10.22947194,1.3823610727,4.7000276472,-8.847110865
12097,2010,889,441,138,612,448,750,NA,NA,NA,NA,NA,NA
12097,2011,3751,1688,3200,3585,2063,6785,13.675182515,6.1540144189,11.666378045,13.069989154,7.5211680961,24.736367199
12097,2012,3784,1731,4512,3825,2053,8337,13.32565629,6.0958538685,15.889366063,13.470041044,7.2298024218,29.359407107
12097,2013,3879,1870,4563,3904,2009,8467,13.173065004,6.3505108426,15.495925655,13.257964882,6.8225541619,28.753890537
12097,2014,4078,1940,4748,5044,2138,9792,13.338064999,6.3452295485,15.529458709,16.497596826,6.9928354509,32.027055535
12097,2015,4172,2044,5028,5231,2128,10259,13.120796557,6.4283097225,15.812887126,16.451315146,6.6924868344,32.264202272
12097,2016,4284,2187,6239,5458,2097,11697,12.939099549,6.6054646855,18.843847358,16.484968566,6.3336348631,35.328815924
12097,2017,4364,2235,6583,5453,2129,12036,12.646159642,6.4766651695,19.076459423,15.801903879,6.1694944724,34.878363302
19143,2010,15,9,-15,1,6,-14,NA,NA,NA,NA,NA,NA
19143,2011,58,84,-122,4,-26,-118,9.0852130326,13.157894737,-19.11027569,0.626566416,-4.072681704,-18.48370927
19143,2012,63,58,-122,4,5,-118,10.067114094,9.2681367849,-19.49504634,0.6391818472,0.798977309,-18.85586449
19143,2013,85,75,13,7,10,20,13.671089666,12.062726176,2.0908725372,1.1258544431,1.6083634901,3.2167269803
19143,2014,76,65,-24,8,11,-16,12.200016053,10.434224256,-3.852636648,1.2842122161,1.7657917971,-2.568424432
19143,2015,85,76,-85,8,9,-77,13.725173583,12.27191991,-13.72517358,1.2917810431,1.4532536735,-12.43339254
19143,2016,64,73,-77,9,-9,-68,10.454953851,11.925181737,-12.57861635,1.4702278853,-1.470227885,-11.10838847
19143,2017,74,80,-41,9,-6,-32,12.202160112,13.191524446,-6.760656278,1.4840465001,-0.989364333,-5.276609778
26133,2010,66,79,-9,0,-13,-9,NA,NA,NA,NA,NA,NA
26133,2011,285,263,-63,6,22,-57,12.13488887,11.198160606,-2.682449119,0.2554713446,0.9367282636,-2.426977774
26133,2012,273,226,-203,6,47,-197,11.669908308,9.6608032146,-8.677624126,0.2564815013,2.0091050933,-8.421142625
26133,2013,295,207,-102,5,88,-97,12.653069978,8.8785948659,-4.374959789,0.2144588132,3.7744751121,-4.160500976
26133,2014,248,247,-122,10,1,-112,10.664831857,10.621828503,-5.24640922,0.4300335426,0.0430033543,-4.816375677
26133,2015,255,226,-69,12,29,-57,10.99967648,9.7487328804,-2.976383048,0.5176318344,1.2509435997,-2.458751213
26133,2016,247,258,4,13,-11,17,10.660796754,11.135569079,0.1726444819,0.561094566,-0.474772325,0.7337390479
26133,2017,234,234,78,13,0,91,10.079472766,10.079472766,3.3598242553,0.5599707092,0,3.9197949646
26135,2010,13,50,0,0,-37,0,NA,NA,NA,NA,NA,NA
26135,2011,80,125,55,2,-45,57,9.2926007666,14.519688698,6.3886630271,0.2323150192,-5.227087931,6.6209780462
26135,2012,89,122,-5,1,-33,-4,10.354255134,14.193473329,-0.58169972700000006,0.1163399453,-3.839218196,-0.465359781
26135,2013,78,126,-163,1,-48,-162,9.2051690565,14.869888476,-19.23644303,0.1180149879,-5.664719419,-19.11842804
26135,2014,80,129,-7,2,-49,-5,9.5883022712,15.461137412,-0.838976449,0.2397075568,-5.872835141,-0.599268892
26135,2015,97,108,-22,2,-11,-20,11.688155199,13.013616098,-2.650921798,0.2409928907,-1.325460899,-2.409928907
26135,2016,98,124,3,2,-26,5,11.847195358,14.99032882,0.3626692456,0.2417794971,-3.143133462,0.6044487427
26135,2017,98,111,37,2,-13,39,11.843615928,13.414707837,4.4715692791,0.2417064475,-1.571091909,4.7132757266
36075,2010,345,218,-97,14,127,-83,NA,NA,NA,NA,NA,NA
36075,2011,1339,1070,-485,51,269,-434,10.970104622,8.7662523861,-3.973488231,0.4178307212,2.2038522354,-3.55565751
36075,2012,1332,999,-915,65,333,-850,10.942788604,8.2070914528,-7.517005685,0.5339949394,2.7356971509,-6.983010746
36075,2013,1330,1114,-533,69,216,-464,10.960258761,9.1802468118,-4.3923443,0.5686149282,1.7800119492,-3.823729372
36075,2014,1308,1080,-887,86,228,-801,10.815325018,8.9300848771,-7.334245635,0.7110993513,1.8852401407,-6.623146284
36075,2015,1263,1098,-1017,86,165,-931,10.50067344,9.128851494,-8.45541163,0.7150102263,1.3718219458,-7.740401403
36075,2016,1163,1036,-1205,82,127,-1123,9.7401237825,8.6764989154,-10.09187374,0.6867499142,1.063624867,-9.405123824
36075,2017,1150,1060,-602,83,90,-519,9.6889019947,8.9306400994,-5.071929566,0.69928597,0.7582618952,-4.372643596
08089,2010,45,31,35,2,14,37,NA,NA,NA,NA,NA,NA
08089,2011,250,220,-58,4,30,-54,13.247138618,11.657481984,-3.073336159,0.2119542179,1.5896566342,-2.861381942
08089,2012,266,265,-211,5,1,-206,14.180238292,14.126929125,-11.24823413,0.2665458326,0.0533091665,-10.9816883
08089,2013,190,225,-142,-3,-35,-145,10.232658337,12.117621715,-7.647565704,-0.16156829,-1.884963378,-7.809133994
08089,2014,218,263,-61,-1,-45,-62,11.832713654,14.275246289,-3.310988683,-0.054278503,-2.442532635,-3.365267186
08089,2015,191,244,-102,0,-53,-102,10.442864954,13.340623291,-5.576817933,0,-2.897758338,-5.576817933
08089,2016,228,243,43,1,-15,44,12.509944857,13.332967545,2.3593317056,0.0548681792,-0.823022688,2.4141998848
08089,2017,217,208,78,1,9,79,11.869273896,11.376999863,4.2663749487,0.0546971147,0.4922740325,4.3210720634
35035,2010,207,95,357,71,112,428,NA,NA,NA,NA,NA,NA
35035,2011,906,567,510,185,339,695,13.958002742,8.735306352,7.8571538616,2.8501440478,5.2226963903,10.707297909
35035,2012,938,528,-422,524,410,102,14.279733587,8.0380589914,-6.424357755,7.9771646051,6.2416745956,1.5528068506
35035,2013,812,569,-945,432,243,-513,12.338550372,8.646102416,-14.35951983,6.5643519222,3.6924479562,-7.795167908
35035,2014,885,601,-1606,406,284,-1200,13.56644107,9.2129164782,-24.61887498,6.2237006492,4.353524592,-18.39517433
35035,2015,923,618,-1412,477,305,-935,14.313406219,9.5836240986,-21.89656509,7.3970690858,4.7297821199,-14.49949601
35035,2016,954,616,239,431,338,670,14.749308143,9.523662281,3.6950572811,6.6634714986,5.225645862,10.35852878
35035,2017,976,601,-113,374,375,261,14.900649613,9.1755024771,-1.72517767,5.7098800773,5.7251471363,3.9847024069
31131,2010,54,69,23,2,-15,25,NA,NA,NA,NA,NA,NA
31131,2011,183,185,-29,29,-2,0,11.621630204,11.748642555,-1.841679103,1.8416791033,-0.127012352,0
31131,2012,182,189,-78,37,-7,-41,11.5768717,12.022135996,-4.961516443,2.3535398512,-0.445264296,-2.607976592
31131,2013,200,198,-36,39,2,3,12.740070707,12.61267,-2.293212727,2.4843137879,0.1274007071,0.1911010606
31131,2014,192,176,37,42,16,79,12.193185787000001,11.177086972,2.3497285111,2.667259391,1.0160988156,5.0169879021
31131,2015,218,208,29,43,10,72,13.769145745,13.137533554,1.8316753513,2.7159324175,0.6316121901,4.5476077688
31131,2016,201,163,25,48,38,73,12.619286791,10.233550979,1.5695630337,3.0135610246,2.3857358112,4.5831240583
31131,2017,213,166,-51,48,47,-3,13.307925401,10.371434819,-3.186404673,2.9989691044,2.9364905814,-0.187435569
26137,2010,66,77,-7,2,-11,-5,NA,NA,NA,NA,NA,NA
26137,2011,268,251,-69,3,17,-66,11.111341446,10.406517548,-2.86075582,0.1243806878,0.7048238977,-2.736375132
26137,2012,249,224,-115,10,25,-105,10.351493484,9.3121869089,-4.780810243,0.4157226299,1.0393065747,-4.365087614
26137,2013,230,269,63,10,-39,73,9.5713691219,11.194340408,2.6217228464,0.4161464836,-1.622971286,3.03786933
26137,2014,234,241,20,20,-7,40,9.725281576,10.016208803,0.8312206475,0.8312206475,-0.290927227,1.662441295
26137,2015,268,262,89,21,6,110,11.105585944,10.856953423,3.6880490635,0.870213824,0.2486325211,4.5582628875
26137,2016,246,296,230,18,-50,248,10.129084059,12.187840982,9.4702818438,0.7411524921,-2.058756923,10.211434336
26137,2017,260,283,159,18,-23,177,10.62894753,11.569200581,6.5000102201,0.7358502136,-0.940253051,7.2358604337
36077,2010,127,112,-39,12,15,-27,NA,NA,NA,NA,NA,NA
36077,2011,532,614,-234,36,-82,-198,8.5648968027,9.8850500692,-3.767266639,0.5795794829,-1.320153267,-3.187687156
36077,2012,516,600,-153,32,-84,-121,8.3405397105,9.698301989,-2.473067007,0.5172427727,-1.357762278,-1.955824234
36077,2013,546,589,-123,53,-43,-70,8.8491272427,9.546036531,-1.993484709,0.8589812159,-0.696909288,-1.134503493
36077,2014,543,608,-652,58,-65,-594,8.8555469483,9.9156032128,-10.63317976,0.9458963591,-1.060056265,-9.687283402
36077,2015,523,616,-283,61,-93,-222,8.597024739,10.125749979,-4.651927344,1.0027122545,-1.52872524,-3.64921509
36077,2016,507,588,-318,67,-81,-251,8.3788496021,9.7174823788,-5.255373123,1.1072641486,-1.338632777,-4.148108975
36077,2017,507,623,-198,65,-116,-133,8.4193395717,10.345657896,-3.288026105,1.0794025092,-1.926318324,-2.208623596
20143,2010,19,6,-8,0,13,-8,NA,NA,NA,NA,NA,NA
20143,2011,69,76,-26,2,-7,-24,11.349617567,12.501028045,-4.276667489,0.3289744222,-1.151410478,-3.947693067
20143,2012,52,85,-4,0,-33,-4,8.6014390869,14.060044661,-0.661649161,0,-5.458605574,-0.661649161
20143,2013,64,56,5,3,8,8,10.603926767,9.2784359208,0.8284317786,0.4970590672,1.3254908458,1.3254908458
20143,2014,48,55,-10,3,-7,-7,7.952945075,9.1127495651,-1.656863557,0.4970590672,-1.15980449,-1.15980449
20143,2015,63,71,-90,3,-8,-87,10.533355626,11.870924595,-15.04765089,0.5015883631,-1.337568968,-14.54606253
20143,2016,55,66,-7,3,-11,-4,9.280350966,11.136421159,-1.181135577,0.5062009618,-1.856070193,-0.674934616
20143,2017,64,60,-62,3,4,-59,10.864029876,10.185028009,-10.52452894,0.5092514004,0.6790018673,-10.01527754
26139,2010,915,427,-281,81,488,-200,NA,NA,NA,NA,NA,NA
26139,2011,3290,1655,689,387,1635,1076,12.394841636,6.2350951087,2.5957586284,1.4579950496,6.1597465274,4.053753678
26139,2012,3318,1657,1614,375,1661,1989,12.353378098,6.1692427692,6.0091477547,1.3961774523,6.1841353287,7.405325207
26139,2013,3417,1784,1416,406,1633,1822,12.556521803,6.5557023402,5.2034049965,1.4919367434,6.0008194628,6.6953417399
26139,2014,3360,1826,1500,449,1534,1949,12.192665894,6.6261333101,5.4431544168,1.6293175554,5.5665325836,7.0724719723
26139,2015,3331,1893,1235,493,1438,1728,11.944590868,6.7880848134,4.4285709163,1.7678424791,5.1565060548,6.1964133954
26139,2016,3356,1851,802,500,1505,1302,11.907444104,6.567544409,2.8455810999,1.7740530548,5.339899695,4.6196341548
26139,2017,3375,1864,1141,500,1511,1641,11.849901251,6.5446565723,4.0061443932,1.755540926,5.3052446785,5.7616853193
39123,2010,75,143,-6,2,-68,-4,NA,NA,NA,NA,NA,NA
39123,2011,361,446,45,1,-85,46,8.7334131679,10.789756989,1.088652611,0.0241922802,-2.056343821,1.1128448912
39123,2012,363,444,5,6,-81,11,8.7943502962,10.756725982,0.1211343016,0.1453611619,-1.962375686,0.2664954635
39123,2013,324,517,-11,0,-193,-11,7.8763127188,12.5680669,-0.267405679,0,-4.691754181,-0.267405679
39123,2014,319,462,20,1,-143,21,7.7866601574,11.277231952,0.4881918594,0.024409593,-3.490571795,0.5126014524
39123,2015,361,461,-41,1,-100,-40,8.8414298135,11.290579346,-1.004151308,0.0244914953,-2.449149533,-0.979659813
39123,2016,352,488,-125,0,-136,-125,8.6642954722,12.011864177,-3.076809472,0,-3.347568705,-3.076809472
39123,2017,334,505,337,0,-171,337,8.231466877,12.445780757,8.3054022082,0,-4.21431388,8.3054022082
40115,2010,93,66,-18,1,27,-17,NA,NA,NA,NA,NA,NA
40115,2011,389,385,-25,8,4,-17,12.214843075,12.089240576,-0.785015622,0.251204999,0.1256024995,-0.533810623
40115,2012,430,464,301,12,-34,313,13.445693469,14.508841325,9.4119854286,0.375228655,-1.063147856,9.7872140836
40115,2013,486,418,-84,4,68,-80,15.133350979,13.015927385,-2.61564091,0.124554329,2.1174235937,-2.491086581
40115,2014,439,409,-269,6,30,-263,13.722395011,12.784645922,-8.408483503,0.1875498179,0.9377490896,-8.220933686
40115,2015,487,465,-101,10,22,-91,15.294985946,14.604042022,-3.17206074,0.3140654198,0.6909439236,-2.85799532
40115,2016,430,494,-232,14,-64,-218,13.580090955,15.601313795,-7.326932794,0.4421424962,-2.02122284,-6.884790298
40115,2017,430,501,-152,14,-71,-138,13.686639612,15.946526617,-4.838067956,0.4456115222,-2.259887006,-4.392456434
27111,2010,164,162,-16,11,2,-5,NA,NA,NA,NA,NA,NA
27111,2011,562,679,61,54,-117,115,9.8104248857,11.852808714,1.0648325944,0.9426386901,-2.042383829,2.0074712844000002
27111,2012,622,692,-31,48,-70,17,10.864723709,12.087441812,-0.541489445,0.8384352702,-1.222718102,0.2969458249
27111,2013,630,646,239,65,-16,304,10.982880653,11.261810955,4.1665213905,1.1331543531,-0.278930302,5.2996757435
27111,2014,671,684,-45,86,-13,41,11.667028907,11.893066725,-0.7824386,1.4953271028,-0.226037818,0.7128885025
27111,2015,653,689,32,92,-36,124,11.344683808,11.970118138,0.5559416261,1.5983321751,-0.625434329,2.1542738013
27111,2016,724,678,245,93,46,338,12.528119052,11.732133587,4.2394878007,1.6092749611,0.7959854646,5.8487627617
27111,2017,681,671,265,94,10,359,11.70847446,11.536543851,4.5561611334,1.6161477228,0.1719306088,6.1723088561
05103,2010,54,131,-2,0,-77,-2,NA,NA,NA,NA,NA,NA
05103,2011,332,359,-285,-4,-27,-289,12.826456498,13.869571936,-11.01066296,-0.15453562,-1.043115438,-11.16519858
05103,2012,308,349,-314,11,-41,-303,12.051021207,13.655215588,-12.28578136,0.4303936145,-1.604194381,-11.85538775
05103,2013,298,388,-372,11,-90,-361,11.842079119,15.418545968,-14.78272964,0.4371237259,-3.576466848,-14.34560591
05103,2014,302,349,-155,9,-47,-146,12.155118633,14.046809281,-6.238554265,0.3622386348,-1.891690648,-5.876315631
05103,2015,287,341,-396,10,-54,-386,11.699482288,13.900778607,-16.14283967,0.4076474665,-2.201296319,-15.73519221
05103,2016,267,331,-239,10,-64,-229,11.048809253,13.697212969,-9.890132627,0.4138130806,-2.648403716,-9.476319546
05103,2017,266,328,-98,10,-62,-88,11.109486917,13.698916199,-4.092968864,0.4176498841,-2.589429281,-3.67531898
22073,2010,502,271,-10,35,231,25,NA,NA,NA,NA,NA,NA
22073,2011,2303,1508,-257,99,795,-158,14.927259587,9.7743410584,-1.665786241,0.6416841942,5.1529185288,-1.024102047
22073,2012,2336,1427,-321,78,909,-243,15.078847656,9.2112652418,-2.072050555,0.50348892,5.867582414,-1.568561635
22073,2013,2200,1483,16,106,717,122,14.134048602,9.5276336712,0.1027930807,0.6810041599,4.6064149307,0.7837972406
22073,2014,2355,1554,-555,90,801,-465,15.074749634,9.9474144084,-3.552648003,0.5761050816,5.1273352259,-2.976542921
22073,2015,2301,1533,-318,99,768,-219,14.689124877,9.7863661173,-2.030048549,0.6319962463,4.9027587594,-1.398052302
22073,2016,2204,1586,-694,102,618,-592,14.045015421,10.106803293,-4.422523005,0.6499961765,3.9382121282,-3.772526828
22073,2017,2197,1636,-1726,103,561,-1623,14.046820604,10.459990218,-11.03541755,0.6585446164,3.5868303864,-10.37687294
08091,2010,12,15,15,0,-3,15,NA,NA,NA,NA,NA,NA
08091,2011,28,19,-44,-2,9,-46,6.3205417607,4.2889390519,-9.93227991,-0.451467269,2.0316027088,-10.38374718
08091,2012,32,18,65,0,14,65,7.1853598293,4.041764904,14.595262153,0,3.1435949253,14.595262153
08091,2013,32,34,46,0,-2,46,7.0843480186,7.5271197698,10.183750277,0,-0.442771751,10.183750277
08091,2014,34,44,30,-1,-10,29,7.4725274725,9.6703296703,6.5934065934,-0.21978022,-2.197802198,6.3736263736
08091,2015,20,26,37,-1,-6,36,4.3720625205,5.6836812766,8.0883156629,-0.218603126,-1.311618756,7.8697125369
08091,2016,40,24,179,-1,16,178,8.5351541662,5.1210924997,38.194814894,-0.213378854,3.4140616665,37.98143604
08091,2017,32,30,9,-1,2,8,6.6819795364,6.2643558154,1.8793067446,-0.208811861,0.417623721,1.6704948841
55087,2010,590,316,-81,33,274,-48,NA,NA,NA,NA,NA,NA
55087,2011,2354,1253,-210,143,1101,-67,13.267690019,7.0621986377,-1.18360871,0.8059811693,6.2054913808,-0.377627541
55087,2012,2242,1247,-57,177,995,120,12.561561175,6.9867380842,-0.319361725,0.991702198,5.5748230904,0.6723404732
55087,2013,2270,1251,110,195,1019,305,12.633852045,6.9625325586,0.6122130947,1.0852868497,5.6713194862,1.6974999443
55087,2014,2245,1271,629,207,974,836,12.388564996,7.0137488239,3.4710055155,1.1422863938,5.3748161719,4.6132919094
55087,2015,2353,1497,133,227,856,360,12.878930934,8.193692991,0.7279633719,1.2424638002,4.6852379428,1.9704271722
55087,2016,2328,1402,203,230,926,433,12.653858802,7.6205799142,1.1034077907,1.2501664624,5.0332788877,2.3535742531
55087,2017,2329,1318,175,229,1011,404,12.564976141,7.1106219636,0.9441265885,1.2354570787,5.454354177,2.1795836671
47133,2010,65,81,25,1,-16,26,NA,NA,NA,NA,NA,NA
47133,2011,252,264,83,-1,-12,82,11.388543667,11.930855271,3.7509885889,-0.045192634,-0.542311603,3.7057959553
47133,2012,261,275,20,0,-14,20,11.776384064,12.4080675,0.9024049091,0,-0.631683436,0.9024049091
47133,2013,211,311,-91,1,-100,-90,9.5613558093,14.09280406,-4.123617908,0.0453144825,-4.531448251,-4.078303426
47133,2014,242,285,24,1,-43,25,11.020287347,12.978437578,1.0929210592,0.0455383775,-1.958150231,1.1384594367
47133,2015,220,278,175,1,-58,176,9.9965920709,12.632057253,7.9518346018,0.0454390549,-2.635465182,7.9972736567
47133,2016,224,290,-24,2,-66,-22,10.171415598,13.168350551,-1.089794528,0.0908162107,-2.996934953,-0.998978318
47133,2017,225,309,116,2,-84,118,10.229597636,14.04864742,5.2739258922,0.0909297568,-3.819049784,5.364855649
18119,2010,64,79,11,0,-15,11,NA,NA,NA,NA,NA,NA
18119,2011,221,198,-103,4,23,-99,10.260934163,9.1930541369,-4.782245334,0.1857182654,1.067880026,-4.596527068
18119,2012,225,205,-142,2,20,-140,10.494402985,9.5615671642,-6.623134328,0.0932835821,0.9328358209,-6.529850746
18119,2013,210,245,-181,1,-35,-180,9.8719003408,11.517217064,-8.508637913,0.0470090492,-1.645316723,-8.461628864
18119,2014,235,222,-153,0,13,-153,11.138760517,10.522573765,-7.252044081,0,0.616186752,-7.252044081
18119,2015,227,245,-182,0,-18,-182,10.845676063,11.705685619,-8.695652174,0,-0.860009556,-8.695652174
18119,2016,229,227,88,0,2,88,10.969271669,10.87347017,4.2152659689,0,0.0958014993,4.2152659689
18119,2017,236,237,-80,0,-1,-80,11.302411340999999,11.350302914,-3.831325878,0,-0.047891573,-3.831325878
21187,2010,33,13,-8,0,20,-8,NA,NA,NA,NA,NA,NA
21187,2011,95,96,-31,0,-1,-31,8.7707150441,8.8630383603,-2.862022804,0,-0.092323316,-2.862022804
21187,2012,121,116,-69,-1,5,-70,11.221366967,10.757674117,-6.398961328,-0.09273857,0.4636928499,-6.491699898
21187,2013,100,108,-107,0,-8,-107,9.3527871306,10.101010101,-10.00748223,0,-0.74822297,-10.00748223
21187,2014,115,117,13,0,-2,13,10.808270677,10.996240602,1.2218045113,0,-0.187969925,1.2218045113
21187,2015,87,116,107,0,-29,107,8.1422554984,10.856340664,10.014038372,0,-2.714085166,10.014038372
21187,2016,76,104,-31,0,-28,-31,7.1071211484,9.725534203,-2.898957311,0,-2.618413055,-2.898957311
21187,2017,76,104,130,0,-28,130,7.0935224939,9.706925518,12.133656898,0,-2.613403024,12.133656898
21189,2010,9,32,14,0,-23,14,NA,NA,NA,NA,NA,NA
21189,2011,54,69,75,-1,-15,74,11.301799916,14.441188782,15.696944328,-0.209292591,-3.139388866,15.487651737
21189,2012,49,87,-87,-1,-38,-88,10.324483776,18.331226296,-18.3312263,-0.210703751,-8.00674252,-18.54193005
21189,2013,35,86,-29,-1,-51,-30,7.5382295929,18.522507,-6.245961663,-0.215377988,-10.98427741,-6.461339651
21189,2014,62,82,-80,0,-20,-80,13.615899857,18.008125618,-17.56890304,0,-4.39222576,-17.56890304
21189,2015,52,72,-37,0,-20,-37,11.617515639,16.085790885,-8.266309205,0,-4.468275246,-8.266309205
21189,2016,57,60,50,0,-3,50,12.748825766,13.419816596,11.183180497,0,-0.67099083,11.183180497
21189,2017,57,54,-63,0,3,-63,12.765957447,12.09406495,-14.10974244,0,0.6718924972,-14.10974244
16073,2010,35,32,-61,2,3,-59,NA,NA,NA,NA,NA,NA
16073,2011,127,97,-132,3,30,-129,11.116460239,8.4905247494,-11.55411615,0.262593549,2.6259354895,-11.2915226
16073,2012,147,88,-31,-1,59,-32,12.907757826,7.7270931203,-2.722044167,-0.087807876000000007,5.1806647056,-2.809852044
16073,2013,140,96,-87,12,44,-75,12.294182217,8.4302963776,-7.639956092,1.0537870472,3.8638858397,-6.586169045
16073,2014,132,80,-156,6,52,-150,11.656143759,7.064329551,-13.77544262,0.5298247163,4.5918142081,-13.24561791
16073,2015,143,103,-44,8,40,-36,12.680115274,9.1332298825,-3.90157393,0.7093770783,3.5468853913,-3.192196852
16073,2016,140,80,16,8,60,24,12.366398728,7.0665135589,1.4133027118000001,0.70665135590000006,5.2998851692,2.1199540677
16073,2017,136,89,210,9,47,219,11.830716367,7.7421599756,18.26801792,0.7829150537,4.0885563916,19.050932974
23017,2010,125,113,-64,2,12,-62,NA,NA,NA,NA,NA,NA
23017,2011,513,613,71,12,-100,83,8.8805027092,10.611594855,1.2290754237,0.2077310575,-1.731092146,1.4368064812
23017,2012,509,619,-168,-3,-110,-171,8.8348115877,10.744102893,-2.91600854,-0.052071581,-1.909291306,-2.968080121
23017,2013,573,605,-114,4,-32,-110,9.9828392728,10.540345131,-1.98611462,0.0696882323,-0.557505858,-1.916426387
23017,2014,508,655,43,10,-147,53,8.8695667356,11.43615396,0.7507704127,0.1745977704,-2.566587225,0.925368183
23017,2015,478,648,13,10,-170,23,8.3646131366,11.339475549,0.2274894786,0.1749919066,-2.974862413,0.4024813852
23017,2016,512,654,163,9,-142,172,8.9695525735,11.45720192,2.8555411513,0.1576679163,-2.487649347,3.0132090677
23017,2017,487,670,518,10,-183,528,8.5039507574,11.699480508,9.0452700048,0.1746191121,-3.195529751,9.2198891169
29153,2010,17,15,14,0,2,14,NA,NA,NA,NA,NA,NA
29153,2011,82,120,-56,-5,-38,-61,8.4653899757,12.388375574,-5.781241935,-0.516182316,-3.922985599,-6.29742425
29153,2012,98,132,-14,-5,-34,-19,10.197180168,13.734977369,-1.456740024,-0.520264294,-3.537797201,-1.977004318
29153,2013,89,123,-50,-5,-34,-55,9.3306075379,12.895109294,-5.241914347,-0.524191435,-3.564501756,-5.766105782
29153,2014,90,137,-14,-5,-47,-19,9.5137420719,14.482029598,-1.479915433,-0.528541226,-4.968287526,-2.00845666
29153,2015,85,133,-26,-5,-48,-31,9.0550761692,14.168530947,-2.769788005,-0.532651539,-5.113454778,-3.302439544
29153,2016,73,109,-119,-5,-36,-124,7.8774144815,11.762166829,-12.8412647,-0.539548937,-3.884752347,-13.38081364
29153,2017,74,127,57,-5,-53,52,8.0552985359,13.824633974,6.2047569804,-0.544276928,-5.769335438,5.6604800523
55089,2010,205,154,-80,12,51,-68,NA,NA,NA,NA,NA,NA
55089,2011,794,715,300,48,79,348,9.1703914163,8.2579721192,3.4648834067,0.5543813451,0.9124192971,4.0192647517
55089,2012,811,751,207,62,60,269,9.3270922704,8.6370484526,2.3806511713,0.7130452784,0.6900438178,3.0936964497
55089,2013,802,718,-63,58,84,-5,9.2027355763,8.2388580346,-0.722908156,0.665534493,0.9638775417,-0.057373663
55089,2014,782,681,143,72,101,215,8.9535149989,7.7971147241,1.637279597,0.8243645523,1.1564002748,2.4616441493
55089,2015,832,742,152,75,90,227,9.4925155166,8.4656809054,1.7342095655,0.8556955093,1.0268346112,2.5899050748
55089,2016,838,803,271,73,35,344,9.5239177624,9.1261407676,3.0799304459,0.8296491607,0.3977769949,3.9095796065
55089,2017,831,773,126,73,58,199,9.4107787957,8.7539494694,1.4269050882,0.8266989796,0.6568293263,2.2536040678
53049,2010,41,84,5,0,-43,5,NA,NA,NA,NA,NA,NA
53049,2011,199,306,114,-4,-107,110,9.5315643261,14.6565763,5.4602931315,-0.191589233,-5.125011974,5.2687038988
53049,2012,208,283,-237,14,-75,-223,10.033283488,13.651053977,-11.43215474,0.6753171579,-3.617770489,-10.75683759
53049,2013,193,307,-24,4,-114,-20,9.408209028,14.96538949,-1.169932729,0.1949887881,-5.557180462,-0.974943941
53049,2014,182,319,241,9,-137,250,8.8763168162,15.557939914,11.753804136,0.4389387437,-6.681623098,12.192742879
53049,2015,193,322,403,12,-129,415,9.3196194891,15.54879521,19.460138104,0.5794582066,-6.229175721,20.039596311
53049,2016,200,315,457,11,-115,468,9.5093191328,14.977177634,21.728794218,0.5230125523,-5.467858501,22.251806771
53049,2017,198,321,526,12,-123,538,9.2447764678,14.987743668,24.559355667,0.5602894829,-5.7429672,25.11964515
19145,2010,42,74,7,1,-32,8,NA,NA,NA,NA,NA,NA
19145,2011,175,209,6,-4,-34,2,11.006635429,13.145067455,0.3773703576,-0.251580238,-2.138432026,0.1257901192
19145,2012,178,216,-162,5,-38,-157,11.275814012,13.683010262,-10.2622577,0.3167363487,-2.40719625,-9.945521348
19145,2013,172,204,-174,11,-32,-163,11.030236958,13.082374066,-11.15849553,0.705422131,-2.052137108,-10.4530734
19145,2014,172,181,-34,11,-9,-23,11.110752237,11.692128807,-2.196311489,0.710571364,-0.581376571,-1.485740125
19145,2015,176,218,13,15,-42,28,11.387900356,14.105467486,0.8411517308,0.9705596894,-2.71756713,1.8117114203
19145,2016,162,189,-103,17,-27,-86,10.525631863,12.27990384,-6.692222728,1.1045416152,-1.754271977,-5.587681112
19145,2017,158,198,-87,16,-40,-71,10.340652508,12.958539219,-5.693903596,1.0471546844,-2.617886711,-4.646748912
51139,2010,63,43,-3,0,20,-3,NA,NA,NA,NA,NA,NA
51139,2011,239,306,-42,1,-67,-41,9.9548076723,12.745485974,-1.749380428,0.0416519149,-2.790678301,-1.707728513
51139,2012,213,276,-48,0,-63,-48,8.9136257114,11.550050218,-2.008704386,0,-2.636424506,-2.008704386
51139,2013,236,285,-63,-2,-49,-65,9.9240974748,11.984609239,-2.649229411,-0.084102521,-2.060511764,-2.733331932
51139,2014,257,287,92,-1,-30,91,10.820824825,12.083956127,3.873602661,-0.042104377,-1.263131302,3.8314982842
51139,2015,238,294,-71,-1,-56,-72,10.036265497,12.397739732,-2.994011976,-0.042169183,-2.361474235,-3.036181159
51139,2016,221,292,16,-1,-71,15,9.3564775614,12.362404742,0.6773920406,-0.042337003,-3.00592718,0.6350550381
51139,2017,233,284,193,-1,-51,192,9.8474282575,12.002873928,8.1568826339,-0.042263641,-2.15544567,8.1146189933
12099,2010,3334,3257,1980,1579,77,3559,NA,NA,NA,NA,NA,NA
12099,2011,13658,13052,5298,7514,606,12812,10.266015939,9.8105169162,3.9822340348,5.6478872287,0.4554990232,9.6301212635
12099,2012,14030,13065,10349,7831,965,18180,10.418360671,9.7017734976,7.6849333277,5.8151234795,0.7165871738,13.500056807
12099,2013,14021,13585,13087,8630,436,21717,10.253938745,9.935080084,9.5708791357,6.3113537817,0.3188586615,15.882232917
12099,2014,14336,13496,12931,9678,840,22609,10.311584493,9.7073900888,9.3009974243,6.9611826674,0.6041944039,16.262180092
12099,2015,14565,14450,15498,10624,115,26122,10.29167519,10.210415825,10.950935949,7.506952092,0.0812593647,18.457888041
12099,2016,15030,15059,14383,11054,-29,25437,10.429728404,10.449852298,9.980757394,7.670673172,-0.020123894,17.651430566
12099,2017,15013,15169,6552,11038,-156,17590,10.265586933,10.37225659,4.4801255967,7.5475620171,-0.106669657,12.027687614
19147,2010,22,16,-32,1,6,-31,NA,NA,NA,NA,NA,NA
19147,2011,104,139,-21,7,-35,-14,11.095108551,14.829039312999999,-2.240358457,0.7467861525,-3.733930762,-1.493572305
19147,2012,88,123,-46,7,-35,-39,9.4501718213,13.208762887,-4.939862543,0.7517182131,-3.758591065,-4.18814433
19147,2013,97,135,-90,12,-38,-78,10.524031681,14.646848215,-9.764565477,1.3019420636,-4.122816535,-8.462623413
19147,2014,104,126,-44,23,-22,-21,11.380423483,13.787820758,-4.814794551,2.5168244241,-2.407397275,-2.297970126
19147,2015,119,143,21,23,-24,44,13.036809816,15.666082384,2.3006134969,2.5197195443,-2.629272568,4.8203330412
19147,2016,105,107,-117,23,-2,-94,11.551155116,11.771177118,-12.87128713,2.5302530253,-0.220022002,-10.3410341
19147,2017,110,108,26,23,2,49,12.131906915,11.911326789,2.8675416345,2.5366714459,0.2205801257,5.4042130804
48363,2010,78,94,-21,0,-16,-21,NA,NA,NA,NA,NA,NA
48363,2011,335,303,-63,2,32,-61,11.935725229,10.795596252,-2.244628924,0.0712580611,1.1401289771,-2.173370863
48363,2012,389,283,-315,8,106,-307,13.915718681,10.123774773,-11.26851256,0.2861844459,3.7919439078,-10.98232811
48363,2013,383,325,-52,13,58,-39,13.745334482,11.663795579,-1.866207293,0.4665518231,2.0815389032,-1.399655469
48363,2014,372,295,57,15,77,72,13.312338964,10.556827942,2.0397938735,0.5367878614,2.755511022,2.5765817349
48363,2015,351,339,-90,22,12,-68,12.541985278,12.113199457,-3.215893661,0.7861073394,0.4287858215,-2.429786322
48363,2016,344,350,162,22,-6,184,12.266438454,12.480387962,5.7766367137,0.784481529,-0.213949508,6.5611182428
48363,2017,347,349,418,22,-2,440,12.239427181,12.30997143,14.743748016,0.7759867377,-0.070544249,15.519734754
37137,2010,21,54,2,2,-33,4,NA,NA,NA,NA,NA,NA
37137,2011,105,158,188,3,-53,191,7.9654073737,11.986041572,14.26187225,0.2275830678,-4.020634198,14.489455318
37137,2012,87,130,-190,9,-43,-181,6.62024883,9.892325838,-14.45801469,0.6848533272,-3.272077008,-13.77316136
37137,2013,99,138,-107,8,-39,-99,7.6382995139,10.647326595,-8.255535838,0.6172363244,-3.009027081,-7.638299514
37137,2014,78,161,68,7,-83,75,6.052141527,12.492240844,5.2762259466,0.5431409063,-6.440099317,5.8193668529
37137,2015,89,175,-53,8,-86,-45,6.9430900651,13.652143387,-4.13464914,0.6240979834,-6.709053321,-3.510551157
37137,2016,88,152,105,8,-64,113,6.8879148403,11.897307451,8.2185347527,0.6261740764,-5.009392611,8.8447088291
37137,2017,88,152,-53,8,-64,-45,6.905210295,11.927181419,-4.158819837,0.6277463905,-5.021971124,-3.531073446
28107,2010,118,132,-43,0,-14,-43,NA,NA,NA,NA,NA,NA
28107,2011,508,380,-295,-5,128,-300,14.700775553,10.99664313,-8.536867693,-0.144692673,3.7041324227,-8.681560366
28107,2012,520,387,-174,-3,133,-177,15.094777787,11.233998084,-5.050944875,-0.087085256,3.8607797033,-5.138030131
28107,2013,498,348,-174,2,150,-172,14.470644641,10.112016737,-5.056008369,0.0581150387,4.3586279039,-4.99789333
28107,2014,539,410,-107,15,129,-92,15.660182751,11.912198382,-3.108793236,0.4358121359,3.7479843689,-2.6729811
28107,2015,477,411,-365,17,66,-348,13.90934142,11.984778457000001,-10.64341639,0.4957207634,1.9245629638,-10.14769563
28107,2016,498,419,-88,17,79,-71,14.57994818,12.267064834,-2.576376385,0.4977090744,2.3128833458,-2.078667311
28107,2017,485,420,-247,17,65,-230,14.232473516,12.325028612,-7.248290636,0.4988702057,1.9074449042,-6.74942043
48365,2010,60,100,15,2,-40,17,NA,NA,NA,NA,NA,NA
48365,2011,316,270,169,19,46,188,13.228952987,11.303219324,7.0749780215,0.7954117302,1.9257336627,7.8703897517
48365,2012,296,265,-60,12,31,-48,12.335646267,11.043737367,-2.500468838,0.5000937676,1.2919088996,-2.00037507
48365,2013,295,278,-236,18,17,-218,12.350072217,11.63837314,-9.880057773,0.7535637285,0.7116990769,-9.126494045
48365,2014,277,286,-58,23,-9,-35,11.656532077,12.035264166,-2.440717908,0.9678708944,-0.378732089,-1.472847013
48365,2015,307,264,-148,26,43,-122,12.953313221,11.139005506,-6.244593996,1.0970232696,1.814307715,-5.147570726
48365,2016,282,262,-267,28,20,-239,11.974522293,11.125265393,-11.33757962,1.1889596603,0.8492569002,-10.14861996
48365,2017,269,275,-219,29,-6,-190,11.52453784,11.781590729,-9.382430435,1.2424222951,-0.257052889,-8.14000814
08093,2010,27,7,51,0,20,51,NA,NA,NA,NA,NA,NA
08093,2011,114,83,-256,-10,31,-266,7.0546737213,5.136297534,-15.84207432,-0.618831028,1.9183761874,-16.46090535
08093,2012,110,77,-47,4,33,-43,6.8587105624,4.8010973937,-2.930539968,0.2494076568,2.0576131687,-2.681132311
08093,2013,97,75,106,5,22,111,6.0246576193,4.6582404273,6.5836464706,0.3105493618,1.366417192,6.8941958324
08093,2014,96,83,179,1,13,180,5.9018812246,5.1026681421,11.004549367,0.0614779294,0.7992130825,11.066027296
08093,2015,115,90,317,2,25,319,6.9530517851,5.4415187884,19.166238399,0.1209226397,1.5115329968,19.287161039
08093,2016,116,96,610,2,20,612,6.8105093204,5.6362835755,35.813885219,0.1174225745,1.1742257449,35.931307794
08093,2017,125,111,533,2,14,535,7.0911927386,6.2969791519,30.236845837,0.1134590838,0.7942135867,30.350304921
30067,2010,35,36,-42,2,-1,-40,NA,NA,NA,NA,NA,NA
30067,2011,160,140,-105,-4,20,-109,10.288396618,9.0023470405,-6.75176028,-0.257209915,1.2860495772,-7.008970196
30067,2012,129,150,104,-1,-21,103,8.2968870594,9.6475430924,6.6889632107,-0.064316954,-1.350656033,6.6246462568
30067,2013,145,133,89,1,12,90,9.2708033631,8.5035644641,5.6903551677,0.0639365749,0.767238899,5.7542917426
30067,2014,151,156,212,1,-5,213,9.5593821221,9.8759179539,13.421119271,0.0633071664,-0.316535832,13.484426437
30067,2015,139,167,90,2,-28,92,8.7245794627,10.482048707,5.6490082852,0.1255335174,-1.757469244,5.7745418027
30067,2016,159,146,118,3,13,121,9.9185926827,9.107638564,7.3609681545,0.1871432582,0.8109541187,7.5481114126
30067,2017,148,159,262,3,-11,265,9.1214446396,9.7993898493,16.147422267,0.1848941481,-0.67794521,16.332316416
56029,2010,73,86,45,11,-13,56,NA,NA,NA,NA,NA,NA
56029,2011,299,261,170,90,38,260,10.529281262,9.1911117372,5.9865478748,3.1693488749,1.3381695249,9.1558967497
56029,2012,326,262,242,80,64,322,11.343273195,9.1163729362,8.4204666052,2.783625324,2.2269002592,11.204091929
56029,2013,302,268,158,43,34,201,10.395332427,9.2249969881,5.4386176273,1.4801301138,1.1703354388,6.9187477411
56029,2014,323,259,-129,15,64,-114,11.082708573,8.886753933,-4.426221071,0.5146768687,2.1959546398,-3.911544202
56029,2015,343,279,-90,20,64,-70,11.781071288,9.5828539044,-3.091243195,0.6869429322,2.1982173831,-2.404300263
56029,2016,304,270,249,20,34,269,10.389255323,9.2272991354,8.5096203137,0.6835036397,1.1619561874,9.1931239534
56029,2017,330,267,75,21,63,96,11.190233978,9.0539165819,2.5432349949,0.7121057986,2.1363173957,3.2553407935
18121,2010,45,54,-71,1,-9,-70,NA,NA,NA,NA,NA,NA
18121,2011,186,159,-232,7,27,-225,10.823392493,9.2522548734,-13.50014548,0.4073319756,1.57113762,-13.0928135
18121,2012,182,154,11,0,28,11,10.638297872,9.0016366612,0.6429740472,0,1.6366612111,0.6429740472
18121,2013,201,171,88,1,30,89,11.695225904,9.949669799,5.1202979082,0.0581852035,1.7455561051,5.1784831117
18121,2014,195,154,-40,1,41,-39,11.307297556,8.9298657621,-2.319445652,0.0579861413,2.3774317938,-2.261459511
18121,2015,214,156,-332,2,58,-330,12.506209274,9.1166759197,-19.40215644,0.1168804605,3.3895333548,-19.28527598
18121,2016,219,156,-86,2,63,-84,12.907028142,9.1940474436,-5.068513334,0.1178724031,3.7129806984,-4.950640931
18121,2017,213,170,-115,2,43,-113,12.587536566,10.046390686,-6.796087817,0.1181928316,2.5411458795,-6.677894986
48367,2010,353,268,258,20,85,278,NA,NA,NA,NA,NA,NA
48367,2011,1264,957,661,37,307,698,10.7288214,8.1230079745,5.6105624568,0.3140556897,2.6058134255,5.9246181465
48367,2012,1289,915,785,11,374,796,10.841544394,7.6958984646,6.6024921254,0.0925189979,3.1456459298,6.6950111233
48367,2013,1317,984,-61,26,333,-35,11.008300108,8.2248802628,-0.509875707,0.217324072,2.783419845,-0.292551635
48367,2014,1426,1027,1883,34,399,1917,11.788826243,8.4902696715,15.566872241,0.2810800086,3.2985565715,15.847952249
48367,2015,1433,1080,3000,55,353,3055,11.570681685,8.7204021074,24.223339187,0.4440945518,2.8502795777,24.667433739
48367,2016,1512,1092,2815,59,420,2874,11.885437588,8.5839271467,22.127980694,0.4637836096,3.301510441,22.591764304
48367,2017,1549,1138,4122,60,411,4182,11.809822967,8.6762934386,31.426785197,0.4574495662,3.1335295284,31.884234763
48369,2010,28,38,2,2,-10,4,NA,NA,NA,NA,NA,NA
48369,2011,150,86,-101,36,64,-65,14.619170606,8.3816578139,-9.843574875,3.5086009454,6.2375127918,-6.334973929
48369,2012,150,71,-223,34,79,-189,14.694357367,6.9553291536,-21.84561129,3.3307210031,7.7390282132,-18.51489028
48369,2013,151,79,-316,42,72,-274,15.012178754,7.8540537854,-31.41621514,4.1755728985,7.1581249689,-27.24064224
48369,2014,157,57,-181,50,100,-131,15.782860015,5.7300829354,-18.19552651,5.0263885398,10.05277708,-13.16913797
48369,2015,155,85,-268,60,70,-208,15.708928752,8.614573832,-27.16124455,6.0808756461,7.0943549204,-21.08036891
48369,2016,170,57,-161,66,113,-95,17.33102253,5.8109899072,-16.41349781,6.7285146294,11.520032623,-9.684983179
48369,2017,174,43,-174,66,131,-108,17.700915565,4.3743641913,-17.70091556,6.7141403866,13.326551373,-10.98677518
12101,2010,1118,1230,751,146,-112,897,NA,NA,NA,NA,NA,NA
12101,2011,4772,5552,936,897,-780,1833,10.240431248,11.914265359,2.0086009322,1.9249092267,-1.67383411,3.9335101589
12101,2012,4690,5430,3269,876,-740,4145,10.017011834,11.597521163,6.9820067556,1.8709813147,-1.58050933,8.8529880704
12101,2013,4799,5712,4929,813,-913,5742,10.159978914,12.09289426,10.435202347,1.7212050129,-1.932915347,12.15640736
12101,2014,4832,5568,8858,960,-736,9818,10.078950387,11.614154751,18.476685127,2.0024404743,-1.535204364,20.479125601
12101,2015,4945,5913,11370,1049,-968,12419,10.094968235,12.071091441,23.211281867,2.1414806226,-1.976123206,25.35276249
12101,2016,5109,6103,14824,1072,-994,15896,10.154947928,12.130680604,29.465051495,2.1307700488,-1.975732676,31.595821544
12101,2017,5205,6151,14901,1074,-946,15975,10.046284322,11.872179609,28.760745953,2.0729508861,-1.825895287,30.833696840000002
37139,2010,134,121,-76,30,13,-46,NA,NA,NA,NA,NA,NA
37139,2011,517,424,-490,36,93,-454,12.780105553,10.481169738,-12.11267257,0.8899106381,2.2989358152,-11.22276194
37139,2012,462,394,-55,104,68,49,11.454356126,9.7684335796,-1.363613825,2.5784697774,1.6859225467,1.2148559528
37139,2013,484,438,-976,75,46,-901,12.108173017,10.957396242,-24.41648112,1.8762664799,1.1507767743,-22.54021464
37139,2014,525,386,-338,76,139,-262,13.292990163,9.7735127676,-8.558153667,1.924318576,3.5194773956,-6.633835091
37139,2015,515,408,-250,88,107,-162,13.067915097,10.352833708,-6.343648105,2.232964133,2.715081389,-4.110683972
37139,2016,477,417,94,77,60,171,12.075949367,10.556962025,2.3797468354,1.9493670886,1.5189873418,4.3291139241
37139,2017,482,386,-31,65,96,34,12.147483556,9.7280677436,-0.781269689,1.6381461226,2.4194158119,0.8568764334
34031,2010,1811,823,-1050,754,988,-296,NA,NA,NA,NA,NA,NA
34031,2011,7145,3642,-4967,3524,3503,-1443,14.193272846,7.2346955498,-9.866758044,7.0002930032,6.9585772957,-2.866465041
34031,2012,7075,3501,-5496,3544,3574,-1952,14.001126027,6.9283310559,-10.87635175,7.0134262388,7.0727949711,-3.862925513
34031,2013,6923,3685,-5071,3589,3238,-1482,13.653203119,7.2673773642,-10.000779,7.078050844,6.3858257545,-2.922728156
34031,2014,6925,3555,-5016,3689,3370,-1327,13.604867497,6.9841594156,-9.854442652,7.2474160575,6.6207080818,-2.607026595
34031,2015,6930,3719,-6429,4042,3211,-2387,13.575125981,7.2851217207,-12.59372077,7.9178440428,6.2900042606,-4.675876727
34031,2016,6898,3703,-7057,4191,3195,-2866,13.496485983,7.2452142063,-13.80758214,8.2000250442,6.2512717767,-5.607557093
34031,2017,6852,3704,-6011,4190,3148,-1821,13.384485561,7.2352794099,-11.74170209,8.1846168271,6.1492061508,-3.557085261
51141,2010,46,79,4,1,-33,5,NA,NA,NA,NA,NA,NA
51141,2011,141,259,-19,5,-118,-14,7.6645013997,14.078764982,-1.032805153,0.2717908298,-6.414263583,-0.761014323
51141,2012,162,243,71,8,-81,79,8.8391761015,13.258764152,3.8739598963,0.4365025235,-4.419588051,4.3104624199
51141,2013,131,266,52,4,-135,56,7.1645382701,14.547841068,2.8439388553,0.2187645273,-7.383302797,3.0627033826
51141,2014,131,250,47,2,-119,49,7.195430078,13.73173679,2.5815665165,0.1098538943,-6.536306712,2.6914204109
51141,2015,120,264,-81,2,-144,-79,6.6454381836,14.619964004,-4.485670774,0.1107573031,-7.97452582,-4.374913471
51141,2016,128,268,-40,2,-140,-38,7.1678566429,15.007699846,-2.239955201,0.11199776,-7.839843203,-2.127957441
51141,2017,118,234,13,2,-116,15,6.6602697974,13.207653666,0.733758537,0.1128859288,-6.547383869,0.8466444658
13223,2010,508,215,125,21,293,146,NA,NA,NA,NA,NA,NA
13223,2011,1864,697,-446,48,1167,-398,13.015941736,4.8670125481,-3.114329407,0.3351744653,8.1489291874,-2.779154941
13223,2012,1888,710,-117,107,1178,-10,13.095196809,4.9245708341,-0.811513785,0.7421536327,8.1706259754,-0.069360153
13223,2013,1851,807,902,90,1044,992,12.697868254,5.5360235984,6.187724022,0.6174004013,7.1618446552,6.8051244233
13223,2014,1857,773,674,85,1084,759,12.572527301,5.2334752849,4.5632113092,0.575479171,7.3390520165,5.1386904802
13223,2015,1850,880,2072,96,970,2168,12.317402826,5.8590889117,13.795491165,0.6391733358,6.458313914,14.434664501
13223,2016,1933,960,2525,100,973,2625,12.586888929,6.2511191782,16.441745755,0.6511582477,6.3357697504,17.092904003
13223,2017,1777,975,3163,97,802,3260,11.289026393,6.1940353028,20.094085808,0.6162271019,5.0949910901,20.71031291
39125,2010,59,68,-47,2,-9,-45,NA,NA,NA,NA,NA,NA
39125,2011,235,190,-244,4,45,-240,12.071711101,9.7601068475,-12.53403195,0.2054759336,2.3116042534,-12.32855602
39125,2012,221,199,-148,3,22,-145,11.44425457,10.305007509,-7.664025685,0.155351872,1.1392470613,-7.508673813
39125,2013,202,204,-112,5,-2,-107,10.52302563,10.627214003,-5.834548864,0.2604709314,-0.104188373,-5.574077933
39125,2014,243,158,-263,7,85,-256,12.749881946,8.2900466971,-13.79925495,0.3672805499,4.4598352484,-13.4319744
39125,2015,213,194,-46,7,19,-39,11.230919301,10.229100208,-2.42545675,0.3690912446,1.0018190926,-2.056365506
39125,2016,209,206,-129,8,3,-121,11.059956607,10.901201249,-6.826480394,0.4233476213,0.158755358,-6.403132772
39125,2017,213,186,-26,8,27,-18,11.304532428,9.8715635283,-1.379895977,0.4245833776,1.4329688993,-0.9553126
20145,2010,15,4,-1,0,11,-1,NA,NA,NA,NA,NA,NA
20145,2011,70,87,15,0,-17,15,10.030090271,12.465969337,2.149305058,0,-2.435879066,2.149305058
20145,2012,73,77,-111,-2,-4,-113,10.549132948,11.12716763,-16.04046243,-0.289017341,-0.578034682,-16.32947977
20145,2013,61,69,12,-2,-8,10,8.8882412939,10.053912283,1.748506484,-0.291417747,-1.165670989,1.4570887367
20145,2014,58,85,-12,-2,-27,-14,8.4751954409,12.420545043,-1.753488712,-0.292248119,-3.945349602,-2.045736831
20145,2015,68,83,-34,-2,-15,-36,10.004413712,12.211269678,-5.002206856,-0.294247462,-2.206855966,-5.296454318
20145,2016,68,64,-31,-2,4,-33,10.064382447,9.4723599497,-4.588174351,-0.296011248,0.5920224969,-4.884185599
20145,2017,64,79,-45,-2,-15,-47,9.5365817315,11.771718075,-6.70540903,-0.298018179,-2.235136343,-7.003427209
31133,2010,1,6,13,0,-5,13,NA,NA,NA,NA,NA,NA
31133,2011,25,38,23,0,-13,23,8.9734386217,13.639626705,8.2555635319,0,-4.666188083,8.2555635319
31133,2012,22,36,15,0,-14,15,7.8824793981,12.898602651,5.3744177714,0,-5.016123253,5.3744177714
31133,2013,34,43,-34,0,-9,-34,12.272153041,15.52066414,-12.27215304,0,-3.248511099,-12.27215304
31133,2014,28,45,-5,0,-17,-5,10.226442659,16.435354273,-1.826150475,0,-6.208911614,-1.826150475
31133,2015,34,32,-38,0,2,-38,12.555391433,11.816838996,-14.03249631,0,0.7385524372,-14.03249631
31133,2016,38,27,10,0,11,10,14.071468247,9.998148491,3.7030179596,0,4.0733197556,3.7030179596
31133,2017,39,25,-84,0,14,-84,14.573991031,9.3423019432,-31.39013453,0,5.2316890882,-31.39013453
40117,2010,53,41,7,1,12,8,NA,NA,NA,NA,NA,NA
40117,2011,192,219,160,5,-27,165,11.520460818,13.140525621,9.6003840154,0.3000120005,-1.620064803,9.9003960158
40117,2012,187,220,-257,3,-33,-254,11.270152177,13.259002561,-15.48892572,0.1808045804,-1.988850384,-15.30812114
40117,2013,193,214,30,6,-21,36,11.727888676,13.00398019,1.8229878771,0.3645975754,-1.276091514,2.1875854526
40117,2014,212,217,-110,7,-5,-103,12.918164646,13.22283834,-6.702821278,0.4265431723,-0.304673694,-6.276278106
40117,2015,198,199,78,7,-1,85,12.072802658,12.133776409,4.7559525624,0.4268162556,-0.060973751,5.1827688180000004
40117,2016,202,205,57,9,-3,66,12.262117947,12.44422861,3.460102589,0.5463319877,-0.182110663,4.0064345767
40117,2017,193,184,-49,9,9,-40,11.705127816,11.15929284,-2.971768202,0.5458349759,0.5458349759,-2.425933226
16075,2010,90,28,-44,-3,62,-47,NA,NA,NA,NA,NA,NA
16075,2011,319,202,-198,-13,117,-211,14.119729999,8.9410202501,-8.763970344,-0.575412194,5.1787097488,-9.339382538
16075,2012,303,186,27,-18,117,9,13.402335456,8.2271762208,1.1942675159,-0.796178344,5.1751592357,0.398089172
16075,2013,297,198,-213,-23,99,-236,13.140720749,8.7604804991,-9.424153264,-1.017631573,4.3802402495,-10.44178484
16075,2014,303,204,137,-24,99,113,13.384278994,9.0111977384,6.0516376968,-1.06014091,4.3730812554,4.9914967864
16075,2015,316,220,-31,-21,96,-52,13.881872296,9.6645946361,-1.361829244,-0.922529488,4.2172776594,-2.284358732
16075,2016,290,203,71,-20,87,51,12.69035533,8.883248731,3.1069490635,-0.875196919,3.807106599,2.2317521442
16075,2017,286,193,223,-21,93,202,12.398396012,8.3667497562,9.6672808063,-0.910371735,4.0316462556,8.7569090712
40119,2010,215,129,-84,59,86,-25,NA,NA,NA,NA,NA,NA
40119,2011,958,541,-152,352,417,200,12.327092582,6.961333076,-1.955864376,4.5293701345,5.3657595059,2.5735057582
40119,2012,884,567,-158,329,317,171,11.295103751,7.2447102116,-2.018808137,4.2037207401,4.0503935398,2.1849126035
40119,2013,934,540,163,372,394,535,11.827725506,6.8382995428,2.0641533805,4.710828574,4.9894259627,6.7749819545
40119,2014,896,539,16,407,357,423,11.226592992,6.7534973468,0.2004748749,5.0995796292,4.4730956453,5.3000545041
40119,2015,950,561,-284,430,389,146,11.807109123,6.9724086503,-3.529704201,5.3442704449,4.8347004723,1.8145662441
40119,2016,928,567,-285,445,361,160,11.45855842,7.0010804136,-3.519061584,5.4946751042,4.4574780059,1.9756135206
40119,2017,958,576,-502,441,382,-61,11.767307031,7.0751240603,-6.16616715,5.4168918587,4.6921829706,-0.749275291
13225,2010,81,29,1,3,52,4,NA,NA,NA,NA,NA,NA
13225,2011,318,238,-161,22,80,-139,11.472689227,8.5864781009,-5.808499892,0.7937080597,2.8862111263,-5.014791832
13225,2012,314,233,-125,37,81,-88,11.342086727,8.4162618071,-4.515161914,1.3364879265,2.9258249201,-3.178673987
13225,2013,293,242,-701,26,51,-675,10.701828077,8.8390525412,-25.60403236,0.949650273,1.8627755355,-24.65438209
13225,2014,300,228,-106,57,72,-49,11.075423635,8.4173219626,-3.913316351,2.1043304906,2.6581016724,-1.80898586
13225,2015,306,238,-276,66,68,-210,11.320964132,8.8051943247,-10.21106569,2.4417765774,2.5157698071,-7.76928911
13225,2016,288,286,-129,66,2,-63,10.694194315,10.619929077,-4.79010787,2.4507528639,0.0742652383,-2.339355006
13225,2017,329,273,77,66,56,143,12.185636505,10.111485611,2.8519574799,2.4445349828,2.0741508945,5.2964924627
28109,2010,165,160,-46,-3,5,-49,NA,NA,NA,NA,NA,NA
28109,2011,661,578,-343,-10,83,-353,11.895870639,10.402138017,-6.172895052,-0.179967786,1.4937326219,-6.352862838
28109,2012,685,574,-556,2,111,-554,12.406273771,10.39591408,-10.06990981,0.0362226971,2.0103596914,-10.03368711
28109,2013,627,637,-133,-15,-10,-148,11.418061297,11.600167538000001,-2.422013002,-0.273159361,-0.182106241,-2.695172364
28109,2014,641,593,275,-23,48,252,11.658785013,10.785740269,5.0018188432,-0.41833394,0.8730447435,4.5834849036
28109,2015,610,637,-133,-22,-27,-155,11.083755031,11.574347467,-2.416621999,-0.399741985,-0.490592436,-2.816363983
28109,2016,624,649,180,-22,-25,158,11.344113877,11.798605619,3.2723405416,-0.399952733,-0.454491742,2.8723878087
28109,2017,613,636,246,-22,-23,224,11.110909717,11.5277954,4.4588642584,-0.398760218,-0.416885683,4.0601040402
48371,2010,49,36,-1,2,13,1,NA,NA,NA,NA,NA,NA
48371,2011,230,107,-19,17,123,-2,14.763463637,6.8682200398,-1.219590474,1.0912125297,7.8952435972,-0.128377945
48371,2012,217,128,-166,8,89,-158,13.907136219,8.2032877239,-10.63863877,0.5127054827,5.7038484955,-10.12593328
48371,2013,223,116,-22,4,107,-18,14.283884192,7.4301819114,-1.409172431,0.2562131694,6.8537022803,-1.152959262
48371,2014,233,103,50,4,130,54,14.796939002,6.5411361255,3.1753087988,0.2540247039,8.2558028768,3.4293335027
48371,2015,222,126,81,3,96,84,13.938594839,7.9110943681,5.0857035223,0.1883593897,6.0275004709,5.274062912
48371,2016,196,93,-245,2,103,-243,12.290712987,5.8318178968,-15.36339123,0.1254154386,6.45889509,-15.23797579
48371,2017,197,104,-338,2,93,-336,12.503570182,6.6008695376,-21.452826,0.1269397988,5.9027006442,-21.3258862
38067,2010,15,26,4,0,-11,4,NA,NA,NA,NA,NA,NA
38067,2011,87,80,-57,6,7,-51,11.798209927,10.848928668,-7.729861676,0.8136696501,0.9492812585,-6.916192026
38067,2012,74,83,-136,9,-9,-127,10.156464452,11.391710129,-18.66593467,1.2352456766,-1.235245677,-17.43068899
38067,2013,73,97,-105,6,-24,-99,10.196242754,13.548432153,-14.66582862,0.8380473497,-3.352189399,-13.82778127
38067,2014,84,92,-36,23,-8,-13,11.850179869,12.978768428,-5.078648515,3.2446921069,-1.128588559,-1.833956408
38067,2015,85,77,-74,24,8,-50,12.043924903,10.910379029,-10.48529933,3.4006376196,1.1335458732,-7.084661707
38067,2016,79,56,-22,26,23,4,11.205673759,7.9432624113,-3.120567376,3.6879432624,3.2624113475,0.5673758865
38067,2017,80,72,-125,26,8,-99,11.40007125,10.260064125,-17.81261133,3.7050231564,1.140007125,-14.10758817
29155,2010,63,31,-58,1,32,-57,NA,NA,NA,NA,NA,NA
29155,2011,298,211,-165,-1,87,-166,16.343991663,11.572423627,-9.049525585,-0.05484561,4.771568036,-9.104371195
29155,2012,276,232,-145,-7,44,-152,15.214575122,12.789063146,-7.993164466,-0.385876905,2.425511976,-8.379041372
29155,2013,308,261,-350,-4,47,-354,17.173125174,14.552550878,-19.51491497,-0.2230276,2.6205742961,-19.73794257
29155,2014,271,263,-212,-3,8,-215,15.326753952,14.874303651,-11.98993298,-0.169668863,0.4524503012,-12.15960184
29155,2015,270,236,-182,-3,34,-185,15.425486331,13.483017682,-10.39792042,-0.171394293,1.9424686491,-10.56931471
29155,2016,261,220,-364,-3,41,-367,15.117289314,12.742542716,-21.08311613,-0.173761946,2.3747465972,-21.25687808
29155,2017,247,236,-285,-3,11,-288,14.560245225,13.911813252,-16.80028295,-0.176845084,0.6484319736,-16.97712804
53051,2010,25,54,-23,0,-29,-23,NA,NA,NA,NA,NA,NA
53051,2011,114,146,38,-2,-32,36,8.8037686308,11.275001931,2.9345895436,-0.154452081,-2.4712333,2.7801374624
53051,2012,100,129,80,-2,-29,78,7.7074261051,9.9425796755,6.165940884,-0.154148522,-2.23515357,6.0117923619
53051,2013,120,155,-79,-3,-35,-82,9.2735703246,11.978361669,-6.105100464,-0.231839258,-2.704791345,-6.336939722
53051,2014,105,137,61,-4,-32,57,8.1436382673,10.625508977,4.731066041,-0.310233839,-2.48187071,4.4208322023
53051,2015,123,140,179,-4,-17,175,9.4724682326,10.781671159,13.785136696,-0.308047747,-1.309202926,13.477088949
53051,2016,129,146,84,-5,-17,79,9.8510882016,11.149293624,6.4146620848,-0.381825124,-1.298205422,6.0328369607
53051,2017,129,141,246,-5,-12,241,9.7432024169000009,10.649546828,18.580060423,-0.377643505,-0.906344411,18.202416918
37141,2010,124,71,147,11,53,158,NA,NA,NA,NA,NA,NA
37141,2011,598,458,619,10,140,629,11.324363478,8.6731747039,11.722041794,0.1893706267,2.6511887741,11.911412421
37141,2012,589,456,402,10,133,412,11.015625731,8.528226372,7.518304828,0.1870225082,2.4873993585,7.7053273361
37141,2013,605,510,942,33,95,975,11.144678186,9.3946873964,17.35254025,0.6078915374,1.7499907895,17.960431787
37141,2014,600,526,1010,24,74,1034,10.832084635,9.4961275297,18.234009135,0.4332833854,1.3359571049,18.66729252
37141,2015,626,539,1415,36,87,1451,11.034142386,9.5006433645,24.941392135,0.6345513193,1.5334990217,25.575943454
37141,2016,630,568,1287,38,62,1325,10.823905368,9.7586956335,22.111692395,0.6528704825,1.0652097346,22.764562877
37141,2017,633,564,1946,38,69,1984,10.562763339,9.4113720746,32.472571023,0.6340995369,1.1513912644,33.10667056
21191,2010,32,17,27,0,15,27,NA,NA,NA,NA,NA,NA
21191,2011,156,153,-266,-1,3,-267,10.549807263,10.346926354,-17.98877392,-0.06762697,0.2028809089,-18.05640089
21191,2012,144,159,-98,-4,-15,-102,9.8630136986,10.890410959,-6.712328767,-0.273972603,-1.02739726,-6.98630137
21191,2013,177,134,-29,2,43,-27,12.16578459,9.2102550003,-1.993264142,0.1374664925,2.9555295897,-1.855797649
21191,2014,168,136,-118,3,32,-115,11.575031005,9.3702631942,-8.130081301,0.2066969822,2.2047678104,-7.923384319
21191,2015,176,173,-2,3,3,1,12.160154766,11.9528794,-0.138183577,0.2072753653,0.2072753653,0.0690917884
21191,2016,187,158,69,3,29,72,12.873911397,10.877422464,4.7502667722,0.2065333379,1.9964889333,4.9568001102
21191,2017,177,154,-29,3,23,-26,12.144498954,10.56640022,-1.989776665,0.2058389653,1.5780987341,-1.783937699
54071,2010,14,30,-4,1,-16,-3,NA,NA,NA,NA,NA,NA
54071,2011,65,112,-89,-3,-47,-92,8.5464466505,14.726184998,-11.702057720000001,-0.394451384,-6.179738347,-12.09650911
54071,2012,82,96,-73,20,-14,-53,10.928961749,12.794882047,-9.729441557,2.6656004265,-1.865920299,-7.06384113
54071,2013,68,102,-69,8,-34,-61,9.1613337824,13.742000674,-9.296059279,1.0778039744,-4.580666891,-8.218255305
54071,2014,82,95,-141,4,-13,-137,11.229800055,13.01013421,-19.30977814,0.5477951246,-1.780334155,-18.76198302
54071,2015,55,89,-96,3,-34,-93,7.6751325705,12.419759978,-13.39659503,0.4186435948,-4.744627407,-12.97795144
54071,2016,65,73,-107,0,-8,-107,9.2264017033,10.361958836,-15.18807665,0,-1.135557133,-15.18807665
54071,2017,58,66,18,0,-8,18,8.2957877423,9.4400343274,2.5745548166,0,-1.144246585,2.5745548166
27113,2010,53,15,-4,3,38,-1,NA,NA,NA,NA,NA,NA
27113,2011,184,165,59,18,19,77,13.128322215,11.772680247,4.209625058,1.2842923905999999,1.3556419678,5.4939174485
27113,2012,183,141,0,9,42,9,12.989778535,10.008517888,0,0.6388415673,2.9812606474,0.6388415673
27113,2013,184,139,-39,19,45,-20,13.028393401,9.8421015365,-2.761452949,1.3453232316,3.1862918643,-1.416129717
27113,2014,171,135,-78,23,36,-55,12.10748044,9.5585371897999991,-5.522710376,1.6284915212,2.5489432506,-3.894218855
27113,2015,192,125,43,26,67,69,13.539720038,8.8149218998,3.0323331335,1.8335037552,4.7247981383,4.8658368887
27113,2016,184,109,-96,26,75,-70,12.91273378,7.6493912067,-6.737078494,1.8246254255,5.2633425734,-4.912453069
27113,2017,170,129,-81,26,41,-55,11.934430833,9.0561269262,-5.686405279,1.8252658921,2.8783039068,-3.861139387
46103,2010,393,233,96,24,160,120,NA,NA,NA,NA,NA,NA
46103,2011,1513,802,436,-5,711,431,14.860723687,7.8772639767,4.2824028602,-0.049110125,6.9834597101,4.2332927356
46103,2012,1541,776,893,126,765,1019,14.920315253,7.5134098875,8.6462307082,1.2199608838,7.4069053659,9.866191592
46103,2013,1590,820,923,47,770,970,15.134497135,7.8052123589,8.7856231796,0.4473719279,7.329284776,9.2329951075
46103,2014,1561,758,750,50,803,800,14.624526296,7.1014676054,7.0265180792,0.4684345386,7.5230586902,7.4949526178
46103,2015,1562,839,-213,67,723,-146,14.486436355,7.7811268259,-1.975423139,0.6213772316,6.7053095293,-1.354045908
46103,2016,1461,910,208,39,551,247,13.46481729,8.3867102898,1.916962352,0.359430441,5.0781069997,2.276392793
46103,2017,1469,893,640,19,576,659,13.412830299,8.1536129727,5.8435748069,0.1734811271,5.2592173262,6.017055934
23019,2010,416,374,-130,19,42,-111,NA,NA,NA,NA,NA,NA
23019,2011,1448,1438,-221,96,10,-125,9.4162325966,9.3512033659,-1.437145997,0.6242806141,0.0650292306,-0.812865383
23019,2012,1481,1489,-429,107,-8,-322,9.6455378804,9.6976407184,-2.794014686,0.6968754579,-0.052102838,-2.097139229
23019,2013,1462,1596,-239,97,-134,-142,9.5416173107,10.416156791,-1.559812953,0.6330621608,-0.87453948,-0.926750792
23019,2014,1452,1462,-187,85,-10,-102,9.489699885,9.5550559448,-1.222158319,0.5555265084,-0.06535606,-0.66663181
23019,2015,1437,1584,-955,96,-147,-859,9.4268142681,10.391143911,-6.264862649,0.6297662977,-0.964329643,-5.635096351
23019,2016,1409,1595,-319,87,-186,-232,9.286568748,10.512474913,-2.102494983,0.5734077225,-1.225906165,-1.52908726
23019,2017,1379,1567,552,86,-188,638,9.088153108,10.32714715,3.6378974007,0.5667738704,-1.238994042,4.2046712712
17143,2010,623,431,-563,77,192,-486,NA,NA,NA,NA,NA,NA
17143,2011,2574,1808,-636,325,766,-311,13.805754007,9.6972817575,-3.411211946,1.7431507584000001,4.108472249,-1.668061187
17143,2012,2579,1736,-676,379,843,-297,13.796645259,9.2869236798,-3.61633664,2.0275023471,4.5097215795,-1.588834293
17143,2013,2779,1820,-21,352,959,331,14.795845024,9.6899740713,-0.111807393,1.8741048753,5.105870953,1.7622974822
17143,2014,2755,1762,-2435,392,993,-2043,14.658309745,9.3749334922,-12.95571115,2.0856832741,5.283376253,-10.87002788
17143,2015,2704,1865,-2194,418,839,-1776,14.461362384,9.9742754611,-11.73381253,2.2355212562,4.4870869233,-9.49829127
17143,2016,2623,1784,-2476,413,839,-2063,14.109129247,9.5961443295,-13.31841556,2.2215289283,4.5129849173,-11.09688663
17143,2017,2578,1758,-3526,408,820,-3118,13.999190892,9.5463838591,-19.14707024,2.2155430117,4.4528070333,-16.93152723
55091,2010,25,7,-17,0,18,-17,NA,NA,NA,NA,NA,NA
55091,2011,69,82,-62,2,-13,-60,9.2791823561,11.027434104,-8.33781603,0.2689618074,-1.748251748,-8.068854223
55091,2012,84,59,-58,4,25,-54,11.372097746,7.9875448453,-7.852162729,0.5415284641,3.3845529006,-7.310634265
55091,2013,83,83,-26,4,0,-22,11.274110296,11.274110296,-3.531649008,0.5433306167,0,-2.988318392
55091,2014,75,84,-44,3,-9,-41,10.237510238,11.466011466,-6.006006006,0.4095004095,-1.228501229,-5.596505597
55091,2015,78,72,-69,4,6,-65,10.728285537,9.9030328038,-9.490406437,0.5501684891,0.8252527336,-8.940237948
55091,2016,76,60,6,4,16,10,10.478422722,8.2724389908,0.8272438991,0.5514959327,2.2059837309,1.3787398318
55091,2017,79,85,-10,4,-6,-6,10.8815427,11.707988981,-1.377410468,0.5509641873,-0.826446281,-0.826446281
31135,2010,6,3,8,0,3,8,NA,NA,NA,NA,NA,NA
31135,2011,34,33,-35,0,1,-35,11.470985155,11.133603239,-11.80836707,0,0.3373819163,-11.80836707
31135,2012,33,32,-16,0,1,-16,11.226399047,10.886205137,-5.443102568,0,0.3401939105,-5.443102568
31135,2013,37,35,-42,0,2,-42,12.703862661,12.017167382,-14.42060086,0,0.686695279,-14.42060086
31135,2014,44,34,-27,2,10,-25,15.246015246,11.781011781,-9.355509356,0.693000693,3.465003465,-8.662508663
31135,2015,43,44,57,2,-1,59,14.784253051,15.12807289,19.597730789,0.6876396768,-0.343819838,20.285370466
31135,2016,44,24,-52,2,20,-50,15.058179329,8.2135523614,-17.79603012,0.6844626968,6.8446269678,-17.11156742
31135,2017,37,23,-19,2,14,-17,12.738853503,7.9187467722,-6.541573421,0.6885866758,4.8201067309,-5.852986745
46105,2010,15,23,4,0,-8,4,NA,NA,NA,NA,NA,NA
46105,2011,23,46,51,0,-23,51,7.6807480381,15.361496076,17.031223911,0,-7.680748038,17.031223911
46105,2012,33,48,27,1,-15,28,10.941644562,15.915119363,8.9522546419,0.3315649867,-4.973474801,9.2838196286
46105,2013,34,45,4,0,-11,4,11.258278146,14.900662252,1.3245033113,0,-3.642384106,1.3245033113
46105,2014,38,37,-3,0,1,-3,12.601558614,12.26993865,-0.994859891,0,0.3316199635,-0.994859891
46105,2015,34,48,-24,0,-14,-24,11.354149274,16.02938721,-8.014693605,0,-4.675237936,-8.014693605
46105,2016,38,31,-15,0,7,-15,12.792459182,10.435953543,-5.04965494,0,2.3565056388,-5.04965494
46105,2017,38,26,-5,0,12,-5,12.794612795,8.7542087542,-1.683501684,0,4.0404040404,-1.683501684
37143,2010,36,49,39,0,-13,39,NA,NA,NA,NA,NA,NA
37143,2011,134,139,24,1,-5,25,9.933283914,10.303928836,1.7790956264,0.0741289844,-0.370644922,1.8532246108
37143,2012,120,137,103,2,-17,105,8.8606660267,10.115927047,7.6054050063,0.1476777671,-1.25526102,7.7530827734
37143,2013,139,161,67,0,-22,67,10.213829084,11.830406349,4.9232125799,0,-1.616577265,4.9232125799
37143,2014,144,168,-65,-5,-24,-70,10.601487153,12.368401679,-4.785393507,-0.368107193,-1.766914526,-5.153500699
37143,2015,108,146,-26,-5,-38,-31,8.0002963073,10.815215378,-1.925997259,-0.370384088,-2.814919071,-2.296381347
37143,2016,119,159,9,-5,-40,4,8.8505447919,11.825517831,0.6693689338,-0.37187163,-2.974973039,0.2974973039
37143,2017,113,143,83,-5,-30,78,8.4011746775,10.631575034,6.1707743207,-0.371733393,-2.230400357,5.7990409278
01105,2010,32,18,-27,0,14,-27,NA,NA,NA,NA,NA,NA
01105,2011,134,145,-86,1,-11,-85,12.738248016,13.783925091,-8.175293503,0.0950615524,-1.045677076,-8.08023195
01105,2012,126,143,-279,1,-17,-278,12.199845081,13.845855926,-27.01394268,0.0968241673,-1.646010844,-26.91711851
01105,2013,119,148,-134,-2,-29,-136,11.780428649,14.651289412,-13.26535663,-0.197990397,-2.870860763,-13.46334703
01105,2014,89,136,-154,-1,-47,-155,8.9726786974,13.711059583,-15.52575865,-0.100816615,-4.738380885,-15.62657526
01105,2015,125,133,-159,-1,-8,-160,12.838948233,13.66064092,-16.33114215,-0.102711586,-0.821692687,-16.43385374
01105,2016,130,100,-113,0,30,-113,13.525464288,10.404203298,-11.75674973,0,3.1212609894,-11.75674973
01105,2017,126,129,-229,1,-3,-228,13.326987149,13.644296367,-24.22127029,0.1057697393,-0.317309218,-24.11550056
05105,2010,31,48,18,0,-17,18,NA,NA,NA,NA,NA,NA
05105,2011,115,103,-79,2,12,-77,11.048131425,9.8952829282,-7.589585935,0.1921414161,1.1528484965,-7.397444519
05105,2012,102,127,-33,2,-25,-31,9.8560247367,12.271717074,-3.188713885,0.193255387,-2.415692337,-2.995458498
05105,2013,101,122,30,1,-21,31,9.7820823245,11.81598063,2.9055690073,0.0968523002,-2.033898305,3.0024213075
05105,2014,106,120,37,1,-14,38,10.250954983,11.604854698,3.5781635317,0.0967071225,-1.353899715,3.6748706542
05105,2015,120,130,-44,1,-10,-43,11.621713234,12.590189337,-4.261294853,0.0968476103,-0.968476103,-4.164447242
05105,2016,115,134,-8,0,-19,-8,11.180244993,13.027415905,-0.777756173,0,-1.847170912,-0.777756173
05105,2017,119,120,78,0,-1,78,11.541632317,11.638620823,7.5651035352,0,-0.096988507,7.5651035352
17145,2010,48,76,-4,3,-28,-1,NA,NA,NA,NA,NA,NA
17145,2011,204,249,-30,19,-45,-11,9.1522914377,11.171179255,-1.345925211,0.8524193006,-2.018887817,-0.493505911
17145,2012,206,227,-426,12,-21,-414,9.3428273391,10.295251485,-19.32060411,0.5442423693,-0.952424146,-18.77636174
17145,2013,210,239,-114,14,-29,-100,9.6454161308,10.977402168,-5.236083042,0.6430277421,-1.331986037,-4.5930553
17145,2014,227,241,-164,11,-14,-153,10.498323506,11.145797202,-7.584691872,0.5087293329,-0.647473696,-7.075962539
17145,2015,201,268,-60,11,-67,-49,9.3573240846,12.476432113,-2.79323107,0.5120923628,-3.119108028,-2.281138707
17145,2016,224,213,-63,12,11,-51,10.46631156,9.9523409027,-2.943650126,0.5606952621,0.5139706569,-2.382954864
17145,2017,209,218,-100,12,-9,-88,9.7967984625,10.218670167,-4.687463379,0.5624956055,-0.421871704,-4.124967774
18123,2010,50,52,66,0,-2,66,NA,NA,NA,NA,NA,NA
18123,2011,217,208,8,-3,9,5,11.177212908,10.713641866,0.4120631487,-0.154523681,0.4635710423,0.2575394679
18123,2012,197,195,-44,-5,2,-49,10.157518884,10.054396865,-2.268684421,-0.257805048,0.1031220191,-2.526489469
18123,2013,210,210,54,-3,0,51,10.82837033,10.82837033,2.7844380849,-0.154691005,0,2.6297470802
18123,2014,168,226,-21,-3,-58,-24,8.6709677419,11.664516129,-1.083870968,-0.15483871,-2.993548387,-1.238709677
18123,2015,215,201,-38,-3,14,-41,11.129804581,10.40507312,-1.967128252,-0.155299599,0.7247314611,-2.12242785
18123,2016,225,178,-339,-2,47,-341,11.745360583,9.2918852609000009,-17.69634328,-0.104403205,2.4534753217,-17.80074648
18123,2017,229,172,18,-2,57,16,12.023837652,9.0310046993,0.9451051429,-0.105011683,2.9928329527,0.8400934604
21193,2010,93,128,8,-1,-35,7,NA,NA,NA,NA,NA,NA
21193,2011,409,425,52,-3,-16,49,14.251864241,14.809394383,1.8119729598,-0.104536902,-0.557530141,1.7074360583
21193,2012,415,431,-386,-3,-16,-389,14.553743644,15.114851832,-13.53673505,-0.105207785,-0.561108189,-13.64194284
21193,2013,399,398,-315,-6,1,-321,14.16953727,14.134024646,-11.18647679,-0.213075748,0.0355126247,-11.39955254
21193,2014,365,399,-400,0,-34,-400,13.136348095,14.360007918,-14.39599791,0,-1.223659823,-14.39599791
21193,2015,414,411,-216,0,3,-216,15.074553498,14.965317603,-7.864984434,0,0.1092358949,-7.864984434
21193,2016,416,403,-203,-1,13,-204,15.259895088,14.783023367,-7.446535344,-0.03668244,0.4768717215,-7.483217784
21193,2017,393,436,-570,-1,-43,-571,14.631966938,16.232920064,-21.22193678,-0.037231468,-1.600953126,-21.25916825
28111,2010,35,55,4,0,-20,4,NA,NA,NA,NA,NA,NA
28111,2011,147,133,-96,-2,14,-98,12.057581102,10.909240044,-7.874338679,-0.164048722,1.1483410573,-8.038387401
28111,2012,166,107,-214,-4,59,-218,13.751397921,8.8638528766,-17.72770575,-0.331358986,4.8875450441,-18.05906474
28111,2013,157,142,5,-4,15,1,13.082243146,11.832347304,0.4166319473,-0.333305558,1.249895842,0.0833263895
28111,2014,146,151,49,-2,-5,47,12.136325852,12.55195345,4.0731504572,-0.166251039,-0.415627598,3.9068994181
28111,2015,126,136,31,-2,-10,29,10.44819437,11.277416145,2.5705875036,-0.165844355,-0.829221775,2.4047431486
28111,2016,130,124,4,-2,6,2,10.768721007,10.271703115,0.3313452618,-0.165672631,0.4970178926,0.1656726309
28111,2017,129,119,-51,-2,10,-53,10.701841712,9.8722415796,-4.230960677,-0.165920027,0.8296001327,-4.396880704
29157,2010,63,68,-31,2,-5,-29,NA,NA,NA,NA,NA,NA
29157,2011,234,200,20,13,34,33,12.33526621,10.542962572,1.0542962572,0.6852925672,1.7923036373,1.7395888245
29157,2012,218,189,-33,0,29,-33,11.473986158,9.9476302008,-1.736887813,0,1.5263559567,-1.736887813
29157,2013,217,187,27,0,30,27,11.406944043,9.8299471706,1.4192971851,0,1.5769968723,1.4192971851
29157,2014,219,183,36,2,36,38,11.474379126,9.5881798177,1.8861993084,0.1047888505,1.8861993084,1.9909881589
29157,2015,215,206,-53,3,9,-50,11.256839184,10.78562266,-2.774941752,0.1570721747,0.471216524,-2.617869578
29157,2016,215,199,105,2,16,107,11.233313305,10.397345803,5.4860367303,0.1044959377,0.8359675018,5.590532668
29157,2017,226,223,21,2,3,23,11.762868891,11.606724614,1.0930099412,0.1040961849,0.1561442773,1.1971061261
39127,2010,108,100,-5,0,8,-5,NA,NA,NA,NA,NA,NA
39127,2011,455,320,57,0,135,57,12.59219284,8.856047712,1.5774834987,0,3.7361451285,1.5774834987
39127,2012,403,357,-295,1,46,-294,11.162043513,9.8879641042,-8.170726641,0.0276973784,1.2740794084,-8.143029262
39127,2013,426,308,-105,4,118,-101,11.836785729,8.558051654,-2.917517609,0.111143528,3.2787340752,-2.806374081
39127,2014,429,371,-145,7,58,-138,11.930917485,10.31787969,-4.032594488,0.1946769753,1.6130377951,-3.837917513
39127,2015,436,371,-27,7,65,-20,12.132173913,10.323478261,-0.751304348,0.1947826087,1.8086956522,-0.556521739
39127,2016,440,310,-75,7,130,-68,12.226127791,8.6138627617,-2.083999055,0.1945065785,3.6122650291,-1.889492477
39127,2017,428,361,-68,7,67,-61,11.881792818,10.021792541,-1.887761476,0.1943283872,1.8600002776,-1.693433089
42099,2010,120,83,-21,2,37,-19,NA,NA,NA,NA,NA,NA
42099,2011,606,417,-197,12,189,-185,13.178783463,9.0685688189,-4.284191984,0.2609660092,4.1102146445,-4.023225975
42099,2012,542,440,-215,8,102,-207,11.800180704,9.5794824902,-4.68088349,0.1741724089,2.2206982136,-4.506711081
42099,2013,548,442,-292,11,106,-281,11.967678532,9.6527626119,-6.376938196,0.2402271238,2.3149159205,-6.136711072
42099,2014,523,425,-112,10,98,-102,11.444451739,9.2999846824,-2.450819493,0.218823169,2.1444670562,-2.231996324
42099,2015,558,479,102,12,79,114,12.186599109,10.461256224,2.2276579016,0.2620774002,1.7253428846,2.4897353018
42099,2016,520,430,2,14,90,16,11.32071364,9.3613593565,0.0435412063,0.3047884442,1.9593542839,0.3483296505
42099,2017,527,428,30,14,99,44,11.442467404,9.2929336793,0.651373856,0.3039744661,2.1495337249,0.9553483222
47135,2010,31,39,17,0,-8,17,NA,NA,NA,NA,NA,NA
47135,2011,90,97,-67,-2,-7,-69,11.393126147,12.279258181,-8.481549465,-0.253180581,-0.886132034,-8.734730046
47135,2012,91,94,-8,-1,-3,-9,11.585715195,11.96766185,-1.018524413,-0.127315552,-0.381946655,-1.145839964
47135,2013,105,111,34,2,-6,36,13.353681801,14.116749332,4.324049345,0.2543558438,-0.763067531,4.5784051889
47135,2014,102,108,-54,2,-6,-52,12.996113907,13.760591196,-6.880295598,0.2548257629,-0.764477289,-6.625469835
47135,2015,100,132,59,2,-32,61,12.765685836,16.850705304,7.5317546435,0.2553137167,-4.085019468,7.7870683602
47135,2016,100,109,52,2,-9,54,12.706480305,13.850063532,6.6073697586,0.2541296061,-1.143583227,6.8614993647
47135,2017,94,104,91,2,-10,93,11.848490578,13.108968299,11.470347262,0.2520955442,-1.260477721,11.722442806
32027,2010,12,16,-11,0,-4,-11,NA,NA,NA,NA,NA,NA
32027,2011,52,55,-125,1,-3,-124,7.7879287105,8.23723229,-18.72098248,0.14976785980000001,-0.449303579,-18.57121462
32027,2012,60,52,131,-1,8,130,8.9739754711,7.7774454083,19.593179779,-0.149566258,1.1965300628,19.443613521
32027,2013,60,46,76,2,14,78,8.8196383948,6.7617227694,11.171541967,0.2939879465,2.0579156255,11.465529913
32027,2014,67,45,-165,0,22,-165,9.8820058997,6.6371681416,-24.33628319,0,3.2448377581,-24.33628319
32027,2015,49,44,-90,2,5,-88,7.3463268366,6.5967016492,-13.49325337,0.299850075,0.7496251874,-13.1934033
32027,2016,61,37,-48,2,24,-46,9.2179826218,5.5912353608,-7.2534945220000004,0.3022289384,3.6267472611,-6.951265584
32027,2017,53,43,-110,2,10,-108,8.0829647705,6.5578770779,-16.77596462,0.3050175385,1.5250876925,-16.47094708
37145,2010,103,137,-30,0,-34,-30,NA,NA,NA,NA,NA,NA
37145,2011,426,440,136,-10,-14,126,10.796016118,11.15081477,3.4466154743,-0.253427608,-0.354798652,3.1931878659
37145,2012,378,389,-319,-7,-11,-326,9.6075640504,9.8871492477,-8.10797072,-0.177917853,-0.279585197,-8.285888573
37145,2013,408,399,68,-7,9,61,10.406039584,10.176494593,1.7343399306,-0.178534993,0.2295449908,1.5558049378
37145,2014,438,418,-132,-6,20,-138,11.179601057,10.66911699,-3.369194839,-0.15314522,0.5104840665,-3.522340059
37145,2015,408,446,122,-4,-38,118,10.420391275,11.390917914,3.1159013128,-0.102160699,-0.970526638,3.013740614
37145,2016,405,429,122,-4,-24,118,10.321890053,10.933557611,3.10931009,-0.101944593,-0.611667559,3.0073654969
37145,2017,400,433,125,-3,-33,122,10.171258566,11.010387398,3.1785183019,-0.076284439,-0.839128832,3.1022338627
02195,2010,14,3,0,1,11,1,NA,NA,NA,NA,NA,NA
02195,2011,43,18,3,7,25,10,13.288009889,5.5624227441,0.9270704574,2.1631644005,7.7255871446,3.0902348578
02195,2012,39,18,-10,17,21,7,11.941212492,5.5113288426,-3.061849357,5.2051439069,6.4298836497,2.1432945499
02195,2013,40,13,-32,12,27,-20,12.183978069,3.9597928724,-9.747182455,3.6551934207,8.2241851965,-6.091989034
02195,2014,42,12,-63,11,30,-52,12.820512821,3.663003663,-19.23076923,3.3577533578,9.1575091575,-15.87301587
02195,2015,37,16,-36,12,21,-24,11.335784314,4.9019607843,-11.02941176,3.6764705882,6.4338235294,-7.352941176
02195,2016,30,20,-9,13,10,4,9.1729093411,6.1152728941,-2.751872802,3.9749273811,3.057636447,1.2230545788
02195,2017,29,21,-17,13,8,-4,8.8428114042,6.4034151547,-5.18371703,3.9640189053,2.4393962494,-1.219698125
51730,2010,127,111,30,14,16,44,NA,NA,NA,NA,NA,NA
51730,2011,516,396,-623,76,120,-547,15.981416957,12.264808362,-19.29539295,2.3538521099,3.7166085947,-16.94154084
51730,2012,493,356,-355,128,137,-227,15.389658025,11.113018777,-11.08180243,3.9956921444,4.2766392483,-7.086110287
51730,2013,483,402,153,82,81,235,15.023094509,12.503693566,4.7588684468,2.5505046578,2.5194009424,7.3093731046
51730,2014,481,444,-181,78,37,-103,14.902944958,13.756564577,-5.607968893,2.416693777,1.1463803814,-3.191275116
51730,2015,570,528,-349,99,42,-250,17.73656533,16.429660516,-10.85975667,3.0805613467,1.3069048138,-7.77919532
51730,2016,703,463,-511,87,240,-424,22.008640661,14.495022228,-15.99774591,2.7236866821,7.5136184334,-13.27405923
51730,2017,651,435,-394,81,216,-313,20.471698113,13.679245283,-12.38993711,2.5471698113,6.7924528302,-9.842767296
30069,2010,1,3,3,0,-2,3,NA,NA,NA,NA,NA,NA
30069,2011,3,1,0,-1,2,-1,6.0544904137,2.0181634712,0,-2.018163471,4.0363269425,-2.018163471
30069,2012,4,6,16,0,-2,16,7.9522862823,11.928429423,31.809145129,0,-3.976143141,31.809145129
30069,2013,4,5,1,0,-1,1,7.8431372549,9.8039215686,1.9607843137,0,-1.960784314,1.9607843137
30069,2014,3,3,-17,0,0,-17,5.9760956175,5.9760956175,-33.86454183,0,0,-33.86454183
30069,2015,3,3,-14,0,0,-14,6.160164271,6.160164271,-28.74743326,0,0,-28.74743326
30069,2016,0,1,20,0,-1,20,0,2.0449897751,40.899795501,0,-2.044989775,40.899795501
30069,2017,2,1,25,0,1,25,3.9177277179,1.958863859,48.971596474,0,1.958863859,48.971596474
29159,2010,166,117,6,6,49,12,NA,NA,NA,NA,NA,NA
29159,2011,600,459,-307,37,141,-270,14.219694277,10.878066122,-7.275743572,0.8768811471,3.341628155,-6.398862424
29159,2012,579,395,-51,35,184,-16,13.716478726,9.3575286648,-1.208187245,0.8291481095,4.3589500616,-0.379039136
29159,2013,574,432,-287,51,142,-236,13.587406794,10.226062256,-6.793703397,1.2072434608,3.3613445378,-5.586459936
29159,2014,561,407,-183,41,154,-142,13.29336635,9.6442069595,-4.336338756,0.971529448,3.6491593901,-3.364809308
29159,2015,600,408,-141,51,192,-90,14.199334998,9.6555477985,-3.336843724,1.2069434748,4.5437871993,-2.12990025
29159,2016,572,449,-201,54,123,-147,13.524856653,10.616539576,-4.752615712,1.2768221316,2.9083170775,-3.47579358
29159,2017,556,400,70,55,156,125,13.107333978,9.4297366746,1.6502039180999999,1.2965887928,3.6775973031,2.9467927108
29161,2010,144,74,59,30,70,89,NA,NA,NA,NA,NA,NA
29161,2011,551,442,-382,166,109,-216,12.173836195,9.7655818475,-8.439937253,3.667616712,2.408254347,-4.772320541
29161,2012,561,400,-319,163,161,-156,12.407249726,8.846523869,-7.055102786,3.6049584766,3.5607258573,-3.450144309
29161,2013,523,437,-487,197,86,-290,11.59079828,9.6848543948,-10.7929613,4.365941226,1.9059438855,-6.427020079
29161,2014,514,433,-355,217,81,-138,11.422983754,9.6228637465,-7.88941485,4.8225437251,1.800120008,-3.066871125
29161,2015,508,480,-436,232,28,-204,11.317938264,10.694114895,-9.71382103,5.1688221992,0.6238233689,-4.54499883
29161,2016,523,464,-263,232,59,-31,11.670590336,10.354022783,-5.868767224,5.1770113917,1.3165675522,-0.691755833
29161,2017,496,442,-369,231,54,-138,11.074889474,9.8691555397,-8.239181887,5.1578618318,1.2057339347,-3.081320055
31137,2010,22,34,7,0,-12,7,NA,NA,NA,NA,NA,NA
31137,2011,114,131,-25,3,-17,-22,12.4420191,14.297407913,-2.72851296,0.3274215553,-1.855388813,-2.401091405
31137,2012,133,111,45,3,22,48,14.491174548,12.094138156,4.9030289823,0.3268685988,2.3970363914,5.2298975812
31137,2013,106,114,-23,1,-8,-22,11.524870889,12.394672465,-2.500679532,0.1087251971,-0.869801577,-2.391954335
31137,2014,115,100,-32,3,15,-29,12.534743038,10.899776555,-3.487928497,0.3269932966,1.6349664832,-3.160935201
31137,2015,120,114,48,3,6,51,13.051280657,12.398716624,5.2205122628,0.3262820164,0.6525640328,5.5467942792
31137,2016,106,122,-25,3,-16,-22,11.517983266,13.256546778,-2.716505487,0.3259806585,-1.738563512,-2.390524829
31137,2017,109,101,-136,3,8,-133,11.949133962,11.072133304,-14.90901118,0.3288752467,0.8770006578,-14.58013594
42101,2010,5561,3488,-1227,1596,2073,369,NA,NA,NA,NA,NA,NA
42101,2011,23257,14374,-5120,7816,8883,2696,15.161412292,9.3705181361,-3.337766304,5.0953088738,5.7908941563,1.7575425696
42101,2012,23326,14305,-4797,8285,9021,3488,15.089955243,9.2541288585,-3.103254536,5.3596964413,5.8358263847,2.2564419055
42101,2013,22891,14382,-10750,8476,8509,-2274,14.720649455,9.2487169833,-6.913065469,5.4507109686,5.4719324719,-1.4623545
42101,2014,22547,14120,-11819,9399,8427,-2420,14.44324762,9.0450461877,-7.571062386,6.0208490877,5.3982014323,-1.550213298
42101,2015,22362,14123,-11771,10073,8239,-1698,14.268081309,9.0111847031,-7.510490345,6.4270808974,5.2568966062,-1.083409447
42101,2016,21790,14752,-13078,10307,7038,-2771,13.855717407,9.3804287833,-8.315973944,6.5539641723,4.4752886237,-1.762009772
42101,2017,21776,15026,-10817,10240,6750,-577,13.801373292,9.5233024932,-6.855687679,6.4899918495,4.2780707992,-0.36569583
05107,2010,67,38,-115,1,29,-114,NA,NA,NA,NA,NA,NA
05107,2011,319,275,-315,-3,44,-318,14.809656453,12.766945218,-14.62395543,-0.139275766,2.0427112349,-14.7632312
05107,2012,303,307,-675,-4,-4,-679,14.378929885,14.568750741,-32.03226955,-0.189820857,-0.189820857,-32.2220904
05107,2013,299,265,-335,-1,34,-336,14.520554598,12.869387854,-16.2688488,-0.048563728,1.6511667436,-16.31741252
05107,2014,318,272,-537,0,46,-537,15.74062616,13.463680238,-26.5808687,0,2.2769459225,-26.5808687
05107,2015,308,252,-461,1,56,-460,15.585467058,12.751745775,-23.32759842,0.0506021658,2.8337212833,-23.27699626
05107,2016,297,283,-527,1,14,-526,15.383818502,14.65865534,-27.2972133,0.0517973687,0.7251631617,-27.24541593
05107,2017,290,265,-507,1,25,-506,15.416511616,14.087501994,-26.95231513,0.0531603849,1.329009622,-26.89915475
08095,2010,17,8,17,3,9,20,NA,NA,NA,NA,NA,NA
08095,2011,50,61,-102,14,-11,-88,11.304544427,13.791544201,-23.06127063,3.1652724395,-2.486999774,-19.89599819
08095,2012,54,48,-2,14,6,12,12.318923235,10.950153987,-0.456256416,3.1937949127,1.3687692483,2.7375384966
08095,2013,41,49,-30,8,-8,-22,9.3650068524,11.192325263,-6.852444038,1.8273184102,-1.82731841,-5.025125628
08095,2014,65,49,-7,8,16,1,14.865637507,11.206403659,-1.600914808,1.829616924,3.6592338479,0.2287021155
08095,2015,56,56,-78,10,0,-68,12.878003909,12.878003909,-17.93721973,2.2996435552,0,-15.63757618
08095,2016,66,41,-71,12,25,-59,15.355979525,9.5393206142,-16.51931131,2.7919962773,5.8166589111,-13.72731503
08095,2017,65,53,-13,12,12,-1,15.163886621,12.36439986,-3.032777324,2.7994867608,2.7994867608,-0.233290563
20147,2010,7,10,-5,0,-3,-5,NA,NA,NA,NA,NA,NA
20147,2011,63,93,-63,0,-30,-63,11.275167785,16.644295302,-11.27516779,0,-5.369127517,-11.27516779
20147,2012,59,69,-11,1,-10,-10,10.666184579,12.474012474,-1.988610684,0.1807827895,-1.807827895,-1.807827895
20147,2013,71,63,30,0,8,30,12.813571557,11.369788847,5.4141851651,0,1.4437827107,5.4141851651
20147,2014,69,82,-53,0,-13,-53,12.484168627,14.836258368,-9.589288945,0,-2.352089741,-9.589288945
20147,2015,63,65,-77,0,-2,-77,11.550096251,11.916765973,-14.11678431,0,-0.366669722,-14.11678431
20147,2016,43,65,1,0,-22,1,7.9570688379,12.028127313,0.1850481125,0,-4.071058475,0.1850481125
20147,2017,46,64,-5,0,-18,-5,8.5478026573,11.892595001,-0.929108984,0,-3.344792344,-0.929108984
30071,2010,6,11,6,1,-5,7,NA,NA,NA,NA,NA,NA
30071,2011,46,65,-45,2,-19,-43,10.89402013,15.393724097,-10.65719361,0.4736530491,-4.499703967,-10.18354056
30071,2012,43,54,-67,1,-11,-66,10.352714578,13.001083424,-16.13097388,0.2407608041,-2.648368846,-15.89021307
30071,2013,46,61,54,-2,-15,52,11.125891885,14.753900109,13.060829605,-0.48373443,-3.628008223,12.577095175
30071,2014,63,63,12,-1,0,11,15.147872085,15.147872085,2.8853089685,-0.240442414,0,2.6448665545
30071,2015,63,48,-40,-1,15,-41,15.169756802,11.557909945,-9.631591621,-0.240789791,3.6118468577,-9.872381411
30071,2016,56,32,-47,-1,24,-48,13.564248516,7.7509991522,-11.38428,-0.242218724,5.8132493642,-11.62649873
30071,2017,54,38,-12,-1,16,-13,13.114754098,9.2289010322,-2.9143898,-0.242865817,3.8858530662,-3.157255616
17147,2010,48,54,-9,1,-6,-8,NA,NA,NA,NA,NA,NA
17147,2011,153,148,-40,2,5,-38,9.1644204852,8.8649296196,-2.395926924,0.1197963462,0.2994908655,-2.276130578
17147,2012,176,178,-180,3,-2,-177,10.608480757,10.729031675,-10.84958259,0.1808263765,-0.120550918,-10.66875622
17147,2013,158,193,-37,2,-35,-35,9.5952388182,11.720766405000001,-2.246986306,0.1214587192,-2.125527586,-2.125527586
17147,2014,185,167,-39,2,18,-37,11.26606175,10.169904391,-2.375007612,0.1217952622,1.0961573595,-2.25321235
17147,2015,189,182,-68,2,7,-66,11.537405,11.110093703,-4.151024021,0.1220889418,0.4273112963,-4.028935079
17147,2016,165,143,151,3,22,154,10.03710688,8.6988259626,9.185473569,0.1824928524,1.3382809173,9.3679664213
17147,2017,178,170,-93,3,8,-90,10.797367383,10.312092445,-5.641321161,0.181978102,0.4852749386,-5.459343059
39129,2010,172,98,-22,2,74,-20,NA,NA,NA,NA,NA,NA
39129,2011,571,481,115,5,90,120,10.22665198,8.6147453635,2.0596584549,0.0895503676,1.6119066169,2.1492088225
39129,2012,587,504,200,13,83,213,10.466909765,8.9869208206,3.5662384209,0.2318054974,1.4799889447,3.7980439182
39129,2013,620,550,50,4,70,54,11.015172512,9.7715240024,0.8883203639,0.0710656291,1.2436485094,0.959385993
39129,2014,594,469,220,9,125,229,10.509740087,8.2980944461,3.8924963287,0.1592384862,2.2116456413,4.0517348148
39129,2015,662,528,144,10,134,154,11.647957209,9.2902136045,2.5336946194,0.1759510152,2.3577436042,2.7096456347
39129,2016,583,577,537,12,6,549,10.182961443,10.078162526,9.3795030785,0.2095978342,0.1047989171,9.5891009126
39129,2017,620,574,245,12,46,257,10.748959778,9.9514563107,4.2475728155,0.2080443828,0.7975034674,4.4556171983
01107,2010,53,31,-18,-1,22,-19,NA,NA,NA,NA,NA,NA
01107,2011,220,265,-352,-4,-45,-356,11.252333581,13.553947267,-18.00373373,-0.204587883,-2.301613687,-18.20832161
01107,2012,224,238,-24,-1,-14,-25,11.586107016,12.310238705,-1.241368609,-0.051723692,-0.724131689,-1.293092301
01107,2013,198,260,53,-2,-62,51,10.255082222,13.466269584,2.7450472614,-0.103586689,-3.211187362,2.6414605723
01107,2014,232,243,944,4,-11,948,11.721907842,12.277687955,47.696038804,0.2021018593,-0.555780113,47.898140663
01107,2015,234,261,505,6,-27,511,11.398509426,12.713722052,24.599347265,0.2922694725,-1.315212626,24.891616737
01107,2016,226,248,-446,6,-22,-440,10.999975664,12.070769755,-21.70791658,0.2920347521,-1.070794091,-21.41588182
01107,2017,226,251,-119,6,-25,-113,11.162974488,12.397816799,-5.877849399,0.2963621546,-1.234842311,-5.581487244
13227,2010,77,51,6,2,26,8,NA,NA,NA,NA,NA,NA
13227,2011,308,290,-73,19,18,-54,10.464800217,9.853220984,-2.480293558,0.6455558576,0.6115792335,-1.8347377
13227,2012,290,293,-139,12,-3,-127,9.8817596347,9.9839847344,-4.736429618,0.4089003987,-0.1022251,-4.327529219
13227,2013,300,311,124,12,-11,136,10.223032492,10.597877017,4.2255200968,0.4089212997,-0.374844525,4.6344413965
13227,2014,295,335,453,9,-40,462,9.9579739742,11.308207733,15.291397323,0.3038025958,-1.350233759,15.595199919
13227,2015,318,283,292,12,35,304,10.596291298,9.4300328218,9.7299278586,0.399860049,1.1662584762,10.129787908
13227,2016,307,347,541,12,-40,553,10.086076615,11.400223405,17.773835337,0.3942440371,-1.31414679,18.168079374
13227,2017,295,351,934,12,-56,946,9.4728898736,11.271133375,29.992132685,0.3853378932,-1.798243501,30.377470578
45077,2010,288,251,-119,53,37,-66,NA,NA,NA,NA,NA,NA
45077,2011,1210,1036,58,183,174,241,10.134639948,8.6772619721,0.4857926587,1.5327595955,1.457377976,2.0185522541
45077,2012,1202,1095,-179,168,107,-11,10.047226982,9.152839888,-1.496217662,1.4042713253,0.8943870941,-0.091946337
45077,2013,1145,1124,-732,141,21,-591,9.5898556915,9.4139718753,-6.130807307,1.1809341943,0.1758838162,-4.949873112
45077,2014,1231,1189,976,235,42,1211,10.280092863,9.9293504585,8.1505854058,1.9624872647,0.3507424048,10.11307267
45077,2015,1288,1201,624,257,87,881,10.65731118,9.937446217,5.1631693917,2.1264976501,0.7198649633,7.2896670418
45077,2016,1251,1138,1230,258,113,1488,10.242554498,9.3173677208,10.070617132,2.1123733497,0.9251867772,12.182990482
45077,2017,1244,1145,190,257,99,447,10.096665016,9.293152286,1.5420951392,2.085886583,0.8035127304,3.6279817221
47137,2010,15,20,0,1,-5,1,NA,NA,NA,NA,NA,NA
47137,2011,42,66,48,-3,-24,45,8.2603992526,12.980627397,9.4404562887,-0.590028518,-4.720228144,8.8504277707
47137,2012,39,72,-24,-1,-33,-25,7.6976216323,14.210993783,-4.736997928,-0.197374914,-6.51337215,-4.934372841
47137,2013,26,85,29,-3,-59,26,5.1787670551,16.930584603,5.7763170999,-0.597550045,-11.75181755,5.1787670551
47137,2014,45,53,72,-3,-8,69,8.9356632248,10.524225576,14.29706116,-0.595710882,-1.588562351,13.701350278
47137,2015,47,74,89,-3,-27,86,9.2211104571,14.518344124,17.461251717,-0.588581519,-5.297233667,16.872670198
47137,2016,49,60,-27,-3,-11,-30,9.5974928998,11.752032122,-5.288414455,-0.587601606,-2.154539222,-5.876016061
47137,2017,43,57,6,-3,-14,3,8.4662335105,11.22268163,1.1813349084,-0.590667454,-2.75644812,0.5906674542
13229,2010,57,37,30,2,20,32,NA,NA,NA,NA,NA,NA
13229,2011,243,196,-93,10,47,-83,12.927594829,10.427195829,-4.947598021,0.5319997872,2.5003989998,-4.415598234
13229,2012,224,180,78,14,44,92,11.885180665,9.5505916061,4.138589696,0.7428237916,2.3345890593,4.8814134876
13229,2013,259,202,57,0,57,57,13.651697238,10.647269661,3.0044275775,0,3.0044275775,3.0044275775
13229,2014,214,211,-2,0,3,-2,11.246583982,11.088921589,-0.105108262,0,0.1576623923,-0.105108262
13229,2015,237,198,59,0,39,59,12.424639581,10.380078637,3.0930537353,0,2.0445609436,3.0930537353
13229,2016,259,186,22,0,73,22,13.51034141,9.7024073446,1.1475965676,0,3.8079340654,1.1475965676
13229,2017,249,204,46,0,45,46,12.926670993,10.590525633,2.3880597015,0,2.3361453602,2.3880597015
31139,2010,20,10,-19,0,10,-19,NA,NA,NA,NA,NA,NA
31139,2011,70,53,-87,2,17,-85,9.6879108712,7.3351325168,-12.04068923,0.2767974535,2.3527783544,-11.76389177
31139,2012,78,69,-17,2,9,-15,10.849155018,9.5973294388,-2.364559427,0.278183462,1.251825579,-2.0863759650000002
31139,2013,91,84,-15,3,7,-12,12.667919538,11.693464189,-2.088118605,0.417623721,0.9744553491,-1.670494884
31139,2014,80,69,12,4,11,16,11.121924093,9.5926595301,1.6682886139,0.5560962046,1.5292645628,2.2243848186
31139,2015,94,95,-14,4,-1,-10,13.054648983,13.193528227,-1.944309423,0.555516978,-0.138879244,-1.388792445
31139,2016,92,51,-84,4,41,-80,12.821406174,7.1075186398,-11.70650129,0.5574524423,5.713887534,-11.14904885
31139,2017,91,61,-52,4,30,-48,12.732615083,8.5350496712,-7.275780048,0.5596753883,4.1975654121,-6.716104659
38069,2010,4,7,4,0,-3,4,NA,NA,NA,NA,NA,NA
38069,2011,40,66,32,0,-26,32,9.1722082091,15.134143545,7.3377665673,0,-5.961935336,7.3377665673
38069,2012,52,75,102,0,-23,102,11.80610739,17.028039505,23.158133727,0,-5.221932115,23.158133727
38069,2013,57,68,-15,0,-11,-15,12.86246192,15.344691414,-3.3848584,0,-2.482229493,-3.3848584
38069,2014,51,69,-38,0,-18,-38,11.617312073,15.717539863,-8.656036446,0,-4.10022779,-8.656036446
38069,2015,49,65,-76,0,-16,-76,11.353104727,15.060240964,-17.60889713,0,-3.707136237,-17.60889713
38069,2016,38,54,-41,0,-16,-41,8.9590946599,12.731345043,-9.666391607,0,-3.772250383,-9.666391607
38069,2017,39,48,-105,0,-9,-105,9.3840230991,11.549566891,-25.26467757,0,-2.165543792,-25.26467757
53053,2010,2666,1357,-1793,496,1309,-1297,NA,NA,NA,NA,NA,NA
53053,2011,10849,5778,1310,1247,5071,2557,13.577322155,7.231059767,1.6394406879,1.5605973571,6.3462623881,3.200038045
53053,2012,11443,5724,-19,2544,5719,2525,14.181821787,7.0940092554,-0.02354755,3.1528930024,7.0878125318,3.1293454525
53053,2013,10967,5870,1469,1735,5097,3204,13.455682256,7.2020474918,1.8023522599,2.1287142075,6.2536347642,3.9310664674
53053,2014,11501,6031,2512,1760,5470,4272,13.957668253,7.3192502593,3.048575137,2.1359443635,6.6384179934,5.1845195005
53053,2015,11515,6367,5351,2139,5148,7490,13.788066108,7.6238486246,6.4072897739,2.5612395489,6.1642174838,8.9685293228
53053,2016,11734,6782,11604,1708,4952,13312,13.794822298,7.9731110299,13.641990621,2.007973111,5.821711268,15.649963732
53053,2017,11778,6936,10736,1388,4842,12124,13.565092403,7.9884089752,12.364988287,1.5986031802,5.5766834282,13.963591467
55093,2010,100,68,38,-5,32,33,NA,NA,NA,NA,NA,NA
55093,2011,401,231,-363,-10,170,-373,9.7878884034,5.6384095292,-8.860357832,-0.244086993,4.1494788743,-9.104444824
55093,2012,398,241,-332,0,157,-332,9.7575326681,5.9084557111,-8.139449361,0,3.849076957,-8.139449361
55093,2013,413,261,-108,29,152,-79,10.137083809,6.4062442473,-2.650859689,0.7118049164,3.7308395616,-1.939054772
55093,2014,357,243,76,43,114,119,8.7306342549,5.9427006273,1.8586224184,1.0515889999,2.7879336276,2.9102114183
55093,2015,390,293,-129,49,97,-80,9.5095278154,7.1443375639,-3.1454592,1.1947868281,2.3651902515,-1.950672372
55093,2016,387,275,249,49,112,298,9.3877352998,6.6708713371,6.0401707743,1.1886279837,2.7168639627,7.228798758
55093,2017,388,273,309,49,115,358,9.3124842492,6.5523407217,7.4163856521,1.1760611552,2.7601435275,8.5924468072
01109,2010,93,79,27,28,14,55,NA,NA,NA,NA,NA,NA
01109,2011,390,325,-158,95,65,-63,11.83001183,9.8583431917,-4.792671459,2.8816695483,1.9716686383,-1.911001911
01109,2012,412,312,-58,90,100,32,12.473508931,9.4459582198,-1.755979413,2.7247956403,3.0275507115,0.9688162277
01109,2013,351,346,369,87,5,456,10.53168507,10.381661066,11.071771483,2.6104176668,0.1500240038,13.68218915
01109,2014,394,321,-747,105,73,-642,11.835563766,9.6426801244,-22.43950795,3.1541477042,2.192883642,-19.28536025
01109,2015,380,314,177,111,66,288,11.447852021,9.4595408809,5.3322889679,3.3439778273,1.9883111406,8.6762667952
01109,2016,389,280,-378,110,109,-268,11.683962335,8.4100500098,-11.35356751,3.3039482181,3.2739123252,-8.049619295
01109,2017,378,330,-104,109,48,5,11.371499052,9.9274991727,-3.128666406,3.2790830601,1.4439998797,0.1504166541
05109,2010,25,49,0,0,-24,0,NA,NA,NA,NA,NA,NA
05109,2011,134,120,-42,-2,14,-44,11.914288255,10.66951187,-3.734329154,-0.177825198,1.2447763848,-3.912154352
05109,2012,118,131,27,4,-13,31,10.498220641,11.65480427,2.4021352313,0.3558718861,-1.15658363,2.7580071174
05109,2013,109,164,-86,3,-55,-83,9.7504249038,14.670364075,-7.692995796,0.2683603185,-4.919939172,-7.424635477
05109,2014,104,156,-80,6,-52,-74,9.4151729133,14.12275937,-7.242440703,0.5431830527,-4.707586457,-6.69925765
05109,2015,112,152,-120,6,-40,-114,10.26957638,13.93728223,-11.00311755,0.5501558775,-3.66770585,-10.45296167
05109,2016,120,126,-11,6,-6,-5,11.086986649,11.641335982,-1.01630711,0.5543493325,-0.554349332,-0.461957777
05109,2017,119,126,-90,6,-7,-84,11.047672098,11.697535162,-8.355382259,0.5570254839,-0.649863065,-7.798356775
13231,2010,40,19,30,0,21,30,NA,NA,NA,NA,NA,NA
13231,2011,166,148,-163,2,18,-161,9.3002409099,8.2917810522,-9.132164267,0.1120510953,1.0084598577,-9.020113172
13231,2012,154,169,1,1,-15,2,8.6648286727,9.5088054915,0.0562651213,0.0562651213,-0.843976819,0.1125302425
13231,2013,175,178,5,3,-3,8,9.8488898894,10.017728002,0.281396854,0.1688381124,-0.168838112,0.4502349664
13231,2014,145,156,2,2,-11,4,8.1616570978,8.7808172915,0.1125745807,0.1125745807,-0.619160194,0.2251491613
13231,2015,151,177,187,2,-26,189,8.4634139506,9.9206905249,10.481181515,0.112098198,-1.457276574,10.593279713
13231,2016,167,150,-18,2,17,-16,9.3178964988,8.3693681127,-1.004324174,0.1115915748,0.9485283861,-0.892732599
13231,2017,163,180,309,2,-17,311,9.020475927,9.9612617598,17.100166021,0.1106806862,-0.940785833,17.210846707
17149,2010,34,55,-14,0,-21,-14,NA,NA,NA,NA,NA,NA
17149,2011,191,215,-23,-1,-24,-24,11.667684789,13.133781307,-1.405009163,-0.061087355,-1.466096518,-1.466096518
17149,2012,167,202,-76,0,-35,-76,10.252002824,12.40062617,-4.665582123,0,-2.148623346,-4.665582123
17149,2013,170,185,-149,0,-15,-149,10.525012382,11.453689946,-9.224863794,0,-0.928677563,-9.224863794
17149,2014,179,205,-88,0,-26,-88,11.178068505,12.801698567,-5.495363287,0,-1.623630062,-5.495363287
17149,2015,178,200,-15,0,-22,-15,11.16897785,12.549413315,-0.941205999,0,-1.380435465,-0.941205999
17149,2016,184,209,-9,0,-25,-9,11.572327044,13.144654088,-0.566037736,0,-1.572327044,-0.566037736
17149,2017,176,181,-55,0,-5,-55,11.103050185,11.418477747,-3.469703183,0,-0.315427562,-3.469703183
18125,2010,39,18,0,0,21,0,NA,NA,NA,NA,NA,NA
18125,2011,140,145,-125,2,-5,-123,11.006721962,11.399819175,-9.827430324,0.1572388852,-0.393097213,-9.670191438
18125,2012,140,139,21,2,1,23,11.05190448,10.972962305,1.657785672,0.1578843497,0.0789421749,1.8156700217
18125,2013,138,129,-136,2,9,-134,10.93719041,10.223895383,-10.7786804,0.1585100059,0.7132950267,-10.6201704
18125,2014,153,125,-36,2,28,-34,12.188321517,9.957779017,-2.867840357,0.1593244643,2.2305424998,-2.708515893
18125,2015,133,162,-64,2,-29,-62,10.636596289,12.955854127,-5.118362124,0.1599488164,-2.319257837,-4.958413308
18125,2016,128,163,4,2,-35,6,10.286908302,13.099734791,0.3214658844,0.1607329422,-2.812826489,0.4821988266
18125,2017,133,143,-54,2,-10,-52,10.728834752,11.535514056,-4.356068245,0.1613358609,-0.806679305,-4.194732384
21195,2010,164,220,93,2,-56,95,NA,NA,NA,NA,NA,NA
21195,2011,739,825,-58,-10,-86,-68,11.37141758,12.69474899,-0.892479323,-0.153875745,-1.32333141,-1.046355068
21195,2012,757,808,-258,-7,-51,-265,11.691751678,12.479439043,-3.984771378,-0.108113952,-0.787687365,-4.09288533
21195,2013,732,810,-669,1,-78,-668,11.398850772,12.613482411,-10.41780214,0.0155722005,-1.21463164,-10.40222994
21195,2014,750,845,-828,19,-95,-809,11.829652997,13.32807571,-13.05993691,0.2996845426,-1.498422713,-12.76025237
21195,2015,705,833,-1059,22,-128,-1037,11.302061624,13.354067139,-16.97713938,0.3526884479,-2.052005515,-16.62445093
21195,2016,624,794,-1214,22,-170,-1192,10.208922991,12.990200088,-19.86159056,0.3599299773,-2.781277097,-19.50166059
21195,2017,614,823,-1381,22,-209,-1359,10.291135209,13.794143774,-23.14667382,0.3687377437,-3.503008565,-22.77793607
28113,2010,145,83,-22,2,62,-20,NA,NA,NA,NA,NA,NA
28113,2011,599,503,-100,-7,96,-107,14.81261669,12.438641394,-2.472890933,-0.173102365,2.3739752958,-2.645993298
28113,2012,587,488,-446,-5,99,-451,14.580952854,12.121814298,-11.0785434,-0.124198917,2.4591385563,-11.20274231
28113,2013,534,459,-225,6,75,-219,13.345329135,11.470985155,-5.623031939,0.1499475184,1.8743439796,-5.47308442
28113,2014,566,504,-71,8,62,-63,14.171434294,12.619086368,-1.777688754,0.2003029582,1.5523479262,-1.577385796
28113,2015,505,518,-67,10,-13,-57,12.656800211,12.98261883,-1.679219038,0.2506297071,-0.325818619,-1.428589331
28113,2016,543,530,-277,10,13,-267,13.665534164,13.338366679,-6.971184095,0.2516672958,0.3271674846,-6.719516799
28113,2017,522,506,-162,10,16,-152,13.202488745,12.79781476,-4.097324093,0.2529212403,0.4046739845,-3.844402853
29163,2010,50,63,-23,1,-13,-22,NA,NA,NA,NA,NA,NA
29163,2011,222,171,133,-1,51,132,11.953478355,9.2074090028,7.1613181133,-0.053844497,2.7460693517,7.1074736162
29163,2012,230,183,-154,-1,47,-155,12.358282736,9.8328945247,-8.274676267,-0.053731664,2.5253882113,-8.328407931
29163,2013,199,199,56,-1,0,55,10.708136031,10.708136031,3.0133448127,-0.053809729,0,2.9595350839
29163,2014,235,212,-131,-1,23,-132,12.664367321,11.424876051,-7.059711145,-0.053890925,1.2394912697,-7.113602069
29163,2015,216,216,-102,-1,0,-103,11.706682565,11.706682565,-5.528155656,-0.054197604,0,-5.58235326
29163,2016,221,194,77,-1,27,76,11.977021461,10.513765445,4.1729893778,-0.054194667,1.4632560156,4.1187947106
29163,2017,216,185,34,-1,31,33,11.653313911,9.9808475628,1.8343179305,-0.053950527,1.6724663484,1.7803674031
39131,2010,89,49,2,1,40,3,NA,NA,NA,NA,NA,NA
39131,2011,353,340,-153,1,13,-152,12.311662946,11.858258929,-5.336216518,0.0348772321,0.4534040179,-5.301339286
39131,2012,322,332,-101,6,-10,-95,11.278656369,11.6289252,-3.537715196,0.2101612988,-0.350268831,-3.327553898
39131,2013,364,346,-121,7,18,-114,12.795725384,12.162969733,-4.253524097,0.246071642,0.6327556509,-4.007452455
39131,2014,353,313,-132,0,40,-132,12.450401199,11.039590865,-4.655674103,0,1.4108103342,-4.655674103
39131,2015,348,324,-84,0,24,-84,12.307257038,11.45848069,-2.970717216,0,0.8487763474,-2.970717216
39131,2016,347,349,-5,1,-2,-4,12.287100315,12.357919337,-0.177047555,0.035409511,-0.070819022,-0.141638044
39131,2017,328,348,52,1,-20,53,11.609181163,12.317058064,1.8404799405,0.035393845,-0.7078769,1.8758737855
42103,2010,115,73,12,5,42,17,NA,NA,NA,NA,NA,NA
42103,2011,368,397,-289,32,-29,-257,6.4266566541,6.9331051405,-5.047021122,0.5588397091,-0.506448486,-4.488181413
42103,2012,326,429,-709,40,-103,-669,5.7454551863,7.5607370397,-12.49548383,0.7049638265,-1.815281853,-11.79052
42103,2013,352,439,-142,54,-87,-88,6.2550533545,7.8010466552,-2.523345387,0.9595820487,-1.545993301,-1.563763339
42103,2014,388,425,-373,49,-37,-324,6.927581774,7.5882016855,-6.659762891,0.8748750179,-0.660619911,-5.784887873
42103,2015,400,469,-281,55,-69,-226,7.1837145192,8.4229052737,-5.04655945,0.9877607464,-1.239190755,-4.058798703
42103,2016,400,494,-303,53,-94,-250,7.2250419956,8.9229268645,-5.472969312,0.9573180644,-1.697884869,-4.515651247
42103,2017,396,498,554,53,-102,607,7.1427283058,8.9825219603,9.992604751,0.9559712126,-1.839793655,10.948575964
04019,2010,2899,2002,114,391,897,505,NA,NA,NA,NA,NA,NA
04019,2011,12078,8633,856,1563,3445,2419,12.269172105,8.7696442113,0.8695488758,1.5877393609,3.4995278939,2.4572882367
04019,2012,11820,8703,-680,1950,3117,1270,11.946483393,8.796129016,-0.68727654,1.9708665496,3.150354377,1.2835900092
04019,2013,12041,8872,-1772,1962,3169,190,12.124129091,8.9332508343,-1.784233598,1.9755453265,3.1908782568,0.1913117289
04019,2014,12033,8778,787,2311,3255,3098,12.059077756,8.7970235635,0.7887055758,2.3160083681,3.2620541922,3.1047139439
04019,2015,11742,9172,-747,2703,2570,1956,11.70548474,9.1434769237,-0.74467698,2.6945942134,2.5620078166,1.9499172332
04019,2016,11482,9708,2749,2687,1774,5436,11.380474784,9.6221607044,2.7246930136,2.663241225,1.7583140801,5.3879342387
04019,2017,11490,9881,6066,2570,1609,8636,11.290785383,9.7096823644,5.9608271655,2.5254411169,1.5811030183,8.4862682824
04021,2010,1172,641,2805,80,531,2885,NA,NA,NA,NA,NA,NA
04021,2011,4912,2367,-4589,690,2545,-3899,12.965040318,6.247607987,-12.1124939,1.8212291977,6.7174323308,-10.2912647
04021,2012,4533,2476,908,759,2057,1667,11.926813097,6.5146236989,2.3890461707,1.9970110612,5.4121893977,4.3860572319
04021,2013,4648,2518,-549,792,2130,243,12.133109188,6.5729709411,-1.433106055,2.067431686,5.5601382464,0.6343256309
04021,2014,4551,2607,6685,949,1944,7634,11.695290275,6.6995433414,17.179304656,2.4387674074,4.9957469336,19.618072063
04021,2015,4510,2779,7162,1082,1731,8244,11.302224233,6.9642751979,17.948232806,2.7115314013,4.3379490347,20.659764207
04021,2016,4518,3134,8515,1141,1384,9656,11.030488877,7.6515166312,20.788980254,2.7856989394,3.3789722456,23.574679193
04021,2017,4542,3090,12437,1152,1452,13589,10.745819493,7.3105641200000004,29.424429114,2.7254918661,3.4352553729,32.14992098
27115,2010,66,86,-12,1,-20,-11,NA,NA,NA,NA,NA,NA
27115,2011,331,249,-184,2,82,-182,11.156801941,8.3928812188,-6.201968451,0.0674127006,2.7639207227,-6.13455575
27115,2012,292,240,-486,5,52,-481,9.9291021303,8.1609058606,-16.52583437,0.1700188721,1.7681962698,-16.3558155
27115,2013,269,261,-130,1,8,-129,9.2322476576,8.9576826715,-4.461681024,0.0343206233,0.2745649861,-4.427360401
27115,2014,298,263,-24,2,35,-22,10.247769047,9.0441720112,-0.825323682,0.0687769735,1.2035970357,-0.756546708
27115,2015,286,319,-4,2,-33,-2,9.8401830412,10.975588777,-0.137624938,0.0688124688,-1.135405736,-0.068812469
27115,2016,257,295,-130,2,-38,-128,8.8740029695,10.186112358,-4.488795276,0.0690583889,-1.312109388,-4.419736888
27115,2017,252,273,345,2,-21,347,8.6776859504,9.4008264463,11.880165289,0.0688705234,-0.723140496,11.949035813
12103,2010,1922,2685,143,442,-763,585,NA,NA,NA,NA,NA,NA
12103,2011,8497,11395,2834,2185,-2898,5019,9.2607578519,12.41924629,3.08873576,2.3814000125,-3.158488438,5.4701357725
12103,2012,8286,11028,4116,2267,-2742,6383,9.0030232817,11.982300356,4.4721752145,2.4631732778,-2.979277074,6.9353484923
12103,2013,8408,11526,7713,2381,-3118,10094,9.0830328342,12.451360186,8.332235044,2.5721576092,-3.368327352,10.904392653
12103,2014,8665,11360,8415,2883,-2695,11298,9.2815402322,12.168297408,9.013751997,3.0881339284,-2.886757176,12.101885925
12103,2015,8658,11881,11331,3151,-3223,14482,9.1752355539,12.590780043,12.007922622,3.3392431543,-3.41554449,15.347165776
12103,2016,8583,11998,13009,3188,-3415,16197,8.980724872,12.553971457,13.61181986,3.335727705,-3.573246585,16.947547565
12103,2017,8660,12482,9147,3174,-3822,12321,8.9613569937,12.916357736,9.4653039747,3.284451166,-3.955000742,12.749755141
27117,2010,35,14,-12,0,21,-12,NA,NA,NA,NA,NA,NA
27117,2011,119,106,-91,0,13,-91,12.439241102,11.08033241,-9.512360843,0,1.3589086918,-9.512360843
27117,2012,114,113,-139,4,1,-135,12.047556143,11.941875826,-14.68956407,0.4227212682,0.105680317,-14.2668428
27117,2013,116,111,-109,5,5,-104,12.408407766,11.873562604,-11.65962454,0.5348451623,0.5348451623,-11.12477938
27117,2014,120,113,3,4,7,7,12.894213722,12.142051254,0.322355343,0.4298071241,0.7521624671,0.7521624671
27117,2015,123,103,-86,5,20,-81,13.249313298,11.094953412,-9.263747509,0.5385899715,2.1543598858,-8.725157538
27117,2016,119,114,-71,6,5,-65,12.901826855,12.35973329,-7.697728628,0.6505122784,0.5420935653,-7.04721635
27117,2017,119,113,-117,6,6,-111,13.019693654,12.363238512,-12.80087527,0.6564551422,0.6564551422,-12.14442013
23021,2010,35,35,17,0,0,17,NA,NA,NA,NA,NA,NA
23021,2011,138,232,-96,1,-94,-95,7.9060441134,13.291320539,-5.499856775,0.0572901747,-5.385276425,-5.4425666
23021,2012,132,222,-5,1,-90,-4,7.624989169,12.823845421,-0.288825347,0.0577650695,-5.198856252,-0.231060278
23021,2013,158,231,-16,2,-73,-14,9.1756438921,13.415023665,-0.929179128,0.116147391,-4.239379773,-0.813031737
23021,2014,136,228,-43,1,-92,-42,7.9494973112,13.327098433,-2.513444003,0.0584521861,-5.377601122,-2.454991817
23021,2015,132,236,1,1,-104,2,7.770419426,13.892568065,0.0588668138,0.0588668138,-6.122148639,0.1177336277
23021,2016,124,217,34,1,-93,35,7.3348910118,12.836059271,2.0111797936,0.0591523469,-5.501168259,2.0703321404
23021,2017,131,215,-19,1,-84,-18,7.7862640792,12.778983031,-1.129305477,0.0594371304,-4.992718952,-1.069868347
08097,2010,37,17,-27,14,20,-13,NA,NA,NA,NA,NA,NA
08097,2011,173,56,-172,41,117,-131,10.086875401,3.2651157367,-10.02856976,2.3905311644,6.8217596642,-7.638038598
08097,2012,125,48,1,34,77,35,7.2663856998,2.7902921087,0.0581310856,1.9764569103,4.476093591,2.0345879959
08097,2013,125,43,5,81,82,86,7.2079344943,2.479529466,0.2883173798,4.6707415523,4.7284050283,4.9590589321
08097,2014,131,54,89,72,77,161,7.4667274644,3.0778876571,5.0728148423,4.1038502095,4.3888398073,9.1766650517
08097,2015,127,54,45,78,73,123,7.1496931825,3.0400270225,2.5333558521,4.3911501436,4.10966616,6.9245059956
08097,2016,150,46,-156,82,104,-74,8.3902002461,2.5729947421,-8.725808256,4.5866428012,5.817205504,-4.139165455
08097,2017,143,35,-192,81,108,-111,7.9923988375,1.9561815336,-10.73105298,4.5271629779,6.0362173038,-6.203890007
37147,2010,544,215,294,37,329,331,NA,NA,NA,NA,NA,NA
37147,2011,2096,1143,816,194,953,1010,12.342153223,6.7304776402,4.804960415,1.1423557849,5.6116755827,5.9473162
37147,2012,2159,1186,1038,197,973,1235,12.558568358,6.8987781717,6.0378851115,1.1459184653,5.6597901864,7.1838035768
37147,2013,2126,1195,301,192,931,493,12.237485502,6.8785490003,1.732588493,1.1051727264,5.3589365015,2.8377612194
37147,2014,2139,1167,-507,196,972,-311,12.239888073,6.6778631982,-2.901179641,1.1215605714,5.5620248746,-1.77961907
37147,2015,2131,1256,84,224,875,308,12.131528311,7.1502578875,0.4782019606,1.2752052283,4.9812704232,1.753407189
37147,2016,2105,1293,349,226,812,575,11.897226053,7.3078922976,1.9725092126,1.2773268826,4.5893337553,3.2498360952
37147,2017,2097,1301,396,225,796,621,11.758801578,7.2952793767,2.2205462207,1.261673989,4.4635222013,3.4822202098
40121,2010,121,157,-17,4,-36,-13,NA,NA,NA,NA,NA,NA
40121,2011,523,603,-12,9,-80,-3,11.435193283,13.184362428,-0.262375372,0.1967815288,-1.749169145,-0.065593843
40121,2012,539,596,-111,-3,-57,-114,11.819268258,13.069172322,-2.434023704,-0.065784424,-1.249904064,-2.499808129
40121,2013,550,600,-214,3,-50,-211,12.118941906,13.220663898,-4.715370124,0.0661033195,-1.101721991,-4.649266804
40121,2014,547,631,-335,2,-84,-333,12.144220949,14.009147018,-7.437502775,0.0444030016,-1.864926069,-7.393099774
40121,2015,488,637,22,2,-149,24,10.900886814,14.229231353,0.4914334219,0.0446757656,-3.32834454,0.5361091876
40121,2016,541,590,-259,2,-49,-257,12.144204005,13.244141150999999,-5.813953488,0.0448953937,-1.099937146,-5.769058095
40121,2017,488,560,-140,2,-72,-138,11.018412942,12.644080425,-3.161020106,0.0451574301,-1.625667483,-3.115862676
51143,2010,147,202,152,6,-55,158,NA,NA,NA,NA,NA,NA
51143,2011,541,641,-249,16,-100,-233,8.5296250749,10.106265569,-3.925834831,0.2522624791,-1.576640494,-3.673572352
51143,2012,557,690,-226,9,-133,-217,8.8299170907,10.938317401,-3.582695265,0.1426737052,-2.108400311,-3.44002156
51143,2013,542,718,-173,7,-176,-166,8.6400663149,11.445696705,-2.757807145,0.11158757230000001,-2.80563039,-2.646219572
51143,2014,516,717,20,3,-201,23,8.2606259505,11.47842792,0.3201793004,0.0480268951,-3.217801969,0.3682061955
51143,2015,482,693,-171,4,-211,-167,7.7518133132000004,11.145241963,-2.75012464,0.0643304009,-3.39342865,-2.685794239
51143,2016,514,698,-137,7,-184,-130,8.3131166101,11.289018276,-2.215752871,0.1132136503,-2.975901666,-2.10253922
51143,2017,488,739,-169,7,-251,-162,7.9394131667,12.023004775,-2.749509888,0.1138850249,-4.083591608,-2.635624863
49031,2010,4,0,3,0,4,3,NA,NA,NA,NA,NA,NA
49031,2011,18,22,-64,0,-4,-64,11.749347258,14.360313316,-41.77545692,0,-2.610966057,-41.77545692
49031,2012,10,17,6,0,-7,6,6.6755674232,11.348464619,4.0053404539,0,-4.672897196,4.0053404539
49031,2013,11,12,-9,0,-1,-9,7.3726541555,8.0428954424,-6.032171582,0,-0.670241287,-6.032171582
49031,2014,19,18,-21,0,1,-21,12.863913338,12.186865267,-14.21800948,0,0.6770480704,-14.21800948
49031,2015,13,11,23,0,2,23,8.7867522812,7.4349442379,15.545792497,0,1.3518080433,15.545792497
49031,2016,10,13,-24,0,-3,-24,6.7681895093,8.7986463621,-16.24365482,0,-2.030456853,-16.24365482
49031,2017,12,9,-45,0,3,-45,8.3246618106,6.243496358,-31.21748179,0,2.0811654527,-31.21748179
06061,2010,951,710,1106,148,241,1254,NA,NA,NA,NA,NA,NA
06061,2011,3856,2788,4824,466,1068,5290,10.916106494,7.8926620607,13.65645688,1.3192182641,3.0234444336,14.975675144
06061,2012,3694,2765,2812,395,929,3207,10.30384344,7.7125411777,7.843640431,1.1017915968,2.5913022619,8.9454320278
06061,2013,3692,2841,3986,399,851,4385,10.165324185,7.8222334803,10.97480558,1.0985818932,2.3430907046,12.073387473
06061,2014,3724,2907,2655,454,817,3109,10.125770003,7.9043000534,7.219097572,1.2344520895,2.2214699497,8.4535496615
06061,2015,3648,3048,2654,526,600,3180,9.8170603717,8.2024122842,7.1421267068,1.4155081567,1.6146480874,8.5576348635
06061,2016,3745,3248,5272,513,497,5785,9.9440926912,8.6244093621,13.998733423,1.3621681043,1.3196833291,15.360901527
06061,2017,3770,3263,5431,495,507,5926,9.8445244076,8.520605608,14.181859962,1.2925834434,1.3239187996,15.474443406
22075,2010,68,12,30,-1,56,29,NA,NA,NA,NA,NA,NA
22075,2011,298,176,342,-3,122,339,12.75930723,7.5356982295,14.643231787,-0.128449402,5.223609,14.514782385
22075,2012,276,182,131,26,94,157,11.63943068,7.6752767528,5.524512388,1.0964681075,3.9641539273,6.6209804955
22075,2013,317,196,-461,19,121,-442,13.386541669,8.2768522624,-19.46749435,0.8023479234,5.1096894069,-18.66514643
22075,2014,313,175,-370,22,138,-348,13.362933868,7.4712889041,-15.7964394,0.9392477479,5.8916449644,-14.85719165
22075,2015,311,178,-38,35,133,-3,13.298554691,7.6113914308,-1.624903789,1.4966219105,5.6871632601,-0.128281878
22075,2016,285,177,-258,26,108,-232,12.185475768,7.5678217928,-11.03106227,1.1116574385,4.6176539752,-9.919404836
22075,2017,281,194,-89,24,87,-65,12.040707017,8.3128012855,-3.813604713,1.0283877879,3.7279057311,-2.785216926
29165,2010,277,155,216,26,122,242,NA,NA,NA,NA,NA,NA
29165,2011,1148,577,482,80,571,562,12.720573977,6.3935289066,5.3408681681,0.8864511482,6.3270450705,6.2273193163
29165,2012,1139,585,581,167,554,748,12.453531599,6.3962387929,6.3525038268,1.8259348349,6.0572928056,8.1784386617
29165,2013,1179,612,520,176,567,696,12.713166592,6.5992009791,5.6071642306,1.8978094319,6.113965613,7.5049736625
29165,2014,1099,631,844,201,468,1045,11.675962815,6.7038512616,8.9667994688,2.1354581673,4.9721115538,11.102257636
29165,2015,1161,636,778,223,525,1001,12.138764585,6.6496591527,8.1343314792,2.331562879,5.4891054326,10.465894358
29165,2016,1213,671,1484,224,542,1708,12.437326334,6.8800049216,15.21598704,2.2967527607,5.5573214121,17.5127398
29165,2017,1229,645,1723,224,584,1947,12.299839872,6.4551641313,17.243795036,2.2417934347,5.8446757406,19.485588471
31141,2010,138,48,-27,5,90,-22,NA,NA,NA,NA,NA,NA
31141,2011,454,289,28,27,165,55,14.006509633,8.9160380706,0.8638375985,0.8329862557,5.0904715628,1.6968238543
31141,2012,487,245,-113,45,242,-68,14.935214291,7.5136088323,-3.4654604,1.3800506019,7.4216054589,-2.085409798
31141,2013,480,273,-317,44,207,-273,14.69620195,8.3584648592,-9.705616705,1.3471518454,6.3377370911,-8.358464859
31141,2014,477,298,-95,46,179,-49,14.589609873,9.1146828977,-2.905687501,1.4069644741,5.4749269755,-1.498723027
31141,2015,509,277,-181,53,232,-128,15.512853725,8.4421620468,-5.516358594,1.615287323,7.0706916782,-3.901071271
31141,2016,485,271,-188,57,214,-131,14.739401307,8.2358304209,-5.713417414,1.732259535,6.5035708859,-3.981157879
31141,2017,495,263,-59,57,232,-2,14.972550324,7.9551125966,-1.784607008,1.7241118555,7.0174377278,-0.060495153
56031,2010,13,34,18,0,-21,18,NA,NA,NA,NA,NA,NA
56031,2011,82,104,55,-3,-22,52,9.4475488219,11.982257042,6.3367705513,-0.34564203,-2.534708221,5.9911285212
56031,2012,93,105,48,0,-12,48,10.674318508,12.051649928,5.5093256815,0,-1.37733142,5.5093256815
56031,2013,95,101,-16,0,-6,-16,10.896369788,11.584561564,-1.83517807,0,-0.688191776,-1.83517807
56031,2014,82,95,84,-2,-13,82,9.3805410971,10.867700051,9.6093347824,-0.228793685,-1.487158954,9.3805410971
56031,2015,92,98,30,-1,-6,29,10.47060832,11.15347408,3.4143287999,-0.11381096,-0.68286576,3.3005178399
56031,2016,83,88,-114,-3,-5,-117,9.5009157509,10.073260073,-13.04945055,-0.343406593,-0.572344322,-13.39285714
56031,2017,85,85,-109,-3,0,-112,9.8625050763,9.8625050763,-12.64721239,-0.348088414,0,-12.99530081
54073,2010,18,33,-18,0,-15,-18,NA,NA,NA,NA,NA,NA
54073,2011,63,98,40,0,-35,40,8.3173806852,12.938147733,5.2808766255,0,-4.620767047,5.2808766255
54073,2012,57,100,4,-1,-43,3,7.5441731189,13.235391437,0.5294156575,-0.132353914,-5.691218318,0.3970617431
54073,2013,68,91,8,-1,-23,7,9.0347439049,12.090613167,1.0629110476,-0.132863881,-3.055869262,0.9300471667
54073,2014,71,72,71,-1,-1,70,9.399616072,9.5320050308,9.399616072,-0.132388959,-0.132388959,9.2672271133
54073,2015,79,108,-57,-1,-29,-58,10.469122714,14.312218394,-7.553670819,-0.132520541,-3.84309568,-7.68619136
54073,2016,89,81,3,-1,8,2,11.854811855,10.789210789,0.3996003996,-0.133200133,1.0656010656,0.2664002664
54073,2017,82,75,-6,-1,7,-7,10.915867945,9.9840255591,-0.798722045,-0.133120341,0.9318423855,-0.931842386
06063,2010,41,87,-49,2,-46,-47,NA,NA,NA,NA,NA,NA
06063,2011,168,225,-151,9,-57,-142,8.4784254353,11.355034065,-7.620489528,0.4542013626,-2.8766086300000002,-7.166288166
06063,2012,156,205,-305,10,-49,-295,7.9809684598,10.487811117,-15.60381654,0.5116005423,-2.506842657,-15.092216
06063,2013,146,264,-363,0,-118,-363,7.6288013377,13.794544885,-18.96749922,0,-6.165743547,-18.96749922
06063,2014,160,198,-199,4,-38,-195,8.5183410531,10.541447053,-10.59468668,0.2129585263,-2.023106,-10.38172816
06063,2015,136,172,-108,5,-36,-103,7.3134007313,9.2493009249,-5.807700581,0.2688750269,-1.935900194,-5.538825554
06063,2016,154,194,296,7,-40,303,8.2547169811,10.398799314,15.866209262,0.3752144082,-2.144082333,16.241423671
06063,2017,164,228,12,7,-64,19,8.7399078046,12.150603533,0.6395054491,0.3730448453,-3.410695729,1.0125502944
19149,2010,54,58,-7,0,-4,-7,NA,NA,NA,NA,NA,NA
19149,2011,296,236,-227,1,60,-226,11.89280405,9.4821005263,-9.120494998,0.0401783921,2.4107035236,-9.080316606
19149,2012,276,252,-15,6,24,-9,11.122305057,10.155148096,-0.604473101,0.2417892404,0.9671569615,-0.362683861
19149,2013,284,245,38,19,39,57,11.419839961,9.8516225019,1.5280067554,0.7640033777,1.5682174595,2.2920101331
19149,2014,280,232,-107,38,48,-69,11.242045249,9.3148374922,-4.296067292,1.525706141,1.927207757,-2.770361151
19149,2015,301,264,-74,41,37,-33,12.089567226,10.603474244,-2.972185962,1.6467516819,1.4860929812,-1.325434281
19149,2016,293,217,188,44,76,232,11.695906433,8.6621559587,7.5045406463,1.7563818534,3.033750474,9.2609224997
19149,2017,296,229,-95,44,67,-51,11.74020823,9.082796232,-3.767972236,1.7451660882,2.657411998,-2.022806148
25023,2010,1293,953,354,294,340,648,NA,NA,NA,NA,NA,NA
25023,2011,5179,4222,184,1222,957,1406,10.419548272,8.4941750923,0.3701866928,2.4585224924,1.9253731794,2.8287091852
25023,2012,4916,3978,-915,1313,938,398,9.8547348734,7.9743969337,-1.834231572,2.6320721905,1.8803379396,0.7978406183
25023,2013,5179,4238,1231,1322,941,2553,10.333035387,8.4555713396,2.4560661442,2.637627492,1.8774640469,5.0936936362
25023,2014,5130,4373,1617,1281,757,2898,10.164282947,8.6644072767,3.2038295372,2.5380987243,1.4998756708,5.7419282616
25023,2015,5243,4661,769,1423,582,2192,10.324026351,9.1780062598,1.5142430409,2.8020388131,1.1460200908,4.316281854
25023,2016,5158,4662,665,1483,496,2148,10.103691138,9.1321070349,1.3026278804,2.9049581151,0.9715841032,4.2075859955
25023,2017,5211,4688,1352,1480,523,2832,10.148379395,9.129841221,2.6330088163,2.8822877575,1.0185381738,5.5152965738
19151,2010,15,14,-23,0,1,-23,NA,NA,NA,NA,NA,NA
19151,2011,74,110,-53,0,-36,-53,10.213235802,15.181837002,-7.314885101,0,-4.968601201,-7.314885101
19151,2012,69,71,-59,0,-2,-59,9.6214181134,9.9002997978,-8.227009691,0,-0.278881684,-8.227009691
19151,2013,83,122,7,0,-39,7,11.648305382,17.121605501,0.9823872009,0,-5.473300119,0.9823872009
19151,2014,79,86,-9,1,-7,-8,11.122061101,12.107560186,-1.267070252,0.14078558360000001,-0.985499085,-1.126284668
19151,2015,85,94,-128,1,-9,-127,12.092758572,13.373168303,-18.21027173,0.1422677479,-1.280409731,-18.06800398
19151,2016,75,89,-100,0,-14,-100,10.861694424,12.889210717,-14.48225923,0,-2.027516293,-14.48225923
19151,2017,78,84,3,1,-6,4,11.391850445,12.268146634,0.4381480941,0.1460493647,-0.876296188,0.5841974587
54075,2010,25,12,0,1,13,1,NA,NA,NA,NA,NA,NA
54075,2011,90,115,109,1,-25,110,10.25290499,13.100934154,12.417407154,0.1139211666,-2.848029164,12.531328321
54075,2012,82,92,-116,1,-10,-115,9.3612649124,10.502882585,-13.242765,0.1141617672,-1.141617672,-13.12860323
54075,2013,86,110,3,-1,-24,2,9.8998503511,12.662599286,0.3453436169,-0.115114539,-2.762748935,0.2302290779
54075,2014,76,110,8,0,-34,8,8.7734487734,12.698412698,0.9235209235,0,-3.924963925,0.9235209235
54075,2015,82,108,-52,0,-26,-52,9.5238095238,12.543554007,-6.039488966,0,-3.019744483,-6.039488966
54075,2016,90,115,-27,0,-25,-27,10.533091462,13.458950202,-3.159927439,0,-2.92585874,-3.159927439
54075,2017,84,116,-30,0,-32,-30,9.8974902793,13.667962767,-3.534817957,0,-3.770472487,-3.534817957
05111,2010,58,101,-21,2,-43,-19,NA,NA,NA,NA,NA,NA
05111,2011,305,332,-75,24,-27,-51,12.4596593,13.562645533,-3.063850647,0.9804322072,-1.102986233,-2.08341844
05111,2012,313,323,-163,16,-10,-147,12.848405238,13.258897418,-6.691022536,0.6567874882,-0.41049218,-6.034235048
05111,2013,296,357,-63,16,-61,-47,12.217773558,14.735625542,-2.600404507,0.6604201923,-2.517851983,-1.939984315
05111,2014,312,301,-48,11,11,-37,12.914976405,12.459640699,-1.986919447,0.4553357066,0.4553357066,-1.53158374
05111,2015,311,366,-90,12,-55,-78,12.916891639,15.201229389,-3.738007227,0.4984009636,-2.28433775,-3.239606263
05111,2016,344,346,-13,13,-2,0,14.327960348,14.411262443,-0.541463618,0.5414636178,-0.083302095,0
05111,2017,337,332,128,14,5,142,13.994435447,13.786802874,5.315393879,0.5813712055,0.2076325734,5.8967650845
22077,2010,59,24,-26,6,35,-20,NA,NA,NA,NA,NA,NA
22077,2011,294,212,-122,19,82,-103,12.891061759,9.2955955539,-5.349352158,0.8330958279,3.5954662048,-4.51625633
22077,2012,304,244,-192,3,60,-189,13.37233598,10.733059142,-8.445685882,0.1319638419,2.6392768381,-8.31372204
22077,2013,278,276,-261,6,2,-255,12.330893768,12.242182302,-11.57684631,0.2661343979,0.088711466,-11.31071191
22077,2014,269,273,-112,6,-4,-106,12.029066518,12.207937395,-5.008384572,0.2683063164,-0.178870878,-4.740078256
22077,2015,280,295,-92,8,-15,-84,12.581725044,13.255746029,-4.133995372,0.3594778584,-0.674020985,-3.774517513
22077,2016,304,232,-126,8,72,-118,13.706041479,10.45987376,-5.680793508,0.3606853021,3.2461677187,-5.320108206
22077,2017,287,242,60,8,45,68,12.920943634,10.895011705,2.7012425716,0.3601656762,2.0259319287,3.0614082478
05113,2010,52,44,6,0,8,6,NA,NA,NA,NA,NA,NA
05113,2011,219,269,-65,2,-50,-63,10.625136453,13.050966693,-3.153579313,0.0970332096,-2.42583024,-3.056546103
05113,2012,244,244,-145,5,0,-140,11.911154503,11.911154503,-7.078350012,0.2440810349,0,-6.834268977
05113,2013,245,291,-33,10,-46,-23,12.021589794,14.278704612,-1.619234544,0.4906771344,-2.257114818,-1.128557409
05113,2014,238,254,-82,9,-16,-73,11.725004311,12.513239895,-4.039707368,0.4433825159,-0.788235584,-3.596324852
05113,2015,256,303,-14,13,-47,-1,12.655724738,14.979236702,-0.692109947,0.6426735219,-2.323511964,-0.049436425
05113,2016,223,273,-23,13,-50,-10,11.054927622,13.533610946,-1.140194329,0.6444576641,-2.478683323,-0.495736665
05113,2017,214,277,27,13,-63,40,10.631163218,13.760898184,1.3413149855,0.6458183263,-3.129734966,1.9871333118
12105,2010,1753,1301,191,445,452,636,NA,NA,NA,NA,NA,NA
12105,2011,7175,5964,2943,2612,1211,5555,11.829597736,9.8329924596,4.8521959773,4.3064681932,1.9966052764,9.1586641705
12105,2012,7248,5835,1818,2555,1413,4373,11.82803332,9.5221543079,2.9667997484,4.1695122976,2.3058790123,7.136312046
12105,2013,7240,6157,4041,2239,1083,6280,11.690429672,9.9417093217,6.5250036331,3.615313817,1.7487203501,10.14031745
12105,2014,7484,6140,7819,2878,1344,10697,11.896993402,9.7604943198,12.429528516,4.5750330053,2.1364990824,17.004561521
12105,2015,7520,6591,10407,3047,929,13454,11.706138562,10.259994583,16.200237236,4.7431654519,1.4461439793,20.943402688
12105,2016,7693,6935,13441,3167,758,16608,11.685611038,10.534214552,20.416781224,4.8106499618,1.151396486,25.227431186
12105,2017,7779,6773,15226,3171,1006,18397,11.494635024,10.008119684,22.498690433,4.6856263867,1.4865153406,27.18431682
13233,2010,145,84,-22,21,61,-1,NA,NA,NA,NA,NA,NA
13233,2011,596,461,-436,69,135,-367,14.389878797,11.130426385,-10.52682409,1.6659423439,3.259452412,-8.860881742
13233,2012,562,451,-346,59,111,-287,13.634819739,10.941821534,-8.3943908,1.4314134601,2.6929982047,-6.96297734
13233,2013,548,468,-193,58,80,-135,13.332684541,11.386307236,-4.695635249,1.4111235463,1.9463773052,-3.284511703
13233,2014,560,485,-234,52,75,-182,13.652875637,11.824365507,-5.704951605,1.2677670234,1.8285101299,-4.437184582
13233,2015,538,456,268,64,82,332,13.068878821,11.076967923,6.5101478144,1.5546621646,1.9919108984,8.064809979
13233,2016,572,511,229,66,61,295,13.766215013,12.298139636,5.511299367,1.5884094246,1.4680753772,7.0997087916
13233,2017,577,501,212,67,76,279,13.768418541,11.954900674,5.0587603651,1.598759172,1.8135178667,6.6575195371
19153,2010,1633,774,445,277,859,722,NA,NA,NA,NA,NA,NA
19153,2011,6479,3106,1361,1177,3373,2538,14.888092284,7.1372765293,3.1274415185,2.70462797,7.7508157544,5.8320694885
19153,2012,6658,3092,1467,1158,3566,2625,15.089994889,7.0078498344,3.3248757138,2.6245440195,8.0821450548,5.9494197333
19153,2013,6743,3273,3035,1184,3470,4219,15.045730721,7.3030812175,6.7720291766,2.6418723378,7.7426495034,9.4139015144
19153,2014,6876,3211,3236,1320,3665,4556,15.073575754,7.0391581947,7.0939632258,2.8937056422,8.0344175595,9.987668868
19153,2015,6970,3521,2042,1486,3449,3528,15.02892043,7.5920844811,4.4030208777,3.2041572107,7.4368359487,7.6071780884
19153,2016,6981,3390,2424,1496,3591,3920,14.821341373,7.1972994204,5.1463875502,3.1761533725,7.6240419524,8.3225409227
19153,2017,7006,3464,2033,1483,3542,3516,14.647741266,7.2423316796,4.2504793027,3.1005709817,7.4054095869,7.3510502844
27119,2010,86,62,12,6,24,18,NA,NA,NA,NA,NA,NA
27119,2011,383,358,-165,35,25,-130,12.125625277,11.334135376,-5.223833344,1.1080858608,0.7914899006,-4.115747483
27119,2012,409,362,-96,25,47,-71,12.97630001,11.48513595,-3.045781909,0.7931723722,1.4911640598,-2.252609537
27119,2013,421,342,28,27,79,55,13.335445043,10.83306937,0.8869179601,0.8552423187,2.5023756731,1.7421602787
27119,2014,399,343,-266,45,56,-221,12.644789174,10.870081922,-8.42985945,1.4261040422,1.7747072525,-7.003755407
27119,2015,424,358,-128,46,66,-82,13.474861756,11.37735969,-4.067882794,1.4618953791,2.0975020657,-2.605987415
27119,2016,420,322,32,49,98,81,13.313679806,10.207154518,1.0143756043,1.553262644,3.1065252881,2.5676382483
27119,2017,432,331,-165,49,101,-116,13.659215227,10.465741297,-5.217061372,1.5493091346,3.1934739305,-3.667752237
29167,2010,77,60,6,6,17,12,NA,NA,NA,NA,NA,NA
29167,2011,393,348,-20,13,45,-7,12.603425053,11.16028478,-0.641395677,0.41690719,1.4431402732,-0.224488487
29167,2012,387,363,-147,7,24,-140,12.426947531,11.656284118,-4.720313403,0.2247768287,0.7706634128,-4.495536574
29167,2013,357,342,23,5,15,28,11.477623457,10.99537037,0.7394547325,0.1607510288,0.4822530864,0.9002057613
29167,2014,412,334,-73,1,78,-72,13.236522521,10.730578937,-2.345306175,0.0321274818,2.5059435841,-2.313178693
29167,2015,359,341,136,3,18,139,11.505119618,10.928261253,4.3584854263,0.0961430609,0.5768583652,4.4546284872
29167,2016,379,325,74,6,54,80,12.091049752,10.368314431,2.3607854397,0.1914150357,1.7227353209,2.5522004753
29167,2017,376,361,361,6,15,367,11.897604658,11.422966174,11.422966174,0.1898553935,0.4746384837,11.612821568
31143,2010,8,11,-5,0,-3,-5,NA,NA,NA,NA,NA,NA
31143,2011,56,68,-47,2,-12,-45,10.430247718,12.665300801,-8.753957907,0.3725088471,-2.235053083,-8.381449059
31143,2012,44,74,-44,2,-30,-42,8.2948440004,13.950419455,-8.294844,0.3770383637,-5.655575455,-7.917805637
31143,2013,54,72,-11,7,-18,-4,10.270064663,13.693419551,-2.092050209,1.3313046786,-3.423354888,-0.760745531
31143,2014,62,67,21,7,-5,28,11.792677128,12.743699477,3.9942938659,1.3314312886,-0.951022349,5.3257251545
31143,2015,40,58,-84,7,-18,-77,7.6613675541,11.108982953,-16.08887186,1.340739322,-3.447615399,-14.74813254
31143,2016,58,47,9,8,11,17,11.179645335,9.0593677718,1.734772552,1.5420200463,2.1202775636,3.2767925983
31143,2017,55,54,117,8,1,125,10.44634378,10.256410256,22.222222222,1.5194681861,0.1899335233,23.741690408
37149,2010,38,53,-24,0,-15,-24,NA,NA,NA,NA,NA,NA
37149,2011,114,285,-10,-1,-171,-11,5.5917986952,13.979496738,-0.490508657,-0.049050866,-8.387698043,-0.539559523
37149,2012,136,260,92,-4,-124,88,6.7079336112,12.823990727,4.5377197958,-0.197292165,-6.116057116,4.3404276308
37149,2013,131,279,287,5,-148,292,6.4446302947,13.725586658,14.119151867,0.2459782555,-7.280956363,14.365130122
37149,2014,150,280,113,2,-130,115,7.3563669356,13.731884946,5.5417964248,0.0980848925,-6.375518011,5.6398813173
37149,2015,152,303,178,5,-151,183,7.4520762857,14.855125754,8.7267735451,0.2451340883,-7.403049468,8.9719076335
37149,2016,146,272,130,5,-126,135,7.1510787843,13.322557735,6.3673989175,0.2448999584,-6.171478951,6.6122988759
37149,2017,140,292,285,5,-152,290,6.8327680031,14.251201835,13.909563435,0.2440274287,-7.418433832,14.153590864
41053,2010,219,190,96,7,29,103,NA,NA,NA,NA,NA,NA
41053,2011,870,604,66,27,266,93,11.490761164,7.9774939574,0.8717129159,0.3566098292,3.5132672064,1.2283227451
41053,2012,908,634,-6,33,274,27,11.942261533,8.3385394404,-0.078913622,0.4340249236,3.6037220925,0.3551113011
41053,2013,852,653,106,67,199,173,11.157381944,8.5513737199,1.3881249836,0.8773997538,2.606008224,2.2655247374
41053,2014,873,648,793,88,225,881,11.322883769,8.4046147561,10.285277009,1.141367436,2.9182690125,11.426644445
41053,2015,815,701,1114,99,114,1213,10.405561549,8.9500596883,14.223062044,1.2639884581,1.4555018609000001,15.487050502
41053,2016,940,688,2094,105,252,2199,11.718287385,8.5767890646,26.104355089,1.3089576334,3.1414983202,27.413312722
41053,2017,943,682,1881,106,261,1987,11.420751129,8.259758505,22.780946844,1.2837747823,3.1609926244,24.064721627
47139,2010,32,48,9,-1,-16,8,NA,NA,NA,NA,NA,NA
47139,2011,149,217,6,-7,-68,-1,8.8790894464,12.931291341,0.357547226,-0.41713843,-4.052201895,-0.059591204
47139,2012,142,219,-51,-4,-77,-55,8.5136998621,13.13028359,-3.057737274,-0.239822531,-4.616583728,-3.297559806
47139,2013,147,242,121,-5,-95,116,8.8423711991,14.556828777,7.2784143884,-0.300760925,-5.714457578,6.9776534633
47139,2014,170,194,80,-6,-24,74,10.203775397,11.644308394,4.8017766574,-0.360133249,-1.440532997,4.4416434081
47139,2015,183,227,129,-6,-44,123,10.942358287,13.573307821,7.7134656781,-0.35876584500000003,-2.630949534,7.3546998326
47139,2016,149,208,73,-7,-59,66,8.8867682581,12.405689917,4.3539200191,-0.41749918,-3.518921659,3.9364208392
47139,2017,164,214,43,-7,-50,36,9.7831598413,12.765830525,2.5650967877,-0.417573896,-2.982670683,2.147522892
48373,2010,135,161,38,13,-26,51,NA,NA,NA,NA,NA,NA
48373,2011,473,560,156,59,-87,215,10.392749245,12.304312002,3.427629772,1.2963471574,-1.911562757,4.7239769294
48373,2012,495,603,-34,69,-108,35,10.868133316,13.239362403,-0.746498046,1.5149519167,-2.371229087,0.7684538708
48373,2013,507,625,23,113,-118,136,11.137471992,13.729625236,0.5052502087,2.4823162427,-2.592153245,2.9875664514
48373,2014,497,642,298,120,-145,418,10.880392307,14.054752236,6.5238569568,2.6270564927,-3.174359929,9.1509134494
48373,2015,516,680,800,131,-164,931,11.164119041,14.712404937,17.308711691,2.8343015394,-3.548285897,20.14301323
48373,2016,550,619,1047,139,-69,1186,11.658841111,13.121495723,22.194193897,2.9465071172,-1.462654612,25.140701014
48373,2017,554,629,1352,139,-75,1491,11.434822544,12.982858086,27.90592072,2.8690258728,-1.548035543,30.774946593
55095,2010,125,121,-49,1,4,-48,NA,NA,NA,NA,NA,NA
55095,2011,432,401,-249,7,31,-242,9.8059244127,9.1022585405,-5.652025877,0.1588922937,0.7036658722,-5.493133583
55095,2012,419,366,-501,9,53,-492,9.5805371046,8.3686791892,-11.45548709,0.2057871932,1.2118579154,-11.24969989
55095,2013,416,433,-198,12,-17,-186,9.5812796536,9.9728223318,-4.560320604,0.2763830669,-0.391542678,-4.283937537
55095,2014,443,465,45,12,-22,57,10.223981352,10.731718575,1.0385534105,0.2769475761,-0.507737223,1.3155009866
55095,2015,414,440,-94,15,-26,-79,9.5639618828,10.16459717,-2.171527577,0.3465203581,-0.600635287,-1.825007219
55095,2016,418,423,55,15,-5,70,9.6613891136,9.776955969,1.2712354097,0.3467005663,-0.115566855,1.617935976
55095,2017,407,423,156,16,-16,172,9.3836098078,9.7524986455,3.5966661671,0.3688888377,-0.368888838,3.9655550048
30073,2010,13,14,1,4,-1,5,NA,NA,NA,NA,NA,NA
30073,2011,78,66,11,7,12,18,12.634648093,10.690856078,1.7818093464,1.133878675,1.9437920143,2.9156880214
30073,2012,72,69,-51,11,3,-40,11.667476908,11.181332037,-8.26446281,1.7825311943,0.4861448712,-6.481931616
30073,2013,70,73,48,6,-3,54,11.329610747,11.815165493,7.7688759408,0.9711094926,-0.485554746,8.7399854334
30073,2014,68,77,-74,6,-9,-68,11.028219267,12.487836523,-12.00129744,0.9730781706,-1.459617256,-11.02821927
30073,2015,84,62,-72,6,22,-66,13.756960367,10.153946937,-11.79168031,0.9826400262,3.6030134294,-10.80904029
30073,2016,75,60,-77,7,15,-70,12.384412153,9.9075297226,-12.71466314,1.1558784676,2.4768824306,-11.55878468
30073,2017,76,65,-87,7,11,-80,12.679346013,10.844177511,-14.51451451,1.1678345012,1.8351685018,-13.34668001
28115,2010,126,95,67,-2,31,65,NA,NA,NA,NA,NA,NA
28115,2011,401,276,-414,1,125,-413,13.405318669,9.2266033731,-13.83990506,0.0334297224,4.1787152958,-13.80647534
28115,2012,431,250,349,-7,181,342,14.348730753,8.3229296712,11.618809821,-0.233042031,6.025801082,11.38576779
28115,2013,423,295,260,-12,128,248,13.873628626,9.6754620443,8.5275258696,-0.393578117,4.1981665819,8.1339477525
28115,2014,452,321,-7,-12,131,-19,14.707557146,10.444968681,-0.227771903,-0.390466119,4.262588465,-0.618238022
28115,2015,447,287,-99,-12,160,-111,14.50804109,9.3150062479,-3.213190308,-0.389477613,5.193034842,-3.602667922
28115,2016,440,266,441,-12,174,429,14.131778838,8.5433026609,14.163896517,-0.38541215,5.5884761767,13.778484367
28115,2017,452,262,27,-11,190,16,14.331689839,8.3073069423,0.856096517,-0.348780062,6.0243828971,0.5073164545
40123,2010,142,65,31,4,77,35,NA,NA,NA,NA,NA,NA
40123,2011,582,469,23,17,113,40,15.447909754,12.448573324,0.6104844061,0.4512276045,2.99933643,1.0617120106
40123,2012,561,406,136,30,155,166,14.798791828,10.709999077,3.5875858976,0.7913792421,4.088792751,4.3789651397
40123,2013,516,413,-49,42,103,-7,13.538687587,10.836197623,-1.285650565,1.1019861989,2.7024899641,-0.183664366
40123,2014,563,398,-78,49,165,-29,14.729351438,10.412578814,-2.040656149,1.281950658,4.3167726238,-0.758705491
40123,2015,518,438,-87,54,80,-33,13.521450293,11.433195422,-2.270977173,1.4095720383,2.0882548715,-0.861405134
40123,2016,513,500,41,58,13,99,13.363899237,13.025242921,1.0680699195,1.5109281788,0.3386563159,2.5789980983
40123,2017,502,510,-269,58,-8,-211,13.095595237,13.304289981,-7.017360794,1.5130368998,-0.208694745,-5.504323894
05115,2010,201,113,227,13,88,240,NA,NA,NA,NA,NA,NA
05115,2011,794,553,283,27,241,310,12.728540626,8.8650918972,4.5367468479,0.43283450489999997,3.8634487291,4.9695813528
05115,2012,746,584,-275,35,162,-240,11.914078096,9.3268386169,-4.391918869,0.5589714925,2.5872394794,-3.832947377
05115,2013,731,634,-185,59,97,-126,11.684969389,10.134433095,-2.957208395,0.9431097044,1.5505362937,-2.014098691
05115,2014,809,563,217,77,246,294,12.880627314,8.9638976237,3.4550013931,1.2259682363,3.9167296899,4.6809696294
05115,2015,838,577,142,93,261,235,13.235201213,9.1130204056,2.24271906,1.4688230463,4.1221808074,3.7115421063
05115,2016,814,574,-40,93,240,53,12.77754668,9.0102110493,-0.627889272,1.4598425568,3.7673356304,0.831953285
05115,2017,811,560,-360,94,251,-266,12.702937652,8.7714489337,-5.6387886,1.4723503567,3.9314887185,-4.166438244
17151,2010,3,5,3,0,-2,3,NA,NA,NA,NA,NA,NA
17151,2011,33,58,46,2,-25,48,7.3627844712,12.940651495,10.263275324,0.4462293619,-5.577867024,10.709504685
17151,2012,33,59,-15,2,-26,-13,7.3759499329,13.187304426,-3.352704515,0.4470272687,-5.811354493,-2.905677246
17151,2013,28,54,22,1,-26,23,6.2878958006,12.126656187,4.9404895576,0.2245677072,-5.838760386,5.1650572648
17151,2014,30,45,-66,1,-15,-65,6.7988668555,10.198300283,-14.95750708,0.2266288952,-3.399433428,-14.73087819
17151,2015,31,44,-7,1,-13,-6,7.1052028421,10.084804034,-1.604400642,0.2292000917,-2.979601192,-1.37520055
17151,2016,21,37,-42,1,-16,-41,4.8566142461,8.5568917669,-9.713228492,0.2312673451,-3.700277521,-9.481961147
17151,2017,23,22,27,1,1,28,5.3364269142,5.1044083527,6.2645011601,0.2320185615,0.2320185615,6.4965197216
27121,2010,22,21,-20,0,1,-20,NA,NA,NA,NA,NA,NA
27121,2011,131,151,-42,0,-20,-42,11.97002924,13.79751462,-3.837719298,0,-1.82748538,-3.837719298
27121,2012,129,122,-26,0,7,-26,11.832691249,11.190607228,-2.384883508,0,0.6420840213,-2.384883508
27121,2013,130,129,-13,1,1,-12,11.941943781,11.850082675,-1.194194378,0.091861106,0.091861106,-1.102333272
27121,2014,121,124,47,0,-3,47,11.099389992,11.37458148,4.3113333028,0,-0.275191487,4.3113333028
27121,2015,129,133,7,1,-4,8,11.808320747,12.174470227,0.6407615909,0.0915373701,-0.366149481,0.7322989611
27121,2016,115,123,43,1,-8,44,10.50852104,11.23954859,3.9292730845,0.0913784438,-0.731027551,4.0206515283
27121,2017,118,117,7,1,1,8,10.761023209,10.669828097,0.6383657836,0.0911951119,0.0911951119,0.7295608955
51735,2010,19,24,-7,1,-5,-6,NA,NA,NA,NA,NA,NA
51735,2011,85,100,-99,6,-15,-93,7.0294409527,8.2699305326,-8.187231227,0.496195832,-1.24048958,-7.691035395
51735,2012,84,99,69,17,-15,86,6.9565217391,8.198757764,5.7142857143,1.4078674948,-1.242236025,7.1221532091
51735,2013,100,107,-14,-1,-7,-15,8.2637798529,8.8422444426,-1.156929179,-0.082637799,-0.57846459,-1.239566978
51735,2014,84,103,-70,-1,-19,-71,6.9724009131,8.5494915958,-5.810334094,-0.083004773,-1.577090683,-5.893338867
51735,2015,105,105,9,-1,0,8,8.7438064704,8.7438064704,0.749469126,-0.083274347,0,0.6661947787
51735,2016,93,100,-58,-1,-7,-59,7.7629382304,8.347245409,-4.841402337,-0.083472454,-0.584307179,-4.924874791
51735,2017,98,106,117,-1,-8,116,8.1666666667,8.8333333333,9.75,-0.083333333,-0.666666667,9.6666666667
39133,2010,407,337,-156,60,70,-96,NA,NA,NA,NA,NA,NA
39133,2011,1500,1292,-23,304,208,281,9.2807998812,7.9938622977,-0.142305598,1.8809087759,1.2869375835,1.7386031777
39133,2012,1381,1365,-845,317,16,-528,8.5455541151,8.4465469712,-5.228814792,1.9615790402,0.099007144,-3.267235751
39133,2013,1420,1378,-317,420,42,103,8.7970907649,8.5368951226,-1.963857586,2.6019564234,0.2601956423,0.6380988372
39133,2014,1504,1373,100,527,131,627,9.2925548347,8.4831634229,0.6178560395,3.2561013284,0.8093914118,3.8739573679
39133,2015,1476,1457,-520,555,19,35,9.0977452878,8.9806333905,-3.205167717,3.420900159,0.1171118973,0.2157324425
39133,2016,1408,1448,-611,552,-40,-59,8.6800525242,8.9266449254,-3.766698929,3.4029751373,-0.246592401,-0.363723792
39133,2017,1397,1403,-425,546,-6,121,8.6117883485,8.6487752705,-2.619906978,3.3658099057,-0.036986922,0.7459029278
55097,2010,197,150,-48,9,47,-39,NA,NA,NA,NA,NA,NA
55097,2011,723,512,-183,28,211,-155,10.321493833,7.3092736409,-2.61249429,0.3997259022,3.0122201919,-2.212768387
55097,2012,717,486,51,64,231,115,10.207568122,6.9189373879,0.7260613308,0.9111357877,3.2886307337,1.6371971185
55097,2013,651,548,-100,62,103,-38,9.2421704194,7.7798915358,-1.419688236,0.8802067066,1.4622788836,-0.53948153
55097,2014,711,526,-296,61,185,-235,10.09355347,7.4672420891,-4.20209821,0.8659729419,2.6263113812,-3.336125268
55097,2015,704,559,-314,64,145,-250,10.005329543,7.9445727483,-4.46260437,0.909575413,2.0607567952,-3.553028957
55097,2016,657,499,-346,67,158,-279,9.352512865,7.10335452,-4.925372072,0.9537570197,2.249158345,-3.971615052
55097,2017,673,497,49,65,176,114,9.5690378354,7.0665851474,0.6967055779,0.9242012768,2.502452688,1.6209068547
18127,2010,446,317,59,23,129,82,NA,NA,NA,NA,NA,NA
18127,2011,1708,1279,491,86,429,577,10.349413907,7.7499416785,2.9751535294,0.5211063208,2.5994722284,3.4962598503
18127,2012,1845,1366,-390,109,479,-281,11.139992573,8.2478210597,-2.354795178,0.6581350626,2.8921715136,-1.696660116
18127,2013,1718,1387,395,78,331,473,10.343011093,8.3502656492,2.3780496982,0.4695895607,1.9927454433,2.8476392589
18127,2014,1819,1361,170,102,458,272,10.902497865,8.1573939494,1.0189250341,0.6113550205,2.7451039154,1.6302800545
18127,2015,1763,1522,-104,113,241,9,10.537262941,9.0968316488,-0.621596906,0.6753889463,1.4404312926,0.05379204
18127,2016,1694,1512,-293,121,182,-172,10.117419401,9.0304239282,-1.749943261,0.7226728144,1.0869954728,-1.027270447
18127,2017,1667,1579,769,120,88,889,9.9272872363,9.4032312814,4.5795344239,0.7146217567,0.5240559549,5.2941561806
51740,2010,381,299,-215,50,82,-165,NA,NA,NA,NA,NA,NA
51740,2011,1590,1008,-334,46,582,-288,16.632930063,10.544650002,-3.49396141,0.481204266,6.0882800609,-3.012757144
51740,2012,1561,1024,-93,294,537,201,16.243242821,10.6554008,-0.96772683,3.0592654641,5.5878420212,2.0915386336
51740,2013,1513,1020,-1053,158,493,-895,15.716704582,10.595531179,-10.93832778,1.6412685552,5.1211734031,-9.297059221
51740,2014,1557,1014,-943,140,543,-803,16.229654299,10.569601451,-9.829520876,1.4593138098,5.660052848,-8.370207066
51740,2015,1516,1050,-193,174,466,-19,15.788130783,10.935051004,-2.009966518,1.8120941664,4.853079779,-0.197872352
51740,2016,1504,1086,-1791,129,418,-1662,15.729091499,11.357575377,-18.73058702,1.3491042575,4.3715161213,-17.38148276
51740,2017,1470,1031,-952,93,439,-859,15.508864846,10.877305889,-10.04383628,0.9811730821,4.6315589574,-9.062663199
18129,2010,63,85,-28,-1,-22,-29,NA,NA,NA,NA,NA,NA
18129,2011,277,235,-217,1,42,-216,10.74663925,9.1171849237,-8.418847355,0.0387965316,1.6294543268,-8.380050823
18129,2012,291,210,-166,4,81,-162,11.344365827,8.1866557511,-6.471356451,0.1559363,3.1577100754,-6.315420151
18129,2013,273,233,-99,4,40,-95,10.6698976,9.1065426405,-3.869303525,0.156335496,1.5633549597,-3.712968029
18129,2014,284,231,-14,3,53,-11,11.102857813,9.0308456155,-0.547323977,0.1172837093,2.0720121975,-0.430040267
18129,2015,274,261,-5,3,13,-2,10.701452898,10.193719731,-0.195281987,0.1171691923,0.5077331667,-0.078112795
18129,2016,274,246,-9,4,28,-5,10.694560996,9.6016861498,-0.351281201,0.156124978,1.0928748463,-0.195156223
18129,2017,284,244,-81,4,40,-77,11.087902864,9.526226404,-3.162394831,0.156167646,1.5616764597,-3.006227185
20149,2010,85,15,43,4,70,47,NA,NA,NA,NA,NA,NA
20149,2011,379,140,36,28,239,64,17.322942615,6.3989761638,1.6454510136,1.2797952328,10.923966451,2.9252462463
20149,2012,356,164,96,18,192,114,16.050495942,7.3940486925,4.3282236249,0.8115419297,8.6564472498,5.1397655546
20149,2013,353,174,66,0,179,66,15.721029661,7.7491760933,2.9393426561,0,7.9718535673,2.9393426561
20149,2014,358,192,-3,8,166,5,15.798764342,8.4730803177,-0.13239188,0.3530450132,7.3256840247,0.2206531333
20149,2015,344,186,210,10,158,220,15.000545078,8.1107598387,9.1573094953,0.4360623569,6.8897852393,9.5933718522
20149,2016,373,189,279,10,184,289,15.969516633,8.0917926104,11.945027187,0.4281371752,7.8777240228,12.373164362
20149,2017,371,191,124,11,180,135,15.620723774,8.0419359592,5.220942717,0.4631481442,7.578787815,5.6840908612
40125,2010,250,179,117,6,71,123,NA,NA,NA,NA,NA,NA
40125,2011,1012,785,155,11,227,166,14.492234768,11.241506219,2.2196604636,0.157524291,3.2507285498,2.3771847545
40125,2012,909,771,311,24,138,335,12.937844262,10.973683087,4.4264791699,0.3415932478,1.9641611751,4.7680724178
40125,2013,919,760,210,31,159,241,13.000700255,10.751395206,2.9707802542,0.4385437518,2.2493050496,3.409324006
40125,2014,923,788,479,23,135,502,12.963301077,11.067260291,6.7274336035,0.3230291709,1.8960407859,7.0504627744
40125,2015,919,865,-131,25,54,-106,12.855124565,12.0997636,-1.832449748,0.3497041503,0.7553609646,-1.482745597
40125,2016,837,802,460,28,35,488,11.670222111,11.182219991,6.4137421397,0.3904016955,0.4880021193,6.8041438351
40125,2017,847,809,181,28,38,209,11.746921114,11.219904582,2.5102629535,0.3883279707,0.5270165317,2.8985909242
19155,2010,328,230,104,3,98,107,NA,NA,NA,NA,NA,NA
19155,2011,1250,837,-278,-8,413,-286,13.381650011,8.9603528473,-2.976078962,-0.08564256,4.4212971636,-3.061721523
19155,2012,1205,869,-917,4,336,-913,12.930780086,9.3251849745,-9.84026999,0.0429237513,3.605595111,-9.797346239
19155,2013,1153,890,-391,36,263,-355,12.41680846,9.5845269121,-4.210730362,0.387688729,2.8322815482,-3.823041633
19155,2014,1203,922,69,60,281,129,12.934857991,9.9134988092,0.7418995855,0.6451300744,3.0213591815,1.3870296599
19155,2015,1201,912,-15,71,289,56,12.863423856,9.7680620786,-0.160658916,0.7604522013,3.0953617771,0.5997932855
19155,2016,1162,888,-370,74,274,-296,12.425149701,9.495295124,-3.956372968,0.7912745937,2.9298545766,-3.165098375
19155,2017,1145,944,-398,75,201,-323,12.252934819,10.101982942,-4.25909874,0.8025939838,2.1509518765,-3.456504757
42105,2010,48,59,18,0,-11,18,NA,NA,NA,NA,NA,NA
42105,2011,189,187,-7,0,2,-7,10.825672309,10.71111493,-0.400950826,0,0.1145573789,-0.400950826
42105,2012,186,198,109,1,-12,110,10.62583907,11.311377074,6.2269702077,0.057128167,-0.685538005,6.2840983747
42105,2013,214,211,-119,0,3,-119,12.231716727,12.060244063,-6.801749021,0,0.1714726644,-6.801749021
42105,2014,175,209,-251,2,-34,-249,10.117361392,12.083020177,-14.51118691,0.1156269873,-1.965658785,-14.39555992
42105,2015,174,202,-101,2,-28,-99,10.179307924,11.817357475,-5.908678738,0.1170035394,-1.638049551,-5.791675198
42105,2016,183,209,-82,3,-26,-79,10.778972169,12.310410838,-4.829921956,0.1767044618,-1.531438669,-4.653217494
42105,2017,180,209,-95,3,-29,-92,10.67394076,12.393631215,-5.633468734,0.1778990127,-1.719690456,-5.455569722
46107,2010,8,3,12,0,5,12,NA,NA,NA,NA,NA,NA
46107,2011,22,32,28,0,-10,28,9.3200593095,13.556449905,11.861893667,0,-4.236390595,11.861893667
46107,2012,27,53,-5,0,-26,-5,11.469838573,22.514868309,-2.12404418,0,-11.04502974,-2.12404418
46107,2013,18,31,29,2,-13,31,7.669365147,13.208351086,12.356199403,0.852151683,-5.538985939,13.208351086
46107,2014,28,32,-47,2,-4,-45,12.009435985,13.725069698,-20.15869612,0.8578168561,-1.715633712,-19.30087926
46107,2015,18,38,8,2,-20,10,7.819287576,16.507384883,3.4752389227,0.8688097307,-8.688097307,4.3440486533
46107,2016,28,31,-26,3,-3,-23,12.261878695,13.575651412,-11.38603022,1.3137727173,-1.313772717,-10.0722575
46107,2017,25,33,-35,3,-8,-32,11.108642524,14.663408132,-15.55209953,1.3330371029,-3.554765608,-14.21906243
48375,2010,533,311,3,89,222,92,NA,NA,NA,NA,NA,NA
48375,2011,2040,1133,-450,482,907,32,16.742239275,9.2985083814,-3.693141016,3.9557643776,7.4437308931,0.2626233612
48375,2012,2038,1144,-1039,528,894,-511,16.635580388,9.3381275585,-8.481044172,4.309905027,7.2974528298,-4.171139145
48375,2013,2127,1183,-2126,538,944,-1588,17.37801889,9.6653485408,-17.36984869,4.3955684826,7.7126703487,-12.97428021
48375,2014,2103,1234,-1649,608,869,-1041,17.236150839,10.113842195,-13.51517486,4.9831572563,7.1223086443,-8.532017605
48375,2015,2001,1228,-2275,674,773,-1601,16.464867133,10.104376232,-18.71942665,5.5458872803,6.3604909015,-13.17353937
48375,2016,1904,1249,-1941,699,655,-1242,15.756958841,10.336366382,-16.06316025,5.7847238601,5.4205924583,-10.27843639
48375,2017,1870,1164,-1494,701,706,-793,15.518672199,9.6597510373,-12.39834025,5.8174273859,5.8589211618,-6.580912863
30075,2010,4,6,-3,0,-2,-3,NA,NA,NA,NA,NA,NA
30075,2011,6,26,19,0,-20,19,3.4512510785,14.95542134,10.928961749,0,-11.50417026,10.928961749
30075,2012,11,24,28,0,-13,28,6.3019192209,13.749641936,16.041248926,0,-7.447722716,16.041248926
30075,2013,9,21,12,0,-12,12,5.1340559042,11.979463776,6.8454078722,0,-6.845407872,6.8454078722
30075,2014,11,16,29,0,-5,29,6.2322946176,9.0651558074,16.430594901,0,-2.83286119,16.430594901
30075,2015,17,20,-6,0,-3,-6,9.5936794582,11.286681716,-3.386004515,0,-1.693002257,-3.386004515
30075,2016,18,17,-18,0,1,-18,10.230179028,9.6618357488,-10.23017903,0,0.5683432793,-10.23017903
30075,2017,21,17,-4,0,4,-4,11.98630137,9.703196347,-2.283105023,0,2.2831050228,-2.283105023
21197,2010,39,25,16,0,14,16,NA,NA,NA,NA,NA,NA
21197,2011,141,153,-9,0,-12,-9,11.162127929,12.112096263,-0.712476251,0,-0.949968334,-0.712476251
21197,2012,172,161,-152,-2,11,-154,13.705725328,12.829196382,-12.11203634,-0.159368899,0.8765289454,-12.27140524
21197,2013,164,179,17,-3,-15,14,13.142078692,14.344098085,1.3622886449,-0.240403879,-1.202019393,1.1218847664
21197,2014,169,173,-115,2,-4,-113,13.607085346,13.929146538,-9.259259259,0.1610305958,-0.322061192,-9.098228663
21197,2015,170,190,-110,3,-20,-107,13.822823922,15.449038501,-8.944180185,0.2439321869,-1.626214579,-8.700247998
21197,2016,178,136,15,3,42,18,14.512249806,11.088011088,1.2229423994,0.2445884799,3.4242387184,1.4675308793
21197,2017,172,134,38,3,38,41,13.94462686,10.863837205,3.080789655,0.2432202359,3.080789655,3.324009891
30077,2010,14,27,-1,0,-13,-1,NA,NA,NA,NA,NA,NA
30077,2011,58,74,81,-1,-16,80,8.2333735538,10.504649017,11.498332032,-0.141954716,-2.271275463,11.356377316
30077,2012,63,69,5,0,-6,5,8.9033352176,9.751271905,0.7066139062,0,-0.847936687,0.7066139062
30077,2013,44,81,-90,0,-37,-90,6.2745098039,11.550802139,-12.8342246,0,-5.276292335,-12.8342246
30077,2014,45,71,-47,0,-26,-47,6.5094749024,10.270504846,-6.798784898,0,-3.761029944,-6.798784898
30077,2015,55,76,-63,0,-21,-63,8.0474065403,11.120052674,-9.217938401,0,-3.072646134,-9.217938401
30077,2016,56,71,69,0,-15,69,8.2105417491,10.409794003,10.116560369,0,-2.199252254,10.116560369
30077,2017,56,83,-24,0,-27,-24,8.2093381221,12.16741186,-3.518287767,0,-3.958073737,-3.518287767
16077,2010,33,3,25,-4,30,21,NA,NA,NA,NA,NA,NA
16077,2011,132,53,-182,8,79,-174,16.874400767,6.7753275807,-23.26621924,1.0226909556,10.099073186,-22.24352828
16077,2012,129,61,-54,10,68,-44,16.559691913,7.8305519897,-6.931964056,1.2836970475,8.729139923,-5.648267009
16077,2013,135,56,-156,14,79,-142,17.367811656,7.2044255757,-20.06947125,1.8011063939,10.16338608,-18.26836485
16077,2014,144,71,-150,12,73,-138,18.673409842,9.207028464,-19.45146859,1.5561174869,9.4663813785,-17.8953511
16077,2015,146,77,-118,17,69,-101,19.048861635,10.046317438,-15.39565529,2.2180181356,9.0025441973,-13.17763716
16077,2016,119,58,-67,18,61,-49,15.545395167,7.576747224,-8.752449379,2.3514043109,7.9686479425,-6.401045069
16077,2017,125,63,-143,19,62,-124,16.381626368,8.2563396894,-18.74058056,2.4900072079,8.1252866785,-16.25057336
19157,2010,57,39,-15,5,18,-10,NA,NA,NA,NA,NA,NA
19157,2011,183,220,-37,27,-37,-10,9.6835643983,11.641443539,-1.957879141,1.4287226161,-1.957879141,-0.529156524
19157,2012,184,237,-139,25,-53,-114,9.791400596,12.611749681,-7.396764581,1.3303533418,-2.820349085,-6.066411239
19157,2013,171,237,-85,25,-66,-60,9.1711136735,12.710841758,-4.558740715,1.3408060926,-3.539728085,-3.217934622
19157,2014,174,235,22,32,-61,54,9.3669250646,12.650732127,1.1843238587,1.7226528854,-3.283807063,2.9069767442
19157,2015,187,228,-183,32,-41,-151,10.121238363,12.340333405,-9.904741286,1.7319766183,-2.219095042,-8.172764668
19157,2016,166,210,-76,32,-44,-44,9.0529817577,11.452567284,-4.144738636,1.7451531099,-2.399585526,-2.399585526
19157,2017,167,205,29,32,-38,61,9.1241872917,11.200349669,1.5844397093,1.7483472655,-2.076162378,3.3327869748
51145,2010,64,22,17,1,42,18,NA,NA,NA,NA,NA,NA
51145,2011,247,192,-47,1,55,-46,8.7830029336,6.8272735354,-1.671259668,0.0355587163,1.9557293982,-1.635700951
51145,2012,242,190,-12,5,52,-7,8.5974136706,6.7500355265,-0.426318033,0.1776325139,1.8473781441,-0.248685519
51145,2013,221,197,100,3,24,103,7.8279965996,6.9778974214,3.5420799093,0.1062623973,0.8500991782,3.6483423066
51145,2014,233,203,153,11,30,164,8.2076933916,7.1509088347,5.38960124,0.3874876708,1.0567845569,5.7770889108
51145,2015,241,193,-511,12,48,-499,8.5267478064,6.8284743844,-18.07953581,0.4245683555,1.698273422,-17.65496745
51145,2016,218,230,352,12,-12,364,7.7246071258,8.1498148575,12.47276013,0.4252077317,-0.425207732,12.897967861
51145,2017,225,242,210,12,-17,222,7.8948753487,8.4913770417,7.3685503254,0.4210600186,-0.596501693,7.789610344
05117,2010,31,14,-13,0,17,-13,NA,NA,NA,NA,NA,NA
05117,2011,84,105,-103,0,-21,-103,9.6975294389,12.121911799,-11.89101824,0,-2.42438236,-11.89101824
05117,2012,85,106,-97,0,-21,-97,9.9508311871,12.409271833,-11.35565441,0,-2.458440646,-11.35565441
05117,2013,89,99,-99,0,-10,-99,10.556906471,11.743075737,-11.74307574,0,-1.186169266,-11.74307574
05117,2014,102,117,-11,0,-15,-11,12.196580175,13.990194906,-1.31531747,0,-1.793614732,-1.31531747
05117,2015,84,105,-26,0,-21,-26,10.09009009,12.612612613,-3.123123123,0,-2.522522523,-3.123123123
05117,2016,83,108,-4,0,-25,-4,10.016895969,13.034033309,-0.482741974,0,-3.01713734,-0.482741974
05117,2017,76,113,14,0,-37,14,9.2015255161,13.68121557,1.6950178582,0,-4.479690054,1.6950178582
30079,2010,2,9,10,0,-7,10,NA,NA,NA,NA,NA,NA
30079,2011,10,18,-37,1,-8,-36,8.6132644272,15.503875969,-31.86907838,0.8613264427,-6.890611542,-31.00775194
30079,2012,16,16,-1,2,0,1,14.041246161,14.041246161,-0.877577885,1.7551557701,0,0.877577885
30079,2013,11,22,30,0,-11,30,9.5652173913,19.130434783,26.086956522,0,-9.565217391,26.086956522
30079,2014,12,18,-34,1,-6,-33,10.521701008,15.782551512,-29.81148619,0.8768084174,-5.260850504,-28.93467777
30079,2015,16,16,14,1,0,15,14.171833481,14.171833481,12.400354296,0.8857395926,0,13.286093888
30079,2016,13,15,30,1,-2,31,11.289622232,13.026487191,26.052974381,0.8684324794,-1.736864959,26.921406861
30079,2017,14,16,-57,1,-2,-56,12.307692308,14.065934066,-50.10989011,0.8791208791,-1.758241758,-49.23076923
20151,2010,27,17,-22,1,10,-21,NA,NA,NA,NA,NA,NA
20151,2011,138,129,-10,6,9,-4,14.313125551,13.379660841,-1.037183011,0.6223098066,0.9334647098,-0.414873204
20151,2012,143,109,81,5,34,86,14.736191261,11.232481451,8.3470733718,0.5152514427,3.5037098104,8.8623248145
20151,2013,147,138,8,3,9,11,15.040671203,14.119813782,0.8185399294,0.3069524735,0.9208574206,1.1254924029
20151,2014,133,128,-29,2,5,-27,13.610315186,13.098649202,-2.96766271,0.2046663938,0.5116659844,-2.762996316
20151,2015,143,110,-113,4,33,-109,14.707394837,11.313380644,-11.62192739,0.4113956598,3.3940141932,-11.21053173
20151,2016,140,98,-159,4,42,-155,14.540167212,10.178117048,-16.51347562,0.4154333489,4.3620501636,-16.09804227
20151,2017,129,91,-66,4,38,-62,13.494429625,9.5193263246,-6.904126785,0.4184319264,3.9751033004,-6.485694859
39135,2010,89,118,-58,4,-29,-54,NA,NA,NA,NA,NA,NA
39135,2011,456,457,-197,5,-1,-192,10.836888197,10.860653303,-4.681725822,0.1188255285,-0.023765106,-4.562900293
39135,2012,449,477,-164,21,-28,-143,10.716885659,11.385199241,-3.914408125,0.5012351867,-0.668313582,-3.413172938
39135,2013,441,432,-167,13,9,-154,10.566037736,10.350404313,-4.001197963,0.3114705001,0.2156334232,-3.689727463
39135,2014,440,475,-162,16,-35,-146,10.583537788,11.425410112,-3.896666186,0.3848559196,-0.841872324,-3.511810266
39135,2015,446,451,-226,16,-5,-210,10.77958646,10.900433842,-5.462301659,0.3867116219,-0.120847382,-5.0755900370000004
39135,2016,416,472,-123,18,-56,-105,10.100642216,11.460344053,-2.986487963,0.437047019,-1.359701837,-2.549440944
39135,2017,422,447,25,18,-25,43,10.264518091,10.872605655,0.6080875646,0.4378230465,-0.608087565,1.0459106111
28117,2010,84,52,-84,0,32,-84,NA,NA,NA,NA,NA,NA
28117,2011,353,314,89,-1,39,88,13.9580862,12.415974694,3.5191775405,-0.039541321,1.5421115065,3.4796362198
28117,2012,353,235,-115,-7,118,-122,13.923950773,9.2694856422,-4.536131272,-0.276112338,4.654465131,-4.81224361
28117,2013,318,322,123,-1,-4,122,12.515004231,12.672425668,4.8407091836,-0.039355359,-0.157421437,4.8013538244
28117,2014,287,274,-74,2,13,-72,11.28299884,10.771922238,-2.909205276,0.0786271696,0.5110766025,-2.830578106
28117,2015,307,316,22,2,-9,24,12.081382079,12.435559403,0.8657667939,0.0787060722,-0.354177325,0.9444728661
28117,2016,305,274,-56,3,31,-53,12.005274448,10.785066226,-2.204247112,0.1180846667,1.2202082226,-2.086162445
28117,2017,311,252,-195,3,59,-192,12.279143224,9.9496594611,-7.69914125,0.1184483269,2.3294837627,-7.580692923
48377,2010,36,17,32,4,19,36,NA,NA,NA,NA,NA,NA
48377,2011,128,30,-239,19,98,-220,16.378758797,3.8387715931,-30.58221369,2.431222009,12.539987204000001,-28.15099168
48377,2012,98,35,-230,23,63,-207,12.750455373,4.5537340619,-29.92453812,2.9924538121,8.1967213115,-26.93208431
48377,2013,115,49,-348,47,66,-301,15.328223925,6.5311562812,-46.38453849,6.2645784738,8.7970676441,-40.11996001
48377,2014,135,52,-344,52,83,-292,18.522329697,7.1345269946,-47.19764012,7.1345269946,11.387802703,-40.06311312
48377,2015,135,50,-287,64,85,-223,18.958011515,7.0214857464,-40.30332818,8.9875017554,11.936525769,-31.31582643
48377,2016,115,34,-39,71,81,32,16.17440225,4.7819971871,-5.485232068,9.9859353024,11.392405063,4.5007032349
48377,2017,119,45,-154,70,74,-84,16.617790811,6.2840385421,-21.50537634,9.7751710655,10.333752269,-11.73020528
26141,2010,24,68,-18,0,-44,-18,NA,NA,NA,NA,NA,NA
26141,2011,98,202,-62,1,-104,-61,7.4076873654,15.26890661,-4.686496088,0.0755886466,-7.861219245,-4.610907442
26141,2012,84,164,11,1,-80,12,6.4065896351,12.508103573,0.8389581665,0.0762689242,-6.101513938,0.9152270907
26141,2013,91,199,31,3,-108,34,6.9785276074,15.260736196,2.3773006135,0.2300613497,-8.282208589,2.6073619632
26141,2014,94,195,48,6,-101,54,7.2427476211,15.024848788,3.6984243171,0.4623030396,-7.782101167,4.1607273568
26141,2015,102,197,-68,6,-95,-62,7.9223300971,15.300970874,-5.281553398,0.4660194175,-7.378640777,-4.815533981
26141,2016,93,188,20,6,-95,26,7.2881156694,14.732965009,1.5673367031,0.4702010109,-7.44484934,2.037537714
26141,2017,99,179,140,6,-80,146,7.759836965,14.03041229,10.973506819,0.4702931494,-6.270575325,11.443799969
54077,2010,77,42,6,0,35,6,NA,NA,NA,NA,NA,NA
54077,2011,355,369,129,-8,-14,121,10.5629612,10.979528684,3.8383718162,-0.238038562,-0.416567484,3.600333254
54077,2012,366,337,215,-5,29,210,10.834653128,9.9761696837,6.3646186409,-0.148014387,0.8584834446,6.2166042539
54077,2013,337,367,-182,-4,-30,-186,9.9729221846,10.860719412,-5.385969844,-0.118372964,-0.887797227,-5.504342808
54077,2014,342,363,249,6,-21,255,10.117894176,10.73916838,7.366536988,0.1775069154,-0.621274204,7.5440439034
54077,2015,348,363,-106,6,-15,-100,10.276854928,10.719822813,-3.130306386,0.1771871539,-0.442967885,-2.953119232
54077,2016,327,362,-66,7,-35,-59,9.6865928076,10.723384087,-1.955092126,0.2073582558,-1.036791279,-1.74773387
54077,2017,313,356,6,7,-43,13,9.2892120493,10.565365781,0.1780679626,0.2077459564,-1.276153732,0.385813919
55099,2010,31,57,-37,0,-26,-37,NA,NA,NA,NA,NA,NA
55099,2011,106,156,-66,3,-50,-63,7.5498575499,11.111111111,-4.700854701,0.2136752137,-3.561253561,-4.487179487
55099,2012,110,160,-107,17,-50,-90,7.9054224011,11.49879622,-7.689819972,1.2217470984,-3.593373819,-6.468072874
55099,2013,105,193,-35,15,-88,-20,7.6139371306,13.995141583,-2.537979044,1.0877053044,-6.381204452,-1.450273739
55099,2014,121,176,-49,17,-55,-32,8.8372772422,12.854221443,-3.578732106,1.2416009349,-4.016944201,-2.337131171
55099,2015,99,205,20,19,-106,39,7.2719259586,15.0580285,1.4690759512,1.3956221537,-7.786102542,2.8646981049
55099,2016,117,192,-101,21,-75,-80,8.6653829062,14.220115538,-7.480373278,1.555325137,-5.554732632,-5.925048141
55099,2017,110,153,41,21,-43,62,8.1887888037,11.389860791,3.0521849177,1.5633142262,-3.201071987,4.6154991439
51147,2010,52,25,-31,2,27,-29,NA,NA,NA,NA,NA,NA
51147,2011,181,230,-84,7,-49,-77,7.7712421107,9.8750590357,-3.6065433,0.300545275,-2.103816925,-3.305998025
51147,2012,209,217,-66,15,-8,-51,9.0099799539,9.3548595693,-2.845256828,0.646649279,-0.344879615,-2.198607549
51147,2013,202,222,-461,21,-20,-440,8.8048121349,9.6765757127,-20.09415047,0.9153517566,-0.871763578,-19.17879871
51147,2014,218,210,216,25,8,241,9.5431960952,9.1929870642,9.4556438374,1.0944032219,0.350209031,10.550047059
51147,2015,217,277,163,25,-60,188,9.4206516312,12.025440101,7.0763420087,1.0853285289,-2.604788469,8.1616705377
51147,2016,266,207,-161,24,59,-137,11.534375474,8.9759989593,-6.981332524,1.0406955315,2.558376515,-5.940636992
51147,2017,249,228,-367,24,21,-343,10.890959192,9.9724445611,-16.05213664,1.0497310064,0.9185146306,-15.00240563
51149,2010,97,31,-213,57,66,-156,NA,NA,NA,NA,NA,NA
51149,2011,420,217,790,67,203,857,11.611833011,5.9994470556,21.841304949,1.8523638374,5.6123859552,23.693668786
51149,2012,382,246,-58,339,136,281,10.348797833,6.6644090755,-1.571283441,9.1838807992,3.6843887572,7.6125973586
51149,2013,382,225,-85,146,157,61,10.261231616,6.0439191458,-2.283258344,3.921831979,4.2173124706,1.6385736351
51149,2014,377,251,-174,109,126,-65,10.08871108,6.7168872178,-4.656328191,2.916895246,3.3718238623,-1.739432945
51149,2015,406,199,397,160,207,557,10.745146819,5.2667098943,10.50695391,4.2345406185,5.4784369252,14.741494528
51149,2016,367,239,-572,81,128,-491,9.6610727213,6.2915432708,-15.05758473,2.1322803554,3.3695294505,-12.92530438
51149,2017,350,257,-145,53,93,-92,9.2573000423,6.7975031739,-3.83516716,1.4018197207,2.4597968684,-2.43334744
24033,2010,3016,1300,-783,1419,1716,636,NA,NA,NA,NA,NA,NA
24033,2011,12136,5158,-3771,5801,6978,2030,13.947405318,5.9278771121,-4.333855097,6.6668505481,8.0195282063,2.3329954512
24033,2012,12015,4981,-4365,5665,7034,1300,13.673219722,5.6684400694,-4.967424393,6.4468405929,8.0047796523,1.4794161996
24033,2013,11951,5279,-3000,5553,6672,2553,13.467288777,5.9487756216,-3.380626419,6.2575395012,7.5185131554,2.8769130824
24033,2014,12056,5230,-2823,5761,6826,2938,13.443264207,5.8318075481,-3.147837994,6.4239088499,7.6114566584,3.2760708559
24033,2015,12497,5613,-6658,6445,6884,-213,13.809404362,6.2024635261,-7.357206869,7.1218381304,7.6069408363,-0.235368739
24033,2016,12108,6451,-9394,6597,5657,-2797,13.309619025,7.0912084844,-10.32627693,7.2516977789,6.2184105404,-3.074579155
24033,2017,11958,6776,-10101,6523,5182,-3578,13.112489103,7.4301911827,-11.07620442,7.1527652132,5.6822979204,-3.923439205
02198,2010,18,3,26,0,15,26,NA,NA,NA,NA,NA,NA
02198,2011,81,48,122,1,33,123,12.866333095,7.624493686,19.378921452,0.1588436185,5.2418394091,19.53776507
02198,2012,91,36,-5,-1,55,-6,14.21875,5.625,-0.78125,-0.15625,8.59375,-0.9375
02198,2013,81,40,-19,1,41,-18,12.587412587,6.216006216,-2.952602953,0.1554001554,6.3714063714,-2.797202797
02198,2014,70,54,0,2,16,2,10.845986985,8.3669042454,0,0.3098853424,2.4790827394,0.3098853424
02198,2015,77,33,-3,2,44,-1,11.87630138,5.0898434488,-0.462713041,0.3084753605,6.7864579317,-0.15423768
02198,2016,77,66,-11,2,11,-9,11.835229019,10.144482017,-1.690747003,0.307408546,1.6907470028,-1.383338457
02198,2017,77,56,-85,2,21,-83,11.891891892,8.6486486486,-13.12741313,0.3088803089,3.2432432432,-12.81853282
51153,2010,1594,445,2375,574,1149,2949,NA,NA,NA,NA,NA,NA
51153,2011,6514,1507,6189,1957,5007,8146,15.774574215,3.6494140838,14.987540653,4.7391528613,12.125160131,19.726693515
51153,2012,6647,1491,3018,2314,5156,5332,15.646055944,3.5095937133,7.1039261079,5.4468141198,12.136462231,12.550740228
51153,2013,6688,1690,1441,2159,4998,3600,15.397135829,3.890723617,3.3174749894,4.9704569758,11.506412212,8.2879319653
51153,2014,6661,1704,-1478,2248,4957,770,15.087459017,3.8596352146,-3.347735239,5.0918192268,11.227823802,1.7440839878
51153,2015,6908,1773,-763,2581,5135,1818,15.42689143,3.9594496968,-1.703925617,5.7638689608,11.467441733,4.0599433439
51153,2016,6765,1909,-2055,2502,4856,447,14.904048988,4.2057397663,-4.527394039,5.5121848587,10.698309222,0.9847908201
51153,2017,6742,1969,-713,2406,4773,1693,14.663167979,4.282375816,-1.550702873,5.2328066091,10.380792163,3.6821037361
44007,2010,1941,1376,-899,768,565,-131,NA,NA,NA,NA,NA,NA
44007,2011,7358,5773,-4161,3519,1585,-642,11.723841239,9.1983875337,-6.629913481,5.6069852297,2.5254537053,-1.022928252
44007,2012,7399,5482,-3725,3326,1917,-399,11.766052894,8.7175972381,-5.923577109,5.289078514,3.0484556559,-0.634498595
44007,2013,7338,5648,-4782,3504,1690,-1278,11.651040385,8.967712741,-7.592705795,5.5635384994,2.6833276438,-2.029167295
44007,2014,7238,5662,-3361,3882,1576,521,11.469590847,8.9722054955,-5.325959497,6.1515545273,2.4973853516,0.8255950306
44007,2015,7403,5818,-4364,4223,1585,-141,11.698743527,9.1940145669,-6.896301061,6.6734829007,2.5047289599,-0.22281816
44007,2016,7455,5638,-4150,4330,1817,180,11.749029385,8.8854497215,-6.540371824,6.824050602,2.8635796637,0.2836787779
44007,2017,7322,5563,-4235,4312,1759,77,11.504628484,8.7408151128,-6.654206723,6.7751923003,2.7638133711,0.1209855768
08099,2010,39,9,-11,2,30,-9,NA,NA,NA,NA,NA,NA
08099,2011,142,149,-54,7,-7,-47,11.320604297,11.878662255,-4.305018535,0.5580579583,-0.558057958,-3.746960577
08099,2012,185,130,-149,11,55,-138,14.827876408,10.419588827,-11.94245181,0.8816575161,4.4082875807,-11.06079429
08099,2013,167,119,-168,12,48,-156,13.485142119,9.6091731266,-13.56589147,0.9689922481,3.8759689922,-12.59689922
08099,2014,144,103,-319,14,41,-305,11.800376956,8.4405474064,-26.14111284,1.1472588708,3.3598295501,-24.99385397
08099,2015,164,127,-177,16,37,-161,13.650740802,10.571000499,-14.73281172,1.3317795905,3.079740303,-13.40103213
08099,2016,178,124,-36,18,54,-18,14.869267396,10.358366051,-3.007267563,1.5036337816,4.5109013449,-1.503633782
08099,2017,177,124,11,18,53,29,14.713828505,10.307992851,0.9144187206,1.4963215429,4.405835654,2.4107402635
08101,2010,502,417,300,2,85,302,NA,NA,NA,NA,NA,NA
08101,2011,1866,1649,476,26,217,502,11.675854258,10.318051271,2.9784065525,0.1626860722,1.3578029872,3.1410926247
08101,2012,1878,1582,233,49,296,282,11.704362025,9.8595850498,1.4521386325,0.3053853776,1.8447769752,1.7575240101
08101,2013,1855,1608,67,45,247,112,11.528720809,9.9936296826,0.4164012368,0.2796724725,1.5350911266,0.6960737092
08101,2014,1918,1622,41,46,296,87,11.894979364,10.059257835,0.2542722387,0.2852810483,1.8357215285,0.5395532871
08101,2015,1876,1735,1425,61,141,1486,11.563757851,10.694626798,8.7837712891,0.3760070517,0.8691310539,9.1597783408
08101,2016,1867,1729,1600,55,138,1655,11.388416998,10.546637916,9.75975747,0.335491663,0.8417790818,10.095249133
08101,2017,1859,1715,1445,53,144,1498,11.22215213,10.352872998,8.7229746249,0.3199430139,0.8692791322,9.0429176388
05119,2010,1413,852,64,149,561,213,NA,NA,NA,NA,NA,NA
05119,2011,5751,3379,339,452,2372,791,14.933492596,8.7741734451,0.8802736898,1.1736982531,6.1593191511,2.0539719429
05119,2012,5608,3407,-810,730,2201,-80,14.464475244,8.7875298065,-2.089198457,1.8828578687,5.6769454371,-0.206340588
05119,2013,5631,3774,-246,759,1857,513,14.442053536,9.6793305002,-0.630926153,1.94663801,4.7627230362,1.3157118565
05119,2014,5627,3469,-1516,782,2158,-734,14.363715728,8.8551146009,-3.869805055,1.9961659319,5.5086011267,-1.873639123
05119,2015,5633,3635,-2215,918,1998,-1297,14.341708453,9.2547683698,-5.639425568,2.337242741,5.0869400833,-3.302182827
05119,2016,5391,3695,-1993,871,1696,-1122,13.703888234,9.3926668565,-5.066193517,2.2140765445,4.3112213772,-2.852116972
05119,2017,5417,3688,-2251,816,1729,-1435,13.755137228,9.3647676012,-5.715860052,2.0720310094,4.3903696265,-3.643829042
13235,2010,27,10,-52,0,17,-52,NA,NA,NA,NA,NA,NA
13235,2011,87,117,-100,0,-30,-100,7.3075469321,9.8273907018,-8.399479232,0,-2.51984377,-8.399479232
13235,2012,95,97,-138,-2,-2,-140,8.0699966021,8.2398912674000009,-11.72273191,-0.169894665,-0.169894665,-11.89262657
13235,2013,94,114,-115,-2,-20,-117,8.0797662025,9.7988653945,-9.884820354,-0.171909919,-1.719099192,-10.05673027
13235,2014,80,105,-27,-2,-25,-29,6.9336106778,9.1003640146,-2.340093604,-0.173340267,-2.166753337,-2.513433871
13235,2015,102,117,-97,-2,-15,-99,8.9055747152,10.215218056,-8.469026935,-0.174619112,-1.30964334,-8.643646047
13235,2016,80,100,-68,-2,-20,-70,7.0472163495,8.8090204369,-5.990133897,-0.176180409,-1.761804087,-6.166314306
13235,2017,84,126,-62,-2,-42,-64,7.4640127955,11.196019193,-5.509152301,-0.17771459,-3.732006398,-5.686866892
17153,2010,13,39,-8,0,-26,-8,NA,NA,NA,NA,NA,NA
17153,2011,57,71,-133,2,-14,-131,9.4129303939,11.72487821,-21.96350425,0.3302782594,-2.311947816,-21.63322599
17153,2012,71,90,-7,2,-19,-5,11.886824042,15.067805123,-1.171940398,0.3348401138,-3.180981082,-0.837100285
17153,2013,56,88,-40,1,-32,-39,9.4498818765,14.849814377,-6.749915626,0.16874789069999999,-5.399932501,-6.581167735
17153,2014,63,72,-91,3,-9,-88,10.782132466,12.322437104,-15.57419134,0.5134348793,-1.540304638,-15.06075646
17153,2015,63,96,-110,3,-33,-107,11.003405816,16.767094577,-19.21229587,0.5239717055,-5.763688761,-18.68832416
17153,2016,50,67,-38,3,-17,-35,8.8817834621,11.901589839,-6.750155431,0.5329070077,-3.019806377,-6.217248423
17153,2017,51,60,-89,3,-9,-86,9.1792656587,10.799136069,-16.0187185,0.5399568035,-1.61987041,-15.4787617
18131,2010,42,49,-58,1,-7,-57,NA,NA,NA,NA,NA,NA
18131,2011,145,162,-80,2,-17,-78,10.91826362,12.198335906,-6.023869583,0.1505967396,-1.280072286,-5.873272844
18131,2012,113,144,-193,1,-31,-192,8.6105078676,10.972682592,-14.70644264,0.0761991847,-2.362174725,-14.63024346
18131,2013,150,170,-54,4,-20,-50,11.557575991,13.098586123,-4.160727357,0.3082020264,-1.541010132,-3.85252533
18131,2014,139,134,-30,3,5,-27,10.749361998,10.362694301,-2.320006187,0.2320006187,0.3866676978,-2.088005568
18131,2015,132,144,-112,4,-12,-108,10.264784789,11.197947043,-8.709514367,0.3110540845,-0.933162254,-8.398460282
18131,2016,137,148,-182,4,-11,-178,10.782731888,11.648498682,-14.32450514,0.3148242887,-0.865766794,-14.00968085
18131,2017,127,134,-74,4,-7,-70,10.101411811,10.658182541,-5.885862,0.3181547027,-0.55677073,-5.567707298
21199,2010,207,170,86,1,37,87,NA,NA,NA,NA,NA,NA
21199,2011,722,706,292,8,16,300,11.398440213,11.1458432,4.609895488,0.1262985065,0.252597013,4.7361939945
21199,2012,773,781,14,13,-8,27,12.17284495,12.298825234,0.2204654971,0.2047179616,-0.125980284,0.4251834588
21199,2013,756,813,270,37,-57,307,11.881748314,12.777594417,4.2434815409,0.5815141371,-0.895846103,4.8249956779
21199,2014,710,798,134,45,-88,179,11.130358445,12.509895829,2.1006591994,0.7054452535,-1.379537385,2.8061044529
21199,2015,731,815,46,46,-84,92,11.452564293,12.768590833,0.7206812004,0.7206812004,-1.31602654,1.4413624008
21199,2016,759,799,181,47,-40,228,11.87412489,12.499902222,2.8316424308,0.735288366,-0.625777333,3.5669307968
21199,2017,737,787,440,46,-50,486,11.474120953,12.25255521,6.8502214645,0.7161595167,-0.778434257,7.5663809813
29169,2010,216,41,239,138,175,377,NA,NA,NA,NA,NA,NA
29169,2011,904,268,-388,161,636,-227,17.040527804,5.0518378888,-7.313854854,3.0348727615,11.988689915,-4.278982092
29169,2012,792,323,-1087,795,469,-292,14.844386966,6.0539608461,-20.37354625,14.900615705,8.7904261201,-5.472930548
29169,2013,862,280,-345,392,582,47,16.0318405,5.207558399,-6.416455885,7.2905817587,10.824282101,0.8741258741
29169,2014,817,318,-1318,326,499,-992,15.171914317,5.9053473106,-24.47562187,6.0539095071,9.2665670062,-18.42171237
29169,2015,808,329,-1307,485,479,-822,15.115800501,6.1548247091,-24.45092977,9.0732218356,8.9609757923,-15.37770794
29169,2016,786,286,-1448,266,500,-1182,14.843772131,5.4011689943,-27.34577868,5.0234648688,9.4426031368,-22.32231382
29169,2017,769,271,-1227,171,498,-1056,14.693799561,5.1781790389,-23.44511321,3.2674118659,9.5156205216,-20.17770135
51155,2010,68,76,-18,1,-8,-17,NA,NA,NA,NA,NA,NA
51155,2011,283,408,36,1,-125,37,8.1362754259,11.730036656,1.0350032344,0.0287500898,-3.593761231,1.0637533242
51155,2012,326,428,102,2,-102,104,9.3849409123,12.321333468,2.9363925554,0.0575763246,-2.936392555,2.99396888
51155,2013,352,479,-63,1,-127,-62,10.161516144,13.827744981,-1.818680446,0.0288679436,-3.666228836,-1.789812503
51155,2014,348,447,-99,1,-99,-98,10.103796182,12.978151992,-2.87435581,0.0290338971,-2.87435581,-2.845321913
51155,2015,303,401,100,1,-98,101,8.8234009406,11.677174182,2.9120135117,0.0291201351,-2.853773242,2.9411336469
51155,2016,315,420,5,1,-105,6,9.186351706,12.248468941,0.1458151064,0.0291630213,-3.062117235,0.1749781277
51155,2017,297,420,66,1,-123,67,8.6811645037,12.276394248,1.9291476675,0.0292295101,-3.595229744,1.9583771776
40127,2010,27,20,6,0,7,6,NA,NA,NA,NA,NA,NA
40127,2011,119,189,-124,6,-70,-118,10.3541286,16.444792482,-10.78917602,0.5220569042,-6.090663882,-10.26711912
40127,2012,117,153,-141,7,-36,-134,10.339342524,13.520678685,-12.4602333,0.6185931425,-3.181336161,-11.84164016
40127,2013,124,163,-11,5,-39,-6,11.063526053,14.54318344,-0.981441827,0.4461099215,-3.479657388,-0.535331906
40127,2014,151,183,-60,7,-32,-53,13.553540975,16.425814559,-5.38551297,0.6283098465,-2.872273584,-4.757203124
40127,2015,158,178,54,8,-20,62,14.208633094,16.007194245,4.8561151079,0.7194244604,-1.798561151,5.5755395683
40127,2016,158,155,-88,8,3,-80,14.230388183,13.960190939,-7.925785824,0.720525984,0.270197244,-7.20525984
40127,2017,154,150,97,8,4,105,13.850789225,13.491028466,8.7241984081,0.7195215182,0.3597607591,9.4437199262
12107,2010,214,263,-116,10,-49,-106,NA,NA,NA,NA,NA,NA
12107,2011,903,967,-514,6,-64,-508,12.215991721,13.081798443,-6.953510237,0.0811693802,-0.865806722,-6.872340857
12107,2012,825,874,-683,9,-49,-674,11.259109643,11.927832519,-9.321178044,0.1228266507,-0.668722876,-9.198351393
12107,2013,797,947,-406,15,-150,-391,10.971991823,13.03698401,-5.589245521,0.2064992187,-2.064992187,-5.382746302
12107,2014,826,948,-264,19,-122,-245,11.444485241,13.13483294,-3.657801578,0.2632508712,-1.690347699,-3.394550707
12107,2015,836,977,99,26,-141,125,11.615951091,13.575100736,1.3755731555,0.3612616368,-1.959149646,1.7368347923
12107,2016,850,985,555,28,-135,583,11.776033693,13.646344927,7.6890572939,0.387916404,-1.870311234,8.0769736979
12107,2017,825,941,1148,28,-116,1176,11.311596786,12.902075849,15.740258316,0.3839087394,-1.590479063,16.124167055
13237,2010,47,73,4,4,-26,8,NA,NA,NA,NA,NA,NA
13237,2011,266,217,5,29,49,34,12.525604502,10.218256304,0.2354436936,1.3655734231,2.3073481977,1.6010171168
13237,2012,259,210,-156,6,49,-150,12.202016395,9.8935268067,-7.349477056,0.2826721945,2.3084895882,-7.066804862
13237,2013,234,244,156,1,-10,157,11.011505612,11.482082775,7.3410037411,0.0470577163,-0.470577163,7.3880614574
13237,2014,232,227,-148,7,5,-141,10.913795131,10.678584029,-6.962248618,0.3292955427,0.235211102,-6.632953075
13237,2015,231,238,162,10,-7,172,10.858835143,11.187890754,7.6152869835,0.4700794434,-0.32905561,8.0853664269
13237,2016,222,256,215,12,-34,227,10.348685437,11.933619243,10.022375536,0.559388402,-1.584933806,10.581763938
13237,2017,231,256,195,12,-25,207,10.675169832,11.830491243,9.0115070012,0.554554277,-1.15532141,9.5660612782
17155,2010,13,5,-2,1,8,-1,NA,NA,NA,NA,NA,NA
17155,2011,49,53,-34,1,-4,-33,8.1755234838,8.8429131559,-5.672812213,0.166847418,-0.667389672,-5.505964795
17155,2012,56,55,-69,1,1,-68,9.4244362168,9.2561427129,-11.61225177,0.1682935039,0.1682935039,-11.44395826
17155,2013,52,59,-53,2,-7,-51,8.8427854774,10.033160446,-9.012839044,0.3401071337,-1.190374968,-8.672731911
17155,2014,41,52,-12,2,-11,-10,7.0193460024,8.9025851738,-2.054442732,0.3424071221,-1.883239171,-1.71203561
17155,2015,62,61,-108,2,1,-106,10.729428052,10.556372761,-18.68997145,0.3461105823,0.1730552912,-18.34386086
17155,2016,43,48,-6,2,-5,-4,7.5148549458,8.3886752884,-1.048584411,0.349528137,-0.873820343,-0.699056274
17155,2017,53,57,12,2,-4,14,9.2624956309,9.9615519049,2.0971688221,0.349528137,-0.699056274,2.4466969591
18133,2010,72,66,-52,7,6,-45,NA,NA,NA,NA,NA,NA
18133,2011,360,333,-61,26,27,-35,9.4973025023,8.7850048146,-1.609265146,0.6859162918,0.7122976877,-0.923348854
18133,2012,334,329,-246,38,5,-208,8.8355113486,8.7032432146,-6.507592191,1.0052378181,0.132268134,-5.502354373
18133,2013,376,368,-160,30,8,-130,9.9887095703,9.7761838348,-4.250514711,0.7969715083,0.2125257355,-3.453543202
18133,2014,360,370,60,39,-10,99,9.5684877802,9.8342791075,1.5947479634,1.0365861762,-0.265791327,2.6313341396
18133,2015,350,341,-220,43,9,-177,9.3127211771,9.073251204,-5.853710454,1.144134316,0.2394699731,-4.709576138
18133,2016,356,352,-282,44,4,-238,9.5231726075,9.4161706681,-7.543636728,1.1770213335,0.1070019394,-6.366615395
18133,2017,364,340,372,44,24,416,9.71093948,9.0706577561,9.9243667214,1.1738498273,0.640281724,11.098216549
29171,2010,16,12,-9,0,4,-9,NA,NA,NA,NA,NA,NA
29171,2011,51,54,7,-2,-3,5,10.252286662,10.855362348,1.4071766007,-0.40205045700000003,-0.603075686,1.0051261433
29171,2012,54,70,-13,-1,-16,-14,10.888194374,14.114326041,-2.621231979,-0.201633229,-3.226131666,-2.822865208
29171,2013,50,70,-40,-1,-20,-41,10.176045589,14.246463824,-8.140836471,-0.203520912,-4.070418235,-8.344357383
29171,2014,56,60,-36,0,-4,-36,11.515525396,12.338062924,-7.402837754,0,-0.822537528,-7.402837754
29171,2015,66,59,12,0,7,12,13.602638087,12.159934048,2.473206925,0,1.4427040396,2.473206925
29171,2016,62,66,-26,0,-4,-26,12.794056954,13.619479983,-5.36524969,0,-0.825423029,-5.36524969
29171,2017,67,64,-22,0,3,-22,13.897531632,13.275254097,-4.563368596,0,0.6222775358,-4.563368596
36079,2010,248,187,-76,38,61,-38,NA,NA,NA,NA,NA,NA
36079,2011,909,674,-190,149,235,-41,9.1114574824,6.7559101684,-1.904485062,1.4935172331,2.3555473139,-0.410967829
36079,2012,837,626,-517,165,211,-352,8.3875299376,6.2731108016,-5.18082793,1.6534557225,2.114419136,-3.527372208
36079,2013,821,705,-271,182,116,-89,8.2316492375,7.0685903927,-2.717146094,1.824799222,1.1630588448,-0.892346872
36079,2014,793,644,-421,189,149,-232,7.953143648,6.4587950937,-4.222286855,1.8955159514,1.4943485543,-2.326770903
36079,2015,858,730,-527,207,128,-320,8.6170533293,7.3315255599,-5.292758863,2.0789394396,1.2855277694,-3.213819424
36079,2016,804,727,-652,207,77,-445,8.0974921946,7.3219861013,-6.566623023,2.0848020949,0.7755060933,-4.481820929
36079,2017,819,739,-68,208,80,140,8.2548001814,7.4484704934,-0.685380235,2.0964571889,0.8063296881,1.4110769541
39137,2010,119,59,-90,3,60,-87,NA,NA,NA,NA,NA,NA
39137,2011,475,309,-279,10,166,-269,13.798111837,8.9760348584,-8.104575163,0.290486565,4.8220769789,-7.814088598
39137,2012,433,282,-348,9,151,-339,12.630166555,8.2256511974,-10.15080361,0.2625207829,4.4045153575,-9.888282822
39137,2013,439,328,-212,6,111,-206,12.856745398,9.6059510038,-6.208724429,0.1757186159,3.2507943946,-6.033005813
39137,2014,472,292,-114,12,180,-102,13.825222243,8.5528917268,-3.33914266,0.3514887011,5.2723305165,-2.987653959
39137,2015,458,301,-342,14,157,-328,13.432660723,8.8280150164,-10.03050211,0.4106053496,4.6046457062,-9.619896762
39137,2016,427,279,-159,16,148,-143,12.553838917,8.2026254281,-4.674614491,0.4704014582,4.3512134888,-4.204213033
39137,2017,423,303,-274,16,120,-258,12.460600348,8.9256782632,-8.071405426,0.4713229446,3.5349220844,-7.600082482
47141,2010,231,148,109,26,83,135,NA,NA,NA,NA,NA,NA
47141,2011,908,648,46,148,260,194,12.473812549,8.9020160044,0.6319332349,2.0331764948,3.571796545,2.6651097297
47141,2012,867,768,163,204,99,367,11.83714707,10.485500519,2.2254382612,2.7852110753,1.3516465513,5.0106493365
47141,2013,867,764,183,266,103,449,11.756968411,10.360235139,2.4815746473,3.6070975747,1.3967332714,6.088672222
47141,2014,925,773,422,327,152,749,12.422110013,10.380855178,5.6671680275,4.3913837559,2.0412548346,10.058551783
47141,2015,857,856,-167,361,1,194,11.425828773,11.412496417,-2.22650339,4.8129803814,0.0133323556,2.5864769917
47141,2016,909,854,603,366,55,969,12.022139782,11.294727584,7.9750828258,4.8405975361,0.727412198,12.815680362
47141,2017,906,771,1046,367,135,1413,11.781764274,10.026203372,13.60234595,4.7725248217,1.7555609017,18.374870771
54079,2010,117,87,96,8,30,104,NA,NA,NA,NA,NA,NA
54079,2011,606,528,308,7,78,315,10.852921424,9.4560107455,5.5160062682,0.1253637788,1.3969106783,5.641370047
54079,2012,608,528,315,20,80,335,10.811003041,9.3885026405,5.6010953253,0.3556251,1.4225004001,5.9567204253
54079,2013,596,579,21,20,17,41,10.55408971,10.253050238,0.3718722884,0.3541640842,0.3010394716,0.7260363727
54079,2014,634,563,59,14,71,73,11.208245309,9.9530632629,1.0430386013,0.247500685,1.2551820456,1.2905392863
54079,2015,635,592,-80,16,43,-64,11.215118333,10.455669375,-1.412928294,0.2825856588,0.759448958,-1.130342635
54079,2016,580,574,67,14,6,81,10.238486116,10.132570743,1.1827216721,0.2471358718,0.1059153736,1.4298575438
54079,2017,584,590,96,14,-6,110,10.292199781,10.39794156,1.6918684572,0.2467308167,-0.105741779,1.9385992739
35037,2010,30,43,37,0,-13,37,NA,NA,NA,NA,NA,NA
35037,2011,123,130,-10,-4,-7,-14,13.583655439,14.356709001,-1.104362231,-0.441744892,-0.773053562,-1.546107123
35037,2012,117,114,-245,-1,3,-246,13.108509327,12.772393703,-27.44944261,-0.112038541,0.3361156238,-27.56148115
35037,2013,95,130,-104,0,-35,-104,10.872053101,14.877546349,-11.90203708,0,-4.005493248,-11.90203708
35037,2014,87,116,-193,7,-29,-186,10.159990657,13.54665421,-22.53882985,0.8174705127,-3.386663552,-21.72135934
35037,2015,82,112,-13,10,-30,-3,9.7156398104,13.27014218,-1.54028436,1.1848341232,-3.55450237,-0.355450237
35037,2016,86,97,-42,11,-11,-31,10.235658177,11.544870269,-4.998809807,1.3092120924,-1.309212092,-3.689597715
35037,2017,87,97,-76,11,-10,-65,10.42727872,11.625816504,-9.108887158,1.3183915623,-1.198537784,-7.790495595
24035,2010,115,123,32,2,-8,34,NA,NA,NA,NA,NA,NA
24035,2011,484,346,320,5,138,325,10.075042413,7.2024063531,6.6611850665,0.1040810167,2.8726360599,6.7652660831
24035,2012,448,421,200,21,27,221,9.2579198611,8.6999648695,4.132999938,0.4339649935,0.5579549916,4.5669649315
24035,2013,437,410,-52,63,27,11,9.00501767,8.4486435806,-1.071535283,1.2982062087,0.5563740895,0.2266709253
24035,2014,477,400,138,70,77,208,9.7979808354,8.2163361303,2.834635965,1.4378588228,1.5816447051,4.2724947878
24035,2015,438,417,128,74,21,202,8.9514719858,8.5222918221,2.6159552835,1.5123491483,0.4291801637,4.1283044318
24035,2016,457,373,-20,76,84,56,9.3059246363,7.5954264537,-0.407261472,1.5475935938,1.7104981826,1.1403321217
24035,2017,465,386,439,76,79,515,9.3988761774,7.8020778591,8.8733476169,1.5361604075,1.5967983183,10.409508024
36081,2010,7600,3337,-4565,5471,4263,906,NA,NA,NA,NA,NA,NA
36081,2011,30798,13890,-16083,25417,16908,9334,13.694765214,6.1763844673,-7.151532857,11.302027646,7.5183807468,4.1504947889
36081,2012,30122,13822,-19278,25321,16300,6043,13.250848029,6.0803805011,-8.480507546,11.138859403,7.1704675277,2.658351857
36081,2013,30885,14458,-18252,25230,16427,6978,13.451130716,6.2967928733,-7.949167487,10.988247627,7.1543378427,3.0390801404
36081,2014,30296,14023,-22560,26486,16273,3926,13.070536286,6.0499118809,-9.733010913,11.426796411,7.0206244054,1.6937854984
36081,2015,30539,14635,-26755,28744,15904,1989,13.067582882,6.2622900384,-11.44841612,12.299505628,6.8052928439,0.8510895037
36081,2016,30068,15069,-34397,29397,14999,-5000,12.789318019,6.4095461362,-14.63064294,12.503910529,6.3797718824,-2.12673241
36081,2017,29706,15638,-40874,29248,14068,-11626,12.601635846,6.6338241888,-17.33923327,12.407346839,5.9678116567,-4.931886432
13239,2010,8,13,7,0,-5,7,NA,NA,NA,NA,NA,NA
13239,2011,27,20,-63,-2,7,-65,10.860820595,8.0450522928,-25.34191472,-0.804505229,2.8157683025,-26.14641995
13239,2012,27,41,-33,-1,-14,-34,11.095130471,16.848161085,-13.56071502,-0.410930758,-5.753030614,-13.97164578
13239,2013,24,24,-39,-1,0,-40,10.03974064,10.03974064,-16.31457854,-0.418322527,0,-16.73290107
13239,2014,19,36,-63,-1,-17,-64,8.1527569191,15.447328899,-27.03282557,-0.429092469,-7.29457198,-27.46191804
13239,2015,20,26,-2,-1,-6,-3,8.7508203894,11.376066506,-0.875082039,-0.437541019,-2.625246117,-1.312623058
13239,2016,29,19,43,-1,10,42,12.570437798,8.2358040746,18.638925011,-0.433463372,4.3346337235,18.205461638
13239,2017,28,16,13,-1,12,12,11.937753144,6.8215732253,5.5425282456,-0.426348327,5.116179919,5.116179919
28119,2010,18,43,-40,0,-25,-40,NA,NA,NA,NA,NA,NA
28119,2011,103,119,-92,1,-16,-91,12.706637059,14.680483592,-11.34961757,0.1233654083,-1.973846533,-11.22625216
28119,2012,117,109,-270,3,8,-267,14.760613133,13.75134044,-34.06295338,0.3784772598,1.0092726929,-33.68447612
28119,2013,106,107,11,5,-1,16,13.577558601,13.705648777,1.4089919303,0.6404508774,-0.128090175,2.0494428077
28119,2014,88,86,-140,6,2,-134,11.355571327,11.097490161,-18.06568166,0.7742434996,0.2580811665,-17.29143816
28119,2015,107,86,-204,6,21,-198,14.081726657,11.318023294,-26.84740409,0.7896295321,2.7637033625,-26.05777456
28119,2016,89,69,-135,6,20,-129,11.933494234,9.2518101368,-18.10136766,0.8045052293,2.6816840976,-17.29686243
28119,2017,89,89,-142,6,0,-136,12.131125196,12.131125196,-19.3552784,0.8178286649,0,-18.53744974
13241,2010,44,33,-5,3,11,-2,NA,NA,NA,NA,NA,NA
13241,2011,137,169,11,10,-32,21,8.4173015483,10.383386581,0.6758417302,0.6144015729,-1.966085033,1.290243303
13241,2012,157,177,61,13,-20,74,9.6342660776,10.861561119,3.7432498773,0.7977417771,-1.227295042,4.5409916544
13241,2013,129,204,-52,9,-75,-43,7.9323597233,12.544196772,-3.197540354,0.5534204458,-4.611837048,-2.644119908
13241,2014,151,206,27,14,-55,41,9.324441151,12.720760776,1.6672841793,0.8645177226,-3.396319625,2.5318019019
13241,2015,148,212,118,15,-64,133,9.1253815088,13.071492431,7.2756420137,0.9248697475,-3.946110923,8.2005117613
13241,2016,168,220,314,15,-52,329,10.250152532,13.422818792,19.158023185,0.9151921904,-3.17266626,20.073215375
13241,2017,157,217,119,15,-60,134,9.4778146695,13.099909448,7.18382131,0.9055236945,-3.622094778,8.0893450045
55101,2010,605,456,-190,30,149,-160,NA,NA,NA,NA,NA,NA
55101,2011,2497,1642,-1445,97,855,-1348,12.794072814,8.4132429157,-7.403858717,0.4970064329,4.3808298983,-6.906852284
55101,2012,2426,1702,-1114,100,724,-1014,12.45456599,8.7377045814,-5.719038134,0.5133786476,3.7168614083,-5.205659486
55101,2013,2354,1751,-564,79,603,-485,12.090457578,8.993369252,-2.896779131,0.40575452360000003,3.0970883261,-2.491024607
55101,2014,2385,1663,-647,94,722,-553,12.241409841,8.5356245557,-3.32083529,0.4824706604,3.7057852852,-2.83836463
55101,2015,2381,1838,-789,111,543,-678,12.220565554,9.4335991131,-4.049570022,0.5697113719,2.7869664409,-3.47985865
55101,2016,2407,1783,-491,114,624,-377,12.35077853,9.1489148812,-2.519415147,0.5849558589,3.2018636488,-1.934459288
55101,2017,2387,1686,260,112,701,372,12.207189815,8.6222547247,1.3296478223,0.5727713696,3.5849350902,1.9024191919
51750,2010,27,2,-5,21,25,16,NA,NA,NA,NA,NA,NA
51750,2011,131,92,278,59,39,337,7.8775669744,5.5323371118,16.717279533,3.5479118434,2.3452298626,20.265191377
51750,2012,125,104,-188,56,21,-132,7.4537865236,6.2015503876,-11.21049493,3.3392963626,1.252236136,-7.871198569
51750,2013,129,106,339,39,23,378,7.6241134752,6.2647754137,20.035460993,2.304964539,1.3593380615,22.340425532
51750,2014,140,107,195,33,33,228,8.1128849999,6.200562107,11.300089821,1.9123228928,1.9123228928,13.212412714
51750,2015,135,124,-117,36,11,-81,7.7791863547,7.1453267258,-6.741961507,2.0744496946,0.6338596289,-4.667511813
51750,2016,130,93,17,37,37,54,7.4865386277,5.3557545567,0.9790088975,2.1307840709,2.1307840709,3.1097929684
51750,2017,132,67,144,37,65,181,7.5282308657,3.8211474849,8.2126154899,2.1101859245,3.7070833809,10.322801414
48379,2010,23,40,12,1,-17,13,NA,NA,NA,NA,NA,NA
48379,2011,102,113,94,6,-11,100,9.3103920405,10.314453927,8.5801652138,0.54767012,-1.004061887,9.1278353339
48379,2012,98,115,-60,9,-17,-51,8.9363060229,10.486481557,-5.471207769,0.8206811654,-1.550175535,-4.650526604
48379,2013,116,134,99,11,-18,110,10.565144132,12.204563049,9.0168040439,1.001867116,-1.639418917,10.01867116
48379,2014,79,145,34,11,-66,45,7.1717125868,13.163269938,3.0865598475,0.9985928918,-5.991557351,4.0851527393
48379,2015,102,149,157,12,-47,169,9.2165898618,13.463449896,14.186319689,1.0843046896,-4.246860034,15.270624379
48379,2016,84,151,231,13,-67,244,7.4879657693,13.460509895,20.591905866,1.1588518452,-5.972544126,21.750757711
48379,2017,100,127,468,13,-27,481,8.6696432442,11.01044692,40.573930383,1.1270536217,-2.340803676,41.700984005
54081,2010,233,239,52,19,-6,71,NA,NA,NA,NA,NA,NA
54081,2011,983,987,308,47,-4,355,12.427542874,12.478112733,3.8938791507,0.5941958444,-0.050569859,4.4880749951
54081,2012,989,1007,-129,46,-18,-83,12.484457545,12.711677197,-1.628407506,0.5806724439,-0.227219652,-1.047735062
54081,2013,957,1067,-364,41,-110,-323,12.122210118,13.515567603,-4.610746586,0.5193423353,-1.393357485,-4.091404251
54081,2014,911,933,-616,49,-22,-567,11.614934945,11.895427337,-7.853786966,0.6247330541,-0.280492392,-7.229053912
54081,2015,843,1029,-668,51,-186,-617,10.844256918,13.236939939,-8.593076656,0.6560582477,-2.392683021,-7.937018408
54081,2016,806,1074,-858,50,-268,-808,10.495201635,13.984921286,-11.17231142,0.651067099,-3.489719651,-10.52124432
54081,2017,779,1055,-1012,50,-276,-962,10.298715635,13.947554551,-13.37907602,0.6610215427,-3.648838916,-12.71805448
29173,2010,35,31,16,0,4,16,NA,NA,NA,NA,NA,NA
29173,2011,101,84,62,0,17,62,9.8772676153,8.2147572246,6.0632731896,0,1.6625103907,6.0632731896
29173,2012,90,74,-63,0,16,-63,8.7869172565,7.2247986331,-6.15084208,0,1.5621186234,-6.15084208
29173,2013,98,123,-37,0,-25,-37,9.6191597958,12.073027091,-3.631723596,0,-2.453867295,-3.631723596
29173,2014,97,87,102,0,10,102,9.4981640147,8.5189718482,9.9877600979,0,0.9791921665,9.9877600979
29173,2015,91,106,-92,0,-15,-92,8.908904009,10.37740467,-9.006804053,0,-1.468500661,-9.006804053
29173,2016,96,99,70,0,-3,70,9.416842415,9.7111187405,6.8664475943,0,-0.294276325,6.8664475943
29173,2017,92,89,-7,0,3,-7,8.9966751418,8.7033053002,-0.68452963,0,0.2933698416,-0.68452963
27123,2010,1843,915,-901,667,928,-234,NA,NA,NA,NA,NA,NA
27123,2011,7477,3919,-103,3128,3558,3025,14.586038019,7.6451361503,-0.200931111,6.1020632504,6.9409018686,5.9011321395
27123,2012,7522,3801,-1261,3079,3721,1818,14.504029486,7.3291433232,-2.431478487,5.9369724526,7.174886163,3.5054939652
27123,2013,7830,4034,-315,3011,3796,2696,14.926710424,7.6902107087,-0.600499845,5.7400159752,7.236499715,5.1395161306
27123,2014,8014,3964,-1900,3524,4050,1624,15.104552947,7.4712313302,-3.581064462,6.6419321916,7.6333216163,3.0608677296
27123,2015,7788,4244,-3149,3827,3544,678,14.544653187,7.9259769037,-5.880985219,7.1471992485,6.6186762834,1.2662140294
27123,2016,7767,4082,-2299,3889,3685,1590,14.378620341,7.5567823139,-4.256012381,7.1994920184,6.8218380272,2.9434796372
27123,2017,7744,4077,-2339,3859,3667,1520,14.198935447,7.4753434679,-4.288650569,7.0756317004,6.7235919786,2.786981131
38071,2010,39,50,10,0,-11,10,NA,NA,NA,NA,NA,NA
38071,2011,187,133,12,9,54,21,16.280689535,11.579313947,1.0447501306,0.7835625979,4.7013755877,1.8283127285
38071,2012,150,148,49,10,2,59,12.984202554,12.811079853,4.2415061675,0.8656135036,0.1731227007,5.1071196711
38071,2013,149,107,-59,10,42,-49,12.86701209,9.2400690846,-5.094991364,0.8635578584,3.6269430052,-4.231433506
38071,2014,159,140,21,0,19,21,13.711624698,12.073128665,1.8109692998,0,1.6384960331,1.8109692998
38071,2015,173,158,17,0,15,17,14.874682946,13.584970552,1.4616740467,0,1.2897123941,1.4616740467
38071,2016,146,112,-164,-1,34,-165,12.607944732,9.6718480138,-14.16234888,-0.086355786,2.9360967185,-14.24870466
38071,2017,145,119,-21,0,26,-21,12.590630834,10.333000478,-1.823470673,0,2.2576303564,-1.823470673
48381,2010,381,263,297,34,118,331,NA,NA,NA,NA,NA,NA
48381,2011,1647,912,1368,137,735,1505,13.465893761,7.4565240497,11.184786075,1.1201138101,6.0093697111,12.304899885
48381,2012,1566,935,758,159,631,917,12.607528288,7.5274833651,6.1024945355,1.2800747113,5.0800449234,7.3825692468
48381,2013,1650,1038,987,151,612,1138,13.109179604,8.2468657143,7.8416728902,1.1996885577,4.8623138894,9.0413614479
48381,2014,1729,981,1040,171,748,1211,13.536683708,7.6804434458,8.1423661403,1.3387928942,5.8562402624,9.4811590345
48381,2015,1756,1066,828,185,690,1013,13.553879759,8.2280386239,6.3910093627,1.4279429132,5.3258411356,7.8189522758
48381,2016,1654,1052,1260,190,602,1450,12.584502193,8.0041694723,9.5867429041,1.4456199617,4.5803327208,11.032362866
48381,2017,1689,1069,1179,189,620,1368,12.656473048,8.0105208337,8.8348026782,1.4162660782,4.6459522141,10.251068756
01111,2010,42,49,30,0,-7,30,NA,NA,NA,NA,NA,NA
01111,2011,221,300,-109,-8,-79,-117,9.6770662288,13.136288998,-4.772851669,-0.35030104,-3.45922277,-5.123152709
01111,2012,241,255,-186,-8,-14,-194,10.646757378,11.265241209,-8.21699947,-0.353419332,-0.618483831,-8.570418802
01111,2013,268,281,35,-7,-13,28,11.89050091,12.467278939,1.5528639248,-0.310572785,-0.576778029,1.2422911398
01111,2014,255,293,-150,-8,-38,-158,11.3595866,13.052387741,-6.682109765,-0.356379187,-1.69280114,-7.038488952
01111,2015,274,302,272,-7,-28,265,12.194579198,13.440740576,12.105567671,-0.311540344,-1.246161378,11.794027327
01111,2016,235,300,-18,-8,-65,-26,10.424522025,13.307900457,-0.798474027,-0.354877346,-2.883378432,-1.153351373
01111,2017,232,280,230,-8,-48,222,10.272759476,12.398157988,10.184201204,-0.354233085,-2.125398512,9.829968119
05121,2010,55,77,6,2,-22,8,NA,NA,NA,NA,NA,NA
05121,2011,224,230,27,-3,-6,24,12.470771629,12.804810155,1.503173366,-0.167019263,-0.334038526,1.3361541031
05121,2012,215,237,-100,-9,-22,-109,12.008154375,13.236895752,-5.585188081,-0.502666927,-1.228741378,-6.087855009
05121,2013,199,229,-173,-12,-30,-185,11.222648319,12.91450485,-9.75637266,-0.676742612,-1.691856531,-10.43311527
05121,2014,194,233,-9,-13,-39,-22,11.027113056,13.243903825,-0.511567101,-0.738930256,-2.216790769,-1.250497357
05121,2015,191,240,-82,-12,-49,-94,10.921150437,13.722911544,-4.688661444,-0.686145577,-2.801761107,-5.374807022
05121,2016,207,255,52,-13,-48,39,11.888011486,14.644651831,2.9863603733,-0.746590093,-2.756640345,2.23977028
05121,2017,193,255,226,-13,-62,213,11.03961104,14.586014586,12.927212927,-0.743600744,-3.546403546,12.183612184
13243,2010,18,41,-32,0,-23,-32,NA,NA,NA,NA,NA,NA
13243,2011,103,85,-123,1,18,-122,13.525935653,11.162179908,-16.15233093,0.1313197636,2.3637557452,-16.02101116
13243,2012,81,96,-251,-1,-15,-252,10.895883777,12.913640032,-33.763788,-0.134517084,-2.017756255,-33.89830508
13243,2013,95,88,-115,0,7,-115,13.101641153,12.136257068,-15.8598814,0,0.965384085,-15.8598814
13243,2014,81,91,120,0,-10,120,11.16471399,12.543073742,16.540317023,0,-1.378359752,16.540317023
13243,2015,80,90,-83,0,-10,-83,11.009426822,12.385605174,-11.42228033,0,-1.376178353,-11.42228033
13243,2016,70,78,13,0,-8,13,9.6912640177,10.798837048,1.7998061747,0,-1.107573031,1.7998061747
13243,2017,76,74,-151,0,2,-151,10.629370629,10.34965035,-21.11888112,0,0.2797202797,-21.11888112
17157,2010,82,56,-42,0,26,-42,NA,NA,NA,NA,NA,NA
17157,2011,345,358,-37,6,-13,-31,10.318219883,10.707022371,-1.106591698,0.1794473023,-0.388802488,-0.927144395
17157,2012,344,380,-320,6,-36,-314,10.348821468,11.431837668,-9.626810668,0.1805027,-1.0830162,-9.446307968
17157,2013,374,379,111,0,-5,111,11.292270531,11.443236715,3.3514492754,0,-0.150966184,3.3514492754
17157,2014,345,335,-47,1,10,-46,10.406611969,10.104971042,-1.417712355,0.0301640927,0.3016409266,-1.387548263
17157,2015,311,403,-219,1,-92,-218,9.4308154168,12.220638627,-6.640992207,0.0303241653,-2.78982321,-6.610668041
17157,2016,320,383,-163,1,-63,-162,9.7830905394,11.709136489,-4.983261744,0.0305721579,-1.92604595,-4.952689586
17157,2017,311,383,-103,1,-72,-102,9.5662872962,11.780990464,-3.168255921,0.0307597662,-2.2147031680000002,-3.137496155
18135,2010,88,42,-44,0,46,-44,NA,NA,NA,NA,NA,NA
18135,2011,289,278,-160,-6,11,-166,11.074494175,10.652973636,-6.131207848,-0.229920294,0.4215205395,-6.361128142
18135,2012,326,319,-177,-5,7,-182,12.570128593,12.300217857,-6.82488577,-0.192793383,0.2699107367,-7.017679153
18135,2013,301,294,-247,0,7,-247,11.698861207,11.426794667,-9.600062187,0,0.2720665397,-9.600062187
18135,2014,299,323,-275,-3,-24,-278,11.743220156,12.685819767,-10.80062054,-0.117824951,-0.942599611,-10.9184455
18135,2015,307,281,-228,0,26,-228,12.176741234,11.145486276,-9.043312708,0,1.031254958,-9.043312708
18135,2016,285,271,-65,0,14,-65,11.361371337,10.803268886,-2.591189954,0,0.5581024517,-2.591189954
18135,2017,289,266,-160,0,23,-160,11.56439447,10.644044737,-6.402432925,0,0.9203497329,-6.402432925
29175,2010,85,44,1,0,41,1,NA,NA,NA,NA,NA,NA
29175,2011,281,245,-219,0,36,-219,11.078475823,9.6591693114,-8.634114609,0,1.4193065111,-8.634114609
29175,2012,271,271,50,3,0,53,10.711462451,10.711462451,1.976284585,0.1185770751,0,2.0948616601
29175,2013,281,305,-369,5,-24,-364,11.179852394,12.134715232,-14.68101613,0.1989297579,-0.954862838,-14.48208638
29175,2014,290,276,88,3,14,91,11.601856297,11.041766683,3.5205632901,0.1200192031,0.5600896143,3.6405824932
29175,2015,263,303,24,3,-40,27,10.503614362,12.101122249,0.9585047326,0.1198130916,-1.597507888,1.0783178242
29175,2016,291,268,-87,3,23,-84,11.64,10.72,-3.48,0.12,0.92,-3.36
29175,2017,277,249,-54,3,28,-51,11.098868076,9.9769608334,-2.163678253,0.1202043474,1.1219072423,-2.043473906
37151,2010,399,313,86,12,86,98,NA,NA,NA,NA,NA,NA
37151,2011,1609,1291,-463,61,318,-402,11.336694181,9.0961293891,-3.26220597,0.4297938751,2.2405647914,-2.832412095
37151,2012,1611,1314,123,42,297,165,11.336647772,9.2466512556,0.865554113,0.295555063,2.0899965167,1.1611091759
37151,2013,1621,1446,-159,52,175,-107,11.387385362,10.158025437,-1.116961303,0.3652955206,1.229359925,-0.751665783
37151,2014,1546,1367,-5,62,179,57,10.850607627,9.5942953597,-0.035092521,0.4351472658,1.2563122673,0.4000547443
37151,2015,1619,1479,-101,81,140,-20,11.350650261,10.369123988,-0.708101097,0.5678830582,0.9815262734,-0.140218039
37151,2016,1579,1506,372,83,73,455,11.046052033,10.53537325,2.6023631136,0.5806347807,0.510678783,3.1829978943
37151,2017,1570,1507,-68,85,63,17,10.960204684,10.520400292,-0.474709502,0.5933868778,0.4398043918,0.1186773756
54083,2010,61,86,-16,0,-25,-16,NA,NA,NA,NA,NA,NA
54083,2011,307,358,107,7,-51,114,10.444486026,12.179563509,3.6402606018,0.2381478898,-1.735077483,3.8784084917
54083,2012,312,367,21,5,-55,26,10.609718774,12.480021764,0.7141156867,0.1700275445,-1.870302989,0.8841432312
54083,2013,327,355,158,12,-28,170,11.099419572,12.049828587,5.3630223007,0.4073181494,-0.950409015,5.7703404501
54083,2014,317,351,-189,7,-34,-182,10.773518216,11.92903752,-6.423327896,0.2379010332,-1.155519304,-6.185426862
54083,2015,312,371,-99,10,-59,-89,10.67013218,12.687881534,-3.385715019,0.341991416,-2.017749354,-3.043723603
54083,2016,283,386,-109,10,-103,-99,9.7372993617,13.28126344,-3.750408588,0.3440741824,-3.543964079,-3.406334406
54083,2017,280,374,-92,11,-94,-81,9.6974734618,12.953053838,-3.186312709,0.3809721717,-3.255580376,-2.805340537
28121,2010,447,207,192,24,240,216,NA,NA,NA,NA,NA,NA
28121,2011,1993,1054,639,55,939,694,13.904634995,7.3534798215,4.458134351,0.383720484,6.5511551731,4.8418548351
28121,2012,1944,1070,691,83,874,774,13.410087228,7.3810665296,4.7666513757,0.5725500205,6.029020698,5.3392013962
28121,2013,1875,1020,609,44,855,653,12.79535955,6.960675595,4.1559327817,0.3002644374,5.8346839546,4.4561972191
28121,2014,1904,1021,145,110,883,255,12.878047461,6.9057176772,0.9807336564,0.7440048428,5.9723297835,1.7247384992
28121,2015,1834,1115,147,127,719,274,12.317818524,7.488750084,0.9873060649,0.8529787091,4.8290684398,1.840284774
28121,2016,1822,1174,930,122,648,1052,12.128554692,7.8149962722,6.190755139,0.8121205666,4.3135584194,7.0028757056
28121,2017,1801,1155,244,121,646,365,11.88174987,7.6198895611,1.6097429029,0.7982741445,4.2618603086,2.4080170474
38073,2010,8,5,-21,0,3,-21,NA,NA,NA,NA,NA,NA
38073,2011,63,83,12,-1,-20,11,11.590470058,15.269984362,2.2077085825,-0.183975715,-3.679514304,2.0237328673
38073,2012,74,83,50,1,-9,51,13.57424562,15.225167385,9.1717875814,0.1834357516,-1.650921765,9.355223333
38073,2013,60,70,31,2,-10,33,10.941916659,12.765569436,5.6533236072,0.3647305553,-1.823652777,6.0180541625
38073,2014,69,78,-46,1,-9,-45,12.617719667,14.263509189,-8.411813111,0.1828655024,-1.645789522,-8.228947609
38073,2015,61,82,27,2,-21,29,11.200881381,15.056922512,4.9577671686,0.3672420125,-3.856041131,5.3250091811
38073,2016,57,84,-52,2,-27,-50,10.533123903,15.522498383,-9.609165666,0.3695832948,-4.98937448,-9.239582371
38073,2017,59,82,-56,2,-23,-54,11.059044049,15.370196813,-10.49671978,0.3748828491,-4.311152765,-10.12183693
22079,2010,432,295,6,30,137,36,NA,NA,NA,NA,NA,NA
22079,2011,1801,1286,-361,90,515,-271,13.655525901,9.7506975616,-2.737170933,0.6823971855,3.9048283392,-2.054773747
22079,2012,1771,1378,-466,135,393,-331,13.41356732,10.436982364,-3.529487505,1.0224910153,2.9765849557,-2.506996489
22079,2013,1774,1497,-82,121,277,39,13.41825003,11.323066683,-0.620234782,0.9152244947,2.0951833475,0.2949897132
22079,2014,1855,1350,-692,138,505,-554,14.017932374,10.20172976,-5.229331107,1.0428434866,3.8162026139,-4.18648762
22079,2015,1881,1488,-851,155,393,-696,14.234094478,11.260144914,-6.439773738,1.1729317619,2.9739495639,-5.266841976
22079,2016,1817,1424,-446,157,393,-289,13.760460449,10.784202355,-3.377636412,1.1889886024,2.9762580938,-2.188647809
22079,2017,1756,1432,-928,156,324,-772,13.315892244,10.85897363,-7.037100229,1.1829608144,2.4569186146,-5.854139415
51157,2010,17,29,7,0,-12,7,NA,NA,NA,NA,NA,NA
51157,2011,79,67,-37,-2,12,-39,10.555147304,8.9518337898,-4.943550003,-0.267218919,1.6033135146,-5.210768922
51157,2012,54,80,-37,-4,-26,-41,7.2595281307,10.75485649,-4.974121127,-0.537742824,-3.495328359,-5.511863951
51157,2013,63,69,29,-3,-6,26,8.4968642525,9.3060894194,3.9112549734,-0.404612583,-0.809225167,3.5066423899
51157,2014,55,67,-79,-2,-12,-81,7.4550999661,9.0816672314,-10.7082345,-0.271094544,-1.626567265,-10.97932904
51157,2015,61,63,57,-1,-2,56,8.290859667,8.5626911315,7.747196738,-0.135915732,-0.271831464,7.6112810058000004
51157,2016,49,70,-30,-1,-21,-31,6.6589658218,9.5128083169,-4.07691785,-0.135897262,-2.853842495,-4.212815112
51157,2017,45,75,20,-1,-30,19,6.141667804,10.236113007,2.7296301351,-0.136481507,-4.094445203,2.5931486284
30081,2010,116,123,100,7,-7,107,NA,NA,NA,NA,NA,NA
30081,2011,377,405,57,21,-28,78,9.3467212099,10.040907401,1.4131647453,0.520639643,-0.694186191,1.9338043882
30081,2012,379,384,208,6,-5,214,9.3672763223,9.4908551656,5.1408798814,0.148294612,-0.123578843,5.2891744933
30081,2013,376,424,144,-14,-48,130,9.2603994779,10.442578135,3.5465359702,-0.344802108,-1.182178657,3.201733862
30081,2014,382,448,163,-13,-66,150,9.3896713615,11.011970602,4.0065875181,-0.31954379,-1.62229924,3.6870437283
30081,2015,395,412,437,-13,-17,424,9.6513304176,10.066704132,10.677547829,-0.317638723,-0.415373714,10.359909106
30081,2016,383,452,828,-12,-69,816,9.228137386,10.890647777,19.950124688,-0.289132242,-1.662510391,19.660992446
30081,2017,404,467,762,-12,-63,750,9.5690380038,11.061239475,18.048532076,-0.284228852,-1.492201471,17.764303225
20153,2010,6,20,-9,0,-14,-9,NA,NA,NA,NA,NA,NA
20153,2011,18,30,21,1,-12,22,7.1956825904,11.992804317,8.3949630222,0.3997601439,-4.797121727,8.7947231661
20153,2012,24,30,3,3,-6,6,9.5731950538,11.966493817,1.1966493817,1.1966493817,-2.393298763,2.3932987635
20153,2013,29,43,64,3,-14,67,11.446615354,16.972567594,25.261495954,1.1841326229,-5.52595224,26.445628577
20153,2014,23,43,-5,4,-20,-1,9.0213767405,16.866052167,-1.961168857,1.5689350853,-7.844675427,-0.392233771
20153,2015,35,39,-35,4,-4,-31,13.880626611,15.466983938,-13.88062661,1.586357327,-1.586357327,-12.29426928
20153,2016,22,31,0,6,-9,6,8.7912087912,12.387612388,0,2.3976023976,-3.596403596,2.3976023976
20153,2017,24,19,-14,6,5,-8,9.6038415366,7.6030412165,-5.602240896,2.4009603842,2.0008003201,-3.201280512
29177,2010,56,32,-23,0,24,-23,NA,NA,NA,NA,NA,NA
29177,2011,258,238,-195,-1,20,-196,11.022108299,10.167681299,-8.330663249,-0.04272135,0.8544269999,-8.373384599
29177,2012,235,244,-262,0,-9,-262,10.134333829,10.522457253,-11.2987041,0,-0.388123423,-11.2987041
29177,2013,248,246,-16,0,2,-16,10.760152725,10.6733773,-0.694203402,0,0.0867754252,-0.694203402
29177,2014,234,261,-99,-2,-27,-101,10.184762029,11.359926879,-4.308937782,-0.087049248,-1.17516485,-4.39598703
29177,2015,272,242,-169,-2,30,-171,11.908671001,10.595214641,-7.399137497,-0.087563757,1.3134563604,-7.486701254
29177,2016,247,253,-41,-2,-6,-43,10.859290849,11.12307929,-1.802554351,-0.087929481,-0.263788442,-1.890483832
29177,2017,258,277,156,-2,-19,154,11.321748289,12.155520449,6.8457082675,-0.087765491,-0.833772161,6.7579427769
48383,2010,13,2,-28,0,11,-28,NA,NA,NA,NA,NA,NA
48383,2011,44,17,9,2,27,11,13.050570962,5.0422660537,2.6694349696,0.593207771,8.0083049088,3.2626427406
48383,2012,43,25,64,2,18,66,12.525487911,7.2822604136,18.642586659,0.5825808331,5.2432274978,19.225167492
48383,2013,68,38,98,26,30,124,19.141449683,10.69669247,27.586206897,7.3187895848,8.4447572132,34.904996481
48383,2014,68,24,76,36,44,112,18.333782691,6.470746832,20.490698301,9.706120248,11.863035859,30.196818549
48383,2015,49,25,-40,37,24,-3,12.89982888,6.5815453468,-10.53047255,9.7406871133,6.318283533,-0.789785442
48383,2016,81,27,-164,39,54,-125,21.465482973,7.1551609911,-43.46097787,10.335232543,14.310321982,-33.12574533
48383,2017,70,17,-120,39,53,-81,18.796992481,4.5649838883,-32.22341568,10.472610097,14.232008593,-21.75080559
48385,2010,8,5,10,0,3,10,NA,NA,NA,NA,NA,NA
48385,2011,26,45,123,1,-19,124,7.7002813564,13.32741004,36.428254109,0.2961646676,-5.627128684,36.724418777
48385,2012,43,60,-61,1,-17,-60,12.676886792,17.688679245,-17.98349057,0.2948113208,-5.011792453,-17.68867925
48385,2013,30,69,5,1,-39,6,8.9928057554,20.683453237,1.4988009592,0.2997601918,-11.69064748,1.7985611511
48385,2014,29,51,48,1,-22,49,8.6995650217,15.299235038,14.399280036,0.2999850007,-6.599670016,14.699265037
48385,2015,42,41,-54,1,1,-53,12.641083521,12.340105342,-16.25282167,0.3009781791,0.3009781791,-15.95184349
48385,2016,35,40,104,1,-5,105,10.457125784,11.951000896,31.07260233,0.2987750224,-1.493875112,31.371377353
48385,2017,42,56,45,1,-14,46,12.305889247,16.407852329,13.184881336,0.292997363,-4.101963082,13.477878699
27125,2010,17,12,-17,0,5,-17,NA,NA,NA,NA,NA,NA
27125,2011,50,50,3,2,0,5,12.250398138,12.250398138,0.7350238883,0.4900159255,0,1.2250398138
27125,2012,61,38,-48,2,23,-46,14.978514426,9.3308778392,-11.78637201,0.4910988336,5.6476365869,-11.29527317
27125,2013,60,51,-37,0,9,-37,14.827628815,12.603484493,-9.143704436,0,2.2241443223,-9.143704436
27125,2014,47,36,-48,0,11,-48,11.709018435,8.9686098655,-11.95814649,0,2.74040857,-11.95814649
27125,2015,51,26,9,0,25,9,12.710280374,6.4797507788,2.2429906542,0,6.230529595,2.2429906542
27125,2016,44,21,-55,0,23,-55,10.965732087,5.2336448598,-13.70716511,0,5.7320872274,-13.70716511
27125,2017,43,21,11,0,22,11,10.715175679,5.2329927735,2.7410914528,0,5.4821829056,2.7410914528
48387,2010,34,23,4,0,11,4,NA,NA,NA,NA,NA,NA
48387,2011,134,192,-135,-1,-58,-136,10.48472282,15.022886429,-10.56296702,-0.0782442,-4.538163609,-10.64121122
48387,2012,126,177,95,0,-51,95,9.9161846299,13.929878409,7.4764884114,0,-4.013693779,7.4764884114
48387,2013,144,194,-186,1,-50,-185,11.417244797,15.381565907,-14.74727453,0.0792864222,-3.96432111,-14.66798811
48387,2014,155,181,-12,2,-26,-10,12.422858059,14.506692314,-0.961769656,0.1602949427,-2.083834255,-0.801474713
48387,2015,106,180,-19,1,-74,-18,8.5411546674,14.503847548,-1.530961686,0.0805769308,-5.962692881,-1.450384755
48387,2016,120,149,-118,1,-29,-117,9.7640358015,12.123677787,-9.601301871,0.081366965,-2.359641985,-9.519934906
48387,2017,115,169,67,1,-54,68,9.4084921869,13.826392866,5.481469361,0.0818129755,-4.417900679,5.5632823366
22081,2010,20,5,-6,0,15,-6,NA,NA,NA,NA,NA,NA
22081,2011,146,103,-63,1,43,-62,16.060722733,11.330509873,-6.930311864,0.1100049502,4.7302128596,-6.820306914
22081,2012,135,93,-56,7,42,-49,14.871116986,10.244547257,-6.168759639,0.7710949548,4.626569729,-5.397664684
22081,2013,131,119,-133,10,12,-123,14.524891895,13.194367447,-14.74664597,1.1087703737,1.3305244484,-13.6378756
22081,2014,116,102,-225,7,14,-218,13.08590445,11.506571155,-25.38214225,0.7896666479,1.5793332957,-24.5924756
22081,2015,122,120,-57,7,2,-50,13.958810069,13.729977117,-6.52173913,0.8009153318,0.2288329519,-5.720823799
22081,2016,107,103,-93,8,4,-85,12.335004899,11.873883221,-10.72107902,0.922243357,0.4611216785,-9.798835668
22081,2017,107,109,-102,8,-2,-94,12.463599301,12.696563774,-11.88118812,0.9318578917,-0.232964473,-10.94933023
31145,2010,29,19,-9,1,10,-8,NA,NA,NA,NA,NA,NA
31145,2011,140,126,-25,1,14,-24,12.666244459,11.399620013,-2.261829368,0.0904731747,1.2666244459,-2.171356193
31145,2012,121,112,-11,-2,9,-13,10.954191563,10.139416984,-0.995835597,-0.181061018,0.814774579,-1.176896614
31145,2013,121,114,2,6,7,8,10.950226244,10.316742081,0.1809954751,0.5429864253,0.6334841629,0.7239819005
31145,2014,126,126,-169,8,0,-161,11.478546051,11.478546051,-15.39582764,0.7287965747,0,-14.66703106
31145,2015,119,125,-15,8,-6,-7,10.926453035,11.477366633,-1.377283996,0.7345514645,-0.550913598,-0.642732531
31145,2016,138,135,-112,9,3,-103,12.738265565,12.461346749,-10.33830249,0.8307564499,0.2769188166,-9.507546038
31145,2017,127,135,-55,9,-8,-46,11.807912231,12.551717726,-5.113662777,0.8367811817,-0.743805495,-4.276881595
27127,2010,50,23,-4,0,27,-4,NA,NA,NA,NA,NA,NA
27127,2011,187,191,-58,5,-4,-53,11.650001557,11.899199452,-3.613369467,0.3114973678,-0.249197894,-3.301872099
27127,2012,185,192,-206,6,-7,-200,11.619873124,12.059543998,-12.93888575,0.37686075,-0.439670875,-12.562025
27127,2013,178,210,-105,4,-32,-101,11.299793684,13.331217267,-6.665608634,0.2539279479,-2.031423584,-6.411680686
27127,2014,200,178,-182,5,22,-177,12.813120636,11.403677366,-11.65993978,0.3203280159,1.4094432699,-11.33961176
27127,2015,182,196,-98,6,-14,-92,11.758245308,12.662725716,-6.331362858,0.3876344607,-0.904480408,-5.943728397
27127,2016,197,179,-213,6,18,-207,12.850200581,11.676070578,-13.89387169,0.3913766674,1.1741300023,-13.50249503
27127,2017,194,176,14,6,18,20,12.717975613,11.537957257,0.9177920545,0.3933394519,1.1800183558,1.3111315065
48389,2010,43,11,13,4,32,17,NA,NA,NA,NA,NA,NA
48389,2011,166,92,-145,37,74,-108,12.01592472,6.6594281578,-10.49583786,2.6782482809,5.3564965617,-7.817589577
48389,2012,153,90,51,48,63,99,11.02384898,6.4846170473,3.6746163268,3.4584624252,4.5392319331,7.1330787521
48389,2013,173,124,109,70,49,179,12.292169959,8.8105726872,7.7447776041,4.9737103879,3.4815972716,12.718487992
48389,2014,199,118,148,87,81,235,13.868562269,8.2235695867,10.314307617,6.0631402885,5.6449926824,16.377447906
48389,2015,209,104,175,113,105,288,14.210436852,7.0712221656,11.898691144,7.683154853,7.1392146864,19.581845997
48389,2016,206,107,-54,118,99,64,13.744787323,7.1392827356,-3.603002502,7.8732276897,6.6055045872000004,4.2702251877
48389,2017,207,104,-10,119,103,109,13.640856672,6.8533772652,-0.658978583,7.84184514,6.7874794069,7.1828665568
48391,2010,21,8,-22,0,13,-22,NA,NA,NA,NA,NA,NA
48391,2011,88,105,-39,0,-17,-39,11.977677964,14.29154757,-5.308289098,0,-2.313869607,-5.308289098
48391,2012,86,99,-63,8,-13,-55,11.804268753,13.58863496,-8.647313156,1.0980715119,-1.784366207,-7.549241644
48391,2013,81,95,29,7,-14,36,11.153184165,13.080895009,3.9931153184,0.9638554217,-1.927710843,4.9569707401
48391,2014,85,99,86,7,-14,93,11.622342244,13.536610378,11.759075682,0.9571340671,-1.914268134,12.716209749
48391,2015,102,107,-37,8,-5,-29,13.902139839,14.583617282,-5.042933079,1.090363909,-0.681477443,-3.95256917
48391,2016,88,72,-51,8,16,-43,12.044070348,9.8542393759,-6.980086225,1.0949154862,2.1898309724,-5.885170738
48391,2017,88,66,-99,8,22,-91,12.123717021,9.0927877661,-13.63918165,1.1021560929,3.0309292554,-12.53702556
20155,2010,199,201,44,3,-2,47,NA,NA,NA,NA,NA,NA
20155,2011,722,710,-134,3,12,-131,11.196055019,11.009971002,-2.077938189,0.0465210042,0.1860840169,-2.031417185
20155,2012,773,755,-222,-6,18,-228,12.018315104,11.738457831,-3.451573031,-0.093285758,0.2798572728,-3.544858789
20155,2013,750,764,-97,-10,-14,-107,11.691804045,11.910051054,-1.51213999,-0.155890721,-0.218247009,-1.66803071
20155,2014,730,787,-335,-8,-57,-343,11.427587448,12.319878523,-5.244166843,-0.125233835,-0.892291075,-5.369400678
20155,2015,709,743,-146,-4,-34,-150,11.150779296,11.685513423,-2.296211251,-0.062909897,-0.534734127,-2.359121149
20155,2016,680,717,-404,-6,-37,-410,10.748609004,11.333459788,-6.38593829,-0.094840668,-0.584850784,-6.480778958
20155,2017,657,683,-497,-7,-26,-504,10.465949821,10.880127439,-7.917164476,-0.111509359,-0.414177618,-8.028673835
36083,2010,430,417,-154,72,13,-82,NA,NA,NA,NA,NA,NA
36083,2011,1716,1482,-236,303,234,67,10.758283439,9.2912447886,-1.479577443,1.8996269709,1.4670386508,0.4200495282
36083,2012,1675,1456,-662,368,219,-294,10.494691566,9.1225498028,-4.147752726,2.3056994007,1.3721417629,-1.842053326
36083,2013,1665,1549,-238,320,116,82,10.428541006,9.7019879993,-1.490686342,2.0042841574,0.7265530071,0.5135978153
36083,2014,1730,1468,-404,348,262,-56,10.822984766,9.1838969001,-2.527448466,2.1771090744,1.6390878664,-0.350339391
36083,2015,1615,1485,-579,372,130,-207,10.100441543,9.2874029044,-3.621149011,2.3265413336,0.8130386381,-1.294607678
36083,2016,1629,1514,-605,377,115,-228,10.194439056,9.4747579681,-3.786148329,2.3593023474,0.7196810874,-1.426845982
36083,2017,1600,1567,-415,372,33,-43,10.016966237,9.8103663079,-2.598150618,2.32894465,0.2065999286,-0.269205968
27129,2010,51,44,-54,0,7,-54,NA,NA,NA,NA,NA,NA
27129,2011,184,208,-252,9,-24,-243,11.829754403999999,13.372765848,-16.20162016,0.5786292915,-1.543011444,-15.62299087
27129,2012,199,201,-151,9,-2,-142,12.962058297,13.092330239,-9.835531672,0.5862237421,-0.130271943,-9.24930793
27129,2013,186,195,-220,8,-9,-212,12.259021256,12.852199703,-14.49991761,0.5272697314,-0.593178448,-13.97264788
27129,2014,157,172,-139,11,-15,-128,10.471553392,11.472020276,-9.27099313,0.7336757153,-1.000466885,-8.537317415
27129,2015,166,190,-132,13,-24,-119,11.176945866,12.792889846,-8.887691893,0.8753029895,-1.615943981,-8.012388904
27129,2016,166,192,-185,11,-26,-174,11.307516774,13.078573618,-12.60175062,0.7492932802,-1.771056844,-11.85245734
27129,2017,176,180,60,11,-4,71,12.044482464,12.318220701,4.1060735672,0.752780154,-0.273738238,4.8588537211
38075,2010,10,1,3,0,9,3,NA,NA,NA,NA,NA,NA
38075,2011,21,18,8,1,3,9,8.4388185654,7.2332730561,3.2147880249,0.4018485031,1.2055455093,3.616636528
38075,2012,32,32,57,0,0,57,12.680800476,12.680800476,22.587675847,0,0,22.587675847
38075,2013,39,34,52,0,5,52,15.107495642,13.170637226,20.143327523,0,1.9368584156,20.143327523
38075,2014,29,31,-38,0,-2,-38,11.196911197,11.969111969,-14.67181467,0,-0.772200772,-14.67181467
38075,2015,30,27,-24,0,3,-24,11.721039265,10.548935339,-9.376831412,0,1.1721039265,-9.376831412
38075,2016,36,26,-36,0,10,-36,14.195583596,10.252365931,-14.1955836,0,3.9432176656,-14.1955836
38075,2017,31,25,-66,0,6,-66,12.434817489,10.02807862,-26.47412756,0,2.4067388688,-26.47412756
20157,2010,3,30,-14,0,-27,-14,NA,NA,NA,NA,NA,NA
20157,2011,47,93,-1,0,-46,-1,9.5635364737,18.923593448,-0.203479499,0,-9.360056974,-0.203479499
20157,2012,41,94,-14,2,-53,-12,8.439687114,19.349526554,-2.88184438,0.4116920543,-10.90983944,-2.470152326
20157,2013,50,80,-31,2,-30,-29,10.425354462,16.680567139,-6.463719766,0.4170141785,-6.255212677,-6.046705588
20157,2014,53,101,14,4,-48,18,11.153198653,21.254208754,2.9461279461,0.8417508418,-10.1010101,3.7878787879
20157,2015,48,95,-14,4,-47,-10,10.193246974,20.174134636,-2.973030367,0.8494372478,-9.980887662,-2.12359312
20157,2016,50,70,-14,5,-20,-9,10.715816545,15.002143163,-3.000428633,1.0715816545,-4.286326618,-1.928846978
20157,2017,45,62,53,5,-17,58,9.633911368,13.273388996,11.346606722,1.0704345964,-3.639477628,12.417041319
29179,2010,13,32,7,0,-19,7,NA,NA,NA,NA,NA,NA
29179,2011,68,92,-89,0,-24,-89,10.264925655,13.887840592,-13.43497622,0,-3.622914937,-13.43497622
29179,2012,59,69,-6,0,-10,-6,8.9925316263,10.516689529,-0.914494742,0,-1.524157903,-0.914494742
29179,2013,68,82,-81,0,-14,-81,10.452693874,12.604719084,-12.451003,0,-2.152025209,-12.451003
29179,2014,58,100,-12,0,-42,-12,9.0181139703,15.548472363,-1.865816684,0,-6.530358392,-1.865816684
29179,2015,52,101,-57,0,-49,-57,8.1876869784,15.9030074,-8.974964573,0,-7.715320422,-8.974964573
29179,2016,58,68,83,0,-10,83,9.157653746,10.736559564,13.104918292,0,-1.578905818,13.104918292
29179,2017,52,77,-71,0,-25,-71,8.2245947015,12.178726769,-11.22973507,0,-3.954132068,-11.22973507
47143,2010,93,58,22,3,35,25,NA,NA,NA,NA,NA,NA
47143,2011,385,354,166,7,31,173,12.045930978,11.075998874,5.1938299803,0.2190169269,0.9699321048,5.4128469072
47143,2012,372,335,216,10,37,226,11.554050906,10.404857671,6.708803752,0.3105927663,1.1491932353,7.0193965183
47143,2013,390,363,106,5,27,111,12.03870908,11.20525999,3.272059391,0.1543424241,0.8334490902,3.4264018151
47143,2014,389,398,49,28,-9,77,11.971440881,12.248415092,1.5079707023,0.8616975442,-0.276974211,2.3696682464
47143,2015,378,436,-177,32,-58,-145,11.658570437,13.447451615,-5.459171871,0.9869689259,-1.788881178,-4.472202945
47143,2016,393,406,50,37,-13,87,12.146124366,12.547904562,1.5453084436,1.1435282482,-0.401780195,2.6888366918
47143,2017,380,379,259,38,1,297,11.677396555,11.646666564,7.9590676521,1.1677396555,0.0307299909,9.1268073076
20159,2010,28,13,17,1,15,18,NA,NA,NA,NA,NA,NA
20159,2011,125,124,-27,12,1,-15,12.368277841,12.269331618,-2.671548014,1.1873546727,0.0989462227,-1.484193341
20159,2012,111,133,-97,13,-22,-84,11.048623899,13.238441248,-9.655103767,1.2939829791,-2.189817349,-8.361120788
20159,2013,124,130,-20,11,-6,-9,12.417384338,13.018225516,-2.002803925,1.101542159,-0.600841178,-0.901261766
20159,2014,126,147,3,12,-21,15,12.632845398,14.738319631,0.3007820333,1.2031281331,-2.105474233,1.5039101664
20159,2015,133,114,-79,14,19,-65,13.370193516,11.460165871,-7.941693893,1.4073887912,1.9100276451,-6.534305102
20159,2016,131,109,-154,16,22,-138,13.276578494,11.04692409,-15.60758082,1.621566839,2.2296544036,-13.98601399
20159,2017,131,96,-202,17,35,-185,13.457291078,9.8618316298,-20.75093739,1.7463660178,3.5954594484,-19.00457137
27131,2010,151,79,3,24,72,27,NA,NA,NA,NA,NA,NA
27131,2011,761,441,-217,121,320,-96,11.826595075,6.8535196165,-3.372366795,1.8804441578,4.9730754586,-1.491922638
27131,2012,699,453,-359,92,246,-267,10.845700898,7.0287589508,-5.570252678,1.427474224,3.8169419468,-4.142778454
27131,2013,740,523,-127,107,217,-20,11.466024156,8.1036900455,-1.967817659,1.6579251145,3.3623341106,-0.309892545
27131,2014,710,457,-107,136,253,29,10.960849697,7.0550821292,-1.651846363,2.0995430406,3.9057675682,0.4476966778
27131,2015,698,501,-123,162,197,39,10.733012471,7.7037811573,-1.89134747,2.4910430089,3.0292313133,0.5996955392
27131,2016,752,438,-37,162,314,125,11.504011871,6.7004749994,-0.566021861,2.4782578765,4.8035368717,1.9122360158
27131,2017,761,479,-63,163,282,100,11.569217672,7.282069993,-0.957767035,2.4780321688,4.2871476786,1.5202651342
49033,2010,8,7,-9,0,1,-9,NA,NA,NA,NA,NA,NA
49033,2011,37,19,22,0,18,22,16.263736264,8.3516483516,9.6703296703,0,7.9120879121,9.6703296703
49033,2012,43,9,-75,1,34,-74,18.896945726,3.9551746869,-32.95978906,0.4394638541,14.941771039,-32.5203252
49033,2013,27,8,-14,2,19,-12,11.946902655,3.5398230088,-6.194690265,0.8849557522,8.407079646,-5.309734513
49033,2014,32,17,-7,1,15,-6,14.103129132,7.4922873513,-3.085059498,0.4407227854,6.6108417805,-2.644336712
49033,2015,34,20,10,1,14,11,14.873140857,8.7489063867,4.3744531934,0.4374453193,6.1242344707,4.8118985127
49033,2016,31,11,-13,1,20,-12,13.466550825,4.7784535187,-5.647263249,0.4344048653,8.6880973067,-5.212858384
49033,2017,31,11,65,1,20,66,13.199914839,4.6838407494,27.677240792,0.4258037045,8.5160740898,28.103044496
31147,2010,31,16,-5,0,15,-5,NA,NA,NA,NA,NA,NA
31147,2011,86,108,-8,0,-22,-8,10.291389936,12.924071082,-0.957338599,0,-2.632681146,-0.957338599
31147,2012,88,120,-24,-1,-32,-25,10.587102984,14.436958614,-2.887391723,-0.120307988,-3.84985563,-3.007699711
31147,2013,84,128,-105,-1,-44,-106,10.234541578,15.595491928,-12.79317697,-0.121839781,-5.36095035,-12.91501675
31147,2014,117,111,-29,-2,6,-31,14.408866995,13.669950739,-3.571428571,-0.246305419,0.7389162562,-3.81773399
31147,2015,90,134,-42,-2,-44,-44,11.160714286,16.617063492,-5.208333333,-0.248015873,-5.456349206,-5.456349206
31147,2016,71,102,12,-2,-31,10,8.8650268448,12.735672369,1.4983143963,-0.249719066,-3.870645524,1.2485953303
31147,2017,75,114,12,-2,-39,10,9.3943759003,14.279451368,1.503100144,-0.250516691,-4.885075468,1.2525834534
17159,2010,50,76,-13,0,-26,-13,NA,NA,NA,NA,NA,NA
17159,2011,213,180,-41,3,33,-38,13.155456735,11.117287382,-2.532271015,0.185288123,2.0381693533,-2.346982892
17159,2012,191,175,-75,5,16,-70,11.818575583,10.828537838,-4.640801931,0.3093867954,0.9900377452,-4.331415135
17159,2013,187,207,-105,4,-20,-101,11.634056055,12.878340125,-6.532491368,0.248856814,-1.24428407,-6.283634554
17159,2014,197,211,22,9,-14,31,12.297512407,13.171447299,1.3733262586,0.5618152876,-0.873934892,1.9351415462
17159,2015,205,219,-54,10,-14,-44,12.815303348,13.690494796,-3.375738443,0.6251367487,-0.875191448,-2.750601694
17159,2016,198,208,-108,9,-10,-99,12.443047918,13.071484682,-6.787117046,0.5655930872,-0.628436764,-6.221523959
17159,2017,189,183,29,9,6,38,11.902137977,11.524292327,1.8262539753,0.5667684751,0.3778456501,2.3930224503
30083,2010,31,17,0,0,14,0,NA,NA,NA,NA,NA,NA
30083,2011,130,83,334,-8,47,326,13.064670117,8.3412893824,33.566152455,-0.8039797,4.7233807346,32.762172755
30083,2012,144,114,597,-9,30,588,13.766072367,10.898140624,57.07184169,-0.860379523,2.8679317432,56.211462167
30083,2013,152,94,319,-13,58,306,13.861024986,8.5719496626,29.089914281,-1.1854824,5.2890753237,27.90443188
30083,2014,187,100,301,-15,87,286,16.486665197,8.8163985012,26.537359489,-1.322459775,7.6702666961,25.214899713
30083,2015,177,83,280,-16,94,264,15.111414667,7.0861436011,23.905062751,-1.366003586,8.0252710663,22.539059165
30083,2016,171,82,-560,-16,89,-576,14.676851772,7.0380224873,-48.06454382,-1.37327268,7.638829285,-49.4378165
30083,2017,163,87,-429,-17,76,-446,14.523098855,7.7515926404,-38.22337061,-1.514679022,6.7715062146,-39.73804963
38077,2010,55,51,2,2,4,4,NA,NA,NA,NA,NA,NA
38077,2011,144,144,-63,-2,0,-65,8.8381513533,8.8381513533,-3.866691217,-0.122752102,0,-3.989443319
38077,2012,146,106,-72,-2,40,-74,8.9893174891,6.5264907798,-4.433088077,-0.123141335,2.4628267094,-4.556229412
38077,2013,179,129,18,-2,50,16,11.009964325,7.9345552959,1.1071472506,-0.123016361,3.0754090294,0.9841308894
38077,2014,185,130,20,3,55,23,11.329536408,7.961295854,1.2248147468,0.183722212,3.3682405536,1.4085369588
38077,2015,196,152,-94,3,44,-91,11.993269084,9.3009025547,-5.751873948,0.1835704452,2.692366529,-5.568303503
38077,2016,196,133,-47,4,63,-43,12.003552072,8.1452674771,-2.878402793,0.2449704504,3.8582845944,-2.633432342
38077,2017,206,129,-69,5,77,-64,12.603628132,7.8925632476,-4.221603598,0.3059133042,4.7110648842,-3.915690293
39139,2010,310,330,-305,3,-20,-302,NA,NA,NA,NA,NA,NA
39139,2011,1415,1351,-1121,14,64,-1107,11.444007263,10.926398454,-9.066241796,0.113226927,0.5176088091,-8.953014869
39139,2012,1415,1323,-617,17,92,-600,11.515533763,10.766820614,-5.021261012,0.1383491689,0.7487131493,-4.882911843
39139,2013,1409,1391,-351,18,18,-333,11.505422002,11.358440031,-2.866148419,0.1469819702,0.1469819702,-2.719166449
39139,2014,1421,1316,-454,23,105,-431,11.634761819,10.775050355,-3.717228618,0.1883177494,0.8597114645,-3.528910868
39139,2015,1401,1458,-280,25,-57,-255,11.502179749,11.970148519,-2.298793954,0.2052494602,-0.467968769,-2.093544494
39139,2016,1368,1367,-499,27,1,-472,11.268162499,11.259925538,-4.110243485,0.2223979441,0.0082369609,-3.887845541
39139,2017,1374,1364,-613,26,10,-587,11.366832674,11.284104634,-5.071228842,0.2150929036,0.0827280398,-4.856135939
45079,2010,1213,564,405,295,649,700,NA,NA,NA,NA,NA,NA
45079,2011,4827,2615,647,807,2212,1454,12.451327742,6.7454365123,1.6689473895,2.0816700824,5.7058912295,3.7506174718
45079,2012,4891,2721,350,1305,2170,1655,12.497444808,6.9526778414,0.8943172527,3.3345257563,5.5447669665,4.228843009
45079,2013,4746,2967,1077,947,1779,2024,12.011464799,7.5090636448,2.725736955,2.3967250663,4.5024011541,5.1224620213
45079,2014,4793,2947,827,911,1846,1738,12.019324205,7.3901415462,2.0738537695,2.2844991342,4.6291826584,4.3583529037
45079,2015,4912,3031,2557,1116,1881,3673,12.178854612,7.5150872008,6.339847566,2.7670198997,4.6637674116,9.1068674657
45079,2016,4933,3079,256,889,1854,1145,12.102477291,7.553928153,0.6280628799,2.1810464852,4.5485491379,2.8091093651
45079,2017,4922,3126,-85,785,1796,700,11.994697184,7.6179242984,-0.207141256,1.9130104204,4.3767728855,1.7058691647
55103,2010,50,22,-34,0,28,-34,NA,NA,NA,NA,NA,NA
55103,2011,177,174,-19,0,3,-19,9.8292378176,9.6626405664,-1.055115924,0,0.1665972511,-1.055115924
55103,2012,180,188,-195,7,-8,-188,10.055023322,10.501913247,-10.89294193,0.3910286847,-0.446889925,-10.50191325
55103,2013,183,171,-16,12,12,-4,10.276568861,9.6026954935,-0.898497824,0.673873368,0.673873368,-0.224624456
55103,2014,179,173,-91,10,6,-81,10.071173376,9.7335921456,-5.119981996,0.5626353841,0.3375812305,-4.557346612
55103,2015,176,199,-176,10,-23,-166,9.9764759232,11.280219936,-9.976475923,0.5668452229,-1.303744013,-9.4096307
55103,2016,174,173,-38,11,1,-27,9.9238600394,9.866826361,-2.167279779,0.6273704623,0.0570336784,-1.539909316
55103,2017,173,184,-2,11,-11,9,9.8755565704,10.503482133,-0.114168284,0.6279255623,-0.627925562,0.5137572782
22083,2010,63,23,-2,0,40,-2,NA,NA,NA,NA,NA,NA
22083,2011,266,267,129,2,-1,131,12.773415928,12.821436289,6.1946265216,0.0960407213,-0.048020361,6.2906672429
22083,2012,279,239,-10,2,40,-8,13.346727899,11.433218523,-0.478377344,0.0956754688,1.9135093762,-0.382701875
22083,2013,308,246,-56,-2,62,-58,14.723457144,11.759644342,-2.676992208,-0.095606865,2.9638128018,-2.772599073
22083,2014,299,207,-248,-2,92,-250,14.346376221,9.9321066142,-11.89933546,-0.095962383,4.4142696063,-11.99529784
22083,2015,244,235,-223,-2,9,-225,11.81197657,11.376288909,-10.79537203,-0.09681948,0.4356876604,-10.89219151
22083,2016,267,234,-128,-2,33,-130,13.023754939,11.414077362,-6.243597873,-0.097556217,1.6096775767,-6.34115409
22083,2017,254,243,-48,-2,11,-50,12.431784255,11.893399897,-2.34931356,-0.097888065,0.5383843575,-2.447201625
51760,2010,702,510,-404,201,192,-203,NA,NA,NA,NA,NA,NA
51760,2011,2820,1871,516,673,949,1189,13.734290188,9.1123606177,2.5130828855,3.2777224456,4.6219295704,5.790805331
51760,2012,2945,1794,2583,588,1151,3171,14.116169605,8.5991199563,12.381007161,2.8184406546,5.5170496487,15.199447816
51760,2013,2864,1897,1551,581,967,2132,13.482278618,8.9301265847,7.3013317516,2.7350572197,4.5521520334,10.036388971
51760,2014,2858,1898,1542,588,960,2130,13.256121912,8.8034007658,7.1521833408,2.7272917019,4.452721146,9.8794750427
51760,2015,3011,1785,1823,652,1226,2475,13.74484169,8.1483036921,8.3217689808,2.9762991637,5.596537998,11.298068144
51760,2016,3118,1895,2432,678,1223,3110,13.974824698,8.4933588209,10.900183985,3.0387848446,5.4814658775,13.93896883
51760,2017,3155,2064,-7,662,1091,655,13.950300672,9.126282278,-0.030951539,2.9271312345,4.8240183941,2.8961796958
13245,2010,690,464,-7,133,226,126,NA,NA,NA,NA,NA,NA
13245,2011,3019,1904,-1852,213,1115,-1639,15.047675062,9.4901534673,-9.230968604,1.0616610759,5.5575215946,-8.169307528
13245,2012,3024,1851,-602,660,1173,58,15.04601124,9.209711245,-2.995270756,3.2838516595,5.8362999948,0.2885809034
13245,2013,3020,1895,-1992,402,1125,-1590,14.99760386,9.4107481172,-9.892459235,1.9963697853,5.5868557424,-7.896089449
13245,2014,2963,1957,-1223,396,1006,-827,14.725395966,9.7258183951,-6.078015277,1.9680245705,4.9995775705,-4.109990707
13245,2015,2937,1886,-1254,524,1051,-730,14.57969813,9.3623802089,-6.225039651,2.601212741,5.2173179213,-3.62382691
13245,2016,2877,2071,-755,361,806,-394,14.256513175,10.262509136,-3.741281699,1.7888777394,3.9940040386,-1.952403959
13245,2017,2939,2005,-1386,253,934,-1133,14.556422854,9.9304620017,-6.864648546,1.2530707663,4.6259608527,-5.61157778
36085,2010,1381,792,182,316,589,498,NA,NA,NA,NA,NA,NA
36085,2011,5695,3324,-1828,1269,2371,-559,12.100004037,7.0624079752,-3.883899452,2.6962080988,5.0375960617,-1.187691353
36085,2012,5401,3187,-3550,1322,2214,-2228,11.453024258,6.7581537326,-7.527908927,2.8033508737,4.6948705253,-4.724558053
36085,2013,5365,3638,-1158,1301,1727,143,11.354317127,7.6993486876,-2.45075475,2.7533954487,3.6549684397,0.3026406988
36085,2014,5349,3515,-2440,1372,1834,-1068,11.289716628,7.4188360342,-5.149917475,2.8957732686,3.8708805937,-2.254144206
36085,2015,5301,3682,-1980,1533,1619,-447,11.166123737,7.7558324091,-4.170708357,3.2291393491,3.4102913282,-0.941569008
36085,2016,5362,3807,-982,1498,1555,516,11.256476358,7.9920562278,-2.06151805,3.1447597135,3.2644201298,1.0832416637
36085,2017,5331,3976,-753,1486,1355,733,11.142917162,8.3106806669,-1.573929211,3.1060541929,2.8322364949,1.5321249821
37153,2010,149,145,-21,4,4,-17,NA,NA,NA,NA,NA,NA
37153,2011,608,552,-27,2,56,-25,13.036300092,11.835588242,-0.578914642,0.0428825661,1.2007118506,-0.536032076
37153,2012,554,524,-326,7,30,-319,11.9114169,11.266394324,-7.009245324,0.1505052677,0.6450225758,-6.858740056
37153,2013,508,510,-214,6,-2,-208,10.981290734,11.024524162,-4.625976805,0.1297002843,-0.043233428,-4.496276521
37153,2014,533,529,-377,9,4,-368,11.593761556,11.506753964,-8.200465491,0.1957670807,0.0870075914,-8.00469841
37153,2015,524,578,-316,16,-54,-300,11.487701144,12.671548209,-6.927697637,0.3507695006,-1.183847064,-6.576928136
37153,2016,545,560,-374,6,-15,-368,12.045529893,12.377058238,-8.266106752,0.1326113383,-0.331528346,-8.133495414
37153,2017,524,561,-224,7,-37,-217,11.663624627,12.487201175,-4.98597694,0.1558117794,-0.823576548,-4.83016516
51159,2010,19,7,10,3,12,13,NA,NA,NA,NA,NA,NA
51159,2011,69,101,-52,11,-32,-41,7.4651087309,10.927188142,-5.625879044,1.1900897977,-3.462079411,-4.435789246
51159,2012,65,115,-79,2,-50,-77,7.1080977637,12.575865274,-8.639072667,0.2187107004,-5.467767511,-8.420361966
51159,2013,75,105,-103,4,-30,-99,8.3157778024,11.642088923,-11.42033485,0.4435081495,-3.326311121,-10.9768267
51159,2014,62,105,-29,4,-43,-25,6.9483357615,11.767342822,-3.250028017,0.4482797265,-4.81900706,-2.801748291
51159,2015,59,127,-32,5,-68,-27,6.6723211761,14.362454057,-3.618886062,0.5654509471,-7.690132881,-3.053435115
51159,2016,77,95,3,5,-18,8,8.760452813,10.808350873,0.3413163434,0.5688605723,-2.04789806,0.9101769156
51159,2017,73,98,173,5,-25,178,8.2378829769,11.059075777,19.522654178,0.5642385601,-2.8211928,20.086892738
20161,2010,284,90,56,176,194,232,NA,NA,NA,NA,NA,NA
20161,2011,1103,334,555,440,769,995,15.222821812,4.6096305395,7.6597154174,6.0725671778,10.613191272,13.732282595
20161,2012,1143,322,2031,1112,821,3143,15.163374415,4.271746773,26.943843776,14.752119291,10.891627642,41.695963067
20161,2013,1092,303,-2070,654,789,-1416,14.162046494,3.9295788347,-26.845637580000002,8.4816652077,10.232467659,-18.36397238
20161,2014,1074,320,-1977,677,754,-1300,14.029862445,4.1802197228,-25.82591997,8.843777351,9.8496427218,-16.98214262
20161,2015,1011,353,-1132,823,658,-309,13.219660813,4.6157668319,-14.80183585,10.76140539,8.6038939812,-4.040430456
20161,2016,993,346,-3411,645,647,-2766,13.134312565,4.5765077014,-45.11695887,8.5313510618,8.5578048635,-36.58560781
20161,2017,934,354,-1483,520,580,-963,12.560516407,4.7606239914,-19.94351802,6.993006993,7.7998924153,-12.95051103
19159,2010,10,29,3,0,-19,3,NA,NA,NA,NA,NA,NA
19159,2011,56,94,-28,0,-38,-28,11.020368002,18.49847486,-5.510184001,0,-7.478106858,-5.510184001
19159,2012,48,70,0,2,-22,2,9.5256995436,13.891645168,0,0.3969041476,-4.365945624,0.3969041476
19159,2013,52,77,-30,0,-25,-30,10.396880936,15.395381386,-5.99820054,0,-4.99850045,-5.99820054
19159,2014,51,64,1,0,-13,1,10.26673377,12.883744338,0.2013085053,0,-2.617010569,0.2013085053
19159,2015,56,86,41,0,-30,41,11.273276296,17.312531454,8.2536487167,0,-6.039255159,8.2536487167
19159,2016,63,72,25,0,-9,25,12.646793135,14.453477868,5.0185687042,0,-1.806684734,5.0185687042
19159,2017,62,66,49,0,-4,49,12.371545445,13.169709668,9.777511723,0,-0.798164222,9.777511723
35039,2010,158,75,-20,8,83,-12,NA,NA,NA,NA,NA,NA
35039,2011,591,355,-316,14,236,-302,14.676666336,8.8159332472,-7.847422271,0.3476706069,5.8607330883,-7.499751664
35039,2012,576,409,-264,27,167,-237,14.328001791,10.173876272,-6.567000821,0.671625084,4.1541255193,-5.895375737
35039,2013,594,366,-428,33,228,-395,14.818510665,9.1305974804,-10.67731071,0.8232505925,5.6879131845,-9.854060122
35039,2014,546,424,-492,29,122,-463,13.706539475,10.643906113,-12.35094766,0.7280030124,3.0626333626,-11.62294465
35039,2015,515,391,-539,32,124,-507,13.045570839,9.9045013552,-13.65351977,0.8105985764,3.1410694835,-12.84292119
35039,2016,516,443,-234,32,73,-202,13.155714195,11.294537574,-5.965963414,0.8158582446,1.8611766206,-5.150105169
35039,2017,516,441,-103,31,75,-72,13.177215675,11.261922699,-2.630335687,0.7916544301,1.915292976,-1.838681257
08103,2010,22,17,-13,7,5,-6,NA,NA,NA,NA,NA,NA
08103,2011,104,41,26,13,63,39,15.477342064,6.1016444676,3.869335516,1.934667758,9.3756975965,5.8040032741
08103,2012,72,55,-9,13,17,4,10.617120106,8.1103000811,-1.327140013,1.9169800192,2.5068200251,0.5898400059
08103,2013,79,52,-93,5,27,-88,11.682934043,7.6900325348,-13.75332742,0.7394262053,3.9929015084,-13.01390121
08103,2014,68,58,-113,4,10,-109,10.173548773,8.6774386595,-16.90604428,0.5984440455,1.4961101137,-16.30760024
08103,2015,84,53,-158,4,31,-154,12.77469394,8.0602235571,-24.02859098,0.608318759,4.7144703825,-23.42027222
08103,2016,73,43,-66,5,30,-61,11.232497307,6.6164025235,-10.15540852,0.7693491306,4.6160947838,-9.386059394
08103,2017,73,39,-103,5,34,-98,11.315198016,6.0451057894,-15.96527939,0.7750135627,5.2700922266,-15.19026583
08105,2010,43,14,14,1,29,15,NA,NA,NA,NA,NA,NA
08105,2011,149,127,-141,-2,22,-143,12.452987881,10.614291684,-11.78437108,-0.1671542,1.8386961972,-11.95152528
08105,2012,135,127,-46,-5,8,-51,11.360767483,10.687536817,-3.871076328,-0.42076916599999997,0.6732306657,-4.291845494
08105,2013,150,129,-201,-9,21,-210,12.745889451,10.961464928,-17.07949186,-0.764753367,1.7844245231,-17.84424523
08105,2014,145,116,-200,-9,29,-209,12.514024338,10.01121947,-17.26072322,-0.776732545,2.5028048675,-18.03745577
08105,2015,128,130,-147,-10,-2,-157,11.210369592,11.385531617,-12.87440883,-0.875810124,-0.175162025,-13.75021895
08105,2016,133,116,-8,-9,17,-17,11.730463927,10.231081319,-0.705591815,-0.793790792,1.4993826072,-1.499382607
08105,2017,130,121,-37,-8,9,-45,11.484606211,10.689518088,-3.268695614,-0.706744998,0.7950881223,-3.975440611
18137,2010,102,82,-20,3,20,-17,NA,NA,NA,NA,NA,NA
18137,2011,337,315,-223,19,22,-204,11.73275772,10.966821015,-7.763812972,0.6614907914,0.7659367058,-7.102322181
18137,2012,338,290,-271,23,48,-248,11.845310063,10.163135853,-9.497275228,0.806041809,1.6821742102,-8.691233419
18137,2013,330,327,-169,15,3,-154,11.636107193,11.530324401,-5.95909732,0.5289139633,0.1057827927,-5.430183357
18137,2014,325,303,2,30,22,32,11.480042388,10.702931826,0.0706464147,1.0596962204,0.7771105616,1.1303426351
18137,2015,311,301,14,30,10,44,10.965569522,10.612978862,0.4936269238,1.0577719796,0.3525906599,1.5513989034
18137,2016,329,295,-44,31,34,-13,11.58532291,10.388055497,-1.549404888,1.0916261709,1.1972674132,-0.457778717
18137,2017,307,314,12,31,-7,43,10.800351803,11.046613896,0.4221635884,1.09058927,-0.246262093,1.5127528584
29181,2010,48,70,18,0,-22,18,NA,NA,NA,NA,NA,NA
29181,2011,188,181,33,-2,7,31,13.319635835,12.823691948,2.3380211839,-0.141698254,0.4959438875,2.1963229303
29181,2012,171,180,-100,-2,-9,-102,12.147474604,12.786815373,-7.103786318,-0.142075726,-0.639340769,-7.245862044
29181,2013,173,196,-13,-3,-23,-16,12.356701546,13.999500018,-0.928538266,-0.214278061,-1.642798471,-1.142816328
29181,2014,184,180,-56,0,4,-56,13.187128216,12.900451516,-4.013473805,0,0.2866767004,-4.013473805
29181,2015,187,171,-159,0,16,-159,13.496932515,12.34211476,-11.47600144,0,1.1548177553,-11.47600144
29181,2016,163,185,20,0,-22,20,11.826591692,13.422818792,1.4511155451,0,-1.5962271,1.4511155451
29181,2017,165,194,-187,0,-29,-187,12.068019748,14.189065643,-13.67708905,0,-2.121045895,-13.67708905
54085,2010,23,45,-6,0,-22,-6,NA,NA,NA,NA,NA,NA
54085,2011,97,123,-84,1,-26,-83,9.3579663306,11.866287203,-8.103805895,0.0964738797,-2.508320872,-8.007332015
54085,2012,94,123,-32,-1,-29,-33,9.1439688716,11.964980545,-3.112840467,-0.097276265,-2.821011673,-3.210116732
54085,2013,89,113,-76,-2,-24,-78,8.727201412,11.08060404,-7.452441655,-0.196116886,-2.353402628,-7.648558541
54085,2014,90,111,-50,1,-21,-49,8.8998763906,10.976514215,-4.944375773,0.0988875155,-2.076637824,-4.845488257
54085,2015,112,143,38,1,-31,39,11.108906963,14.183693712,3.7690934338,0.0991866693,-3.074786749,3.8682801032
54085,2016,97,130,-111,1,-33,-110,9.6864389854,12.981825444,-11.08448173,0.0998601957,-3.295386459,-10.98462153
54085,2017,92,145,-115,1,-53,-114,9.3325218097,14.708865896,-11.66565226,0.1014404545,-5.376344086,-11.56421181
06065,2010,7216,3376,7476,452,3840,7928,NA,NA,NA,NA,NA,NA
06065,2011,31003,14462,14552,2742,16541,17294,13.971951993,6.5175102318,6.5580700382,1.2357221031,7.4544417607,7.7937921414
06065,2012,30101,14588,10977,2572,15513,13549,13.376159321,6.4825558014,4.8779143839,1.1429348452,6.8936035198,6.020849229
06065,2013,29936,14984,9195,2697,14952,11892,13.140746366,6.5773965642,4.0362494266,1.1838787062,6.5633498017,5.2201281328
06065,2014,30344,14986,12057,3118,15358,15175,13.155453201,6.4970874527,5.2272376496,1.3517895821,6.658365748,6.5790272318
06065,2015,30538,15763,11845,3907,14775,15752,13.067688986,6.745234838,5.0686612102,1.6718665554,6.3224541478,6.7405277655
06065,2016,30411,16952,17083,3914,13459,20997,12.835431209,7.1548528448,7.2101434136,1.6519640181,5.6805783647,8.8621074317
06065,2017,30599,17222,19586,3811,13377,23397,12.723637715,7.161230391,8.1442258994,1.5846852294,5.5624073244,9.7289111287
47145,2010,137,129,-38,2,8,-36,NA,NA,NA,NA,NA,NA
47145,2011,511,697,-52,3,-186,-49,9.4565710214,12.898688849,-0.962312511,0.0555180295,-3.442117828,-0.906794482
47145,2012,474,657,-185,15,-183,-170,8.820738039,12.226212851,-3.442693116,0.2791372797,-3.405474813,-3.163555837
47145,2013,489,733,-208,5,-244,-203,9.1689792245,13.744093602,-3.900097502,0.0937523438,-4.575114378,-3.806345159
47145,2014,446,708,-13,6,-262,-7,8.4204166785,13.366939481,-0.245438154,0.1132791481,-4.946522802,-0.132159006
47145,2015,441,714,194,7,-273,201,8.3542505328,13.525929434,3.6751124793,0.1326071513,-5.171678901,3.8077196306
47145,2016,472,716,402,7,-244,409,8.9342330661,13.552777278,7.6092408741,0.1324992192,-4.618544212,7.7417400933
47145,2017,468,700,348,7,-232,355,8.8344392113,13.213904803,6.5691983879,0.132139048,-4.379465592,6.7013374359
54087,2010,33,65,3,0,-32,3,NA,NA,NA,NA,NA,NA
54087,2011,159,173,-82,-1,-14,-83,10.709594854,11.652578049,-5.523187283,-0.067355942,-0.942983195,-5.590543226
54087,2012,173,164,-131,-1,9,-132,11.738363414,11.12769711,-8.888587325,-0.067851812,0.6106663048,-8.956439137
54087,2013,146,207,-9,2,-61,-7,9.9716559096,14.137895707,-0.614691118,0.1365980262,-4.166239798,-0.478093092
54087,2014,157,191,20,2,-34,22,10.754897931,13.083984107,1.3700506919,0.1370050692,-2.329086176,1.5070557611
54087,2015,139,203,-158,2,-64,-156,9.5987846143,14.018368897,-10.9108487,0.1381120088,-4.419584283,-10.77273669
54087,2016,134,179,-200,2,-45,-198,9.4035087719,12.561403509,-14.03508772,0.1403508772,-3.157894737,-13.89473684
54087,2017,123,180,-31,2,-57,-29,8.7323843669,12.779099074,-2.20084484,0.1419899897,-4.046714707,-2.058854851
51770,2010,333,326,-270,95,7,-175,NA,NA,NA,NA,NA,NA
51770,2011,1454,1247,-580,477,207,-103,15.020971508,12.882497572,-5.991859336,4.9277877642,2.1384739354,-1.064071572
51770,2012,1456,1110,390,511,346,901,14.937623112,11.387885752,4.0011490479,5.2425311884,3.5497373605,9.2436802364
51770,2013,1489,1202,100,452,287,552,15.113989322,12.200816095,1.0150429363,4.5879940721,2.9131732272,5.6030370085
51770,2014,1405,1168,-107,460,237,353,14.159167179,11.770752502,-1.078313799,4.6357415675,2.3884146772,3.5574277681
51770,2015,1518,1085,-620,498,433,-122,15.230030651,10.885759721,-6.220434126,4.9964132174,4.34427093,-1.224020909
51770,2016,1591,1119,-1075,524,472,-551,15.944599782,11.214335107,-10.77337823,5.2513955283,4.7302646743,-5.521982702
51770,2017,1578,1150,-849,520,428,-329,15.813207736,11.524200822,-8.50786652,5.2109429803,4.2890069145,-3.296923539
51161,2010,193,238,-53,42,-45,-11,NA,NA,NA,NA,NA,NA
51161,2011,807,957,385,207,-150,592,8.7120332936,10.331370337,4.1562984114,2.2346851199,-1.619337043,6.3909835313
51161,2012,799,955,-127,187,-156,60,8.6102385327,10.291336419,-1.3685861,2.0151622098,-1.681097886,0.6465761101
51161,2013,854,956,550,156,-102,706,9.1786505019,10.274929602,5.9113088713,1.6766621526,-1.0962791,7.5879710238
51161,2014,880,941,-59,165,-61,106,9.4265851124,10.080018853,-0.632009684,1.7674847086,-0.653433741,1.1354750249
51161,2015,790,1062,25,183,-272,208,8.4644066344,11.378733982,0.2678609694,1.9607422963,-2.914327348,2.2286032658
51161,2016,784,967,63,191,-183,254,8.4003450142,10.361139833,0.6750277244,2.0465126246,-1.960794818,2.721540349
51161,2017,756,979,409,190,-223,599,8.0815423346,10.465383526,4.3721571625,2.0310754545,-2.383841191,6.4032326169
46109,2010,37,15,21,0,22,21,NA,NA,NA,NA,NA,NA
46109,2011,176,121,42,10,55,52,17.179950217,11.811215774,4.0997608473,0.9761335351,5.3687344429,5.0758943824
46109,2012,189,115,-53,8,74,-45,18.32905009,11.152596615,-5.139892353,0.775832808,7.1764534743,-4.364059545
46109,2013,178,133,-131,6,45,-125,17.304233704,12.92956788,-12.73513829,0.5832887766,4.3746658241,-12.15184951
46109,2014,190,101,-47,2,89,-45,18.502288441,9.8354270133,-4.576881877,0.194760931,8.6668614276,-4.382120947
46109,2015,174,130,-128,4,44,-124,16.973953761,12.681689591,-12.48658667,0.3902058336,4.2922641693,-12.09638084
46109,2016,178,88,-84,4,90,-80,17.422796457,8.6135173494,-8.221993834,0.3915235159,8.8092791073,-7.830470318
46109,2017,171,106,-12,4,65,-8,16.682926829,10.341463415,-1.170731707,0.3902439024,6.3414634146,-0.780487805
48393,2010,4,4,-6,0,0,-6,NA,NA,NA,NA,NA,NA
48393,2011,11,7,-3,0,4,-3,11.891891892,7.5675675676,-3.243243243,0,4.3243243243,-3.243243243
48393,2012,10,6,14,0,4,14,10.706638116,6.4239828694,14.989293362,0,4.2826552463,14.989293362
48393,2013,8,15,-18,0,-7,-18,8.5975282106,16.120365395,-19.34443847,0,-7.522837184,-19.34443847
48393,2014,10,12,-3,0,-2,-3,10.911074741,13.093289689,-3.273322422,0,-2.182214948,-3.273322422
48393,2015,6,8,0,0,-2,0,6.5789473684,8.7719298246,0,0,-2.192982456,0
48393,2016,11,4,-2,0,7,-2,12.048192771,4.3811610077,-2.190580504,0,7.6670317634,-2.190580504
48393,2017,10,6,19,0,4,19,10.787486516,6.4724919094,20.49622438,0,4.3149946063,20.49622438
21201,2010,4,9,-2,0,-5,-2,NA,NA,NA,NA,NA,NA
21201,2011,31,20,5,0,11,5,13.581599124,8.7623220153,2.1905805038,0,4.8192771084,2.1905805038
21201,2012,22,34,-65,0,-12,-65,9.7647581003,15.090989791,-28.85042166,0,-5.326231691,-28.85042166
21201,2013,21,47,26,0,-26,26,9.476534296,21.209386282,11.732851986,0,-11.73285199,11.732851986
21201,2014,25,30,-24,0,-5,-24,11.355893709,13.627072451,-10.90165796,0,-2.271178742,-10.90165796
21201,2015,19,40,-33,0,-21,-33,8.7922258214,18.509949098,-15.27070801,0,-9.717723276,-15.27070801
21201,2016,29,30,2,0,-1,2,13.583138173,14.051522248,0.9367681499,0,-0.468384075,0.9367681499
21201,2017,23,29,4,0,-6,4,10.775357227,13.586319981,1.8739751698,0,-2.810962755,1.8739751698
47147,2010,197,191,0,6,6,6,NA,NA,NA,NA,NA,NA
47147,2011,888,603,39,36,285,75,13.347362092,9.0635803397,0.5862017135,0.541109274,4.2837817526,1.1273109875
47147,2012,953,627,-309,9,326,-300,14.284322469,9.3979750137,-4.631537925,0.1348991629,4.8863474553,-4.496638763
47147,2013,871,618,209,37,253,246,13.004949645,9.2273925151,3.1205906726,0.5524490664,3.77755713,3.673039739
47147,2014,871,576,309,47,295,356,12.895106966,8.5276482345,4.5747279591,0.695832408,4.3674587312,5.2705603672
47147,2015,885,676,297,61,209,358,12.986250715,9.9194412244,4.3580976977,0.8950975069,3.066809491,5.2531952046
47147,2016,882,661,464,63,221,527,12.819208465000001,9.6071392236,6.7438919815,0.9156577475,3.2120692412,7.6595497289
47147,2017,881,655,708,63,226,771,12.64405758,9.4005195402,10.161172266,0.9041721084,3.2435380398,11.065344375
48395,2010,43,74,-34,-1,-31,-35,NA,NA,NA,NA,NA,NA
48395,2011,211,185,77,0,26,77,12.707781258,11.14189352,4.6374367622,0,1.5658877379,4.6374367622
48395,2012,203,188,-225,2,15,-223,12.265119932,11.358830282,-13.59434475,0.12083862,0.9062896502,-13.47350613
48395,2013,213,167,-87,19,46,-68,12.958963283,10.160313935,-5.293097679,1.1559638609,2.7986493475,-4.137133818
48395,2014,202,203,16,22,-1,38,12.28523643,12.346054432,0.9730880341,1.3379960468,-0.060818002,2.3110840809
48395,2015,211,195,188,23,16,211,12.730783154,11.765415711,11.343067455,1.3877156993,0.965367443,12.730783154
48395,2016,231,164,83,21,67,104,13.772133786,9.7776187921,4.9484290228,1.2520121624,3.9945149943,6.2004411852
48395,2017,214,168,277,21,46,298,12.565690966,9.8646545903,16.264936438,1.2330818238,2.7010363759,17.498018261
37155,2010,500,253,24,15,247,39,NA,NA,NA,NA,NA,NA
37155,2011,1998,1203,-115,54,795,-61,14.815089443,8.9201964964,-0.852720363,0.4004078228,5.8948929465,-0.452312541
37155,2012,1804,1230,-148,59,574,-89,13.318321921,9.080674037,-1.092633949,0.4355770473,4.2376478839,-0.657056902
37155,2013,1935,1254,-1210,54,681,-1156,14.285661552,9.257994618,-8.933152702,0.3986696247,5.0276669337,-8.534483077
37155,2014,1887,1272,-863,68,615,-795,13.964744017,9.4134363483,-6.386631736,0.5032340186,4.5513076684,-5.883397718
37155,2015,1783,1360,-980,84,423,-896,13.227150154,10.089133039,-7.270110572,0.6231523348,3.1380171144,-6.646958238
37155,2016,1762,1443,-1454,86,319,-1368,13.145525896,10.765603784,-10.84767006,0.6416090959,2.3799221116,-10.20606097
37155,2017,1708,1397,-1308,87,311,-1221,12.836314445,10.499022997,-9.830151811,0.6538403728,2.3372914475,-9.176311438
27133,2010,35,50,-13,0,-15,-13,NA,NA,NA,NA,NA,NA
27133,2011,103,136,-29,1,-33,-28,10.697408734,14.124733863,-3.01189178,0.1038583372,-3.427325129,-2.908033442
27133,2012,107,117,-107,-1,-10,-108,11.215932914,12.264150943,-11.21593291,-0.104821803,-1.048218029,-11.32075472
27133,2013,112,117,-47,-2,-5,-49,11.846210799,12.375059495,-4.971177746,-0.211539479,-0.528848696,-5.182717225
27133,2014,124,125,-41,-1,-1,-42,13.183074633,13.289389751,-4.358919838,-0.106315118,-0.106315118,-4.465234956
27133,2015,100,103,73,-1,-3,72,10.617965598,10.936504566,7.7511148864,-0.106179656,-0.318538968,7.6449352304
27133,2016,110,107,-40,-1,3,-41,11.66180758,11.343758283,-4.240657302,-0.106016433,0.3180492976,-4.346673734
27133,2017,110,105,73,-1,5,72,11.638364281,11.109347723,7.72364175,-0.105803312,0.5290165582,7.6178384383
31149,2010,1,3,-2,0,-2,-2,NA,NA,NA,NA,NA,NA
31149,2011,14,18,-39,0,-4,-39,9.3209054594,11.984021305,-25.96537949,0,-2.663115846,-25.96537949
31149,2012,13,28,-40,0,-15,-40,8.9470061941,19.27047488,-27.52924983,0,-10.32346869,-27.52924983
31149,2013,15,19,18,0,-4,18,10.463899547,13.254272759,12.556679456,0,-2.790373212,12.556679456
31149,2014,14,18,13,0,-4,13,9.6885813149,12.456747405,8.9965397924,0,-2.76816609,8.9965397924
31149,2015,12,34,-11,0,-22,-11,8.3740404745,23.726448011,-7.676203768,0,-15.35240754,-7.676203768
31149,2016,21,22,-4,0,-1,-4,14.846235419,15.55319901,-2.827854366,0,-0.706963591,-2.827854366
31149,2017,17,15,21,0,2,21,11.938202247,10.533707865,14.747191011,0,1.404494382,14.747191011
55105,2010,488,308,-249,0,180,-249,NA,NA,NA,NA,NA,NA
55105,2011,1957,1397,-924,-18,560,-942,12.225710225,8.7272954443,-5.772384388,-0.112449047,3.4984147808,-5.884833435
55105,2012,1925,1407,-310,12,518,-298,12.032227618,8.7944645502,-1.937657435,0.0750060942,3.2377630682,-1.86265134
55105,2013,1880,1552,-81,58,328,-23,11.732950556,9.68592514,-0.505515423,0.3619740065,2.0470254162,-0.143541416
55105,2014,1929,1403,16,79,526,95,12.005862894,8.7321024575,0.0995820665,0.4916864534,3.2737604367,0.5912685199
55105,2015,2028,1517,-510,101,511,-409,12.595138947,9.4215117272,-3.167416599,0.627272699,3.1736272199,-2.5401439
55105,2016,1937,1498,-181,107,439,-74,12.013148102,9.2904986356,-1.122550236,0.6636070454,2.7226494666,-0.45894319
55105,2017,1935,1429,282,107,506,389,11.95440645,8.8283446082,1.7421925679,0.6610446977,3.1260618417,2.4032372656
17161,2010,479,298,-163,62,181,-101,NA,NA,NA,NA,NA,NA
17161,2011,1872,1546,-832,279,326,-553,12.691138236,10.481036172,-5.640505883,1.8914677179,2.2101020647,-3.749038165
17161,2012,1900,1567,-483,363,333,-120,12.882185632,10.624413098,-3.27478719,2.4611754655,2.2577725345,-0.813611724
17161,2013,1781,1574,-682,425,207,-257,12.069707474,10.666883528,-4.6218644,2.8801940912,1.4028239456,-1.741670309
17161,2014,1889,1505,-1452,497,384,-955,12.828740726,10.220886602,-9.860948403,3.3752695292,2.6078541232,-6.485678874
17161,2015,1881,1594,-1567,555,287,-1012,12.830219567,10.872604992,-10.68843916,3.7856309726,1.957614575,-6.902808188
17161,2016,1936,1485,-1788,562,451,-1226,13.272956009,10.180960575,-12.25828788,3.8529965275,3.091995434,-8.405291357
17161,2017,1893,1443,-1669,553,450,-1116,13.042579578,9.942124845,-11.49924211,3.8101143723,3.1004547334,-7.689127739
51163,2010,51,63,7,2,-12,9,NA,NA,NA,NA,NA,NA
51163,2011,182,231,142,2,-49,144,8.1282658211,10.316645081,6.3418337725,0.0893216024,-2.18837926,6.4311553749
51163,2012,202,253,-21,11,-51,-10,9.0154422922,11.291618317,-0.937248951,0.4909399268,-2.276176024,-0.446309024
51163,2013,223,249,-40,22,-26,-18,9.9778518535,11.141188841,-1.789749211,0.9843620663,-1.163336987,-0.805387145
51163,2014,184,229,125,25,-45,150,8.222544967,10.233493464,5.5859680483,1.1171936097,-2.010948497,6.7031616579
51163,2015,168,254,9,27,-86,36,7.4991630398,11.33802031,0.4017408771,1.2052226314,-3.83885727,1.6069635085
51163,2016,146,250,113,28,-104,141,6.5197490343,11.163953826,5.0461071293,1.2503628285,-4.644204792,6.2964699578
51163,2017,147,229,301,28,-82,329,6.5231861549,10.161970268,13.357000222,1.2425116485,-3.638784114,14.59951187
21203,2010,41,21,6,0,20,6,NA,NA,NA,NA,NA,NA
21203,2011,168,200,60,2,-32,62,9.8274349225,11.699327289,3.5097981866,0.1169932729,-1.871892366,3.6267914595
21203,2012,212,218,-38,2,-6,-36,12.407456179,12.758610599,-2.223977994,0.1170514734,-0.35115442,-2.106926521
21203,2013,171,191,-304,2,-20,-302,10.115051315,11.298098252,-17.98231345,0.1183046937,-1.183046937,-17.86400875
21203,2014,173,215,123,1,-42,124,10.305593614,12.807529636,7.3270983499,0.0595699053,-2.501936022,7.3866682552
21203,2015,167,189,128,1,-22,129,9.8933649289,11.196682464,7.5829383886,0.0592417062,-1.303317536,7.6421800948
21203,2016,189,210,-41,1,-21,-40,11.182108626,12.42456514,-2.425748432,0.0591645959,-1.242456514,-2.366583836
21203,2017,178,249,-104,1,-71,-103,10.605022491,14.835115732,-6.196192916,0.059578778,-4.230093241,-6.136614138
13247,2010,234,96,38,35,138,73,NA,NA,NA,NA,NA,NA
13247,2011,1065,583,-464,103,482,-361,12.465179428,6.8236616026,-5.430838737,1.2055525644,5.6415178258,-4.225286172
13247,2012,997,572,-487,95,425,-392,11.656796778,6.6877510099,-5.693941856,1.1107278775,4.9690457678,-4.583213979
13247,2013,935,674,693,110,261,803,10.861105626,7.8292889751,8.0499959343,1.2777771324,3.0318166506,9.3277730668
13247,2014,988,638,331,134,350,465,11.354103221,7.3319006631,3.8038544193,1.5399289794,4.0222025581,5.3437833986
13247,2015,998,631,751,160,367,911,11.334275963,7.1662606543,8.5290994475,1.8171183909,4.1680153092,10.346217838
13247,2016,1028,717,211,169,311,380,11.546539969,8.0533746673,2.3699610248,1.8982152284,3.493165302,4.2681762532
13247,2017,1012,684,446,170,328,616,11.264031343,7.613238576,4.9641877264,1.8921791782,3.6507927674,6.8563669047
33015,2010,637,559,-23,38,78,15,NA,NA,NA,NA,NA,NA
33015,2011,2590,2208,236,98,382,334,8.7611586379,7.4689723059,0.7983140689,0.3315032998,1.2921863319,1.1298173687
33015,2012,2512,2043,1243,136,469,1379,8.4615449393,6.881742162,4.1869826272,0.4581091209,1.5798027773,4.6450917481
33015,2013,2610,2142,600,183,468,783,8.7470152067,7.1785848938,2.0108080935,0.6132964685,1.5684303129,2.624104562
33015,2014,2603,2108,1290,222,495,1512,8.6773174655,7.0271937062,4.3003225242,0.7400555042,1.6501237593,5.0403780284
33015,2015,2609,2371,748,252,238,1000,8.6517066312,7.8624746733,2.4804432963,0.8356573672,0.7892319579,3.3161006636
33015,2016,2765,2332,1110,232,433,1342,9.1242381344,7.6953791426,3.6628948749,0.7655780279,1.4288589917,4.4284729028
33015,2017,2701,2378,1917,215,323,2132,8.8516021203,7.7930802822,6.2823107237,0.7045888396,1.0585218382,6.9868995633
37157,2010,238,211,-4,13,27,9,NA,NA,NA,NA,NA,NA
37157,2011,964,1017,-318,27,-53,-291,10.31242144,10.879390669,-3.401815371,0.2888333806,-0.566969229,-3.112981991
37157,2012,894,1051,-446,25,-157,-421,9.6115080069,11.299435028,-4.795002876,0.2687781881,-1.687927021,-4.526224688
37157,2013,944,1169,-585,27,-225,-558,10.223918988,12.660764086,-6.335797254,0.2924214117,-2.436845098,-6.043375843
37157,2014,962,1101,35,29,-139,64,10.46841249,11.981000158,0.3808673983,0.3155758443,-1.512587668,0.6964432426
37157,2015,954,1164,73,37,-210,110,10.393175802,12.680981796,0.7952849408,0.4030896275,-2.287805994,1.1983745683
37157,2016,906,1168,-150,40,-262,-110,9.8966639722,12.758613156,-1.638520525,0.4369388067,-2.861949184,-1.201581718
37157,2017,905,1153,-199,40,-248,-159,9.9282532856,12.648923799,-2.183118678,0.4388178248,-2.720670514,-1.744300854
51165,2010,220,168,34,12,52,46,NA,NA,NA,NA,NA,NA
51165,2011,882,635,176,36,247,212,11.510603589,8.2871125612,2.2969004894,0.4698205546,3.2234910277,2.766721044
51165,2012,840,692,61,81,148,142,10.910862153,8.9884721546,0.7923364182,1.0521188505,1.9223899984,1.8444552687
51165,2013,810,734,124,103,76,227,10.482519428,9.4989743955,1.6047313693,1.332962347,0.9835450328,2.9376937163
51165,2014,869,686,182,106,183,288,11.191891352,8.8350258547,2.3439864512,1.3651789222,2.3568654977,3.7091653734
51165,2015,812,709,363,120,103,483,10.388679921,9.0709040199,4.6442005066,1.5352728948,1.3177759013,6.1794734014
51165,2016,834,732,623,124,102,747,10.57382661,9.280624794,7.8986738342,1.5721276973,1.2932018156,9.4708015316
51165,2017,807,755,755,124,52,879,10.117536436,9.465601003,9.465601003,1.5546152641,0.6519354333,11.020216267
36087,2010,1121,452,-189,392,669,203,NA,NA,NA,NA,NA,NA
36087,2011,4557,1970,-793,1564,2587,771,14.502208587,6.2693330957,-2.523645251,4.9772776455,8.2328754917,2.4536323943
36087,2012,4638,1977,-2035,1516,2661,-519,14.631630253,6.2368980187,-6.419872265,4.7825682328,8.3947322345,-1.637304032
36087,2013,4623,2156,-1199,1337,2467,138,14.475622682,6.7509068791,-3.754330866,4.1864390062,7.7247158028,0.4321081398
36087,2014,4846,1936,-1878,1362,2910,-516,15.055861409,6.0148880908,-5.834689997,4.2315483366,9.0409733183,-1.603141661
36087,2015,5298,2006,-2232,1513,3292,-719,16.333527046,6.1844196403,-6.881168812,4.6645198982,10.149107406,-2.216648914
36087,2016,5352,2323,-3375,1560,3029,-1815,16.403843501,7.119979158,-10.34435198,4.7813893614,9.2838643434,-5.562962622
36087,2017,5262,2428,-2403,1554,2834,-849,16.048970405,7.4053402019,-7.329090818,4.7396617272,8.6436302027,-2.58942909
48397,2010,217,112,418,29,105,447,NA,NA,NA,NA,NA,NA
48397,2011,961,434,1474,99,527,1573,12.017156648,5.4271030024,18.432142455,1.2379797171,6.5900536458,19.670122172
48397,2012,995,533,1144,59,462,1203,12.153117061,6.5101622044,13.973031073,0.720637092,5.6429548564,14.693668165
48397,2013,952,506,1493,43,446,1536,11.373003453,6.0448946922,17.836023272,0.5136965845,5.3281087603,18.349719856
48397,2014,1025,564,1778,63,461,1841,11.936578918,6.5680297658,20.705597382,0.7336628994,5.3685491525,21.439260281
48397,2015,927,544,2590,79,383,2669,10.465234424,6.1414104923,29.239435984,0.8918592443,4.3238239312,30.131295228
48397,2016,1104,521,2633,82,583,2715,12.030075188,5.6772365697,28.691293451,0.8935381933,6.3528386183,29.584831644
48397,2017,1082,552,2755,82,530,2837,11.377078656,5.8042027896,28.968439647,0.8622185303,5.5728758668,29.830658178
40129,2010,18,18,1,0,0,1,NA,NA,NA,NA,NA,NA
40129,2011,50,37,93,3,13,96,13.502565487,9.9918984607,25.114771807,0.8101539292,3.5106670267,25.924925736
40129,2012,47,39,-1,-2,8,-3,12.498337987,10.370961308,-0.265922085,-0.53184417,2.1273766786,-0.797766254
40129,2013,41,25,-50,1,16,-49,10.943547311,6.6728947017,-13.3457894,0.2669157881,4.2706526091,-13.07887362
40129,2014,47,39,20,0,8,20,12.551742556,10.415275738,5.341167045,0,2.136466818,5.341167045
40129,2015,53,41,4,0,12,4,14.071419089,10.885437409,1.0619938935,0,3.1859816806,1.0619938935
40129,2016,65,21,-127,0,44,-127,17.41693462,5.6270096463,-34.03001072,0,11.789924973,-34.03001072
40129,2017,57,20,-11,0,37,-11,15.392924656,5.401026195,-2.970564407,0,9.9918984607,-2.970564407
40131,2010,244,206,46,6,38,52,NA,NA,NA,NA,NA,NA
40131,2011,937,720,308,16,217,324,10.738701156,8.2517234068,3.5299039018,0.1833716313,2.486977749,3.7132755331
40131,2012,999,746,304,17,253,321,11.378196915,8.4966315298,3.4624342963,0.1936229705,2.8815653848,3.6560572668
40131,2013,965,819,461,26,146,487,10.91709232,9.2653871608,5.2153156058,0.2941392749,1.6517051593,5.5094548807
40131,2014,1058,825,388,28,233,416,11.884502407,9.2672159598,4.3583997484,0.3145236932,2.6172864468,4.6729234416
40131,2015,998,921,607,30,77,637,11.12665771,10.268188127,6.7674160623,0.3344686686,0.8584695829,7.1018847309
40131,2016,1050,881,705,29,169,734,11.602209945,9.7348066298,7.7900552486,0.320441989,1.8674033149,8.1104972376
40131,2017,1034,846,278,31,188,309,11.3380301,9.2765700814,3.0483291757,0.3399215987,2.0614600181,3.3882507744
38079,2010,81,19,6,1,62,7,NA,NA,NA,NA,NA,NA
38079,2011,303,141,21,0,162,21,21.494697265,10.002482886,1.4897314936,0,11.492214379,1.4897314936
38079,2012,296,125,41,0,171,41,20.710162673,8.7458457233,2.8686373972,0,11.964316949,2.8686373972
38079,2013,319,149,106,1,170,107,21.946269478,10.250765368,7.2924907984,0.068797083,11.695504111,7.3612878814
38079,2014,304,141,-115,0,163,-115,20.681679026,9.592489285,-7.823661474,0,11.089189741,-7.823661474
38079,2015,286,143,-180,0,143,-180,19.448505661,9.7242528306,-12.24031825,0,9.7242528306,-12.24031825
38079,2016,269,155,-135,0,114,-135,18.327996185,10.560741296,-9.198065,0,7.7672548886,-9.198065
38079,2017,257,185,-208,0,72,-208,17.603945476,12.672100829,-14.2475512,0,4.9318446469,-14.2475512
20163,2010,21,5,-2,0,16,-2,NA,NA,NA,NA,NA,NA
20163,2011,59,68,12,1,-9,13,11.354888376,13.086989992,2.3094688222,0.1924557352,-1.732101617,2.5019245574
20163,2012,64,57,13,1,7,14,12.287606797,10.943649803,2.4959201306,0.1919938562,1.3439569934,2.6879139868
20163,2013,61,67,-22,3,-6,-19,11.717249328,12.869765655,-4.2258932,0.5762581637,-1.152516327,-3.649635036
20163,2014,71,63,0,3,8,3,13.6577859,12.118880446,0,0.5770895451,1.5389054535,0.5770895451
20163,2015,47,67,-6,3,-20,-3,9.0523882897,12.904468413,-1.155624037,0.5778120185,-3.852080123,-0.577812018
20163,2016,61,66,-56,2,-5,-54,11.844660194,12.815533981,-10.87378641,0.3883495146,-0.970873786,-10.48543689
20163,2017,55,70,-64,2,-15,-62,10.823575716,13.775460002,-12.59470629,0.3935845715,-2.951884286,-12.20112172
30085,2010,59,39,-1,0,20,-1,NA,NA,NA,NA,NA,NA
30085,2011,198,116,-29,-1,82,-30,18.914787925,11.081390906,-2.770347726,-0.095529232,7.8333970195,-2.865876958
30085,2012,223,112,242,0,111,242,20.896781146,10.495244342,22.677224383,0,10.401536804,22.677224383
30085,2013,235,126,124,-1,109,123,21.424989743,11.487441309,11.305100971,-0.091170169,9.9375484342,11.213930802
30085,2014,242,155,107,-2,87,105,21.639021773,13.859704028,9.5676666518,-0.178834891,7.7793177449,9.3888317611
30085,2015,256,174,46,-2,82,44,22.569980163,15.340533392,4.0555433106,-0.17632797,7.229446771,3.8792153405
30085,2016,257,126,-315,-2,131,-317,22.719236209,11.138613861,-27.84653465,-0.176803395,11.580622348,-28.02333805
30085,2017,236,170,-186,-2,66,-188,21.14979612,15.235022628,-16.66890711,-0.17923556,5.9147734911,-16.84814267
35041,2010,77,43,133,1,34,134,NA,NA,NA,NA,NA,NA
35041,2011,284,158,261,5,126,266,14.046541534,7.8146252195,12.908969508,0.2472982664,6.2319163143,13.156267775
35041,2012,296,162,-265,11,134,-254,14.540095788,7.9577551271,-13.01731549,0.5403413975,6.5823406607,-12.47697409
35041,2013,276,167,-471,24,109,-447,13.707814944,8.2942213613,-23.3926842,1.1919839082,5.4135935832,-22.20070029
35041,2014,314,126,-602,34,188,-568,15.870207981,6.3683000177,-30.42632231,1.7184301635,9.5019079629,-28.70789214
35041,2015,298,154,-730,37,144,-693,15.414058863,7.9656545803,-37.75927171,1.9138261005,7.4484042828,-35.84544561
35041,2016,281,133,-165,36,148,-129,14.732868453,6.9732082001,-8.650972579,1.8874849263,7.7596602527,-6.763487653
35041,2017,275,144,-403,34,131,-369,14.500777769,7.5931345409,-21.25023069,1.7928234333,6.9076432281,-19.45740726
26143,2010,59,121,46,2,-62,48,NA,NA,NA,NA,NA,NA
26143,2011,173,398,69,28,-225,97,7.0975814889,16.328540073,2.830827299,1.1487415126,-9.230958584,3.9795688117
26143,2012,184,404,51,18,-220,69,7.5920118831,16.669417396,2.1043076415,0.7426968147,-9.077405512,2.8470044562
26143,2013,168,381,44,11,-213,55,6.9763096153,15.821273592,1.8271287088,0.4567821772,-8.844963976,2.2839108859
26143,2014,150,380,219,12,-230,231,6.2484378905,15.829375989,9.1227193202,0.4998750312,-9.580938099,9.6225943514
26143,2015,178,400,115,12,-222,127,7.4284283449,16.693097404,4.7992655037,0.5007929221,-9.264669059,5.3000584258
26143,2016,165,363,121,12,-198,133,6.9094030694,15.200686753,5.0668955843,0.5025020414,-8.291283683,5.5693976257
26143,2017,165,361,232,12,-196,244,6.9121528214,15.122952537,9.7189057853,0.5027020234,-8.210799715,10.221607809
27135,2010,61,41,-97,1,20,-96,NA,NA,NA,NA,NA,NA
27135,2011,198,148,-118,19,50,-99,12.743772929,9.5256484521,-7.594773766,1.2228873013,3.2181244771,-6.371886465
27135,2012,172,135,-60,17,37,-43,11.088189789,8.7029396596,-3.867973182,1.0959257349,2.3852501289,-2.772047447
27135,2013,202,131,-94,9,71,-85,13.029315961,8.4497049053,-6.063147031,0.5805140775,4.5796110556,-5.482632954
27135,2014,220,143,99,9,77,108,14.112515235,9.1731349028,6.3506318558,0.5773301687,4.9393803323,6.9279620245
27135,2015,182,138,-111,9,44,-102,11.62827844,8.8170462895,-7.091972015,0.575024758,2.8112321503,-6.516947257
27135,2016,170,122,-121,9,48,-112,10.9040762,7.8252782143,-7.76113659,0.5772746224,3.078797986,-7.183861967
27135,2017,181,130,-295,9,51,-286,11.720520624,8.418053487,-19.10250599,0.5827883183,3.3024671372,-18.51971767
30087,2010,42,22,-4,1,20,-3,NA,NA,NA,NA,NA,NA
30087,2011,138,83,26,0,55,26,14.853083629,8.9333763857,2.7984070606,0,5.9197072436,2.7984070606
30087,2012,168,63,-84,0,105,-84,17.981376432,6.7430161618,-8.990688216,0,11.23836027,-8.990688216
30087,2013,180,103,-147,7,77,-140,19.303984128,11.046168695,-15.76492037,0.7507104939,8.2578154325,-15.01420988
30087,2014,174,84,-75,6,90,-69,18.700628728,9.0278897308,-8.060615831,0.6448492665,9.6727389973,-7.415766565
30087,2015,147,90,-39,7,57,-32,15.760694757,9.6494049534,-4.181408813,0.7505092742,6.1112898038,-3.430899539
30087,2016,171,70,-182,7,101,-175,18.38314341,7.5252633842,-19.5656848,0.7525263384,10.857880026,-18.81315846
30087,2017,149,89,-85,7,60,-78,16.096796845,9.6148652298,-9.182736455,0.7562253552,6.4819316156,-8.4265111
39141,2010,183,171,13,8,12,21,NA,NA,NA,NA,NA,NA
39141,2011,776,841,-500,26,-65,-474,9.9712811683000009,10.806504462,-6.424794567,0.3340893175,-0.835223294,-6.09070525
39141,2012,909,816,-312,17,93,-295,11.735543592,10.534877416,-4.028041365,0.2194766128,1.2006661761,-3.808564752
39141,2013,806,822,-100,19,-16,-81,10.426301186,10.633274906,-1.293585755,0.2457812935,-0.206973721,-1.047804462
39141,2014,902,750,-346,25,152,-321,11.689085867,9.7193064303,-4.483840033,0.323976881,1.9697794365,-4.159863152
39141,2015,808,862,28,27,-54,55,10.483567527,11.18420199,0.363291944,0.3503172317,-0.700634463,0.7136091757
39141,2016,866,857,-194,28,9,-166,11.248360155,11.131460338,-2.519840497,0.3636883191,0.1168998169,-2.156152178
39141,2017,821,824,379,28,-3,407,10.646920369,10.685825071,4.9149608035,0.3631105607,-0.038904703,5.2780713642
08107,2010,68,33,-107,4,35,-103,NA,NA,NA,NA,NA,NA
08107,2011,227,88,-358,10,139,-348,9.7232930695,3.7693823353,-15.33453268,0.4283389017,5.9539107342,-14.90619378
08107,2012,215,92,-164,46,123,-118,9.2475106992,3.9570743457,-7.053915138,1.9785371728,5.2904363535,-5.075377965
08107,2013,204,102,146,66,102,212,8.7138524625,4.3569262313,6.2363846055,2.8191875614,4.3569262313,9.0555721669
08107,2014,206,105,282,63,101,345,8.6576447844,4.4128771959,11.851727326,2.6477263176,4.2447675885,14.499453644
08107,2015,213,101,113,65,112,178,8.8145833764,4.1796850752,4.6762813218,2.6898963355,4.6348983012,7.3661776573
08107,2016,239,91,155,66,148,221,9.7572924534,3.7151197208,6.3279511727,2.6944824348,6.0421727327,9.0224336075
08107,2017,231,117,356,68,114,424,9.2587025792,4.6894727349,14.268823023,2.7255055212,4.5692298443,16.994328544
21205,2010,69,72,39,-3,-3,36,NA,NA,NA,NA,NA,NA
21205,2011,267,220,158,-16,47,142,11.378891517,9.3758656694,6.7335762535,-0.68188114,2.0030258476,6.0516951139
21205,2012,273,226,185,1,47,186,11.528716216,9.5439189189,7.8125,0.0422297297,1.9847972973,7.8547297297
21205,2013,302,223,315,2,79,317,12.581236461,9.2901183136,13.122812865,0.0833194468,3.291118147,13.206132311
21205,2014,275,213,-38,5,62,-33,11.3547215,8.7947479252,-1.569016062,0.2064494818,2.5599735745,-1.36256658
21205,2015,273,223,314,6,50,320,11.180505785,9.1327941026,12.859629364,0.2457254019,2.0477116822,13.105354766
21205,2016,281,235,-251,4,46,-247,11.467983512,9.5906623679,-10.24364364,0.1632453169,1.8773211443,-10.08039832
21205,2017,270,208,50,4,62,54,11.038655737,8.5038533085,2.0441955069,0.1635356405,2.5348024285,2.2077311474
37159,2010,383,410,-137,11,-27,-126,NA,NA,NA,NA,NA,NA
37159,2011,1539,1450,-609,22,89,-587,11.143896743,10.499447874,-4.409768107,0.1593019677,0.6444488695,-4.250466139
37159,2012,1532,1440,-374,20,92,-354,11.124383239,10.456339337,-2.715743689,0.1452269352,0.6680439021,-2.570516754
37159,2013,1540,1607,242,44,-67,286,11.185276109,11.671908252,1.7576862457,0.3195793174,-0.486632142,2.0772655631
37159,2014,1522,1609,439,51,-87,490,11.030983874,11.661532886,3.1817358217,0.3696321797,-0.630549013,3.5513680014
37159,2015,1591,1586,354,69,5,423,11.497990923,11.461856445,2.5583210476,0.4986557974,0.0361344781,3.056976845
37159,2016,1643,1620,861,71,23,932,11.815681128,11.650275975,6.1919059348,0.5105985149,0.1654051527,6.7025044498
37159,2017,1629,1582,999,72,47,1071,11.628529516,11.293022525,7.131308156,0.5139681554,0.3355069903,7.6452763114
48399,2010,33,47,20,0,-14,20,NA,NA,NA,NA,NA,NA
48399,2011,125,138,-9,9,-13,0,11.904195038,13.142231322,-0.857102043,0.8571020428,-1.238036284,0
48399,2012,110,144,-141,8,-34,-133,10.566255223,13.832188656,-13.54401806,0.7684549253,-3.265933433,-12.77556313
48399,2013,98,144,-102,5,-46,-97,9.5553822153,14.040561622,-9.945397816,0.4875195008,-4.485179407,-9.457878315
48399,2014,99,136,114,5,-37,119,9.6816781575,13.300083126,11.148599091,0.4889736443,-3.618404968,11.637572735
48399,2015,93,135,126,5,-42,131,9.0194937445,13.0928135,12.219959267,0.4849190185,-4.073319756,12.704878285
48399,2016,121,129,-97,5,-8,-92,11.741303188,12.517587696,-9.412449663,0.4851778177,-0.776284508,-8.927271845
48399,2017,108,125,23,5,-17,28,10.525802836,12.182642171,2.2416061595,0.4873056869,-1.656839335,2.7289118464
18139,2010,46,32,-21,0,14,-21,NA,NA,NA,NA,NA,NA
18139,2011,169,202,-66,-2,-33,-68,9.7499062509,11.653734099,-3.807655696,-0.115383506,-1.903827848,-3.923039202
18139,2012,176,174,-179,-3,2,-182,10.235533585,10.119220704,-10.41000291,-0.174469322,0.1163128817,-10.58447223
18139,2013,186,218,-77,-1,-32,-78,10.908131249,12.784798991,-4.515731754,-0.058645867,-1.876667742,-4.574377621
18139,2014,178,178,-154,2,0,-152,10.520094563,10.520094563,-9.101654846,0.1182033097,0,-8.983451537
18139,2015,199,209,-129,2,-10,-127,11.861830537,12.457902423,-7.689327333,0.1192143773,-0.596071886,-7.570112956
18139,2016,182,179,-79,1,3,-78,10.917161538,10.737208326,-4.73876792,0.0599844041,0.1799532122,-4.678783516
18139,2017,181,185,15,1,-4,16,10.878057576,11.118456638,0.9014964842,0.0600997656,-0.240399062,0.9615962498
20165,2010,8,20,16,1,-12,17,NA,NA,NA,NA,NA,NA
20165,2011,26,48,-84,1,-22,-83,7.969348659,14.712643678,-25.74712644,0.30651341,-6.743295019,-25.44061303
20165,2012,29,52,21,1,-23,22,9.0342679128,16.199376947,6.5420560748,0.3115264798,-7.165109034,6.8535825545
20165,2013,27,47,-11,0,-20,-11,8.4546735557,14.717394708,-3.444496634,0,-6.262721152,-3.444496634
20165,2014,26,56,14,0,-30,14,8.2018927445,17.665615142,4.4164037855,0,-9.463722397,4.4164037855
20165,2015,30,44,-48,0,-14,-48,9.5831336847,14.055262738,-15.3330139,0,-4.472129053,-15.3330139
20165,2016,35,44,-16,0,-9,-16,11.339705168,14.255629354,-5.18386522,0,-2.915924186,-5.18386522
20165,2017,37,26,18,0,11,18,11.97992553,8.4183260482,5.8280718796,0,3.5615994819,5.8280718796
48401,2010,147,113,20,7,34,27,NA,NA,NA,NA,NA,NA
48401,2011,693,566,181,16,127,197,12.948672434,10.575683402,3.3819764943,0.2989592481,2.3729890319,3.6809357424
48401,2012,668,504,-65,4,164,-61,12.432764429,9.3804090901,-1.209774982,0.0744476912,3.0523553388,-1.135327291
48401,2013,695,594,-540,-10,101,-550,12.976828426,11.090987173,-10.08271561,-0.186716956,1.8858412532,-10.26943257
48401,2014,596,529,-223,-4,67,-227,11.191542499,9.9334328554,-4.187439559,-0.075111023,1.2581096433,-4.262550583
48401,2015,585,557,-273,5,28,-268,11.027020914,10.499231878,-5.145943093,0.094248042,0.5277890352,-5.051695051
48401,2016,631,530,-180,6,101,-174,11.929744957,10.020229519999999,-3.403096818,0.1134365606,1.9095154368,-3.289660258
48401,2017,612,534,-105,6,78,-99,11.581148464,10.105119738,-1.986961746,0.1135406712,1.4760287258,-1.873421075
55107,2010,37,28,-32,0,9,-32,NA,NA,NA,NA,NA,NA
55107,2011,134,162,-95,6,-28,-89,9.1324200913,11.040686976,-6.47447693,0.4089143324,-1.908266885,-6.065562598
55107,2012,161,169,-327,18,-8,-309,11.134548221,11.687817698,-22.61488986,1.2448563228,-0.553269477,-21.37003354
55107,2013,120,189,112,16,-69,128,8.3717036417,13.185433236,7.8135900656,1.1162271522,-4.813729594,8.9298172178
55107,2014,154,208,10,19,-54,29,10.731333403,14.494268492,0.6968398314,1.3239956796,-3.762935089,2.020835511
55107,2015,136,204,-183,21,-68,-162,9.5619770794,14.342965619,-12.86648386,1.4764817549,-4.78098854,-11.39000211
55107,2016,147,177,-9,22,-30,13,10.425162228,12.552746357,-0.638275238,1.5602283607,-2.127584128,0.9219531222
55107,2017,139,157,57,22,-18,79,9.8431469745,11.117799101,4.0363983996,1.5579081542,-1.274652126,5.5943065538
01113,2010,192,93,231,5,99,236,NA,NA,NA,NA,NA,NA
01113,2011,799,572,1283,-23,227,1260,14.776867452,10.578683583,23.728061253,-0.425366648,4.1981838694,23.302694605
01113,2012,903,574,2153,97,329,2250,16.080348319,10.221616761,38.3399667,1.7273463864,5.8587315579,40.067313086
01113,2013,868,521,1222,38,347,1260,14.888380031,8.9364585209,20.960369122,0.6517954391,5.9519215101,21.612164561
01113,2014,918,455,-409,29,463,-380,15.515930026,7.6903574749,-6.912870785,0.4901546522,7.8255725513,-6.422716133
01113,2015,936,614,-755,64,322,-691,15.857150118,10.402019415,-12.79075677,1.0842495807,5.4551307029,-11.70650719
01113,2016,836,658,-875,26,178,-849,14.287667487,11.245556467,-14.95419743,0.4443532951,3.04211102,-14.50984413
01113,2017,821,642,-1309,-3,179,-1312,14.250750725,11.143705195,-22.7213553,-0.052073389,3.1070455295,-22.77342869
20167,2010,30,14,17,0,16,17,NA,NA,NA,NA,NA,NA
20167,2011,83,105,7,0,-22,7,11.863074394,15.007503752,1.0005002501,0,-3.144429358,1.0005002501
20167,2012,86,91,11,-3,-5,8,12.302410414,13.017666834,1.5735641227,-0.429153852,-0.715256419,1.1444102711
20167,2013,88,89,-7,-5,-1,-12,12.598425197,12.74158912,-1.002147459,-0.715819613,-0.143163923,-1.717967072
20167,2014,79,91,48,-5,-12,43,11.297819092,13.013943511,6.8644976761,-0.715051841,-1.716124419,6.1494458348
20167,2015,92,89,41,-5,3,36,13.094221463,12.667235981,5.8354682607,-0.711642471,0.4269854825,5.1238257899
20167,2016,70,81,-38,-5,-11,-43,9.9750623441,11.542572141,-5.415033844,-0.712504453,-1.567509797,-6.127538297
20167,2017,71,91,-51,-5,-20,-56,10.212153901,13.088816972,-7.335490831,-0.719165768,-2.876663071,-8.054656598
21207,2010,60,37,-21,3,23,-18,NA,NA,NA,NA,NA,NA
21207,2011,222,237,111,15,-15,126,12.593243895,13.444138753,6.2966219474,0.8508948578,-0.850894858,7.1475168052
21207,2012,232,224,-114,18,8,-96,13.151554661,12.698052776,-6.462401859,1.020379241,0.4535018849,-5.442022618
21207,2013,224,213,91,7,11,98,12.69121813,12.067988669,5.1558073654,0.3966005666,0.6232294618,5.552407932
21207,2014,189,230,76,14,-41,90,10.662003216,12.974924548,4.2873663724,0.789778016,-2.312921332,5.0771443883
21207,2015,222,234,-96,17,-12,-79,12.539893241,13.217725309,-5.422656537,0.9602620951,-0.677832067,-4.462394442
21207,2016,209,241,129,17,-32,146,11.798910436,13.605442177,7.2825810822,0.9597199876,-1.806531741,8.2423010698
21207,2017,210,222,1,17,-12,18,11.816007877,12.491208327,0.0562667042,0.956533971,-0.67520045,1.0128006752
51167,2010,69,111,-1,2,-42,1,NA,NA,NA,NA,NA,NA
51167,2011,249,359,-82,-4,-110,-86,8.6593635889,12.484785255,-2.851677969,-0.139106242,-3.825421666,-2.990784211
51167,2012,267,331,-200,6,-64,-194,9.3592260236,11.602636007,-7.010656197,0.2103196859,-2.243409983,-6.800336511
51167,2013,288,356,-27,7,-68,-20,10.157117918,12.555326315,-0.952229805,0.2468743938,-2.398208397,-0.705355411
51167,2014,268,346,-198,11,-78,-187,9.5111347707,12.279300861,-7.026883151,0.3903823973,-2.76816609,-6.636500754
51167,2015,237,364,-104,11,-127,-93,8.4836769759,13.02978236,-3.72279496,0.3937571592,-4.546105384,-3.329037801
51167,2016,246,355,-334,11,-109,-323,8.9098152843,12.857660268,-12.09706628,0.3984063745,-3.947844984,-11.69865991
51167,2017,235,364,-229,11,-129,-218,8.6330406671,13.372028948,-8.412622608,0.4040997759,-4.738988281,-8.008522832
37161,2010,156,203,-28,4,-47,-24,NA,NA,NA,NA,NA,NA
37161,2011,716,825,-220,14,-109,-206,10.595791281,12.208837719,-3.255690058,0.2071802764,-1.613046438,-3.048509782
37161,2012,682,789,-97,17,-107,-80,10.131546695,11.721100209,-1.440997111,0.2525458854,-1.589553514,-1.1884512250000001
37161,2013,687,873,-205,13,-186,-192,10.250289082,13.025476519,-3.058674326,0.1939647133,-2.775187437,-2.864709612
37161,2014,629,828,-78,13,-199,-65,9.4312039404,12.415002961,-1.169529264,0.1949215441,-2.983799021,-0.97460772
37161,2015,699,903,13,17,-204,30,10.51681336,13.586097946,0.1955916648,0.2557737155,-3.069284586,0.4513653803
37161,2016,663,843,96,18,-180,114,9.9941211052,12.707457152,1.4471125582,0.2713336047,-2.713336047,1.7184461629
37161,2017,660,833,405,18,-173,423,9.9355693382,12.539892816,6.0968266394,0.2709700729,-2.604323478,6.3677967122
47149,2010,933,326,453,74,607,527,NA,NA,NA,NA,NA,NA
47149,2011,3686,1583,2678,394,2103,3072,13.838596017,5.943162641,10.054194285,1.4792205184,7.8954333759,11.533414803
47149,2012,3653,1622,2666,426,2031,3092,13.452650574,5.9732272736,9.8178939034,1.5688007513,7.4794233,11.386694655
47149,2013,3652,1660,4275,446,1992,4721,13.159459352,5.9815724329,15.404350693,1.6070971717,7.1778869195,17.011447865
47149,2014,3858,1619,4771,580,2239,5351,13.548203581,5.6854695692,16.754401059,2.0367957691,7.862734012,18.791196828
47149,2015,3978,1815,6368,683,2163,7051,13.564569807,6.1889628458,21.714223362,2.3289595723,7.3756069616,24.043182934
47149,2016,4134,1873,6793,695,2261,7488,13.652508326,6.1855704149,22.43383867,2.2952330157,7.4669379115,24.729071686
47149,2017,4173,1922,6494,696,2251,7190,13.357019397,6.1519749056,20.786121247,2.2277703092,7.2050444914,23.013891556
50021,2010,141,131,-83,-1,10,-84,NA,NA,NA,NA,NA,NA
50021,2011,545,668,-251,-3,-123,-254,8.8784628041,10.882225969,-4.088980117,-0.048872272,-2.003763165,-4.137852389
50021,2012,564,645,-346,8,-81,-338,9.2480241367,10.576197816,-5.673433247,0.1311776473,-1.328173679,-5.5422556
50021,2013,535,695,-149,21,-160,-128,8.8237962115,11.462688536,-2.457468478,0.3463546176,-2.638892325,-2.11111386
50021,2014,591,670,-365,24,-79,-341,9.8046534777,11.115258596,-6.055327444,0.3981585169,-1.310605118,-5.657168927
50021,2015,520,682,-362,24,-162,-338,8.6931808683,11.401441062,-6.051791297,0.4012237324,-2.708260194,-5.650567564
50021,2016,509,677,-246,22,-168,-224,8.5734979535,11.403257592,-4.143576614,0.3705637622,-2.829759639,-3.773012852
50021,2017,499,629,28,21,-130,49,8.4391040005,10.637668169,0.4735368978,0.3551526734,-2.198564168,0.8286895712
48403,2010,23,23,32,0,0,32,NA,NA,NA,NA,NA,NA
48403,2011,92,177,-56,-2,-85,-58,8.5204908544,16.392683492,-5.186385737,-0.185228062,-7.872192637,-5.371613799
48403,2012,93,155,-138,-3,-62,-141,8.7541770603,14.5902951,-12.99006919,-0.282392808,-5.83611804,-13.27246199
48403,2013,74,183,14,-3,-109,11,7.066125567,17.474337551,1.3368345667,-0.28646455,-10.40821198,1.0503700167
48403,2014,95,174,88,-4,-79,84,9.1122727927,16.68984701,8.4408421658,-0.383674644,-7.577574217,8.0571675219
48403,2015,91,181,114,-4,-90,110,8.7185628743,17.341317365,10.922155689,-0.383233533,-8.622754491,10.538922156
48403,2016,113,175,6,-4,-62,2,10.848694316,16.801075269,0.5760368664,-0.384024578,-5.952380952,0.19201228880000001
48403,2017,108,158,129,-4,-50,125,10.361700086,15.15878346,12.376475103,-0.38376667,-4.797083373,11.992708433
22085,2010,66,44,-18,0,22,-18,NA,NA,NA,NA,NA,NA
22085,2011,296,274,167,0,22,167,12.166550208,11.262279584,6.8642360968,0,0.9042706235,6.8642360968
22085,2012,320,276,-141,0,44,-141,13.127935837,11.32284466,-5.784496728,0,1.8050911776,-5.784496728
22085,2013,313,322,-62,10,-9,-52,12.884104802,13.254574269,-2.552122996,0.4116327413,-0.370469467,-2.140490255
22085,2014,288,277,-166,15,11,-151,11.905007957,11.450302792,-6.861914309,0.6200524978,0.454705165,-6.241861811
22085,2015,284,286,94,17,-2,111,11.74743025,11.830158632,3.8882339559,0.7031912473,-0.082728382,4.5914252032
22085,2016,260,239,-173,17,21,-156,10.761143992,9.8919746699,-7.160299656,0.703613261,0.8691693225,-6.456686395
22085,2017,252,224,-117,17,28,-100,10.475774771,9.3117997963,-4.863752572,0.7066990917,1.1639749745,-4.15705348
19161,2010,34,38,10,0,-4,10,NA,NA,NA,NA,NA,NA
19161,2011,90,142,-82,1,-52,-81,8.7480559876,13.802488336,-7.970451011,0.0972006221,-5.054432348,-7.873250389
19161,2012,110,135,-34,0,-25,-34,10.793308149,13.246332728,-3.336113428,0,-2.453024579,-3.336113428
19161,2013,105,142,-93,0,-37,-93,10.399643441,14.064279701,-9.211112762,0,-3.66463626,-9.211112762
19161,2014,133,150,34,0,-17,34,13.247011952,14.940239044,3.3864541833,0,-1.693227092,3.3864541833
19161,2015,111,145,-47,0,-34,-47,11.092235435,14.4898571,-4.696712301,0,-3.397621665,-4.696712301
19161,2016,109,127,-130,0,-18,-130,11.019005257,12.838657501,-13.14193288,0,-1.819652244,-13.14193288
19161,2017,111,115,3,0,-4,3,11.306340718,11.71377642,0.3055767762,0,-0.407435702,0.3055767762
06067,2010,5027,2493,-410,925,2534,515,NA,NA,NA,NA,NA,NA
06067,2011,20194,10214,-1295,4373,9980,3078,14.140679241,7.15226789,-0.906812896,3.0621565971,6.9884113513,2.1553437013
06067,2012,19533,10477,-932,4172,9056,3240,13.559446751,7.2729393136,-0.646977135,2.8961251137,6.2865074376,2.249147979
06067,2013,19410,10438,-459,4571,8972,4112,13.358297268,7.183611895,-0.315891728,3.1458411546,6.1746853729,2.8299494264
06067,2014,19652,10679,4063,5169,8973,9232,13.382381181,7.2720562098,2.7667725799,3.5199230779,6.1103249715,6.2866956577
06067,2015,19785,11246,4475,5705,8539,10180,13.306869802,7.5637633455,3.0097671146,3.8370327126,5.7431064563,6.8467998273
06067,2016,19436,12014,4006,5703,7422,9709,12.916903426,7.9843423418,2.6623335626,3.7901368716,4.9325610838,6.4524704342
06067,2017,19385,11843,4174,5654,7542,9828,12.73705392,7.7815284793,2.7425567738,3.7150014373,4.9555254404,6.4575582112
23023,2010,96,48,-116,4,48,-112,NA,NA,NA,NA,NA,NA
23023,2011,326,338,-105,8,-12,-97,9.26689218,9.6080047756,-2.984735211,0.2274083971,-0.341112596,-2.757326814
23023,2012,352,306,-53,8,46,-45,10.022065627,8.7123638693,-1.5090042,0.2277742188,1.3097017581,-1.281229981
23023,2013,322,349,-67,1,-27,-66,9.1801970036,9.9499650753,-1.910165215,0.0285099286,-0.769768072,-1.881655286
23023,2014,354,333,42,-6,21,36,10.098704855,9.4996291436,1.1981514235,-0.171164489,0.5990757118,1.0269869344
23023,2015,343,392,92,-5,-49,87,9.7731935263,11.16936403,2.621381354,-0.142466378,-1.396170504,2.4789149761
23023,2016,319,388,95,-6,-69,89,9.0823676793,11.04689235,2.7047803434,-0.170828232,-1.96452467,2.5339521112
23023,2017,324,401,342,-6,-77,336,9.1882311237,11.371853952,9.6986884084,-0.170152428,-2.183622829,9.5285359801
26145,2010,585,546,-394,29,39,-365,NA,NA,NA,NA,NA,NA
26145,2011,2229,1995,-1407,140,234,-1267,11.181788083,10.007926077,-7.058221549,0.7023106019,1.173862006,-6.355910947
26145,2012,2374,2002,-1119,167,372,-952,11.957197865,10.083534173,-5.636101269,0.8411339695,1.8736636925,-4.794967299
26145,2013,2302,2042,-2052,162,260,-1890,11.658795376,10.341989643,-10.39263602,0.8204712645,1.3168057332,-9.572164753
26145,2014,2295,2001,-2091,183,294,-1908,11.718151647,10.217002808,-10.67653817,0.9343885627,1.5011488384,-9.742149604
26145,2015,2163,2088,-2241,192,75,-2049,11.145118407,10.758671861,-11.54702282,0.9893031596,0.3864465467,-10.55771966
26145,2016,2258,2139,-1129,199,119,-930,11.718243198,11.100674136,-5.859121599,1.0327415396,0.6175690613,-4.826380059
26145,2017,2174,2099,-618,196,75,-422,11.316462747,10.926060398,-3.216915353,1.0202514712,0.3904023487,-2.196663882
08109,2010,18,1,8,2,17,10,NA,NA,NA,NA,NA,NA
08109,2011,72,37,-3,10,35,7,11.69495655,6.0099082271,-0.487289856,1.6242995208,5.6850483229,1.1370096646
08109,2012,70,30,99,3,40,102,11.202688645,4.8011522765,15.843802513,0.4801152277,6.4015363687,16.32391774
08109,2013,76,33,-138,6,43,-132,12.109623964,5.258126195,-21.98852772,0.9560229446,6.8514977693,-21.03250478
08109,2014,56,47,-61,5,9,-56,9.0191657272,7.5696569496,-9.824448381,0.8052826542,1.4495087776,-9.019165727
08109,2015,78,60,31,5,18,36,12.555331992,9.6579476861,4.9899396378,0.8048289738,2.8973843058,5.7947686117
08109,2016,75,39,126,5,36,131,11.861458169,6.1679582477,19.927249723,0.7907638779,5.6934999209,20.718013601
08109,2017,70,51,192,5,19,197,10.74196271,7.8262871173,29.463669148,0.7672830507,2.9156755927,30.230952198
51775,2010,57,41,35,12,16,47,NA,NA,NA,NA,NA,NA
51775,2011,235,283,90,91,-48,181,9.4212921202,11.345641149,3.608154429,3.6482450338,-1.924349029,7.2563994628
51775,2012,244,310,151,64,-66,215,9.7277040226,12.358968225,6.020013555,2.551528924,-2.631264203,8.571542479
51775,2013,228,323,188,58,-95,246,9.0356074266,12.800443854,7.4504131413,2.2985317138,-3.764836428,9.7489448551
51775,2014,233,266,108,51,-33,159,9.1831707557,10.483791507,4.2565770027,2.0100502513,-1.300620751,6.2666272539
51775,2015,306,334,-15,57,-28,42,12.02735634,13.12789875,-0.589576291,2.2403899065,-1.10054241,1.6508136153
51775,2016,356,329,19,51,27,70,13.961879363,12.902972782,0.7451564829,2.000156875,1.0589065809,2.7453133579
51775,2017,355,298,212,50,57,262,13.810811337,11.593300784,8.247583108,1.9451846953,2.2175105526,10.192767803
34033,2010,200,201,-94,8,-1,-86,NA,NA,NA,NA,NA,NA
34033,2011,727,697,-159,34,30,-125,11.026428544,10.571417738,-2.411557274,0.515678914,0.4550108065,-1.89587836
34033,2012,717,692,-483,16,25,-467,10.919142002,10.53841878,-7.355572646,0.243662862,0.3807232218,-7.111909784
34033,2013,699,713,-640,37,-14,-603,10.730239627,10.945151436,-9.824539858,0.5679812106,-0.214911809,-9.256558648
34033,2014,670,712,-476,33,-42,-443,10.371517028,11.021671827,-7.368421053,0.5108359133,-0.650154799,-6.857585139
34033,2015,674,714,-637,41,-40,-596,10.523850418,11.148411273,-9.946131626,0.640174877,-0.624560856,-9.305956749
34033,2016,644,755,-505,45,-111,-460,10.150684068,11.900258496,-7.95977555,0.7092869302,-1.749574428,-7.25048862
34033,2017,644,769,-286,46,-125,-240,10.22628027,12.211194919,-4.541484716,0.7304485907,-1.984914649,-3.811036125
05125,2010,287,248,439,13,39,452,NA,NA,NA,NA,NA,NA
05125,2011,1300,909,1404,46,391,1450,11.97312494,8.3719773616,12.930974935,0.4236644209,3.601147578,13.354639356
05125,2012,1321,917,1357,71,404,1428,11.961841635,8.3035645564,12.287826721,0.6429150311,3.6582770783,12.930741752
05125,2013,1411,1035,1480,43,376,1523,12.562545629,9.2149076729,13.176872808,0.3828415748,3.3476379565,13.559714382
05125,2014,1345,1079,1173,57,266,1230,11.79529679,9.462546644,10.286901959,0.4998750312,2.3327501458,10.78677699
05125,2015,1376,1116,1201,60,260,1261,11.9090378,9.6587835645,10.394443603,0.519289439,2.2502542355,10.913733042
05125,2016,1337,1091,966,62,246,1028,11.433164729,9.3295308298,8.2606111655,0.5301841535,2.1036338993,8.790795319
05125,2017,1353,1074,1403,62,279,1465,11.422541157,9.067116927,11.844660194,0.5234276066,2.3554242296,12.368087801
17165,2010,70,116,32,2,-46,34,NA,NA,NA,NA,NA,NA
17165,2011,311,359,45,7,-48,52,12.489207477,14.416802201,1.807120053,0.2811075638,-1.927594723,2.0882276168
17165,2012,317,327,15,6,-10,21,12.727856741,13.129366418,0.6022645146,0.2409058058,-0.401509676,0.8431703204
17165,2013,311,354,-69,4,-43,-65,12.512824639,14.242893641,-2.776157235,0.1609366513,-1.730069002,-2.615220584
17165,2014,309,369,-250,4,-60,-246,12.536768435,14.971092403,-10.14301653,0.1622882645,-2.434323968,-9.980728269
17165,2015,370,360,-8,4,10,-4,15.103890272,14.695677022,-0.3265706,0.1632853002,0.4082132506,-0.1632853
17165,2016,325,346,-227,3,-21,-224,13.333059835,14.194580624,-9.312629485,0.1230743985,-0.861520789,-9.189555086
17165,2017,332,329,-158,3,3,-155,13.731775411,13.607693103,-6.535001551,0.1240823079,0.1240823079,-6.410919243
20169,2010,207,89,46,20,118,66,NA,NA,NA,NA,NA,NA
20169,2011,787,554,-277,50,233,-227,14.099141869,9.9249359537,-4.962467977,0.8957523424,4.1742059155,-4.066715634
20169,2012,774,532,-208,43,242,-165,13.856192769,9.5238947717,-3.723628031,0.7697884872,4.3322979977,-2.953839544
20169,2013,772,529,-355,29,243,-326,13.821997028,9.4712907095,-6.355970136,0.5192200956,4.3507063184,-5.83675004
20169,2014,738,576,-424,18,162,-406,13.252406263,10.343341474,-7.613848585,0.3232294211,2.9090647895,-7.290619164
20169,2015,766,529,-335,25,237,-310,13.794718028,9.5266394734,-6.032938041,0.4502192568,4.2680785543,-5.582718784
20169,2016,704,499,-655,29,205,-626,12.735051239,9.0266911479,-11.84866273,0.5245972811,3.7083600908,-11.32406545
20169,2017,696,482,-579,29,214,-550,12.677133802,8.7792794434,-10.5460639,0.5282139084,3.8978543587,-10.01784999
29195,2010,73,37,6,8,36,14,NA,NA,NA,NA,NA,NA
29195,2011,311,245,-188,40,66,-148,13.303959104,10.48061087,-8.042264668,1.711120142,2.8233482343,-6.331144525
29195,2012,325,262,40,44,63,84,13.884438748000001,11.192993699,1.7088539998,1.8797393998,2.6914450497,3.5885933996
29195,2013,301,252,-335,25,49,-310,12.889964242,10.79159797,-14.34597349,1.0705950367,2.098366272,-13.27537846
29195,2014,302,285,16,22,17,38,12.988967979,12.257800908,0.6881572439,0.9462162104,0.7311670717,1.6343734543
29195,2015,269,246,-291,24,23,-267,11.616859561,10.623596476,-12.56693729,1.0364484367,0.9932630852,-11.53048886
29195,2016,255,239,-223,22,16,-201,11.11425894,10.416893674,-9.719528407,0.9588772419,0.6973652669,-8.760651165
29195,2017,244,237,-222,23,7,-199,10.722446827,10.414835648,-9.755668835,1.0107224468,0.3076111795,-8.744946388
31151,2010,48,27,-7,8,21,1,NA,NA,NA,NA,NA,NA
31151,2011,205,132,2,42,73,44,14.357250411,9.2446685576,0.1400707357,2.9414854502,5.1125818538,3.0815561859
31151,2012,193,157,0,63,36,63,13.416287234,10.913767335,0,4.3794098224,2.5025198985,4.3794098224
31151,2013,183,149,-221,81,34,-140,12.72291167,10.359092015,-15.36482775,5.6314527062,2.3638196545,-9.733375048
31151,2014,182,137,-154,86,45,-68,12.708609734,9.5663710635,-10.75343901,6.0051672369,3.1422386705,-4.748271769
31151,2015,190,140,-212,97,50,-115,13.305788018,9.8042648552,-14.84645821,6.7929549354,3.5015231626,-8.053503274
31151,2016,184,144,-95,101,40,6,12.892376682,10.089686099,-6.656390135,7.076793722,2.802690583,0.4204035874
31151,2017,192,134,-13,101,58,88,13.363028953,9.3262806236,-0.904788419,7.0295100223,4.0367483296,6.1247216036
49035,2010,4755,1415,-422,543,3340,121,NA,NA,NA,NA,NA,NA
49035,2011,18005,5678,484,2651,12327,3135,17.301919211,5.4562786604,0.4651001887,2.5474805792,11.845640551,3.0125807679
49035,2012,17707,6008,1881,2671,11699,4552,16.76162745,5.6872342983,1.7805738541,2.5283959406,11.074393152,4.3089697946
49035,2013,18235,6190,1309,3050,12045,4359,16.999802827,5.7707035644,1.2203313353,2.8433999792,11.229099262,4.0637313146
49035,2014,17812,6153,-3997,2945,11659,-1052,16.400710648,5.6654824062,-3.680307684,2.7116602773,10.735228242,-0.968647406
49035,2015,17598,6592,-1081,3329,11006,2248,16.029928363,6.004619148,-0.984677382,3.0323691055,10.025309215,2.047691724
49035,2016,17507,6457,2597,3352,11050,5949,15.731319451,5.8020865766,2.3335943688,3.0120170675,9.9292328747,5.3456114363
49035,2017,17471,6497,-8,3326,10974,3318,15.4814207,5.7571284007,-0.007088968,2.947238581,9.7242922994,2.9401496127
45081,2010,54,26,15,1,28,16,NA,NA,NA,NA,NA,NA
45081,2011,239,202,-145,12,37,-133,12.030605054,10.168126447,-7.298902648,0.6040471157,1.8624786067,-6.694855532
45081,2012,271,213,14,16,58,30,13.645175096,10.724805518,0.7049167946,0.8056191939,2.9203695778,1.5105359885
45081,2013,229,201,105,58,28,163,11.450858814,10.050753807,5.2503937795,2.9002175163,1.4001050079,8.1506112958
45081,2014,253,208,-109,70,45,-39,12.589570064,10.350318471,-5.423964968,3.4832802548,2.2392515924,-1.940684713
45081,2015,277,241,-9,80,36,71,13.746557157,11.960000993,-0.446639041,3.9701248108,1.7865561649,3.5234857696
45081,2016,227,183,-33,82,44,49,11.210430145,9.0374833325,-1.629710109,4.0495826954,2.1729468122,2.4198725863
45081,2017,241,199,35,81,42,116,11.829091712,9.767590252,1.7179178835,3.9757528162,2.0615014602,5.6936706997
37163,2010,209,108,-59,23,101,-36,NA,NA,NA,NA,NA,NA
37163,2011,852,642,-275,90,210,-185,13.408454251,10.103553555,-4.327846149,1.4163860124,3.3049006956,-2.911460137
37163,2012,872,607,-126,80,265,-46,13.698307348,9.5354043121,-1.979342576,1.2567254448,4.1629030358,-0.722617131
37163,2013,834,606,-132,112,228,-20,13.059102617,9.4889882327,-2.066908328,1.7537403994,3.5701143846,-0.313167928
37163,2014,838,682,-381,151,156,-230,13.108804643,10.668502108,-5.959969653,2.3620877101,2.4403025349,-3.597881943
37163,2015,844,695,-543,176,149,-367,13.232780922,10.896662015,-8.513507157,2.7594424672,2.3361189069,-5.75406469
37163,2016,838,686,-646,185,152,-461,13.193110614,10.800088164,-10.17034541,2.9125602192,2.3930224503,-7.257785195
37163,2017,799,687,-229,185,112,-44,12.603219421,10.836560378,-3.612186793,2.9181421687,1.7666590427,-0.694044624
48405,2010,23,17,-11,-1,6,-12,NA,NA,NA,NA,NA,NA
48405,2011,93,183,24,0,-90,24,10.538243626,20.736543909,2.7195467422,0,-10.19830028,2.7195467422
48405,2012,119,135,14,0,-16,14,13.536571494,15.35661472,1.5925378228,0,-1.820043226,1.5925378228
48405,2013,105,136,-95,0,-31,-95,12.032315361,15.58471323,-10.88638056,0,-3.552397869,-10.88638056
48405,2014,82,130,-146,0,-48,-146,9.5699363949,15.171850382,-17.03915504,0,-5.601913987,-17.03915504
48405,2015,105,141,-96,0,-36,-96,12.49033486,16.772735383,-11.41973473,0,-4.282400523,-11.41973473
48405,2016,76,117,-16,0,-41,-16,9.1439571678,14.076881429,-1.925043614,0,-4.932924262,-1.925043614
48405,2017,82,131,20,0,-49,20,9.9177552008,15.844218674,2.4189646831,0,-5.926463474,2.4189646831
06069,2010,190,34,97,7,156,104,NA,NA,NA,NA,NA,NA
06069,2011,761,267,-4,18,494,14,13.642149042,4.7864044601,-0.071706434,0.3226789524,8.8557445817,0.2509725185
06069,2012,716,277,224,11,439,235,12.70235508,4.91417927,3.9739211425,0.1951479132,7.7881758105,4.1690690558
06069,2013,742,321,270,-19,421,251,13.009441488,5.6280737435,4.733893803,-0.33312586,7.3813677447,4.4007679428
06069,2014,726,311,211,-14,415,197,12.588431128,5.3925648495,3.658621168,-0.242752115,7.1958662783,3.4158690526
06069,2015,719,298,-35,11,421,-24,12.360535681,5.1230036617,-0.601695061,0.189104162,7.2375320188,-0.412590899
06069,2016,710,331,580,13,379,593,12.064673447,5.6245167758,9.8556487311,0.2209024716,6.4401566708,10.076551203
06069,2017,725,330,564,13,395,577,12.119185925,5.5163191107,9.4278908437,0.2173095407,6.6028668143000004,9.6452003845
06071,2010,7464,3062,1143,607,4402,1750,NA,NA,NA,NA,NA,NA
06071,2011,31440,12191,-44,2183,19249,2139,15.323074899,5.9415905245,-0.021444507,1.0639399651,9.3814843741,1.0424954583
06071,2012,30167,12087,-6753,2998,18080,-3755,14.577014348,5.8405665934,-3.263121222,1.4486653965,8.7364477545,-1.814455825
06071,2013,30563,12703,-10160,2428,17860,-7732,14.681986764,6.1023223461,-4.880704954,1.1663731919,8.5796644179,-3.714331763
06071,2014,30677,12871,-2858,2653,17806,-205,14.640268972,6.1425465964,-1.363949823,1.2661157735,8.4977223756,-0.09783405
06071,2015,31244,13188,-4519,3401,18056,-1118,14.790647297,6.2430884826,-2.139256662,1.6100048475,8.5475588142,-0.529251814
06071,2016,30275,14424,-2745,3226,15851,481,14.220541696,6.7751310791,-1.289360428,1.515292073,7.4454106167,0.2259316451
06071,2017,30317,14611,1664,2976,15706,4640,14.118874337,6.8044619499,0.774938381,1.3859474891,7.3144123869,2.1608858701
06073,2010,10717,4674,-257,2985,6043,2728,NA,NA,NA,NA,NA,NA
06073,2011,44688,19671,-89,11449,25017,11360,14.314910083,6.3012127696,-0.028509376,3.6674589497,8.0136973137,3.6389495736
06073,2012,43831,19883,-336,16843,23948,16507,13.871524385,6.2925217163,-0.106336433,5.3304301799,7.5790026687,5.224093747
06073,2013,43742,20733,-583,14655,23009,14072,13.677239413,6.4827901043,-0.182292318,4.5823223353,7.1944493084,4.4000300173
06073,2014,44246,19890,857,15536,24356,16393,13.670102421,6.1451506836,0.2647759747,4.7999527914,7.5249517371,5.0647287661
06073,2015,44442,20621,-8528,18359,23821,9831,13.576462455,6.2994516963,-2.605194902,5.608439634,7.2770107588,3.0032447324
06073,2016,43744,22285,-11260,16990,21459,5730,13.241224329,6.745626467,-3.408380257,5.1428401918,6.495597862,1.7344599352
06073,2017,43652,22715,-15784,15445,20937,-339,13.118784171,6.8265642457,-4.743583097,4.6417030497,6.2922199257,-0.101880048
06075,2010,2120,1270,-1656,1419,850,-237,NA,NA,NA,NA,NA,NA
06075,2011,8898,5761,642,6677,3137,7319,10.971207055,7.1032955543,0.7915840559,8.2327207804,3.8679115004,9.0243048363
06075,2012,8782,5553,3751,6943,3229,10694,10.666180847,6.7443978867,4.5557782231,8.4326228214,3.9217829599,12.988401045
06075,2013,9098,5772,719,6753,3326,7472,10.884884391,6.9056443952,0.8602145392,8.0793168054,3.9792399963,8.9395313446
06075,2014,8948,5492,792,7647,3456,8439,10.561052989,6.4820410167,0.9347735771,9.0255221513,4.0790119727,9.9602957284
06075,2015,9107,5672,1353,8214,3435,9567,10.592133651,6.5969673955,1.5736419052,9.5535067325,3.9951662559,11.127148638
06075,2016,8898,6100,-1334,8304,2798,6970,10.213363804,7.001744123,-1.531201092,9.5315546225,3.2116196813,8.0003535307
06075,2017,9033,6300,-2689,8244,2733,5555,10.262055615,7.1571958788,-3.054872971,9.3657020357,3.104859736,6.3108290646
48407,2010,78,45,64,-1,33,63,NA,NA,NA,NA,NA,NA
48407,2011,255,283,337,-8,-28,329,9.5765655807,10.628110037,12.65608863,-0.300441273,-1.051544456,12.355647357
48407,2012,270,275,187,-16,-5,171,10.050812441,10.236938597,6.9611182459,-0.5956037,-0.186126156,6.3655145458
48407,2013,279,297,-173,-14,-18,-187,10.39435203,11.064955386,-6.445243373,-0.521580389,-0.670603357,-6.966823762
48407,2014,295,281,320,-16,14,304,10.96796981,10.447455989,11.897458777,-0.594872939,0.5205138215,11.302585838
48407,2015,277,302,343,-15,-25,328,10.180642079,11.099472591,12.606354632,-0.551298308,-0.918830513,12.055056324
48407,2016,296,319,433,-15,-23,418,10.74059291,11.575166007,15.711745709,-0.544286803,-0.834573098,15.167458906
48407,2017,299,303,531,-15,-4,516,10.673425313,10.816213611,18.955146626,-0.535456119,-0.142788298,18.419690506
06077,2010,2547,1092,330,264,1455,594,NA,NA,NA,NA,NA,NA
06077,2011,10549,4757,661,1424,5792,2085,15.262282962,6.8824229833,0.9563341585,2.060241818,8.3798599788,3.0165759765
06077,2012,10083,4977,-372,1221,5106,849,14.445258659,7.1302243721,-0.532940218,1.7492473294,7.3150342865,1.2163071111
06077,2013,10049,4974,-3684,1375,5075,-2309,14.307630428,7.0819139962,-5.245229425,1.9577064223,7.2257164316,-3.287523003
06077,2014,9921,5401,3630,1618,4520,5248,14.000856619,7.6220770689,5.1227809221,2.2833772815,6.3787795504,7.4061582036
06077,2015,9985,5721,4284,1893,4264,6177,13.89412634,7.9607708353,5.9611855022,2.6341092801,5.9333555046,8.5952947823
06077,2016,10076,5541,4001,1922,4535,5923,13.820346469,7.6000932695,5.4878132415,2.6362352038,6.2202531993,8.1240484453
06077,2017,10019,5409,4646,1902,4610,6548,13.541769445,7.3108524732,6.279574892,2.5707601043,6.230916972,8.8503349963
08111,2010,0,1,9,0,-1,9,NA,NA,NA,NA,NA,NA
08111,2011,8,8,-18,0,0,-18,11.444921316,11.444921316,-25.75107296,0,0,-25.75107296
08111,2012,3,3,2,0,0,2,4.3415340087,4.3415340087,2.8943560058,0,0,2.8943560058
08111,2013,1,4,2,0,-3,2,1.446131598,5.7845263919,2.892263196,0,-4.338394794,2.892263196
08111,2014,7,3,17,0,4,17,9.9857346648,4.2796005706,24.2510699,0,5.7061340942,24.2510699
08111,2015,6,6,-24,0,0,-24,8.5775553967,8.5775553967,-34.31022159,0,0,-34.31022159
08111,2016,3,1,-2,0,2,-2,4.3572984749,1.452432825,-2.90486565,0,2.90486565,-2.90486565
08111,2017,6,3,23,0,3,23,8.547008547,4.2735042735,32.763532764,0,4.2735042735,32.763532764
35045,2010,457,201,-92,4,256,-88,NA,NA,NA,NA,NA,NA
35045,2011,1922,880,-1607,-21,1042,-1628,14.792922179,6.7730340884,-12.36848384,-0.161629223,8.019888091,-12.53011306
35045,2012,1865,895,-942,-6,970,-948,14.383440149,6.9025088113,-7.264986928,-0.046273802,7.4809313374,-7.31126073
35045,2013,1935,907,-1424,27,1028,-1397,14.942027251,7.003833962,-10.99609654,0.2084934035,7.9381932888,-10.78760314
35045,2014,1903,938,-1360,9,965,-1351,14.735831378,7.2633787875,-10.53112489,0.0696912677,7.4724525906,-10.46143363
35045,2015,1857,1023,-1694,14,834,-1680,14.446696203,7.9585192331,-13.17862325,0.1089142417,6.4881769701,-13.069709
35045,2016,1742,1062,-1049,15,680,-1034,13.614852851,8.3002145394,-8.19861116,0.1172346686,5.3146383115,-8.081376491
35045,2017,1700,1043,-1521,14,657,-1507,13.349142907,8.190091795,-11.94355668,0.1099341181,5.1590511115,-11.83362256
49037,2010,58,8,30,1,50,31,NA,NA,NA,NA,NA,NA
49037,2011,220,87,-132,9,133,-123,14.83379408,5.8660912953,-8.900276448,0.6068370305,8.9677027847,-8.293439417
49037,2012,245,96,42,7,149,49,16.403869974,6.427638847,2.8120919956,0.4686819993,9.9762311272,3.2807739948
49037,2013,281,94,-249,11,187,-238,18.719605623,6.2620744787,-16.58783559,0.7327959496,12.457531144,-15.85503964
49037,2014,240,98,-89,11,142,-78,15.978695073,6.5246338216,-5.925432756,0.7323568575,9.4540612517,-5.193075899
49037,2015,242,99,34,11,143,45,15.978870914,6.5368108287,2.2449653351,0.7263123143,9.4420600858,2.9712776494
49037,2016,245,114,-50,11,131,-39,16.030359538,7.4590244381,-3.271501947,0.7197304282,8.5713350999,-2.551771518
49037,2017,264,108,-141,11,156,-130,17.207104448,7.0392700016,-9.190158058,0.7169626854,10.167834447,-8.473195372
53055,2010,33,17,1,0,16,1,NA,NA,NA,NA,NA,NA
53055,2011,83,117,80,10,-34,90,5.2491778396,7.3994434607,5.0594485201,0.632431065,-2.150265621,5.6918795851
53055,2012,77,138,55,10,-61,65,4.8604974119,8.7110213357,3.4717838657,0.6312334301,-3.850523924,4.1030172958
53055,2013,84,145,105,20,-61,125,5.291005291,9.1332829428,6.6137566138,1.2597631645,-3.842277652,7.8735197783
53055,2014,95,144,123,20,-49,143,5.9546195312,9.0259496051,7.7096652877,1.2536041118,-3.071330074,8.9632693995
53055,2015,88,150,223,22,-62,245,5.4680461056,9.3205331345,13.856525927,1.3670115264,-3.852487029,15.223537453
53055,2016,81,148,154,23,-67,177,4.9872240864,9.1124588246,9.481882831,1.4161253579,-4.125234738,10.898008189
53055,2017,74,132,452,23,-58,475,4.4833540335,7.9973342219,27.384811124,1.3934749023,-3.513980188,28.778286026
06079,2010,704,516,52,19,188,71,NA,NA,NA,NA,NA,NA
06079,2011,2644,2260,827,152,384,979,9.7750518052,8.3553771103,3.0574764913,0.5619545667,1.4196746949,3.619431058
06079,2012,2628,2271,2666,170,357,2836,9.6347025267,8.3258787817,9.774017099,0.6232494024,1.3088237451,10.397266501
06079,2013,2632,2265,1043,213,367,1256,9.5648050063,8.2311106912,3.7903083668,0.774051469,1.3336943151,4.5643598358
06079,2014,2630,2264,1962,226,366,2188,9.4859036946,8.1658121539,7.0765562923,0.8151384924,1.3200915408,7.8916947847
06079,2015,2602,2360,1354,298,242,1652,9.3105471825,8.4446161994,4.844919633,1.0663117065,0.8659309832,5.9112313395
06079,2016,2680,2372,1269,306,308,1575,9.5257729027,8.4310198975,4.5105245573,1.0876442195,1.0947530052,5.5981687768
06079,2017,2644,2359,539,309,285,848,9.3479256196,8.340301262,1.9056474694,1.0924769351,1.0076243576,2.9981244045
06081,2010,2286,1111,-596,884,1175,288,NA,NA,NA,NA,NA,NA
06081,2011,9142,4556,518,4090,4586,4608,12.619045483,6.2888176788,0.7150148283,5.6455804009,6.330227804,6.3605952291
06081,2012,9010,4657,2968,4273,4353,7241,12.2612893,6.3374943695,4.0390129458,5.8149266568,5.9237949303,9.8539396026
06081,2013,9070,4716,808,4552,4354,5360,12.16642108,6.3260024051,1.0838443476,6.1060141959,5.8404186751,7.1898585436
06081,2014,8953,4543,-674,5143,4410,4469,11.86219817,6.0192076719,-0.893010339,6.8141723656,5.8429904982,5.9211620264
06081,2015,9172,4816,-2249,5598,4356,3349,12.021481911,6.3121954736,-2.947700918,7.337140835,5.7092864375,4.3894399172
06081,2016,8925,5060,-6767,5688,3865,-1079,11.618521942,6.5870835883,-8.809247953,7.4046109585,5.0314383535,-1.404636994
06081,2017,8948,5108,-7635,5660,3840,-1975,11.61345671,6.6295861506,-9.909336386,7.3460175435,4.9838705595,-2.563318842
08113,2010,17,7,-19,6,10,-13,NA,NA,NA,NA,NA,NA
08113,2011,74,18,35,20,56,55,9.9831365936,2.4283305228,4.7217537943,2.6981450253,7.5548060708,7.4198988196
08113,2012,72,29,37,11,43,48,9.5808383234,3.8589487691,4.9234863606,1.4637391883,5.7218895542,6.3872255489
08113,2013,68,25,-11,5,43,-6,8.9715680454,3.2983706049,-1.451283066,0.659674121,5.6731974405,-0.791608945
08113,2014,69,26,48,15,43,63,9.0184289635,3.398248595,6.2736897138,1.9605280356,5.6201803686,8.2342177493
08113,2015,67,23,20,18,44,38,8.6513009232,2.9698495707,2.5824778875,2.3242300988,5.6814513526,4.9067079863
08113,2016,68,18,110,20,50,130,8.6354689187000009,2.2858594196,13.969140898,2.5398437996,6.349609499,16.508984697
08113,2017,65,20,-63,21,45,-42,8.1601908229,2.5108279455,-7.909108028,2.6363693428,5.6493628774,-5.272738686
35047,2010,92,33,-47,4,59,-43,NA,NA,NA,NA,NA,NA
35047,2011,319,280,-147,37,39,-110,10.862162898,9.5341868701,-5.005448107,1.2598746935,1.3279760283,-3.745573413
35047,2012,335,266,-403,54,69,-349,11.474567563,9.1111491694,-13.80373352,1.8496317863,2.3634183936,-11.95410173
35047,2013,351,278,-464,74,73,-390,12.14385801,9.6182123272,-16.05341914,2.5602435691,2.525645683,-13.49317557
35047,2014,304,269,-438,64,35,-374,10.635506499,9.4110238424,-15.32352581,2.2390539997,1.2244826561,-13.08447181
35047,2015,313,284,-379,72,29,-307,11.067501149,10.04207772,-13.40122344,2.5458788586,1.0254234292,-10.85534458
35047,2016,250,293,-218,74,-43,-144,8.9126559715,10.445632799,-7.771836007,2.6381461676,-1.532976827,-5.13368984
35047,2017,277,274,-284,73,3,-211,9.9454258222,9.8377136292,-10.19675427,2.6209966968,0.107712193,-7.575757576
48409,2010,209,201,-427,11,8,-416,NA,NA,NA,NA,NA,NA
48409,2011,898,591,-315,31,307,-284,13.934903208,9.1709663654,-4.88807852,0.4810489972,4.7639368429,-4.407029522
48409,2012,923,615,459,43,308,502,14.230650632,9.4819611471,7.0767807586,0.6629663891,4.748689485,7.7397471477
48409,2013,973,630,479,47,343,526,14.809853956,9.5891140724,7.2907708582,0.7153783514,5.2207398839,8.0061492097
48409,2014,985,636,112,55,349,167,14.837465731,9.5803332028,1.6871027024,0.8284879342,5.2571325279,2.5155906366
48409,2015,1044,575,-77,63,469,-14,15.61448378,8.5999312006,-1.151642961,0.9422533315,7.0145525792,-0.209389629
48409,2016,1037,659,-261,62,378,-199,15.437750287,9.8104893335,-3.885489706,0.9229898918,5.6272609531,-2.962499814
48409,2017,1027,583,-555,63,444,-492,15.273987373,8.670627691,-8.254199603,0.9369631982,6.6033596823,-7.317236405
48411,2010,11,27,18,1,-16,19,NA,NA,NA,NA,NA,NA
48411,2011,61,65,-95,-1,-4,-96,10.023003615,10.680249754,-15.60959579,-0.164311535,-0.657246139,-15.77390733
48411,2012,81,69,-85,0,12,-85,13.497750375,11.498083653,-14.16430595,0,1.9996667222,-14.16430595
48411,2013,64,78,-276,7,-14,-269,10.982410982,13.384813385,-47.36164736,1.2012012012,-2.402402402,-46.16044616
48411,2014,66,56,102,9,10,111,11.472275335,9.7340517991,17.729880063,1.564401182,1.7382235355,19.294281245
48411,2015,63,57,81,14,6,95,10.738941447,9.7161851189,13.807210432,2.3864314327,1.0227563283,16.193641865
48411,2016,71,65,-66,14,6,-52,12.045126813,11.027228773,-11.19687845,2.3750954279,1.0178980405,-8.821783018
48411,2017,64,69,78,14,-5,92,10.819034739,11.664271828,13.185698588,2.3666638492,-0.845237089,15.552362438
46111,2010,5,4,-1,0,1,-1,NA,NA,NA,NA,NA,NA
46111,2011,28,25,-2,0,3,-2,11.89212147,10.617965598,-0.849437248,0,1.2741558717,-0.849437248
46111,2012,29,36,-32,1,-7,-31,12.411726942,15.407661031,-13.69569869,0.4279905842,-2.995934089,-13.26770811
46111,2013,35,32,4,1,3,5,15.073212748,13.781223084,1.7226528854,0.4306632214,1.2919896641,2.1533161068
46111,2014,35,34,2,1,1,3,15.034364261,14.604810997,0.8591065292,0.4295532646,0.4295532646,1.2886597938
46111,2015,38,27,3,1,11,4,16.256684492,11.550802139,1.2834224599,0.4278074866,4.7058823529,1.7112299465
46111,2016,39,22,16,1,17,17,16.514926953,9.3161126403,6.7753546475,0.4234596655,7.1988143129,7.1988143129
46111,2017,37,17,51,1,20,52,15.327257664,7.0422535211,21.126760563,0.4142502071,8.2850041425,21.541010771
30089,2010,24,17,-26,1,7,-25,NA,NA,NA,NA,NA,NA
30089,2011,83,134,45,6,-51,51,7.2851751075,11.761608005,3.949793733,0.5266391644,-4.476432897,4.4764328974
30089,2012,88,122,10,-1,-34,9,7.7335442482,10.721504526,0.8788118464,-0.087881185,-2.987960278,0.7909306617
30089,2013,110,138,-36,-1,-28,-37,9.7061678285,12.17682873,-3.176564017,-0.088237889,-2.470660902,-3.264801906
30089,2014,115,151,45,-3,-36,42,10.174740102,13.359876134,3.9814200398,-0.265428003,-3.185136032,3.7159920372
30089,2015,127,147,6,-3,-20,3,11.243415519,13.014032137,0.5311849852,-0.265592493,-1.770616617,0.2655924926
30089,2016,116,143,209,-2,-27,207,10.196905767,12.570323488,18.372011252,-0.17580872,-2.373417722,18.196202532
30089,2017,111,123,257,-2,-12,255,9.5784614057,10.613970747,22.17715839,-0.17258489,-1.035509341,22.0045735
35043,2010,371,160,548,10,211,558,NA,NA,NA,NA,NA,NA
35043,2011,1601,950,1127,26,651,1153,12.011178423,7.1271826997,8.4550893711,0.195059737,4.8839957237,8.6501491082
35043,2012,1474,888,471,5,586,476,10.940967763,6.5913021533,3.4960622908,0.0371131878,4.3496656102,3.5331754786
35043,2013,1445,990,480,-15,455,465,10.648607022,7.2955854339,3.5372535437,-0.110539173,3.3530215883,3.4267143705
35043,2014,1444,980,295,-23,464,272,10.578057124,7.1790138379,2.1610296757,-0.168487059,3.3990432865,1.9925426162
35043,2015,1467,1040,1053,-15,427,1038,10.661569656,7.5583043235,7.6527831275,-0.109014005,3.1032653328,7.5437691229
35043,2016,1465,1100,1557,-22,365,1535,10.518720091,7.8980150852,11.179281352,-0.157960302,2.6207050055,11.021321051
35043,2017,1475,1083,1909,-19,392,1890,10.433946048,7.6609922506,13.504002037,-0.134403373,2.7729537971,13.369598664
39143,2010,162,135,-94,4,27,-90,NA,NA,NA,NA,NA,NA
39143,2011,704,628,-379,13,76,-366,11.590480659,10.339235588,-6.239761605,0.2140287622,1.2512450712,-6.025732843
39143,2012,710,609,-254,10,101,-244,11.730689798,10.061957869,-4.19661297,0.1652209831,1.668731929,-4.031391987
39143,2013,674,650,-443,3,24,-440,11.187279035,10.78891895,-7.353063223,0.0497950105,0.3983600843,-7.303268213
39143,2014,623,635,-206,4,-12,-202,10.395201188,10.595429782,-3.437257536,0.0667428648,-0.200228594,-3.370514671
39143,2015,676,668,-380,4,8,-376,11.334959799,11.200818263,-6.371722964,0.067070768,0.1341415361,-6.304652196
39143,2016,677,638,-216,3,39,-213,11.403545711,10.746620626,-3.638354318,0.0505326989,0.6569250853,-3.58782162
39143,2017,683,613,-156,3,70,-153,11.529761302,10.348087376,-2.633444748,0.0506431682,1.1816739255,-2.58280158
17167,2010,625,498,162,26,127,188,NA,NA,NA,NA,NA,NA
17167,2011,2407,1800,437,191,607,628,12.13407472,9.0740899444,2.2029873921,0.9628617663,3.0599847757,3.1658491584
17167,2012,2339,1851,-331,222,488,-109,11.745210776,9.2947349921,-1.662105501,1.114765623,2.450475784,-0.547339878
17167,2013,2283,1835,-963,213,448,-750,11.462742322,9.2133737015,-4.835138351,1.0694542771,2.2493686203,-3.765684074
17167,2014,2263,1842,-671,230,421,-441,11.372030734,9.2564209511,-3.371910129,1.1557963185,2.1156097831,-2.216113811
17167,2015,2334,1967,-956,254,367,-702,11.740029275,9.8940178163,-4.808683799,1.2776210093,1.8460114583,-3.53106279
17167,2016,2275,2125,-1437,245,150,-1192,11.483374345,10.726228784,-7.253454477,1.2366710833,0.7571455612,-6.016783393
17167,2017,2235,2097,-1522,242,138,-1280,11.343939621,10.64350845,-7.725045236,1.2282923437,0.7004311712,-6.496752892
26151,2010,133,85,-70,0,48,-70,NA,NA,NA,NA,NA,NA
26151,2011,469,436,-434,2,33,-432,10.932655773,10.163407072,-10.11678594,0.0466211334,0.7692487004,-10.07016481
26151,2012,427,435,-402,6,-8,-396,10.04599513,10.234210495,-9.457822113,0.1411615241,-0.188215365,-9.316660589
26151,2013,441,468,-390,7,-27,-383,10.474437385,11.11572947,-9.263107891,0.1662609109,-0.641292085,-9.096846981
26151,2014,446,479,-213,7,-33,-206,10.675091851,11.464952908,-5.09819409,0.1675462847,-0.789861056,-4.930647806
26151,2015,417,489,-136,7,-72,-129,10.034531301,11.767112245,-3.272652894,0.1684453696,-1.732580944,-3.104207525
26151,2016,458,497,-30,8,-39,-22,11.056659344,11.998165271,-0.724235328,0.1931294209,-0.941505927,-0.531105907
26151,2017,423,483,-68,8,-60,-60,10.234572531,11.686284947,-1.645274071,0.1935616554,-1.451712416,-1.451712416
49039,2010,107,31,36,5,76,41,NA,NA,NA,NA,NA,NA
49039,2011,417,183,-189,16,234,-173,14.908031389,6.5423734873,-6.756877536,0.5720107967,8.3656579018,-6.184866739
49039,2012,394,177,-284,8,217,-276,14.082996747,6.3266254423,-10.15119562,0.2859491725,7.756371305,-9.865246452
49039,2013,385,212,-16,25,173,9,13.730874853,7.5608973216,-0.57063376,0.8916152502,6.1699775313,0.3209814901
49039,2014,388,174,-62,28,214,-34,13.750332241,6.1663861079,-2.197218038,0.9922920174,7.5839461327,-1.204926021
49039,2015,370,185,166,30,185,196,12.984050673,6.4920253364,5.8252767884,1.0527608654,6.4920253364,6.8780376537
49039,2016,394,180,373,31,214,404,13.58878408,6.2080739451,12.864508786,1.0691682905,7.3807101347,13.933677077
49039,2017,400,178,477,31,222,508,13.482085679,5.999528127,16.077387172,1.0448616401,7.4825575517,17.122248812
06083,2010,1511,763,-643,273,748,-370,NA,NA,NA,NA,NA,NA
06083,2011,5746,2865,-2439,1263,2881,-1176,13.513704204,6.7380373379,-5.736151158,2.9703808579,6.7756668658,-2.7657703
06083,2012,5638,2858,683,1356,2780,2039,13.159292087,6.6706734276,1.594146239,3.1649521231,6.4886186594,4.7590983621
06083,2013,5702,2984,1185,1279,2718,2464,13.156331225,6.8850389995,2.734172659,2.9510606167,6.2712922254,5.6852332757
06083,2014,5762,2978,537,1403,2784,1940,13.146126889,6.7943710302,1.2251770461,3.200974666,6.3517558589,4.4261517121
06083,2015,5814,2993,-1176,1695,2821,519,13.145592982,6.7672445467,-2.658964112,3.8324355184,6.3783484351,1.1734714065
06083,2016,5668,3178,-1830,1711,2490,-119,12.733888026,7.1397840766,-4.111329408,3.8439806655,5.5941039492,-0.267348743
06083,2017,5662,3182,-2292,1677,2480,-615,12.660350653,7.115018682,-5.124960031,3.7498071432,5.5453319709,-1.375152888
06085,2010,5866,2171,-2020,3227,3695,1207,NA,NA,NA,NA,NA,NA
06085,2011,24025,9154,-3015,15637,14871,12622,13.345909874,5.0850555251,-1.674835308,8.6863680627,8.2608543493,7.0115327548
06085,2012,23417,9313,-1553,15770,14104,14217,12.811296394,5.095084909,-0.84963673,8.6276698179,7.7162114846,7.7780330882
06085,2013,24178,9436,-2151,16724,14742,14573,13.024122206,5.0829521523,-1.158693311,9.0088270237,7.941170054,7.850133713
06085,2014,23415,9449,-7630,19237,13966,11607,12.43104592,5.0164831475,-4.050774306,10.21294172,7.4145627725,6.1621674138
06085,2015,23703,9948,-11297,20658,13755,9361,12.424694651,5.2145661893,-5.921688203,10.828559342,7.2101284614,4.9068711397
06085,2016,23230,10837,-20974,20911,12393,-63,12.065041115,5.6284481516,-10.89333501,10.860614496,6.4365929633,-0.032720516
06085,2017,23101,11030,-26293,20734,12071,-5559,11.939340439,5.7006590644,-13.58906879,10.715998644,6.238681375,-2.873070149
04023,2010,179,40,-143,-1,139,-144,NA,NA,NA,NA,NA,NA
04023,2011,711,273,-273,18,438,-255,14.962121212,5.7449494949,-5.744949495,0.3787878788,9.2171717172,-5.366161616
04023,2012,660,279,-704,-12,381,-716,13.908352387,5.8794398727,-14.83557588,-0.252879134,8.0289125144,-15.08845501
04023,2013,670,293,-849,10,377,-839,14.234573016,6.2249699905,-18.03754103,0.2124563137,8.0096030254,-17.82508472
04023,2014,619,288,-780,54,331,-726,13.267176063,6.1727733542,-16.71792783,1.1573950039,7.0944027092,-15.56053283
04023,2015,624,282,-719,92,342,-627,13.46874022,6.0868345223,-15.51926958,1.9857758016,7.3819056972,-13.53349378
04023,2016,640,312,-547,102,328,-445,13.872932608,6.7630546463,-11.85702209,2.2109986344,7.1098779615,-9.646023454
04023,2017,628,324,-272,106,304,-166,13.609717512,7.0215740028,-5.894654718,2.2971816182,6.5881435088,-3.5974731
06087,2010,811,437,403,46,374,449,NA,NA,NA,NA,NA,NA
06087,2011,3240,1698,67,313,1542,380,12.265316977,6.427934638,0.2536346412,1.1848901894,5.8373823391,1.4385248306
06087,2012,3163,1680,16,231,1483,247,11.89328009,6.3170125043,0.0601620239,0.8685892193,5.5762675856,0.9287512432
06087,2013,2986,1737,994,364,1249,1358,11.137863701,6.4790586901,3.707647863,1.3577302033,4.6588050109,5.0653780663
06087,2014,2893,1735,603,398,1158,1001,10.696511894,6.414949235,2.2295183797,1.4715560781,4.2815626594,3.7010744578
06087,2015,2983,1718,1006,505,1265,1511,10.930183135,6.2950233407,3.6861428875,1.8503997596,4.6351597939,5.5365426471
06087,2016,2833,1882,-570,517,951,-53,10.311285817,6.849925841,-2.074632162,1.8817277682,3.461359976,-0.192904394
06087,2017,2808,1923,-695,521,885,-174,10.190657475,6.9788583778,-2.522260308,1.8907879432,3.2117990974,-0.631472365
35049,2010,341,211,100,87,130,187,NA,NA,NA,NA,NA,NA
35049,2011,1484,1032,159,328,452,487,10.235718104,7.1181004604,1.0966840826,2.2623420068,3.1176176435,3.3590260894
35049,2012,1386,1062,227,195,324,422,9.5058142525,7.2836758558,1.5568685681,1.3373981091,2.2221383967,2.8942666772
35049,2013,1322,1111,136,113,211,249,9.0305172738,7.5891866045,0.9290093413,0.7718974674,1.4413306693,1.7009068088
35049,2014,1313,1086,78,89,227,167,8.9441721532,7.3978453605,0.5313369596,0.6062690949,1.5463267927,1.1376060545
35049,2015,1333,1140,-20,144,193,124,9.060045742,7.7482761785,-0.13593467,0.9787296225,1.3117695635,0.8427949527
35049,2016,1268,1224,481,145,44,626,8.5902330135,8.292149218,3.2585978545,0.9823215985,0.2980837954,4.240919453
35049,2017,1287,1173,550,148,114,698,8.67563441,7.9071632967,3.7075360726,0.9976642523,0.76847111319999994,4.7052003249
12113,2010,453,276,1178,50,177,1228,NA,NA,NA,NA,NA,NA
12113,2011,1792,1233,2190,18,559,2208,11.612309567,7.9899429105,14.191382785,0.1166415023,3.6223666561,14.308024287
12113,2012,1845,1287,1591,311,558,1902,11.754137839,8.1992278583,10.135953009,1.9813207956,3.5549099805,12.117273805
12113,2013,1853,1244,1468,132,609,1600,11.631191428,7.8085278665,9.2145650386,0.8285576193,3.8226635617,10.043122658
12113,2014,1836,1254,1637,122,582,1759,11.361772833,7.7601651046,10.130295276,0.7549761904,3.601607728,10.885271467
12113,2015,1819,1339,2881,203,480,3084,11.053282412,8.1365283943,17.506600675,1.2335438865,2.9167540174,18.740144562
12113,2016,1957,1397,3035,102,560,3137,11.633990037,8.3048973332,18.04249349,0.6063704567,3.3290927033,18.648863947
12113,2017,1951,1496,3725,18,455,3743,11.331987744,8.6892125401,21.635906893,0.1045493487,2.6427752044,21.740456242
12115,2010,690,1187,867,143,-497,1010,NA,NA,NA,NA,NA,NA
12115,2011,2832,4950,3682,724,-2118,4406,7.4310521945,12.988597586,9.6614174365,1.8997463944,-5.557545391,11.561163831
12115,2012,2966,5010,5691,654,-2044,6345,7.7148170787,13.031434108,14.802772756,1.7011093626,-5.316617029,16.503882119
12115,2013,2808,5165,5241,707,-2357,5948,7.2285713918,13.296143603,13.491788698,1.8200142358,-6.067572212,15.311802934
12115,2014,2879,5132,7691,893,-2253,8584,7.3159358566,13.041119422,19.543891168,2.2692360958,-5.725183565,21.813127264
12115,2015,2965,5450,9725,1000,-2485,10725,7.3946880452,13.592259645,24.25407799,2.4939925953,-6.197571599,26.748070585
12115,2016,2921,5737,9534,1014,-2816,10548,7.1415735666,14.02643189,23.309744055,2.4791357742,-6.884858324,25.788879829
12115,2017,2905,5864,8160,1020,-2959,9180,6.9831898634,14.096187731,19.615431768,2.451928971,-7.112997868,22.067360739
36091,2010,629,368,197,78,261,275,NA,NA,NA,NA,NA,NA
36091,2011,2170,1676,336,244,494,580,9.8354711508,7.5964284096,1.5229116621,1.1059239451,2.2390427412,2.6288356071
36091,2012,2193,1629,434,470,564,904,9.8842332282,7.342186926,1.9561136439,2.1183719185,2.5420463022,4.0744855624
36091,2013,2247,1723,757,447,524,1204,10.056075937,7.711000819,3.3878279861,2.0004743854,2.3450751185,5.3883023715
36091,2014,2242,1678,-433,450,564,17,9.9826350238,7.4713923149,-1.927957612,2.0036510976,2.5112427089,0.0756934859
36091,2015,2266,1785,697,525,481,1222,10.03936441,7.9083254509,3.0880127951,2.3259780738,2.131038959,5.4139908689
36091,2016,2142,1884,286,469,258,755,9.4338168421,8.2975307799,1.2596039294,2.0655742759,1.1362860622,3.3251782053
36091,2017,2160,1943,1701,394,217,2095,9.4440885908,8.4953074685,7.4372197653,1.7226717152,0.9487811223,9.1598914804
38081,2010,8,3,-24,0,5,-24,NA,NA,NA,NA,NA,NA
38081,2011,32,32,-24,2,0,-22,8.4188371481,8.4188371481,-6.314127861,0.5261773218,0,-5.787950539
38081,2012,30,35,105,2,-5,107,7.8094494338,9.1110243395,27.333073018,0.5206299623,-1.301574906,27.853702981
38081,2013,42,36,-24,3,6,-21,10.808028821,9.2640247041,-6.176016469,0.7720020587,1.5440041173,-5.404014411
38081,2014,39,38,38,6,1,44,9.9974365547,9.7410920277,9.7410920277,1.5380671623,0.256344527,11.27915919
38081,2015,43,39,-68,6,4,-62,11.041211966,10.01412248,-17.46052125,1.5406342278,1.0270894852,-15.919887020000001
38081,2016,46,27,-1,7,19,6,11.861784425,6.9623517277,-0.257864879,1.8050541516,4.8994326973,1.5471892728
38081,2017,42,31,-52,7,11,-45,10.841507486,8.002065049,-13.422818790000001,1.8069179143,2.8394424368,-11.61590088
31153,2010,634,142,301,87,492,388,NA,NA,NA,NA,NA,NA
31153,2011,2592,786,924,132,1806,1056,16.08279662,4.8769591601,5.7332191653,0.8190313093,11.20583746,6.5522504747
31153,2012,2609,796,797,530,1813,1327,15.893273228,4.8490017209,4.8550934316,3.2286066735,11.044271508,8.0837001051
31153,2013,2521,877,1419,315,1644,1734,15.059062467,5.2387139166,8.4763227454,1.8816361274,9.8203485507,10.357958873
31153,2014,2615,931,807,320,1684,1127,15.337963072,5.4606667762,4.733359923,1.8769209112,9.8772962954,6.6102808343
31153,2015,2577,921,1247,402,1656,1649,14.849645182,5.3071490929,7.1856839509,2.3164754998,9.5424960888,9.5021594507
31153,2016,2511,925,1247,304,1586,1551,14.205783015,5.233114014,7.0548034329,1.7198558489,8.9726690013,8.7746592818
31153,2017,2500,994,1390,218,1506,1608,13.897883908,5.5257986419,7.727223453,1.2118954768,8.3720852663,8.9391189298
55111,2010,202,112,-4,17,90,13,NA,NA,NA,NA,NA,NA
55111,2011,769,606,-35,75,163,40,12.36891205,9.7471530593,-0.562954385,1.2063308242,2.6217589912,0.6433764396
55111,2012,769,572,-95,50,197,-45,12.334886556,9.1749741352,-1.523815634,0.8020082286,3.1599124207,-0.721807406
55111,2013,750,565,189,37,185,226,11.977673616,9.023180791,3.0183737513,0.5908985651,2.9544928254,3.6092723164
55111,2014,765,609,-3,45,156,42,12.159938962,9.6802651344,-0.047686035,0.7152905272,2.4796738275,0.667604492
55111,2015,790,583,41,47,207,88,12.510194225,9.2322066241,0.6492632446,0.7442773779,3.2779876007,1.3935406225
55111,2016,757,666,172,51,91,223,11.931030135,10.496784769,2.7108813517,0.8038078426,1.4342453663,3.5146891943
55111,2017,762,621,189,51,141,240,11.944977858,9.7346866795,2.9627307285,0.799467022,2.2102911784,3.7621977505
31155,2010,70,33,50,2,37,52,NA,NA,NA,NA,NA,NA
31155,2011,269,193,-119,13,76,-106,12.897967012,9.2539317223,-5.705792098,0.6233218259,3.6440352896,-5.082470272
31155,2012,234,174,-115,11,60,-104,11.238923177,8.3571480032,-5.523402416,0.5283254485,2.8817751735,-4.995076967
31155,2013,235,190,30,8,45,38,11.276662108,9.1173012788,1.4395738861,0.3838863696,2.1593608292,1.8234602558
31155,2014,219,215,-24,11,4,-13,10.491269252,10.299647896,-1.149728137,0.5269587296,0.1916213562,-0.622769408
31155,2015,246,203,44,11,43,55,11.761331038,9.7054886212,2.1036527061,0.5259131765,2.0558424173,2.6295658826
31155,2016,249,235,7,12,14,19,11.869011869,11.201677868,0.3336670003,0.572000572,0.6673340007,0.9056675723
31155,2017,258,202,-6,12,56,6,12.270522211,9.6071530486,-0.285360982,0.5707219633,2.663369162,0.2853609816
55113,2010,47,46,9,1,1,10,NA,NA,NA,NA,NA,NA
55113,2011,163,182,9,0,-19,9,9.8426979862,10.99000634,0.543461852,0,-1.147308354,0.543461852
55113,2012,169,194,2,1,-25,3,10.21611002,11.727368898,0.1209007103,0.0604503551,-1.511258879,0.1813510654
55113,2013,175,221,6,1,-46,7,10.5999576,13.386232169,0.3634271177,0.0605711863,-2.786274569,0.423998304
55113,2014,162,227,-53,1,-65,-52,9.8603122432,13.816610366,-3.225904623,0.060866125,-3.956298122,-3.165038498
55113,2015,172,216,-27,1,-44,-26,10.530504791,13.224354854,-1.653044357,0.0612238651,-2.693850063,-1.591820492
55113,2016,153,193,91,1,-40,92,9.3735640986,11.824169092,5.5751263593,0.0612651248,-2.450604993,5.6363914841
55113,2017,169,198,98,1,-29,99,10.315571019,12.08569859,5.9818104132,0.0610388818,-1.770127571,6.042849295
36093,2010,451,356,-35,88,95,53,NA,NA,NA,NA,NA,NA
36093,2011,1824,1515,-583,350,309,-233,11.774730808,9.7799984507,-3.763524156,2.2594055827,1.9947323573,-1.504118574
36093,2012,1856,1514,-487,390,342,-97,11.970023347,9.7643401654,-3.140841255,2.5152527507,2.2056831813,-0.625588505
36093,2013,1839,1562,-628,420,277,-208,11.849379502,10.064562688,-4.046443897,2.706220441,1.7848168146,-1.340223456
36093,2014,1757,1495,-574,434,262,-140,11.314752325,9.627521187,-3.696452951,2.7948790603,1.6872311378,-0.90157389
36093,2015,1817,1657,-872,469,160,-403,11.706380525,10.675548998,-5.61803182,3.0216249126,1.0308315267,-2.596406908
36093,2016,1796,1424,-978,488,372,-490,11.584817181,9.1852893463,-6.308436082,3.1477676973,2.3995278348,-3.160668385
36093,2017,1782,1463,-208,488,319,280,11.476893253,9.4223876704,-1.339614925,3.1429427089,2.0545055823,1.8033277838
48413,2010,8,2,34,-1,6,33,NA,NA,NA,NA,NA,NA
48413,2011,41,21,-220,0,20,-220,12.041116006,6.1674008811,-64.61086637,0,5.8737151248,-64.61086637
48413,2012,31,26,-55,-1,5,-56,9.4440213252,7.9207920792,-16.75552171,-0.304645849,1.523229246,-17.06016756
48413,2013,42,29,-79,-2,13,-81,13.029315961,8.9964324492,-24.50752288,-0.620443617,4.0328835117,-25.1279665
48413,2014,46,32,-41,-1,14,-42,14.483627204,10.075566751,-12.9093199,-0.314861461,4.4080604534,-13.22418136
48413,2015,24,23,30,-1,1,29,7.5519194462,7.2372561359,9.4398993077,-0.31466331,0.3146633103,9.1252359975
48413,2016,29,18,-138,-1,11,-139,9.2696180278,5.7535560173,-44.11059613,-0.319642001,3.5160620105,-44.43023813
48413,2017,26,17,-72,-1,9,-73,8.5737840066,5.6059356966,-23.74278648,-0.329760923,2.96784831,-24.0725474
13249,2010,12,1,-3,0,11,-3,NA,NA,NA,NA,NA,NA
13249,2011,63,30,-9,0,33,-9,12.526096033,5.964807635,-1.78944229,0,6.5612883984,-1.78944229
13249,2012,48,40,-29,0,8,-29,9.5389507154,7.9491255962,-5.763116057,0,1.5898251192,-5.763116057
13249,2013,47,42,67,0,5,67,9.2931290163,8.3044982699,13.247652002,0,0.9886307464,13.247652002
13249,2014,49,31,74,0,18,74,9.53307393,6.0311284047,14.39688716,0,3.5019455253,14.39688716
13249,2015,41,48,11,0,-7,11,7.9020911631,9.2512286788,2.1200732389,0,-1.349137516,2.1200732389
13249,2016,57,20,-69,0,37,-69,11.016621569,3.8654812524,-13.33591032,0,7.151140317,-13.33591032
13249,2017,52,31,34,0,21,34,10.027962588,5.9782084659,6.5567447691,0,4.0497541221,6.5567447691
36095,2010,82,88,-32,2,-6,-30,NA,NA,NA,NA,NA,NA
36095,2011,300,266,-118,15,34,-103,9.1832986409,8.1425247949,-3.612097465,0.459164932,1.040773846,-3.152932533
36095,2012,266,252,-632,30,14,-602,8.2230740695,7.7902806974,-19.53752937,0.9274143687,0.4327933721,-18.610115
36095,2013,250,277,-120,10,-27,-110,7.8139651185,8.6578733513,-3.750703257,0.3125586047,-0.843908233,-3.438144652
36095,2014,271,290,-118,10,-19,-108,8.5058301031,9.1021798151,-3.70364558,0.3138682695,-0.596349712,-3.38977731
36095,2015,236,302,-277,10,-66,-267,7.461506845,9.5481994372,-8.757785577,0.3161655443,-2.086692592,-8.441620032
36095,2016,235,283,32,9,-48,41,7.4702778308,8.9961218132,1.0172293216,0.2860957467,-1.525843982,1.3033250683
36095,2017,228,280,12,9,-52,21,7.2527157922,8.9068439553,0.3817218838,0.2862914128,-1.654128163,0.6680132966
26153,2010,18,33,1,1,-15,2,NA,NA,NA,NA,NA,NA
26153,2011,71,106,39,1,-35,40,8.3805476865,12.511803588,4.6033994334,0.1180358829,-4.131255902,4.7214353163
26153,2012,83,107,-107,2,-24,-105,9.8686166102,12.722192497,-12.7221925,0.2377979906,-2.853575887,-12.48439451
26153,2013,66,99,-53,1,-33,-52,7.9479768786,11.921965318,-6.382466281,0.1204238921,-3.973988439,-6.262042389
26153,2014,65,139,-50,2,-74,-48,7.9268292683,16.951219512,-6.097560976,0.243902439,-9.024390244,-5.853658537
26153,2015,56,102,33,2,-46,35,6.8855280954,12.541497602,4.0575433419,0.2459117177,-5.655969507,4.3034550596
26153,2016,62,84,-117,2,-22,-115,7.6937395297,10.423776137,-14.51883105,0.2481851461,-2.730036607,-14.2706459
26153,2017,57,106,107,2,-49,109,7.1076750421,13.217781657,13.342477711,0.2493921067,-6.110106615,13.591869817
17169,2010,20,30,-1,3,-10,2,NA,NA,NA,NA,NA,NA
17169,2011,63,92,-42,-1,-29,-43,8.4016803361,12.269120491,-5.601120224,-0.133360005,-3.867440155,-5.734480229
17169,2012,75,81,-1,0,-6,-1,10.055641215,10.860092512,-0.134075216,0,-0.804451297,-0.134075216
17169,2013,58,83,-53,11,-25,-42,7.8146052277,11.18296955,-7.140932363,1.4820803018,-3.368364322,-5.658852061
17169,2014,55,76,-116,12,-21,-104,7.5059706585,10.371886728,-15.83077448,1.6376663255,-2.86591607,-14.19310815
17169,2015,70,87,-103,12,-17,-91,9.7046998475,12.061555525,-14.27977263,1.663662831,-2.356855677,-12.6161098
17169,2016,61,80,-101,13,-19,-88,8.5836909871,11.257299655,-14.21234081,1.829311194,-2.673608668,-12.38302962
17169,2017,63,70,-23,13,-7,-10,8.9437819421,9.9375354912,-3.265190233,1.8455423055,-0.993753549,-1.419647927
29197,2010,18,11,3,0,7,3,NA,NA,NA,NA,NA,NA
29197,2011,56,49,-61,-1,7,-62,12.685468343,11.0997848,-13.81809945,-0.22652622,1.5856835429,-14.04462567
29197,2012,61,47,-14,-1,14,-15,13.904718486,10.713471621,-3.191246866,-0.227946205,3.1912468657,-3.41919307
29197,2013,59,52,-24,0,7,-24,13.476473275,11.877569667,-5.481955231,0,1.598903609,-5.481955231
29197,2014,69,71,20,0,-2,20,15.755223199,16.211896335,4.566731362,0,-0.456673136,4.566731362
29197,2015,64,49,89,0,15,89,14.412791352,11.034793379,20.042787974,0,3.3779979732,20.042787974
29197,2016,66,45,-22,0,21,-22,14.694422799,10.018924635,-4.898140933,0,4.6754981632,-4.898140933
29197,2017,68,40,-11,0,28,-11,15.11279031,8.889876653,-2.44471608,0,6.2229136571,-2.44471608
36097,2010,47,68,-3,0,-21,-3,NA,NA,NA,NA,NA,NA
36097,2011,167,215,117,5,-48,122,9.0953651762,11.709601874,6.3722019498,0.2723163226,-2.614236697,6.6445182724
36097,2012,192,193,72,15,-1,87,10.411582886,10.46580988,3.9043435822,0.813404913,-0.054226994,4.7177484952
36097,2013,171,196,-94,10,-25,-84,9.279105733,10.635700138,-5.100794964,0.5426377622,-1.356594405,-4.558157202
36097,2014,154,187,-188,12,-33,-176,8.4281961471,10.234238179,-10.28896673,0.6567425569,-1.806042032,-9.632224168
36097,2015,174,189,-147,12,-15,-135,9.6159159989,10.444874275,-8.123791103,0.6631666206,-0.828958276,-7.460624482
36097,2016,185,165,-52,11,20,-41,10.272641457,9.1620856239,-2.887445166,0.6108057083,1.1105558332,-2.276639458
36097,2017,183,185,-6,11,-2,5,10.167231513,10.278348797,-0.333351853,0.6111450636,-0.111117284,0.2777932107
42107,2010,347,416,54,12,-69,66,NA,NA,NA,NA,NA,NA
42107,2011,1402,1933,-329,64,-531,-265,9.4816858735,13.072823676,-2.225017584,0.4328301683,-3.591137802,-1.792187415
42107,2012,1415,1950,59,64,-535,123,9.6100297469,13.243503892,0.400700887,0.4346585893,-3.633474145,0.8353594762
42107,2013,1345,2013,99,55,-668,154,9.1648410803,13.716598583,0.6745868156,0.3747704531,-4.551757503,1.0493572687
42107,2014,1360,1912,-860,75,-552,-785,9.3263431477,13.111741249,-5.89754052,0.5143203942,-3.785398101,-5.383220126
42107,2015,1361,1982,-731,85,-621,-646,9.4173165146,13.714269898,-5.058088444,0.5881498191,-4.296953384,-4.469938625
42107,2016,1305,1854,-87,90,-549,3,9.0871109254,12.909964487,-0.605807395,0.6266973052,-3.822853562,0.0208899102
42107,2017,1288,1805,-334,90,-517,-244,9.0100173485,12.626615927,-2.336448598,0.6295819576,-3.616598579,-1.706866641
39145,2010,217,224,19,2,-7,21,NA,NA,NA,NA,NA,NA
39145,2011,872,905,-242,12,-33,-230,10.987487872,11.403298766,-3.049279891,0.1512039615,-0.415810894,-2.89807593
39145,2012,902,939,-606,18,-37,-588,11.430019641,11.89887854,-7.679148451,0.2280935183,-0.468858899,-7.451054933
39145,2013,914,955,-493,29,-41,-464,11.665081968,12.18835151,-6.291997167,0.3701174804,-0.523269541,-5.921879686
39145,2014,925,996,-793,32,-71,-761,11.90606437,12.819935257,-10.20703681,0.4118854701,-0.913870887,-9.795151336
39145,2015,872,1002,-379,35,-130,-344,11.31842814,13.005808482,-4.919362689,0.4542947075,-1.687380342,-4.465067982
39145,2016,856,962,-497,38,-106,-459,11.186252409,12.571465909,-6.494821784,0.4965859714,-1.385213499,-5.998235813
39145,2017,858,926,-276,37,-68,-239,11.276935512,12.170678653,-3.627545689,0.4863014149,-0.893743141,-3.141244274
29199,2010,22,31,-5,0,-9,-5,NA,NA,NA,NA,NA,NA
29199,2011,69,56,-14,-4,13,-18,14.265040314,11.577424023,-2.894356006,-0.826958859,2.6876162911,-3.721314865
29199,2012,84,53,2,-3,31,-1,17.321373337,10.928961749,0.4124136509,-0.618620476,6.3924115888,-0.206206825
29199,2013,73,58,17,-3,15,14,14.963615866,11.888900277,3.4846776673,-0.614943118,3.0747155888,2.8697345496
29199,2014,82,50,-85,-3,32,-88,16.856819817,10.278548669,-17.47353274,-0.61671292,6.5782711481,-18.09024566
29199,2015,61,67,-12,-3,-6,-15,12.64117708,13.884571547,-2.486788934,-0.621697233,-1.243394467,-3.108486167
29199,2016,106,65,55,-3,41,52,21.806212713,13.371734211,11.314544332,-0.617156964,8.4344785024,10.697387369
29199,2017,100,50,5,-3,50,2,20.261371695,10.130685847,1.0130685847,-0.607841151,10.130685847,0.4052274339
37165,2010,121,128,-99,4,-7,-95,NA,NA,NA,NA,NA,NA
37165,2011,477,357,80,15,120,95,13.188636207,9.8707403055,2.2119306007,0.4147369876,3.317895901,2.6266675883
37165,2012,444,390,-256,16,54,-240,12.270786408,10.778393467,-7.075048019,0.4421905012,1.4923929415,-6.632857518
37165,2013,447,403,-241,13,44,-228,12.417011584,11.19475541,-6.694630406,0.3611211423,1.2222561738,-6.333509264
37165,2014,454,365,-354,15,89,-339,12.687766366,10.200517013,-9.893104171,0.4191993293,2.4872493537,-9.473904842
37165,2015,440,379,-420,17,61,-403,12.398382575,10.6795159,-11.83481973,0.4790284177,1.7188666751,-11.35579131
37165,2016,453,409,-131,18,44,-113,12.838498491,11.591492015,-3.712678372,0.5101390129,1.2470064759,-3.202539359
37165,2017,438,419,-193,18,19,-175,12.453264717,11.913054604,-5.487397467,0.5117780021,0.5402101133,-4.975619465
05127,2010,35,42,35,2,-7,37,NA,NA,NA,NA,NA,NA
05127,2011,142,131,-25,1,11,-24,12.630080939,11.651694388,-2.223605799,0.088944232,0.9783865516,-2.134661567
05127,2012,152,122,-263,-2,30,-265,13.66845016,10.970729733,-23.65001574,-0.179848028,2.6977204262,-23.82986377
05127,2013,109,127,-78,-4,-18,-82,9.9484324374,11.59129284,-7.119061744,-0.365080089,-1.642860403,-7.484141834
05127,2014,111,117,-239,0,-6,-239,10.291118116,10.847394771,-22.15835342,0,-0.556276655,-22.15835342
05127,2015,132,112,-143,0,20,-143,12.447545853,10.561554057,-13.48484134,0,1.8859917959,-13.48484134
05127,2016,124,102,-205,0,22,-205,11.863758132,9.7588978186,-19.61347111,0,2.1048603138,-19.61347111
05127,2017,123,111,73,0,12,73,11.82408075,10.670511896,7.0175438596,0,1.1535688536,7.0175438596
17171,2010,8,26,-9,0,-18,-9,NA,NA,NA,NA,NA,NA
17171,2011,50,64,-87,0,-14,-87,9.4741828517,12.12695405,-16.48507816,0,-2.652771198,-16.48507816
17171,2012,53,55,59,0,-2,59,10.081795701,10.462240822,11.223131063,0,-0.380445121,11.223131063
17171,2013,43,67,-51,0,-24,-51,8.1928169953,12.765552062,-9.717062018,0,-4.572735067,-9.717062018
17171,2014,46,55,-34,0,-9,-34,8.8631984586,10.597302505,-6.55105973,0,-1.734104046,-6.55105973
17171,2015,53,66,-47,0,-13,-47,10.313290523,12.842965558,-9.1457482,0,-2.529675034,-9.1457482
17171,2016,52,41,-65,0,11,-65,10.23219205,8.0676898859,-12.79024006,0,2.1645021645,-12.79024006
17171,2017,55,45,-63,0,10,-63,10.937655364,8.9489907527,-12.52858705,0,1.9886646117,-12.52858705
18143,2010,64,90,5,0,-26,5,NA,NA,NA,NA,NA,NA
18143,2011,289,296,-260,-1,-7,-261,12.026633375,12.317935913,-10.81980857,-0.041614648,-0.291302538,-10.86142322
18143,2012,282,301,-169,3,-19,-166,11.845255597,12.643340194,-7.098752468,0.1260133574,-0.798084597,-6.97273911
18143,2013,281,299,44,8,-18,52,11.840802309,12.599287866,1.8540758064,0.3371046921,-0.758485557,2.1911804985
18143,2014,279,287,-130,19,-8,-111,11.778364116,12.116094987,-5.488126649,0.8021108179,-0.337730871,-4.686015831
18143,2015,272,312,51,20,-40,71,11.504462209,13.196294886,2.1570866641,0.8459163389,-1.691832678,3.003003003
18143,2016,305,286,12,20,19,32,12.878707907,12.076427742,0.5067032619,0.8445054365,0.8022801647,1.3512086984
18143,2017,297,303,151,20,-6,171,12.485024276,12.737246989,6.3476049352,0.8407423755,-0.252222713,7.1883473107
19163,2010,520,311,-185,8,209,-177,NA,NA,NA,NA,NA,NA
19163,2011,2187,1431,440,77,756,517,13.183355336,8.6261460839,2.652344009,0.4641602016,4.5572092519,3.1165042106
19163,2012,2244,1429,804,134,815,938,13.405538447,8.5367711411,4.803053882,0.8005089803,4.8687673058,5.6035628624
19163,2013,2216,1461,829,222,755,1051,13.099365426,8.636359606,4.9004395026,1.312301049,4.4630058196,6.2127405516
19163,2014,2301,1436,-23,234,865,211,13.48812535,8.4176219046,-0.134822635,1.3716737644,5.0705034453,1.2368511294
19163,2015,2259,1490,-402,258,769,-144,13.178082032,8.6920505656,-2.345103575,1.5050664738,4.4860314664,-0.840037102
19163,2016,2207,1439,-706,260,768,-446,12.84001757,8.3719008986,-4.107409336,1.5126436648,4.4681166714,-2.594765671
19163,2017,2171,1449,-511,258,722,-253,12.601798267,8.4108731868,-2.966153346,1.4975881865,4.19092508,-1.46856516
20171,2010,12,14,14,12,-2,26,NA,NA,NA,NA,NA,NA
20171,2011,60,66,-81,50,-6,-31,12.142062127,13.35626834,-16.39178387,10.118385106,-1.214206213,-6.273398766
20171,2012,66,60,-39,-2,6,-41,13.452914798,12.229922544,-7.949449653,-0.407664085,1.2229922544,-8.357113738
20171,2013,59,59,51,2,0,53,12.001627339,12.001627339,10.374288039,0.4068348251,0,10.781122864
20171,2014,77,51,35,1,26,36,15.483611502,10.255379047,7.0380052282,0.2010858637,5.2282324553,7.2390910919
20171,2015,64,35,-47,3,29,-44,12.810248199,7.0056044836,-9.407526021,0.6004803843,5.804643715,-8.807045637
20171,2016,47,49,22,3,-2,25,9.4,9.8,4.4,0.6,-0.4,5
20171,2017,55,66,-41,3,-11,-38,11.030886482,13.237063779,-8.223024469,0.6016847172,-2.206177296,-7.621339751
21209,2010,154,46,61,3,108,64,NA,NA,NA,NA,NA,NA
21209,2011,595,297,290,24,298,314,12.484394507,6.2317061656,6.0848309361,0.5035722154,6.2526883413,6.5884031515
21209,2012,651,287,612,36,364,648,13.428910319,5.9202722913,12.624413388,0.7426125522,7.508638028,13.36702594
21209,2013,648,339,646,33,309,679,13.09395112,6.8500762803,13.053537691,0.6668215848,6.2438748396,13.720359275
21209,2014,662,322,836,29,340,865,13.083133233,6.363699246,16.52190239,0.573128193,6.7194339865,17.095030583
21209,2015,687,393,575,35,294,610,13.296945767,7.6065497619,11.12917586,0.6774280958,5.6903960051,11.806603956
21209,2016,730,367,899,33,363,932,13.834141904,6.9549727107,17.036840509,0.6253790176,6.8791691935,17.662219527
21209,2017,757,393,1054,34,364,1088,13.981106114,7.2583549576,19.4664278,0.6279492839,6.7227511566,20.094377084
27139,2010,511,107,122,60,404,182,NA,NA,NA,NA,NA,NA
27139,2011,1917,559,474,246,1358,720,14.573901541,4.2497709761,3.6035625093,1.8702033276,10.324130565,5.4737658369
27139,2012,1952,547,955,234,1405,1189,14.58147361,4.0860994185,7.1338664436,1.7479840291,10.495374192,8.8818504727
27139,2013,1934,570,589,234,1364,823,14.193974533,4.1833327217,4.3227771458,1.71736817,10.010641811,6.0401453158
27139,2014,1890,586,352,275,1304,627,13.666141231,4.2372268579,2.5452284198,1.988459703,9.4289143733,4.5336881227
27139,2015,1838,653,734,296,1185,1030,13.095598582,4.6525712046,5.2296895317,2.108975615,8.4430273775,7.3386651467
27139,2016,1847,707,552,295,1140,847,12.966362574,4.963301754,3.8751662917,2.0709674928,8.0030608198,5.9461337845
27139,2017,1843,666,925,293,1177,1218,12.742640831,4.604774169,6.3955196792,2.0258240714,8.1378666621,8.4213437505
28123,2010,106,45,-5,19,61,14,NA,NA,NA,NA,NA,NA
28123,2011,454,311,-212,79,143,-133,16.020890677,10.974662997,-7.481120757,2.787776131,5.0462276801,-4.693344626
28123,2012,474,261,-295,65,213,-230,16.726951919,9.2104102338,-10.41023379,2.2937803264,7.516541685,-8.116453463
28123,2013,422,279,-222,52,143,-170,14.902445484,9.8525646685,-7.839675113,1.8363202966,5.0498808157,-6.003354816
28123,2014,455,288,3,29,167,32,16.019998592,10.140130977,0.1056263643,1.0210548553,5.879867615,1.1266812196
28123,2015,460,270,-343,45,190,-298,16.170990649,9.4916684244,-12.05793433,1.5819447374,6.6793222246,-10.47598959
28123,2016,494,277,-277,47,217,-230,17.403558217,9.7586753567,-9.758675357,1.6558041219,7.6448828607,-8.102871235
28123,2017,462,302,-165,47,160,-118,16.268178457,10.63417726,-5.810063735,1.6549878517,5.6340011972,-4.155075883
29201,2010,118,76,19,3,42,22,NA,NA,NA,NA,NA,NA
29201,2011,553,416,-259,5,137,-254,14.112182922,10.61603634,-6.609503394,0.1275965906,3.496146583,-6.481906803
29201,2012,503,409,-86,14,94,-72,12.852780723,10.450869415,-2.197493324,0.3577314714,2.4019113081,-1.839761853
29201,2013,535,458,-21,-5,77,-26,13.659458217,11.693517502,-0.53616565,-0.127658488,1.9659407154,-0.663824138
29201,2014,507,435,-411,-3,72,-414,12.993003767,11.147843469,-10.53279004,-0.076881679,1.8451602983,-10.60967172
29201,2015,504,440,73,-1,64,72,12.950638538,11.30611301,1.8757869312,-0.025695711,1.6445255287,1.8500912198
29201,2016,455,424,-289,0,31,-289,11.710958111,10.913068657,-7.438388778,0,0.7978894537,-7.438388778
29201,2017,466,448,-199,0,18,-199,12.062538828,11.596603852,-5.151170014,0,0.4659349762,-5.151170014
47151,2010,70,70,-3,0,0,-3,NA,NA,NA,NA,NA,NA
47151,2011,224,261,-83,-4,-37,-87,10.106250987,11.775587087,-3.744726928,-0.180468768,-1.669336101,-3.925195696
47151,2012,287,268,21,-2,19,19,12.97527013,12.116280121,0.9494100095,-0.090420001,0.8589900086,0.8589900086
47151,2013,279,271,-143,-5,8,-148,12.643600027,12.281059525,-6.480411483,-0.226587814,0.3625405026,-6.706999298
47151,2014,282,268,-20,-4,14,-24,12.823136212,12.186526613,-0.909442285,-0.181888457,0.6366095992,-1.091330741
47151,2015,255,290,-63,-4,-35,-67,11.626051474,13.221784029,-2.872318599,-0.182369435,-1.595732555,-3.054688034
47151,2016,301,259,-27,-5,42,-32,13.752769972,11.833778813,-1.233637174,-0.228451328,1.9189911589,-1.462088502
47151,2017,268,268,103,-5,0,98,12.214853809,12.214853809,4.6945147102,-0.227889064,0,4.4666256466
51169,2010,63,50,-58,2,13,-56,NA,NA,NA,NA,NA,NA
51169,2011,185,278,27,-3,-93,24,8.0095248404,12.035934625,1.1689576794,-0.129884187,-4.026409785,1.0390734928
51169,2012,217,315,3,-3,-98,0,9.430682312,13.68970013,0.1303780965,-0.130378096,-4.259017818,0
51169,2013,181,323,-46,4,-142,-42,7.9155095883,14.125467387,-2.01167647,0.1749283887,-6.209957799,-1.836748081
51169,2014,182,307,-126,6,-125,-120,8.0347879831,13.553186323,-5.562545527,0.2648831203,-5.51839834,-5.297662406
51169,2015,176,344,-109,6,-168,-103,7.8597744781,15.36228648,-4.867701239,0.2679468572,-7.502512002,-4.599754382
51169,2016,167,315,-87,7,-148,-80,7.5422274411,14.226357149,-3.929184356,0.31614127,-6.684129708,-3.613043086
51169,2017,171,286,-54,7,-115,-47,7.7916752102,13.031690702,-2.460529014,0.3189574647,-5.240015492,-2.141571549
31157,2010,153,113,43,2,40,45,NA,NA,NA,NA,NA,NA
31157,2011,533,443,-175,-9,90,-184,14.402680574,11.970708244,-4.728835085,-0.243197233,2.4319723296,-4.972032318
31157,2012,467,416,-96,2,51,-94,12.644004928,11.26318212,-2.599195874,0.054149914,1.3808228079,-2.54504596
31157,2013,502,435,-146,25,67,-121,13.610606512,11.79405146,-3.958463249,0.6778190494,1.8165550525,-3.280644199
31157,2014,473,387,-539,56,86,-483,12.901817983,10.556032896,-14.70207166,1.5274879642,2.3457850879,-13.17458369
31157,2015,475,396,-307,63,79,-244,13.054292114,10.883157215,-8.437195114,1.7314113751,2.1711348989,-6.705783738
31157,2016,501,403,88,64,98,152,13.752779379,11.06261495,2.415657855,1.7568420764,2.6901644294,4.1724999314
31157,2017,500,379,-374,63,121,-311,13.714411103,10.395523616,-10.25837951,1.728015799,3.318887487,-8.530363706
13251,2010,50,56,-91,0,-6,-91,NA,NA,NA,NA,NA,NA
13251,2011,216,182,-135,4,34,-131,14.946028231,12.593412676,-9.341267645,0.2767783006,2.3526155549,-9.064489344
13251,2012,194,175,-264,3,19,-261,13.57877791,12.248897599,-18.47833695,0.2099811017,1.3298803108,-18.26835585
13251,2013,178,161,-41,1,17,-40,12.573729382,11.372867587,-2.896196094,0.0706389291,1.2008617949,-2.825557165
13251,2014,185,197,-136,3,-12,-133,13.147141385,13.999928934,-9.664925559,0.2131968873,-0.852787549,-9.451728671
13251,2015,161,168,61,4,-7,65,11.476636846,11.975621057,4.3482909791,0.2851338347,-0.498984211,4.6334248138
13251,2016,172,140,-58,2,32,-56,12.246786998,9.9683149988,-4.129730499,0.1424045,2.2784719997,-3.987326
13251,2017,161,162,-81,2,-1,-79,11.506164016,11.577630874,-5.788815437,0.1429337145,-0.071466857,-5.645881722
48415,2010,59,52,6,0,7,6,NA,NA,NA,NA,NA,NA
48415,2011,273,167,-167,4,106,-163,16.150023663,9.8793185045,-9.879318504,0.2366303833,6.2707051585,-9.642688121
48415,2012,253,191,153,7,62,160,14.891988934,11.242568721,9.0058273,0.4120313144,3.6494202131,9.4178586144
48415,2013,251,158,61,10,93,71,14.607035819,9.1948671691,3.5499170716,0.5819536183,5.4121686502,4.1318706899
48415,2014,270,189,43,10,81,53,15.578121394,10.904684976,2.4809600739,0.576967459,4.6734364182,3.0579275329
48415,2015,226,167,120,12,59,132,12.919084231,9.5464029497,6.8596907423,0.6859690742,3.3726812816,7.5456598165
48415,2016,261,158,-276,13,103,-263,14.906619453,9.02393055,-15.76332172,0.7424752984,5.8826889028,-15.02084642
48415,2017,246,166,-474,13,80,-461,14.269141531,9.6287703016,-27.49419954,0.7540603248,4.6403712297,-26.74013921
05129,2010,14,32,6,0,-18,6,NA,NA,NA,NA,NA,NA
05129,2011,77,104,-83,1,-27,-82,9.4786729858,12.802363513,-10.21727088,0.1230996492,-3.323690527,-10.09417123
05129,2012,77,119,-32,1,-42,-31,9.5854599776,14.813892693,-3.983567783,0.1244864932,-5.228432715,-3.85908129
05129,2013,82,109,15,-2,-27,13,10.264755586,13.644614133,1.8776991926,-0.250359892,-3.379858547,1.6273393002
05129,2014,74,127,-18,5,-53,-13,9.3105183694,15.978862607,-2.264720684,0.629089079,-6.668344238,-1.635631605
05129,2015,78,121,-48,5,-43,-43,9.9091659785,15.371911326,-6.097948294,0.6352029473,-5.462745347,-5.462745347
05129,2016,73,102,161,5,-29,166,9.2446020389,12.917115178,20.388779839,0.6331919205,-3.672513139,21.02197176
05129,2017,79,110,0,5,-31,5,9.9352323461,13.833867824,0,0.6288121738,-3.898635478,0.6288121738
05131,2010,417,312,-134,25,105,-109,NA,NA,NA,NA,NA,NA
05131,2011,1762,1194,466,143,568,609,13.946438395,9.4506512164,3.6884451146,1.1318619128,4.4957871783,4.8203070274
05131,2012,1760,1227,-133,135,533,2,13.838273046,9.6474778568,-1.045733134,1.0614584439,4.1907951896,0.0157253103
05131,2013,1627,1262,-820,79,365,-741,12.785452717,9.917173527,-6.443805303,0.6208056328,2.8682791897,-5.82299967
05131,2014,1698,1267,-936,120,431,-816,13.383251232,9.9862068966,-7.377339901,0.9458128079,3.397044335,-6.431527094
05131,2015,1690,1251,131,152,439,283,13.303420317,9.8476797733,1.0312118707,1.1965206439,3.4557405439,2.2277325147
05131,2016,1743,1250,-464,152,493,-312,13.673054747,9.8056904383,-3.639872291,1.1923719573,3.8673643089,-2.447500333
05131,2017,1711,1225,-96,154,486,58,13.384231482,9.5825152342,-0.750956296,1.204659058,3.801716248,0.4537027621
08115,2010,6,14,-3,0,-8,-3,NA,NA,NA,NA,NA,NA
08115,2011,28,41,9,1,-13,10,11.829319814,17.321504014,3.8022813688,0.42247570759999997,-5.492184199,4.2247570765
08115,2012,21,38,22,2,-17,24,8.8626292467,16.037138637,9.2846592108,0.8440599283,-7.17450939,10.128719139
08115,2013,27,29,-37,1,-2,-36,11.469838573,12.319456245,-15.71792693,0.424808836,-0.849617672,-15.2931181
08115,2014,27,32,0,1,-5,1,11.578044597,13.72212693,0,0.4288164666,-2.144082333,0.4288164666
08115,2015,22,54,71,1,-32,72,9.3636944031,22.983613535,30.219195574,0.4256224729,-13.61991913,30.644818046
08115,2016,29,29,34,1,0,35,12.146596859,12.146596859,14.240837696,0.4188481675,0,14.659685864
08115,2017,33,23,-72,1,10,-71,13.897662666,9.6862497368,-30.32217309,0.4211412929,4.211412929,-29.9010318
20173,2010,2024,1028,-328,169,996,-159,NA,NA,NA,NA,NA,NA
20173,2011,7969,4056,-2926,754,3913,-2172,15.936613515,8.1112943174,-5.85149092,1.5078688154,7.8253191972,-4.343622105
20173,2012,7739,4002,-1613,1118,3737,-495,15.400535307,7.9639413749,-3.209854432,2.2248092097,7.4365939325,-0.985045223
20173,2013,7800,4146,-2294,1002,3654,-1292,15.436878505,8.2052946514,-4.54002555,1.9830451618,7.2315838534,-2.556980388
20173,2014,7452,4175,-1819,1051,3277,-768,14.678306361,8.2235546241,-3.582909188,2.0701690802,6.4547517373,-1.512740108
20173,2015,7258,4488,-2128,1188,2770,-940,14.236453009,8.8031415132,-4.174038578,2.3302433417,5.4333114955,-1.843795237
20173,2016,7265,4480,-2004,1152,2785,-852,14.198382577,8.7555063927,-3.916525627,2.2514159295,5.4428761839,-1.665109698
20173,2017,7186,4374,-2852,1096,2812,-1756,14.003320576,8.5235908988,-5.557677468,2.1357694616,5.4797296771,-3.421908006
12117,2010,1077,772,-200,253,305,53,NA,NA,NA,NA,NA,NA
12117,2011,4461,2837,650,1135,1624,1785,10.502895889,6.6793803268,1.5303479776,2.672223007,3.8235155625,4.2025709846
12117,2012,4389,2883,1770,1223,1506,2993,10.239481144,6.7260023097,4.1293874742,2.8532434356,3.513478834,6.9826309097
12117,2013,4469,3057,2267,1510,1412,3777,10.310598414,7.0529199712,5.2302811824,3.483777938,3.2576784427,8.7140591204
12117,2014,4444,3127,2963,1905,1317,4868,10.120770581,7.1214333052,6.7479395213,4.3384491354,2.9993372763,11.086388657
12117,2015,4576,3310,3701,2006,1266,5707,10.268078527,7.4273033055,8.3046675328,4.5012599489,2.840775222,12.805927482
12117,2016,4626,3510,3992,2080,1116,6072,10.218168726,7.7530852199,8.8177539025,4.594420871,2.4650835058,13.412174774
12117,2017,4668,3566,3185,2080,1102,5265,10.159166809,7.7608373695,6.9316508755,4.5267924085,2.3983294395,11.458443284
13253,2010,19,14,-6,0,5,-6,NA,NA,NA,NA,NA,NA
13253,2011,119,116,36,0,3,36,13.606219986,13.263206037,4.1161673908,0,0.3430139492,4.1161673908
13253,2012,103,105,105,0,-2,105,11.681977997,11.908812521,11.908812521,0,-0.226834524,11.908812521
13253,2013,99,122,0,0,-23,0,11.177599639,13.774415716,0,0,-2.596816078,0
13253,2014,108,117,-240,0,-9,-240,12.381061561,13.412816692,-27.51347014,0,-1.03175513,-27.51347014
13253,2015,92,134,5,0,-42,5,10.720736468,15.614985725,0.5826487211,0,-4.894249257,0.5826487211
13253,2016,90,116,-91,0,-26,-91,10.583877227,13.641441759,-10.70147586,0,-3.057564532,-10.70147586
13253,2017,86,114,-126,0,-28,-126,10.27663261,13.622512995,-15.05646173,0,-3.345880385,-15.05646173
40133,2010,83,60,-20,0,23,-20,NA,NA,NA,NA,NA,NA
40133,2011,356,320,-77,1,36,-76,13.982168807,12.568241624,-3.024233141,0.0392757551,1.4139271828,-2.984957386
40133,2012,318,354,-19,2,-36,-17,12.512788227,13.92933029,-0.747619422,0.0786967813,-1.416542063,-0.668922641
40133,2013,362,347,38,4,15,42,14.244397663,13.65416019,1.4952682629,0.1573966593,0.5902374722,1.6526649222
40133,2014,321,357,-52,5,-36,-47,12.639039276,14.056501624,-2.047445615,0.1968697706,-1.417462349,-1.850575844
40133,2015,304,387,120,5,-83,125,11.980531636,15.25153205,4.7291572248,0.1970482177,-3.271000414,4.9262054425
40133,2016,362,318,-278,5,44,-273,14.320186716,12.579611535,-10.99727046,0.1977926342,1.740575181,-10.79947783
40133,2017,329,329,-291,5,0,-286,13.148954878,13.148954878,-11.63023061,0.199832141,0,-11.43039847
36099,2010,115,66,-29,4,49,-25,NA,NA,NA,NA,NA,NA
36099,2011,367,314,-3,10,53,7,10.399251934,8.8974526083,-0.085007509,0.2833583633,1.5017993256,0.1983508543
36099,2012,382,332,-35,19,50,-16,10.811575745,9.3964480294,-0.990589401,0.5377485318,1.4151277153,-0.452840869
36099,2013,353,330,-148,12,23,-136,10.002408512,9.3506935098,-4.193644362,0.3400252185,0.6517150022,-3.853619143
36099,2014,410,338,-438,15,72,-423,11.693237886,9.6397912329,-12.49180047,0.4278013861,2.0534466532,-12.06399909
36099,2015,381,373,-99,16,8,-83,10.9324113,10.702859356,-2.840705298,0.4591038866,0.2295519433,-2.381601412
36099,2016,357,338,-68,20,19,-48,10.259799977,9.7137602023,-1.954247615,0.5747787102,0.5460397747,-1.379468904
36099,2017,356,319,-342,20,37,-322,10.277284603,9.2091398548,-9.873121725,0.5773755395,1.068144748,-9.295746186
39147,2010,141,156,-122,7,-15,-115,NA,NA,NA,NA,NA,NA
39147,2011,601,566,-178,33,35,-145,10.625790083,10.006983672,-3.147072604,0.5834460445,0.6188064108,-2.563626559
39147,2012,581,625,-415,36,-44,-379,10.320724049,11.102327936,-7.37194575,0.6394940891,-0.781603887,-6.73245166
39147,2013,583,604,-285,33,-21,-252,10.420297238,10.795642421,-5.093970348,0.5898281455,-0.375345184,-4.504142202
39147,2014,554,570,-67,40,-16,-27,9.9306289996,10.217434169,-1.200996648,0.7170129242,-0.28680517,-0.483983724
39147,2015,598,568,-265,42,30,-223,10.742836612,10.20389832,-4.760621575,0.7545136082,0.5389382916,-4.006107967
39147,2016,595,570,-278,42,25,-236,10.727872636,10.277121685,-5.012350576,0.7572615978,0.4507509511,-4.255088978
39147,2017,582,556,-180,41,26,-139,10.524412297,10.054249548,-3.254972875,0.7414104882,0.4701627486,-2.513562387
47153,2010,40,19,-12,-2,21,-14,NA,NA,NA,NA,NA,NA
47153,2011,155,149,121,-7,6,114,10.92472512,10.501832535,8.5283338032,-0.493374683,0.4228925853,8.0349591204
47153,2012,165,148,83,-4,17,79,11.541689983,10.352546167,5.8058198097,-0.279798545,1.1891438165,5.5260212647
47153,2013,132,141,192,-1,-9,191,9.1441238613,9.7675868519,13.300543798,-0.069273666,-0.623462991,13.231270133
47153,2014,144,170,134,-1,-26,133,9.8758658528,11.659008298,9.1900418353,-0.068582402,-1.783142446,9.1214594335
47153,2015,166,170,3,-1,-4,2,11.344609602,11.617973689,0.2050230651,-0.068341022,-0.273364087,0.1366820434
47153,2016,149,166,128,-2,-17,126,10.146062443,11.303666882,8.7160804876,-0.136188758,-1.15760444,8.5798917299
47153,2017,154,167,13,-2,-13,11,10.449178993,11.331252544,0.8820735514,-0.135703623,-0.882073551,0.7463699281
40135,2010,56,59,32,-1,-3,31,NA,NA,NA,NA,NA,NA
40135,2011,251,391,-172,-6,-140,-178,5.9329645913,9.2421878693,-4.06561717,-0.141823855,-3.309223278,-4.207441025
40135,2012,400,490,-444,11,-90,-433,9.5491602707,11.697721332,-10.5995679,0.2626019074,-2.148561061,-10.33696599
40135,2013,510,524,-229,14,-14,-215,12.284716368,12.621943876,-5.516078526,0.3372275081,-0.337227508,-5.178851018
40135,2014,509,539,56,24,-30,80,12.288601055,13.012880096,1.3519875424,0.5794232325,-0.724279041,1.9314107749
40135,2015,525,508,-124,32,17,-92,12.680546833,12.26993865,-2.995024395,0.7729095213,0.4106081832,-2.222114874
40135,2016,458,580,93,32,-122,125,11.072563975,14.022024248,2.2483590605,0.7736289241,-2.949460273,3.0219879846
40135,2017,459,538,-62,32,-79,-30,11.111649075,13.024111552,-1.500919919,0.7746683451,-1.912462477,-0.726251574
05133,2010,72,21,28,7,51,35,NA,NA,NA,NA,NA,NA
05133,2011,276,170,-100,25,106,-75,16.08485343,9.9073372574,-5.827845446,1.4569613614,6.1775161723,-4.370884084
05133,2012,284,161,-147,1,123,-146,16.547223679,9.3806444095,-8.5649362,0.0582648721,7.1665792694,-8.506671328
05133,2013,280,167,49,10,113,59,16.244597221,9.688741914,2.8428045137,0.5801641865,6.5558553071,3.4229687001
05133,2014,288,148,-76,2,140,-74,16.594641314,8.5278017862,-4.379141458,0.1152405647,8.0668395275,-4.263900893
05133,2015,234,163,-217,7,71,-210,13.511172701,9.4116288469,-12.52959178,0.4041803799,4.0995438536,-12.1254114
05133,2016,236,158,-382,10,78,-372,13.799152171,9.2384154363,-22.3359158,0.5847098377,4.5607367344,-21.75120596
05133,2017,233,145,64,10,88,74,13.677722336,8.5118872909,3.7569709422,0.5870267097,5.1658350455,4.3439976519
47155,2010,255,246,165,48,9,213,NA,NA,NA,NA,NA,NA
47155,2011,1045,887,855,139,158,994,11.543453647,9.7981276408,9.4446438927,1.5354450305,1.7453260059,10.980088923
47155,2012,1020,864,796,161,156,957,11.126989495,9.4252146309,8.6834153312,1.7563189301,1.7017748639,10.439734261
47155,2013,1037,951,815,159,86,974,11.178845356,10.25176657,8.7856884907,1.7140177546,0.9270787855,10.499706245
47155,2014,1036,991,1010,202,45,1212,11.029020376,10.549960611,10.752230289,2.1504460579,0.4790597654,12.902676347
47155,2015,1031,1063,733,232,-32,965,10.848520561,11.185235069,7.7128667031000004,2.4411801844,-0.336714508,10.154046887
47155,2016,1106,996,760,239,110,999,11.5141767,10.369005419,7.9120924882,2.4881448746,1.1451712812,10.400237363
47155,2017,1066,1008,730,240,58,970,10.975716485,10.378538665,7.5162035965,2.4710806344,0.59717782,9.9872842309
49041,2010,89,64,-26,0,25,-26,NA,NA,NA,NA,NA,NA
49041,2011,347,204,-73,-1,143,-74,16.654667627,9.7912167027,-3.503719702,-0.04799616,6.8634509239,-3.551715863
49041,2012,282,172,-325,-2,110,-327,13.580871198,8.2833682487,-15.65171326,-0.096318235,5.2975029497,-15.7480315
49041,2013,277,187,6,-2,90,4,13.378087948,9.0314167733,0.2897780783,-0.096592693,4.3466711743,0.1931853855
49041,2014,309,200,-130,3,109,-127,14.896591621,9.6418068746,-6.267174468,0.1446271031,5.2547847467,-6.122547365
49041,2015,329,203,-4,4,126,0,15.820730446,9.7617272968,-0.192349306,0.1923493063,6.0590031497,0
49041,2016,311,181,156,4,130,160,14.808113513,8.6182268355,7.427864013,0.1904580516,6.1898866775,7.6183220646
49041,2017,311,183,36,4,128,40,14.648046535,8.6192685397,1.6955938111,0.1883993123,6.0287779949999996,1.8839931234
20175,2010,116,53,-58,22,63,-36,NA,NA,NA,NA,NA,NA
20175,2011,451,130,-178,40,321,-138,19.548350743,5.6347795934,-7.715313597,1.7337783364,13.91357115,-5.981535261
20175,2012,473,128,-197,88,345,-109,20.316560359,5.497927539,-8.461654103,3.7798251831,14.81863282,-4.68182892
20175,2013,425,113,-423,58,312,-365,18.180262651,4.8338110108,-18.09470847,2.4810711383,13.346451641,-15.61363734
20175,2014,452,153,-451,86,299,-365,19.377934021,6.5593449229,-19.33506249,3.6869520482,12.818589098,-15.64811044
20175,2015,442,133,-555,117,309,-438,19.022616255,5.7239999139,-23.8858643,5.0353984205,13.298616341,-18.85046588
20175,2016,422,118,-844,121,304,-723,18.375789245,5.1382538646,-36.75157849,5.2688874374,13.23753538,-31.48269105
20175,2017,407,116,-1016,122,291,-894,18.123121452,5.1653122565,-45.2410108,5.4324835801,12.957809195,-39.80852722
31159,2010,58,48,39,-2,10,37,NA,NA,NA,NA,NA,NA
31159,2011,207,177,-129,3,30,-126,12.357840064,10.566848751,-7.701262649,0.1790991314,1.7909913137,-7.522163518
31159,2012,206,153,135,5,53,140,12.261904762,9.1071428571,8.0357142857,0.2976190476,3.1547619048,8.3333333333
31159,2013,180,164,73,10,16,83,10.622289103,9.6780856275,4.3079283586,0.5901271724,0.9442034758,4.898055531
31159,2014,189,149,-36,8,40,-28,11.117647059,8.7647058824,-2.117647059,0.4705882353,2.3529411765,-1.647058824
31159,2015,206,192,-46,8,14,-38,12.122282049,11.298437638,-2.706917351,0.4707682349,0.8238444111,-2.236149116
31159,2016,171,172,97,8,-1,105,10.039335408,10.098044972,5.6948276874,0.4696765103,-0.058709564,6.1645041977
31159,2017,172,160,58,8,12,66,10.044968755,9.3441569818,3.3872569059,0.4672078491,0.7008117736,3.854464755
48417,2010,10,2,-2,0,8,-2,NA,NA,NA,NA,NA,NA
48417,2011,25,30,-47,3,-5,-44,7.4360499703,8.9232599643,-13.97977394,0.8923259964,-1.487209994,-13.08744795
48417,2012,34,28,19,3,6,22,10.144711323,8.3544681486,5.6691033865,0.8951215873,1.7902431747,6.5642249739
48417,2013,42,29,-2,3,13,1,12.455516014,8.6002372479,-0.59311981,0.8896797153,3.8552787663,0.2965599051
48417,2014,23,47,-34,4,-24,-30,6.8625988363,14.023571535,-10.14471132,1.1934954498,-7.160972699,-8.951215873
48417,2015,37,29,7,4,8,11,11.096116359,8.6969560654,2.0992652572,1.1995801469,2.3991602939,3.2988454041
48417,2016,37,19,-2,4,18,2,11.029959756,5.664033388,-0.596214041,1.1924280817,5.3659263676,0.5962140408
48417,2017,34,30,-45,4,4,-41,10.16138673,8.965929468,-13.4488942,1.1954572624,1.1954572624,-12.25343694
29203,2010,29,10,-11,1,19,-10,NA,NA,NA,NA,NA,NA
29203,2011,98,93,-38,1,5,-37,11.621012688,11.028103878,-4.506106961,0.1185817621,0.5929088106,-4.387525199
29203,2012,96,90,-85,0,6,-85,11.459265891,10.743061773,-10.14622501,0,0.7162041182,-10.14622501
29203,2013,92,101,-36,0,-9,-36,11.063011063,12.145262145,-4.329004329,0,-1.082251082,-4.329004329
29203,2014,79,91,19,0,-12,19,9.5220876273,10.968480685,2.2901223407,0,-1.446393057,2.2901223407
29203,2015,89,90,-18,0,-1,-18,10.737121486,10.857763301,-2.17155266,0,-0.120641814,-2.17155266
29203,2016,84,84,-36,0,0,-36,10.167645101,10.167645101,-4.357562186,0,0,-4.357562186
29203,2017,80,79,5,0,1,5,9.7010853089,9.5798217426,0.6063178318,0,0.1212635664,0.6063178318
28125,2010,19,3,-50,0,16,-50,NA,NA,NA,NA,NA,NA
28125,2011,71,68,-15,0,3,-15,14.549180328,13.93442623,-3.073770492,0,0.6147540984,-3.073770492
28125,2012,89,58,-123,0,31,-123,18.428408738,12.009524796,-25.468475,0,6.4188839424,-25.468475
28125,2013,61,73,-100,1,-12,-99,12.893679983,15.430141619,-21.1371803,0.211371803,-2.536461636,-20.9258085
28125,2014,63,81,-52,2,-18,-50,13.567352213,17.443738559,-11.19844945,0.4307095941,-3.876386347,-10.76773985
28125,2015,62,59,-51,2,3,-49,13.517933064,12.863839529,-11.1195901,0.4360623569,0.6540935354,-10.68352774
28125,2016,47,36,-42,2,11,-40,10.333076839,7.9146971529,-9.233813345,0.4397053974,2.4183796856,-8.794107948
28125,2017,48,46,-103,2,2,-101,10.703534396,10.257553796,-22.96800089,0.4459805998,0.4459805998,-22.52202029
05135,2010,40,44,-8,0,-4,-8,NA,NA,NA,NA,NA,NA
05135,2011,174,274,114,3,-100,117,10.081112399,15.874855156,6.6048667439,0.1738122827,-5.793742758,6.7786790267
05135,2012,178,270,-151,4,-92,-147,10.379008746,15.743440233,-8.804664723,0.2332361516,-5.364431487,-8.571428571
05135,2013,169,249,88,3,-80,91,9.9198779092,14.615678103,5.1653802131,0.1760925073,-4.695800194,5.3414727203
05135,2014,160,248,-138,3,-88,-135,9.4509583862,14.648985499,-8.151451608,0.1772054697,-5.198027112,-7.974246138
05135,2015,191,285,93,3,-94,96,11.357554855,16.947136826,5.5301183326,0.178390914,-5.589581971,5.7085092466
05135,2016,277,235,275,3,42,278,16.315711972,13.841849507,16.197908997,0.1767044618,2.473862465,16.374613459
05135,2017,251,230,231,3,21,234,14.537661811,13.321363413,13.379282384,0.1737569141,1.2162983985,13.553039298
06089,2010,534,464,-22,39,70,17,NA,NA,NA,NA,NA,NA
06089,2011,2109,2053,128,156,56,284,11.885741337,11.570140809,0.7213726369,0.8791729012,0.3156005286,1.6005455381
06089,2012,2057,2006,152,150,51,302,11.572042575,11.285132429,0.8551047503,0.843853372,0.2869101465,1.6989581224
06089,2013,2106,2071,309,212,35,521,11.819442028,11.623012555,1.7341916366,1.1898013817,0.1964294734,2.9239930183
06089,2014,2143,2112,299,244,31,543,11.991226205,11.817764697,1.6730642255,1.3653099365,0.1734615083,3.0383741621
06089,2015,2093,2205,-649,265,-112,-384,11.710564966,12.337217272,-3.631226308,1.4827041166,-0.626652306,-2.148522192
06089,2016,2025,2118,131,272,-93,403,11.336725954,11.85737559,0.7333881975,1.5227602268,-0.520649636,2.2561484243
06089,2017,2042,2144,989,270,-102,1259,11.385717671,11.954445978,5.5144342687,1.5054572826,-0.568728307,7.0198915513
55115,2010,121,144,8,3,-23,11,NA,NA,NA,NA,NA,NA
55115,2011,431,463,-258,18,-32,-240,10.311004785,11.076555024,-6.172248804,0.4306220096,-0.765550239,-5.741626794
55115,2012,428,407,-194,14,21,-180,10.292543918,9.7875359217,-4.665311963,0.3366719973,0.505007996,-4.328639965
55115,2013,433,502,-27,7,-69,-20,10.444682981,12.10907819,-0.651285082,0.1688516879,-1.664395209,-0.482433394
55115,2014,423,435,-60,11,-12,-49,10.223194325,10.513214022,-1.450098486,0.2658513891,-0.290019697,-1.184247097
55115,2015,443,462,-284,12,-19,-272,10.752818671,11.21400051,-6.893454859,0.2912727405,-0.461181839,-6.602182118
55115,2016,396,450,-67,12,-54,-55,9.6592433593,10.976412908,-1.634265922,0.2927043442,-1.317169549,-1.341561578
55115,2017,405,418,-3,12,-13,9,9.8930089403,10.210562314,-0.073281548,0.2931261908,-0.31755337300000003,0.2198446431
20177,2010,669,320,68,21,349,89,NA,NA,NA,NA,NA,NA
20177,2011,2497,1671,-337,77,826,-260,13.979045428,9.3548197476,-1.886639291,0.4310718854,4.6242256801,-1.455567405
20177,2012,2402,1745,-744,144,657,-600,13.424994411,9.7529622178,-4.158283032,0.8048289738,3.6720321932,-3.353454058
20177,2013,2434,1785,-1112,130,649,-982,13.614574419,9.9843941403,-6.219969907,0.7271547553,3.6301802784,-5.492815152
20177,2014,2395,1770,-942,197,625,-745,13.413534508,9.9131340625,-5.275803552,1.1033262205,3.5004004458,-4.172477331
20177,2015,2271,1925,-527,225,346,-302,12.7226178,10.78425331,-2.952364413,1.2604971401,1.938364491,-1.691867272
20177,2016,2239,1804,-1009,217,435,-792,12.555058051,10.115821672,-5.657906911,1.2168144694,2.4392363788,-4.441092441
20177,2017,2206,1784,-598,214,422,-384,12.381398716,10.01288092,-3.356335645,1.2010967023,2.3685177962,-2.155238942
55117,2010,365,226,-153,22,139,-131,NA,NA,NA,NA,NA,NA
55117,2011,1324,1022,-692,85,302,-607,11.476368995,8.858647366,-5.99822307,0.7367759551,2.6177216287,-5.261447115
55117,2012,1248,1061,-714,96,187,-618,10.851607742,9.2256056206,-6.208371737,0.8347390571,1.6260021216,-5.37363268
55117,2013,1288,1161,-307,110,127,-197,11.2237162,10.117029898,-2.675218069,0.958547191,1.1066863024,-1.716670878
55117,2014,1174,1025,48,120,149,168,10.220382437,8.9232470172,0.4178691286,1.0446728215,1.2971354201,1.4625419501
55117,2015,1279,1123,-36,138,156,102,11.108312561,9.7534284647,-0.312665561,1.1985513162,1.3548840966,0.8858857555
55117,2016,1270,1135,-407,139,135,-268,11.024879768,9.8529437297,-3.53317013,1.2066600691,1.1719360383,-2.326510061
55117,2017,1264,1087,-95,140,177,45,10.968842067,9.4328570623,-0.824398731,1.2149033935,1.5359850046,0.3905046622
01117,2010,632,316,393,77,316,470,NA,NA,NA,NA,NA,NA
01117,2011,2477,1260,379,301,1217,680,12.576732284,6.3975303502,1.9243365101,1.528298917,6.1792019335,3.4526354271
01117,2012,2377,1286,1660,182,1091,1842,11.923363422,6.4507553052,8.3267914515,0.912937376,5.4726081166,9.2397288275
01117,2013,2403,1347,1834,171,1056,2005,11.874729755,6.6563716104,9.0629439743,0.8450182222,5.2183581444,9.9079621966
01117,2014,2350,1280,1041,162,1070,1203,11.46204478,6.2431563057,5.0774419643,0.7901494699,5.2188884743,5.8675914342
01117,2015,2404,1372,1500,202,1032,1702,11.584732633,6.6115861783,7.2284105448,0.9734259534,4.9731464548,8.2018364982
01117,2016,2401,1445,1041,204,956,1245,11.434694607,6.8817716395,4.9577330635,0.9715442315,4.552922967,5.9292772949
01117,2017,2363,1534,1507,203,829,1710,11.128431423,7.2242969968,7.0971418345,0.9560184422,3.9041344266,8.0531602767
17173,2010,64,47,-19,1,17,-18,NA,NA,NA,NA,NA,NA
17173,2011,226,227,-81,6,-1,-75,10.124540812,10.169339665,-3.628707105,0.2687931189,-0.044798853,-3.359913986
17173,2012,230,220,-89,6,10,-83,10.338937337,9.8894183224,-4.00071923,0.2697114088,0.4495190147,-3.731007822
17173,2013,245,234,-81,4,11,-77,11.047730706,10.551710144,-3.65251505,0.1803711136,0.4960205623,-3.472143936
17173,2014,262,227,-68,4,35,-64,11.84073756,10.258959642,-3.073168527,0.1807746192,1.5817779184,-2.892393908
17173,2015,251,269,-268,4,-18,-264,11.424670005,12.243969049,-12.19845244,0.1820664543,-0.819299044,-12.01638598
17173,2016,250,259,-96,4,-9,-92,11.479474699,11.892735788,-4.408118285,0.1836715952,-0.413261089,-4.224446689
17173,2017,242,255,3,4,-13,7,11.140266077,11.738710123,0.138102472,0.1841366294,-0.598444045,0.3222391014
18145,2010,132,135,-88,8,-3,-80,NA,NA,NA,NA,NA,NA
18145,2011,538,472,-124,32,66,-92,12.141454718,10.651982578,-2.798402203,0.7221683104,1.4894721401,-2.076233892
18145,2012,517,420,-120,5,97,-115,11.674250037,9.4839168577,-2.709690531,0.1129037721,2.190333179,-2.596786759
18145,2013,470,433,47,3,37,50,10.605889654,9.7709579149,1.0605889654,0.067697168,0.8349317387,1.1282861334
18145,2014,515,429,-77,9,86,-68,11.609165605,9.6705476596,-1.735739324,0.2028786222,1.9386179457,-1.532860701
18145,2015,512,432,-108,11,80,-97,11.542450065,9.7389422427,-2.434735561,0.2479823256,1.8035078227,-2.186753235
18145,2016,491,425,-196,10,66,-186,11.086399404,9.5961705635,-4.425528072,0.2257922486,1.4902288404,-4.199735823
18145,2017,480,433,115,10,47,125,10.832402424,9.7717296864,2.5952630807,0.2256750505,1.0606727373,2.8209381312
19165,2010,30,33,10,0,-3,10,NA,NA,NA,NA,NA,NA
19165,2011,117,158,-148,-1,-41,-149,9.686232304,13.080553026,-12.25266992,-0.08278831,-3.394320722,-12.33545823
19165,2012,125,131,33,9,-6,42,10.414063151,10.913938182,2.7493126718,0.7498125469,-0.499875031,3.4991252187
19165,2013,124,120,-143,11,4,-132,10.370494271,10.035962198,-11.95952162,0.9199632015,0.3345320733,-11.03955842
19165,2014,116,155,8,11,-39,19,9.761433921,13.043295325,0.6732023394,0.9256532166,-3.281861404,1.598855556
19165,2015,132,168,-52,11,-36,-41,11.154772468000001,14.196983141,-4.394304306,0.9295643723,-3.042210673,-3.464739933
19165,2016,110,151,-93,11,-41,-82,9.3752663428,12.869683798,-7.926361544,0.9375266343,-3.494417455,-6.98883491
19165,2017,112,133,-34,11,-21,-23,9.6137339056,11.416309013,-2.918454936,0.9442060086,-1.802575107,-1.974248927
21211,2010,149,53,101,7,96,108,NA,NA,NA,NA,NA,NA
21211,2011,605,327,286,46,278,332,14.214056645,7.6826388807,6.7193722321,1.0807381912,6.531417764,7.8001104232
21211,2012,622,352,427,49,270,476,14.383498289,8.1398575525,9.8742022015,1.1331051707,6.2436407363,11.007307372
21211,2013,623,325,352,90,298,442,14.162148646,7.3879587638,8.0017276457,2.0458962731,6.7741898819,10.047623919
21211,2014,624,358,276,122,266,398,13.961449395,8.0099341082,6.1752564633,2.7296423497,5.9515152871,8.9048988131
21211,2015,619,366,334,138,253,472,13.637515284,8.0635389242,7.3585300565,3.0403507419,5.5739763602,10.398880798
21211,2016,585,332,445,143,253,588,12.67001646,7.190505068,9.6378757689,3.0971151347,5.4795113922,12.734990904
21211,2017,597,317,403,143,280,546,12.700371225,6.743748205,8.5732824184,3.042132471,5.9566230202,11.615414889
29205,2010,24,27,-4,0,-3,-4,NA,NA,NA,NA,NA,NA
29205,2011,64,94,-104,0,-30,-104,10.157117918,14.918266942,-16.50531662,0,-4.761149024,-16.50531662
29205,2012,88,86,-20,0,2,-20,14.133140609,13.811932868,-3.212077411,0,0.3212077411,-3.212077411
29205,2013,59,68,-54,1,-9,-53,9.5392077607,10.994341148,-8.730800323,0.1616814875,-1.455133387,-8.569118836
29205,2014,72,82,-52,1,-10,-51,11.758941695,13.392128042,-8.492569002,0.1633186347,-1.633186347,-8.329250367
29205,2015,75,92,26,1,-17,27,12.301131704,15.089388224,4.2643923241,0.1640150894,-2.78825652,4.4284074134999996
29205,2016,74,80,-46,1,-6,-45,12.179065174,13.166556945,-7.570770244,0.1645819618,-0.987491771,-7.406188282
29205,2017,76,62,-45,1,14,-44,12.591119947,10.271703115,-7.45526839,0.1656726309,2.3194168323,-7.289595759
39149,2010,136,112,-146,9,24,-137,NA,NA,NA,NA,NA,NA
39149,2011,626,435,-337,41,191,-296,12.707176713,8.8300668852,-6.840764461,0.8322591777,3.8771098278,-6.008505283
39149,2012,629,397,-388,46,232,-342,12.794564853,8.0754248752,-7.89235479,0.9356915472,4.7191399774,-6.956663243
39149,2013,642,439,-260,72,203,-188,13.07123006,8.9381152589,-5.293644572,1.4659323432,4.1331148008,-3.827712229
39149,2014,564,429,-408,83,135,-325,11.503630578,8.7501019825,-8.321775312,1.6929101738,2.7535285959,-6.628865138
39149,2015,642,429,-265,84,213,-181,13.115289936,8.7639554244,-5.413632139,1.7160192439,4.3513345114,-3.697612895
39149,2016,598,453,-476,88,145,-388,12.242432928,9.2739500271,-9.744812832,1.8015620362,2.9684829005,-7.943250796
39149,2017,591,440,-204,87,151,-117,12.124942299,9.0270297995,-4.185259271,1.7848899831,3.0979124994,-2.400369288
47157,2010,3283,1744,-932,286,1539,-646,NA,NA,NA,NA,NA,NA
47157,2011,13739,7549,-2647,1240,6190,-1407,14.758676993,8.1092694245,-2.843454254,1.3320299492,6.6494075689,-1.511424305
47157,2012,14112,7471,-1599,1248,6641,-351,15.071343781,7.9788838854,-1.707701156,1.3328399262,7.092459896,-0.374861229
47157,2013,13776,7946,-7670,1144,5830,-6526,14.668973779,8.461067483,-8.167176893,1.2181551977,6.2079062958,-6.949021696
47157,2014,13831,7816,-7827,1353,6015,-6474,14.735313561,8.3270342558,-8.33875347,1.441463325,6.4082793051,-6.897290145
47157,2015,13695,8053,-7824,1612,5642,-6212,14.597730983,8.5838282296,-8.339733276,1.7182579295,6.0139027532,-6.621475346
47157,2016,13313,8108,-7564,1599,5205,-5965,14.20041973,8.6484641456,-8.068202121,1.7055863553,5.5519555844,-6.362615766
47157,2017,13196,8200,-6733,1563,4996,-5170,14.082560559,8.7509091074,-7.185350124,1.6680086506,5.3316514513,-5.517341474
48419,2010,90,55,-25,2,35,-23,NA,NA,NA,NA,NA,NA
48419,2011,354,287,186,21,67,207,13.831636939,11.21378475,7.2674702561,0.8205208354,2.617852189,8.0879910915
48419,2012,336,268,224,35,68,259,12.975728437,10.349688158,8.6504856244,1.3516383788,2.6260402788,10.002124003
48419,2013,379,270,-234,50,109,-184,14.564879042,10.376035202,-8.992563841,1.9214880003,4.1888438407,-7.071075841
48419,2014,385,323,-443,55,62,-388,14.90774622,12.507018257,-17.15358851,2.1296780314,2.4007279627,-15.02391048
48419,2015,357,309,-280,66,48,-214,13.953488372,12.077389095,-10.94391245,2.5796365058,1.8760992769,-8.364275943
48419,2016,400,272,78,69,128,147,15.600624025,10.608424337,3.0421216849,2.6911076443,4.992199688,5.7332293292
48419,2017,390,295,-429,69,95,-360,15.207642815,11.503217001,-16.7284071,2.6905829596,3.704425814,-14.03782414
51171,2010,122,120,45,11,2,56,NA,NA,NA,NA,NA,NA
51171,2011,475,432,121,51,43,172,11.267405176,10.247408497,2.8702232132,1.2097635031,1.0199966791,4.0799867163
51171,2012,470,456,227,31,14,258,11.085690025,10.755477982,5.3541524164,0.7311838102,0.3302120433,6.0853362266
51171,2013,462,472,-33,29,-10,-4,10.864964019,11.1001364,-0.776068858,0.6819999059,-0.235172381,-0.094068953
51171,2014,479,464,183,37,15,220,11.236877602,10.884992083,4.2930033429,0.8679842824,0.3518855199,5.1609876254
51171,2015,433,508,155,45,-75,200,10.115995187,11.868188349,3.621199201,1.0513158971,-1.752193162,4.6725150981
51171,2016,457,488,50,46,-31,96,10.653674002,11.376352107,1.1656098471,1.0723610593,-0.722678105,2.2379709064
51171,2017,438,462,279,44,-24,323,10.167957007,10.725105336,6.4768493262,1.0214386034,-0.557148329,7.4982879296
27141,2010,327,68,42,8,259,50,NA,NA,NA,NA,NA,NA
27141,2011,1172,499,-275,63,673,-212,13.164915276,5.6051985689,-3.089037287,0.7076703604,7.5597167072,-2.381366927
27141,2012,1134,430,-573,58,704,-515,12.691235885,4.8123733954,-6.412767339,0.6491108301,7.8788624892,-5.763656508
27141,2013,1188,502,-106,45,686,-61,13.23499922,5.5925670105,-1.180900604,0.501325728,7.6424322096,-0.679574876
27141,2014,1134,457,82,51,677,133,12.534611112,5.0514261713,0.9063828141,0.5637258966,7.4831849408,1.4701087107
27141,2015,1225,523,-247,57,702,-190,13.443515287,5.7395579553,-2.710651654,0.625534997,7.7039573319,-2.085116657
27141,2016,1193,506,1113,59,687,1172,12.924333606,5.4817374724,12.057655745,0.6391749227,7.4425961335,12.696830667
27141,2017,1235,524,566,59,711,625,13.151869482,5.5802264038,6.0274964591,0.6283079348,7.5716430785,6.6558043939
20179,2010,4,13,-6,0,-9,-6,NA,NA,NA,NA,NA,NA
20179,2011,26,42,-11,0,-16,-11,10.335917313,16.696481813,-4.372888094,0,-6.3605645,-4.372888094
20179,2012,26,20,-15,-1,6,-16,10.416666667,8.0128205128,-6.009615385,-0.400641026,2.4038461538,-6.41025641
20179,2013,30,35,11,2,-5,13,12.02163895,14.025245442,4.4079342817,0.8014425967,-2.003606492,5.2093768784
20179,2014,27,28,4,1,-1,5,10.793523886,11.19328403,1.5990405757,0.3997601439,-0.399760144,1.9988007196
20179,2015,27,31,-26,2,-4,-24,10.847730012,12.454801125,-10.44596223,0.8035355564,-1.607071113,-9.642426677
20179,2016,27,29,8,2,-2,10,10.893685697,11.700625378,3.227758725,0.8069396813,-0.806939681,4.0346984063
20179,2017,28,22,37,2,6,39,11.179876223,8.7841884608,14.773407866,0.7985625873,2.395687762,15.571970453
30091,2010,4,21,1,0,-17,1,NA,NA,NA,NA,NA,NA
30091,2011,32,66,81,0,-34,81,9.431181845,19.451812555,23.872679045,0,-10.02063071,23.872679045
30091,2012,39,47,136,0,-8,136,11.195636572,13.492177408,39.041194201,0,-2.296540835,39.041194201
30091,2013,41,58,90,-1,-17,89,11.431757981,16.171755193,25.094102886,-0.278823365,-4.739997212,24.81527952
30091,2014,38,65,51,3,-27,54,10.446735395,17.869415808,14.020618557,0.824742268,-7.422680412,14.845360825
30091,2015,51,54,1,3,-3,4,13.966862933,14.788443106,0.2738600575,0.8215801725,-0.821580173,1.09544023
30091,2016,42,48,-54,3,-6,-51,11.589403974,13.245033113,-14.90066225,0.8278145695,-1.655629139,-14.07284768
30091,2017,45,42,-132,3,3,-129,12.738853503,11.889596603,-37.36730361,0.8492569002,0.8492569002,-36.51804671
31161,2010,15,28,-12,0,-13,-12,NA,NA,NA,NA,NA,NA
31161,2011,53,64,-71,0,-11,-71,9.8111810441,11.847463902,-13.14328027,0,-2.036282858,-13.14328027
31161,2012,65,70,-28,1,-5,-27,12.162035738,13.097576948,-5.239030779,0.1871082421,-0.935541211,-5.051922537
31161,2013,46,79,-88,0,-33,-88,8.7303093566,14.993357373,-16.70146138,0,-6.263048017,-16.70146138
31161,2014,71,71,45,0,0,45,13.572930606,13.572930606,8.6025616517,0,0,8.6025616517
31161,2015,51,82,-7,0,-31,-7,9.7439816584,15.666794039,-1.337409247,0,-5.922812381,-1.337409247
31161,2016,58,56,23,0,2,23,11.096231108,10.713602449,4.4002295772,0,0.3826286589,4.4002295772
31161,2017,57,55,49,0,2,49,10.828267477,10.448328267,9.3085106383,0,0.3799392097,9.3085106383
38083,2010,4,4,-6,0,0,-6,NA,NA,NA,NA,NA,NA
38083,2011,11,12,1,0,-1,1,8.358662614,9.1185410334,0.7598784195,0,-0.759878419,0.7598784195
38083,2012,12,14,-29,0,-2,-29,9.2307692308,10.769230769,-22.30769231,0,-1.538461538,-22.30769231
38083,2013,13,9,38,0,4,38,9.9578705477,6.8939103792,29.107621601,0,3.0639601685,29.107621601
38083,2014,7,11,10,0,-4,10,5.2611800075,8.2675685832,7.5159714393,0,-3.006388576,7.5159714393
38083,2015,13,15,-22,0,-2,-22,9.8335854766,11.346444781,-16.64145234,0,-1.512859304,-16.64145234
38083,2016,15,3,25,0,12,25,11.29092962,2.258185924,18.818216033,0,9.0327436959,18.818216033
38083,2017,12,11,7,0,1,7,8.8888888889,8.1481481481,5.1851851852,0,0.7407407407,5.1851851852
56033,2010,88,84,-1,8,4,7,NA,NA,NA,NA,NA,NA
56033,2011,343,298,47,41,45,88,11.751203385,10.209500317,1.6102232043,1.4046627953,1.541703068,3.0148859996
56033,2012,332,286,202,25,46,227,11.295974958,9.7308699942,6.8728522337,0.850600524,1.5651049641,7.7234527576
56033,2013,307,292,157,34,15,191,10.360595987,9.8543779424,5.2984155375,1.1474275686,0.506218045,6.4458431062
56033,2014,361,296,67,24,65,91,12.109420861,9.929054224,2.2474548413,0.8050584506,2.180366637,3.0525132919
56033,2015,330,332,29,28,-2,57,11.031623989,11.098482316,0.9694457445,0.9360165809,-0.066858327,1.9054623253
56033,2016,327,333,83,33,-6,116,10.9019987,11.102035373,2.7671739819,1.1002017036,-0.200036673,3.8673756855
56033,2017,331,343,142,33,-12,175,10.985910818,11.384191573,4.7129889311,1.0952720755,-0.398280755,5.8082610067
20181,2010,20,8,-4,1,12,-3,NA,NA,NA,NA,NA,NA
20181,2011,79,71,29,-2,8,27,13.08813784,11.762756793,4.8045062956,-0.331345262,1.3253810471,4.4731610338
20181,2012,76,75,68,-4,1,64,12.484599589,12.320328542,11.170431211,-0.657084189,0.1642710472,10.513347023
20181,2013,85,72,-41,-3,13,-44,13.920733705,11.791680314,-6.714706846,-0.491320013,2.1290533901,-7.206026859
20181,2014,84,81,-23,-4,3,-27,13.818062181,13.324559961,-3.783517026,-0.658002961,0.4935022208,-4.441519987
20181,2015,75,68,-111,-4,7,-115,12.471938139,11.30789058,-18.45846845,-0.665170034,1.1640475597,-19.12363848
20181,2016,83,75,-20,-4,8,-24,13.943721126,12.599748005,-3.359932801,-0.67198656,1.3439731205,-4.031919362
20181,2017,80,84,-5,-4,-4,-9,13.473684211,14.147368421,-0.842105263,-0.673684211,-0.673684211,-1.515789474
31163,2010,7,3,7,0,4,7,NA,NA,NA,NA,NA,NA
31163,2011,33,48,-47,0,-15,-47,10.53471668,15.323224262,-15.00399042,0,-4.788507582,-15.00399042
31163,2012,28,34,-17,0,-6,-17,9.0629551707,11.005016993,-5.502508497,0,-1.942061822,-5.502508497
31163,2013,29,43,-4,0,-14,-4,9.4477928001,14.008796221,-1.303143835,0,-4.561003421,-1.303143835
31163,2014,33,28,-32,0,5,-32,10.82854799,9.1878589007,-10.50041017,0,1.6406890894,-10.50041017
31163,2015,25,45,24,0,-20,24,8.23723229,14.827018122,7.9077429984,0,-6.589785832,7.9077429984
31163,2016,30,35,-6,0,-5,-6,9.8993565418,11.549249299,-1.979871308,0,-1.649892757,-1.979871308
31163,2017,31,35,65,0,-4,65,10.145639012,11.454753723,21.273114057,0,-1.309114711,21.273114057
41055,2010,3,1,10,0,2,10,NA,NA,NA,NA,NA,NA
41055,2011,20,13,-38,1,7,-37,11.337868481,7.3696145125,-21.54195011,0.566893424,3.9682539683,-20.97505669
41055,2012,17,18,-3,0,-1,-3,9.7337532207,10.30632694,-1.717721157,0,-0.572573719,-1.717721157
41055,2013,12,11,-21,1,1,-20,6.916426513,6.3400576369,-12.1037464,0.5763688761,0.5763688761,-11.52737752
41055,2014,14,20,-9,3,-6,-6,8.1395348837,11.627906977,-5.23255814,1.7441860465,-3.488372093,-3.488372093
41055,2015,21,24,-21,3,-3,-18,12.323943662,14.084507042,-12.32394366,1.7605633803,-1.76056338,-10.56338028
41055,2016,18,16,19,3,2,22,10.55408971,9.3814130753,11.140428027,1.7590149516,1.1726766344,12.899442979
41055,2017,19,14,33,3,5,36,10.935251799,8.0575539568,18.992805755,1.726618705,2.8776978417,20.71942446
48421,2010,5,8,-7,0,-3,-7,NA,NA,NA,NA,NA,NA
48421,2011,36,26,-25,3,10,-22,11.922503726,8.6106971353,-8.279516476,0.9935419771,3.3118065905,-7.285974499
48421,2012,48,32,2,5,16,7,15.865146257,10.576764171,0.6610477607,1.6526194018,5.2883820856,2.3136671625
48421,2013,36,24,15,5,12,20,11.791680314,7.8611202096,4.913200131,1.637733377,3.9305601048,6.550933508
48421,2014,41,42,-7,6,-1,-1,13.361577318,13.687469448,-2.281244908,1.9553527782,-0.32589213,-0.32589213
48421,2015,41,31,-25,7,10,-18,13.381201044,10.117493473,-8.15926893,2.2845953003,3.2637075718,-5.874673629
48421,2016,35,19,-8,7,16,-1,11.40994295,6.1939690302,-2.60798696,2.2819885901,5.2159739201,-0.32599837
48421,2017,37,10,-41,7,27,-34,12.048192771,3.2562683165,-13.3507001,2.2793878216,8.7919244546,-11.07131228
26155,2010,178,145,-75,5,33,-70,NA,NA,NA,NA,NA,NA
26155,2011,691,663,-691,5,28,-686,9.8309811063,9.4326200774,-9.830981106,0.071135898,0.3983610289,-9.759845208
26155,2012,698,676,-705,1,22,-704,10.024126838,9.7081801471,-10.12465533,0.0143612132,0.3159466912,-10.11029412
26155,2013,710,732,-414,3,-22,-411,10.277417907,10.59587311,-5.992747907,0.0434257095,-0.318455203,-5.949322197
26155,2014,714,737,-74,6,-23,-68,10.375041776,10.709251805,-1.075284442,0.087185225,-0.334210029,-0.988099217
26155,2015,707,749,-277,7,-42,-270,10.304019588,10.916139563,-4.037076981,0.1020199959,-0.612119976,-3.935056985
26155,2016,734,687,27,11,47,38,10.715406682,10.029270287,0.394163461,0.1605851138,0.6861363952,0.5547485748
26155,2017,712,710,-105,11,2,-94,10.395146985,10.365947134,-1.532992182,0.1605991809,0.0291998511,-1.372393001
16079,2010,33,42,-31,0,-9,-31,NA,NA,NA,NA,NA,NA
16079,2011,125,187,-30,2,-62,-28,9.8351626736,14.71340336,-2.360439042,0.1573626028,-4.878240686,-2.203076439
16079,2012,112,192,117,8,-80,125,8.8279341058,15.133601324,9.2220383069,0.6305667218,-6.305667218,9.8526050288
16079,2013,124,194,40,0,-70,40,9.7672403608,15.281005081,3.150722697,0,-5.51376472,3.150722697
16079,2014,139,177,-276,8,-38,-268,11.092933243,14.125533698,-22.02625594,0.638442201,-3.032600455,-21.38781373
16079,2015,145,158,60,8,-13,68,11.687421916,12.735259743,4.8361745859,0.6448232781,-1.047837827,5.480997864
16079,2016,163,189,0,6,-26,6,13.120824278,15.213716494,0,0.4829751268,-2.092892216,0.4829751268
16079,2017,155,174,142,6,-19,148,12.422360248,13.945101182,11.380484873,0.480865558,-1.522740934,11.861350431
27143,2010,46,21,-3,1,25,-2,NA,NA,NA,NA,NA,NA
27143,2011,188,163,-123,6,25,-117,12.365980399,10.721568112,-8.090508452,0.3946589489,1.644412287,-7.695849503
27143,2012,178,141,-135,11,37,-124,11.777160249,9.3290988487,-8.932115919,0.7278020378,2.4480614,-8.204313881
27143,2013,170,149,-75,12,21,-63,11.295681063,9.9003322259,-4.983388704,0.7973421927,1.3953488372,-4.186046512
27143,2014,177,131,-196,16,46,-180,11.828783373,8.7546362816,-13.09853978,1.0692685535,3.0741470913,-12.02927123
27143,2015,154,151,-63,17,3,-46,10.35259319,10.150919297,-4.23515176,1.1428187288,0.2016738933,-3.092333031
27143,2016,154,165,-69,19,-11,-50,10.38961039,11.131725417,-4.655085175,1.2818350481,-0.742115028,-3.373250126
27143,2017,147,141,52,19,6,71,9.912005664,9.5074340042,3.5062877179,1.2811435892,0.4045716598,4.7874313071
06091,2010,7,20,-5,0,-13,-5,NA,NA,NA,NA,NA,NA
06091,2011,17,35,-107,1,-18,-106,5.3788957443,11.074197121,-33.85540263,0.316405632,-5.695301376,-33.53899699
06091,2012,21,31,-23,2,-10,-21,6.8093385214,10.051880674,-7.457846952,0.6485084306,-3.242542153,-6.809338521
06091,2013,19,38,-19,-1,-19,-20,6.2315513283,12.463102657,-6.231551328,-0.327976386,-6.231551328,-6.559527714
06091,2014,15,34,-32,-1,-19,-33,4.9925112332,11.316358795,-10.65069063,-0.332834082,-6.323847562,-10.98352471
06091,2015,16,27,27,-1,-11,26,5.3574418215,9.0406830738,9.0406830738,-0.334840114,-3.683241252,8.70584296
06091,2016,29,26,-30,-1,3,-31,9.734810339,8.7277609936,-10.07049345,-0.335683115,1.0070493454,-10.40617657
06091,2017,30,43,49,-1,-13,48,10.062049304,14.422270669,16.43468053,-0.335401643,-4.360221365,16.099278886
35051,2010,17,30,54,0,-13,54,NA,NA,NA,NA,NA,NA
35051,2011,93,231,120,-4,-138,116,7.7300307539,19.200398969,9.9742332308,-0.332474441,-11.47036822,9.6417587898
35051,2012,75,232,-7,-3,-157,-10,6.2824593734,19.433740995,-0.586362875,-0.251298375,-13.15128162,-0.83766125
35051,2013,111,250,-188,-3,-139,-191,9.4961074515,21.387629395,-16.08349731,-0.256651553,-11.89152194,-16.34014886
35051,2014,110,247,-119,-2,-137,-121,9.6537803326,21.677124929,-10.44363509,-0.175523279,-12.0233446,-10.61915837
35051,2015,125,230,76,-1,-105,75,11.112098853000001,20.44626189,6.7561561028,-0.088896791,-9.334163037,6.6672593119
35051,2016,97,244,50,-1,-147,49,8.6734921983,21.817856664,4.4708722672,-0.089417445,-13.14436447,4.3814548218
35051,2017,104,241,120,-1,-137,119,9.3483146067,21.662921348,10.786516854,-0.08988764,-12.31460674,10.696629213
30093,2010,93,121,25,11,-28,36,NA,NA,NA,NA,NA,NA
30093,2011,396,401,135,27,-5,162,11.547209424,11.693007523,3.9365486674,0.7873097335,-0.145798099,4.7238584009
30093,2012,427,392,37,12,35,49,12.408281874,11.39120959,1.0751907011,0.3487104976,1.0170722848,1.4239011987
30093,2013,389,402,-41,43,-13,2,11.294022007,11.67145719,-1.190372499,1.2484394507,-0.377435183,0.0580669512
30093,2014,380,417,121,61,-37,182,11.01241795,12.084679698,3.5065857157,1.7677828815,-1.072261748,5.2743685972
30093,2015,405,398,-158,63,7,-95,11.727912432,11.525207772,-4.575333739,1.8243419338,0.2027046593,-2.750991805
30093,2016,402,435,-55,68,-33,13,11.659778116,12.616924081,-1.595243275,1.9723007759,-0.957145965,0.3770575013
30093,2017,396,415,87,68,-19,155,11.466794075,12.016968539,2.5192199105,1.9690454473,-0.550174463,4.4882653578
21213,2010,67,71,19,-5,-4,14,NA,NA,NA,NA,NA,NA
21213,2011,245,183,-89,-7,62,-96,14.146313298,10.566429932,-5.138864831,-0.40418038,3.5798833651,-5.54304521
21213,2012,240,207,219,-5,33,214,13.771733517,11.878120158,12.566706834,-0.286911115,1.8936133586,12.279795719000001
21213,2013,206,158,88,1,48,89,11.691259932,8.9670828604,4.9943246311,0.056753689,2.7241770715,5.0510783201
21213,2014,203,184,42,5,19,47,11.4563052,10.384040182,2.3702700415,0.2821750049,1.0722650188,2.6524450464
21213,2015,236,203,85,6,33,91,13.249122807,11.396491228,4.7719298246,0.3368421053,1.8526315789,5.1087719298
21213,2016,230,149,24,7,81,31,12.828020859,8.3103265568,1.3385760897,0.3904180262,4.5176943027,1.7289941158
21213,2017,235,164,47,6,71,53,13.021915607,9.0876347214,2.6043831214,0.332474441,3.9342808855,2.9368575624
28127,2010,90,43,-19,0,47,-19,NA,NA,NA,NA,NA,NA
28127,2011,362,301,-217,20,61,-197,13.183291453,10.961797589,-7.902691285,0.7283586438,2.2214938636,-7.174332641
28127,2012,353,295,-45,11,58,-34,12.882036311,10.765441109,-1.642185932,0.4014232278,2.1165952012,-1.240762704
28127,2013,317,303,91,4,14,95,11.54154227,11.031821161,3.3131872133,0.1456346028,0.5097211097,3.4588218161
28127,2014,343,288,-84,2,55,-82,12.470686615,10.471013834,-3.054045702,0.0727153738,1.9996727808,-2.981330328
28127,2015,292,328,-318,3,-36,-315,10.690097016,12.008054183,-11.64195497,0.1098297639,-1.317957166,-11.53212521
28127,2016,297,302,-160,5,-5,-155,10.975609756,11.160384331,-5.912786401,0.184774575,-0.184774575,-5.728011826
28127,2017,292,295,-33,5,-3,-28,10.829454633,10.940716153,-1.223876722,0.185435867,-0.11126152,-1.038440855
19167,2010,138,54,-59,7,84,-52,NA,NA,NA,NA,NA,NA
19167,2011,510,237,-78,51,273,-27,15.06179767,6.999305976,-2.303569055,1.506179767,8.0624916939,-0.797389288
19167,2012,502,255,-23,61,247,38,14.709976118,7.4721990242,-0.673963049,1.7874672176,7.237777094,1.1135041683
19167,2013,526,273,-115,49,253,-66,15.307829984,7.9449383758,-3.346768913,1.4260145803,7.3628916083,-1.920754333
19167,2014,514,253,-207,55,261,-152,14.894233555,7.3312083454,-5.998261374,1.5937409447,7.5630252101,-4.404520429
19167,2015,508,247,-206,66,261,-140,14.670844584,7.1332649849,-5.949200757,1.9060546114,7.5375795994,-4.043146145
19167,2016,486,248,-98,66,238,-32,13.969933025,7.1286901032,-2.816982379,1.8971513984,6.8412429216,-0.919830981
19167,2017,479,261,-316,64,218,-252,13.734570114,7.4837636736,-9.060801996,1.8350991384,6.2508064401,-7.225702857
31165,2010,2,1,-1,0,1,-1,NA,NA,NA,NA,NA,NA
31165,2011,10,8,7,0,2,7,7.6045627376,6.0836501901,5.3231939163,0,1.5209125475,5.3231939163
31165,2012,9,5,0,0,4,0,6.8130204391,3.785011355,0,0,3.028009084,0
31165,2013,12,8,2,0,4,2,9.0463626084,6.0309084056,1.5077271014,0,3.0154542028,1.5077271014
31165,2014,9,10,-8,0,-1,-8,6.7898906073,7.544322897,-6.035458318,0,-0.75443229,-6.035458318
31165,2015,8,11,-43,0,-3,-43,6.160954948,8.4713130535,-33.11513285,0,-2.310358106,-33.11513285
31165,2016,8,5,-19,0,3,-19,6.3041765169,3.9401103231,-14.97241923,0,2.3640661939,-14.97241923
31165,2017,8,7,-60,0,1,-60,6.490872211,5.6795131846,-48.68154158,0,0.8113590264,-48.68154158
38085,2010,23,15,-15,0,8,-15,NA,NA,NA,NA,NA,NA
38085,2011,94,39,31,1,55,32,22.431690729,9.3067653025,7.3976852404,0.2386350078,13.124925427,7.6363202482
38085,2012,102,35,25,3,67,28,23.82620883,8.1756598925,5.8397570661,0.7007708479,15.650548937,6.540527914
38085,2013,100,57,65,0,43,65,22.820629849,13.007759014,14.833409402,0,9.8128708352,14.833409402
38085,2014,98,48,-29,1,50,-28,22.03485104,10.792580101,-6.520517144,0.2248454188,11.242270939,-6.295671726
38085,2015,106,47,-145,1,59,-144,24.000905695,10.641911016,-32.8314276,0.2264236386,13.358994679,-32.60500396
38085,2016,89,52,43,1,37,44,20.160833616,11.779363461,9.7406274776,0.2265262204,8.3814701552,9.967153698
38085,2017,89,78,-91,1,11,-90,20.156267693,17.665043596,-20.60921753,0.2264749179,2.4912240969,-20.38274261
06093,2010,90,109,50,8,-19,58,NA,NA,NA,NA,NA,NA
06093,2011,463,539,-262,16,-76,-246,10.340245441,12.037564347,-5.851283597,0.357330296,-1.697318906,-5.493953301
06093,2012,494,530,-522,18,-36,-504,11.139172003,11.950933526,-11.77054208,0.4058807613,-0.811761523,-11.36466132
06093,2013,453,576,-428,7,-123,-421,10.339514979,13.146932953,-9.768901569,0.1597717546,-2.807417974,-9.609129815
06093,2014,461,474,-151,19,-13,-132,10.605868888,10.904949789,-3.473939701,0.4371182405,-0.299080901,-3.03682146
06093,2015,399,503,50,21,-104,71,9.1998017085,11.597745011,1.152857357,0.4842000899,-2.397943302,1.6370574469
06093,2016,434,555,261,22,-121,283,9.9928622413,12.778890654,6.0095323617,0.5065506205,-2.786028413,6.5160829822
06093,2017,466,561,416,23,-95,439,10.668009707,12.842818552,9.5233734719,0.5265326679,-2.174808846,10.04990614
02220,2010,27,26,-2,4,1,2,NA,NA,NA,NA,NA,NA
02220,2011,117,68,-79,34,49,-45,13.167520117,7.6529176749,-8.890889652,3.8264588374,5.5146024422,-5.064430814
02220,2012,114,57,22,56,57,78,12.730318258,6.365159129,2.4567280849,6.2534896706,6.365159129,8.7102177554
02220,2013,95,71,-126,39,24,-87,10.564946619,7.8959074733,-14.01245552,4.3371886121,2.6690391459,-9.675266904
02220,2014,97,64,-197,42,33,-155,10.895203864,7.1885881164,-22.1273728,4.7175109514,3.7066157475,-17.40986184
02220,2015,70,69,-102,43,1,-59,7.9410096427,7.8275666478,-11.57118548,4.8780487805,0.1134429949,-6.693136699
02220,2016,88,47,-99,39,41,-60,10.026204854,5.354904865,-11.27948046,4.4434316965,4.6712999886,-6.836048764
02220,2017,83,41,-162,39,42,-123,9.5090794524,4.697256115,-18.55989002,4.4681216704,4.8118233373,-14.09176835
53057,2010,379,298,-35,22,81,-13,NA,NA,NA,NA,NA,NA
53057,2011,1480,1084,164,84,396,248,12.621040468,9.2440593701,1.3985477276,0.7163293239,3.3769810983,2.1148770515
53057,2012,1447,1105,-228,55,342,-173,12.298617574,9.3918261365,-1.937860958,0.4674664593,2.9067914377,-1.470394499
53057,2013,1423,1124,173,104,299,277,12.057891437,9.5242937279,1.4659277713,0.881251377,2.5335977087,2.3471791482
53057,2014,1485,1084,1049,156,401,1205,12.468409165,9.1015188789,8.8076506494,1.30981268,3.3668902864,10.117463329
53057,2015,1383,1163,1097,189,220,1286,11.461911728,9.6386141281,9.0916248482,1.5663783923,1.8232975995,10.65800324
53057,2016,1484,1196,1494,194,288,1688,12.123984902,9.7710821719,12.205682914,1.5849414225,2.3529027303,13.790624336
53057,2017,1475,1213,1764,196,262,1960,11.846961355,9.7426197447,14.168162597,1.5742402885,2.1043416101,15.742402885
02230,2010,3,0,-4,0,3,-4,NA,NA,NA,NA,NA,NA
02230,2011,15,0,-21,1,15,-20,15.544041451,0,-21.76165803,1.0362694301,15.544041451,-20.7253886
02230,2012,6,1,30,0,5,30,6.119326874,1.0198878123,30.59663437,0,5.0994390617,30.59663437
02230,2013,8,0,15,1,8,16,7.9090459713,0,14.829461196,0.9886307464,7.9090459713,15.818091943
02230,2014,8,2,22,0,6,22,7.7071290944,1.9267822736,21.19460501,0,5.7803468208,21.19460501
02230,2015,15,4,22,0,11,22,14.031805426,3.7418147802,20.579981291,0,10.289990645,20.579981291
02230,2016,11,2,35,0,9,35,9.9277978339,1.8050541516,31.588447653,0,8.1227436823,31.588447653
02230,2017,13,14,28,0,-1,28,11.36860516,12.243113249,24.486226498,0,-0.874508089,24.486226498
53059,2010,19,4,26,1,15,27,NA,NA,NA,NA,NA,NA
53059,2011,101,88,16,9,13,25,9.0729428674,7.9051383399,1.43729788,0.8084800575,1.1678045275,2.2457779375
53059,2012,101,86,30,5,15,35,9.0388401647,7.69643816,2.6848040093,0.4474673349,1.3424020047,3.1322713442
53059,2013,106,84,85,2,22,87,9.4197102995,7.4646760864,7.5535412779,0.177730383,1.9550342131,7.7312716609
53059,2014,104,82,43,4,22,47,9.1694586493,7.2297654735,3.79121848,0.3526714865,1.9396931758,4.1438899665
53059,2015,86,80,-9,4,6,-5,7.5594427109,7.032039731,-0.79110447,0.3516019866,0.5274029798,-0.439502483
53059,2016,90,69,190,5,21,195,7.8363082281,6.0078363082,16.54331737,0.4353504571,1.8284719199,16.978667828
53059,2017,97,89,227,5,8,232,8.2799829279,7.5970977379,19.376867264,0.4268032437,0.6828851899,19.803670508
38087,2010,5,0,0,0,5,0,NA,NA,NA,NA,NA,NA
38087,2011,9,3,-11,0,6,-11,12.337217272,4.1124057574,-15.07882111,0,8.2248115147,-15.07882111
38087,2012,7,5,37,0,2,37,9.3770931011,6.6979236437,49.564634963,0,2.6791694575,49.564634963
38087,2013,6,2,1,0,4,1,7.8125,2.6041666667,1.3020833333,0,5.2083333333,1.3020833333
38087,2014,11,4,1,0,7,1,14.202711427,5.164622337,1.2911555842,0,9.0380890897,1.2911555842
38087,2015,8,3,-2,0,5,-2,10.249839846,3.8436899423,-2.562459962,0,6.4061499039,-2.562459962
38087,2016,8,3,-2,0,5,-2,10.217113665,3.8314176245,-2.554278416,0,6.3856960409,-2.554278416
38087,2017,8,2,-18,0,6,-18,10.289389068,2.5723472669,-23.1511254,0,7.7170418006,-23.1511254
20183,2010,7,8,9,0,-1,9,NA,NA,NA,NA,NA,NA
20183,2011,33,56,-47,0,-23,-47,8.6263233564,14.638609332,-12.28597569,0,-6.012285976,-12.28597569
20183,2012,31,60,-8,0,-29,-8,8.2184517497,15.906680806,-2.120890774,0,-7.688229056,-2.120890774
20183,2013,32,72,-14,0,-40,-14,8.5882984434,19.323671498,-3.757380569,0,-10.73537305,-3.757380569
20183,2014,26,72,75,0,-46,75,7.000538503,19.386106624,20.193861066,0,-12.38556812,20.193861066
20183,2015,39,66,-14,0,-27,-14,10.5135463,17.792155277,-3.774093544,0,-7.278608977,-3.774093544
20183,2016,48,37,-21,0,11,-21,13.029315961,10.043431053,-5.700325733,0,2.9858849077,-5.700325733
20183,2017,45,44,-11,0,1,-11,12.251565478,11.979308467,-2.994827117,0,0.2722570106,-2.994827117
28129,2010,58,15,-34,0,43,-34,NA,NA,NA,NA,NA,NA
28129,2011,217,144,-43,0,73,-43,13.137979052,8.7182902464,-2.603378337,0,4.4196888055,-2.603378337
28129,2012,177,166,-202,0,11,-202,10.768715968,10.099473732,-12.28972105,0,0.6692422353,-12.28972105
28129,2013,190,172,-127,0,18,-127,11.665387567,10.560245587,-7.797390637,0,1.10514198,-7.797390637
28129,2014,185,175,-32,0,10,-32,11.404265812,10.787819011,-1.972629762,0,0.6164468006,-1.972629762
28129,2015,183,198,-118,0,-15,-118,11.335480674,12.264618434,-7.309217047,0,-0.92913776,-7.309217047
28129,2016,189,156,-138,0,33,-138,11.794807788,9.7353969046,-8.612081877,0,2.0594108837,-8.612081877
28129,2017,178,168,97,0,10,97,11.107990889,10.483946457,6.05323099,0,0.624044432,6.05323099
47159,2010,59,72,-11,0,-13,-11,NA,NA,NA,NA,NA,NA
47159,2011,210,219,17,-1,-9,16,10.978670013,11.449184442,0.8887494772,-0.052279381,-0.470514429,0.8364700962
47159,2012,214,222,-17,-1,-8,-18,11.194225035,11.612700738,-0.889260867,-0.052309463,-0.418475702,-0.94157033
47159,2013,230,221,-72,-1,9,-73,12.059879926,11.587971581,-3.775266759,-0.052434261,0.4719083449,-3.82770102
47159,2014,247,210,-48,0,37,-48,12.977460201,11.033468187,-2.521935586,0,1.9439920139,-2.521935586
47159,2015,208,204,196,0,4,196,10.874679772,10.665551315,10.247294401,0,0.2091284572,10.247294401
47159,2016,242,185,181,0,57,181,12.508399235,9.5622060268,9.3554556262,0,2.9461932082,9.3554556262
47159,2017,231,207,146,0,24,146,11.815252417,10.587693724,7.4676487136,0,1.2275586926,7.4676487136
48423,2010,725,443,365,29,282,394,NA,NA,NA,NA,NA,NA
48423,2011,2984,1939,973,246,1045,1219,14.107046195,9.1667434896,4.5999182132,1.1629803499,4.9403027058,5.7628985631
48423,2012,2975,1954,866,178,1021,1044,13.922688132,9.1445151629,4.0527892175,0.8330213403,4.7781729689,4.8858105578
48423,2013,3008,1967,398,299,1041,697,13.95393069,9.124794437,1.8462980101,1.3870429775,4.8291362526,3.2333409876
48423,2014,3184,2035,1581,347,1149,1928,14.607414272,9.3360829283,7.2532418229,1.5919512413,5.2713313438,8.8451930642
48423,2015,3115,2043,1424,405,1072,1829,14.09735092,9.2458709244,6.4445032777,1.8328819013,4.8514799956,8.277385179
48423,2016,3147,2128,1470,409,1019,1879,14.058050322,9.5060473739,6.5666774622,1.8270551579,4.5520029483,8.3937326201
48423,2017,3159,2064,920,410,1095,1330,13.946034717,9.1119391125,4.0615232478,1.8100266648,4.8340956047,5.8715499126
51173,2010,65,80,1,3,-15,4,NA,NA,NA,NA,NA,NA
51173,2011,343,437,-63,7,-94,-56,10.678538628,13.605018602,-1.961364238,0.2179293598,-2.926479974,-1.743434878
51173,2012,322,420,-54,15,-98,-39,10.070839914,13.135878149,-1.688898619,0.4691385053,-3.065038235,-1.219760114
51173,2013,291,449,16,18,-158,34,9.1400213581,14.102644638,0.5025441297,0.5653621459,-4.96262328,1.0679062755
51173,2014,282,406,-92,17,-124,-75,8.9034824614,12.818488934,-2.904682221,0.5367347583,-3.915006472,-2.367947463
51173,2015,315,413,-77,19,-98,-58,10.002222716,13.114025339,-2.444987775,0.6033086718,-3.111802623,-1.841679103
51173,2016,273,452,-177,19,-179,-158,8.7376776341,14.466777621,-5.665087697,0.6081167584,-5.729099987,-5.056970938
51173,2017,280,464,-255,19,-184,-236,9.0716171778,15.032965609,-8.261651358,0.6155740228,-5.961348431,-7.646077336
53061,2010,2359,977,261,501,1382,762,NA,NA,NA,NA,NA,NA
53061,2011,8951,4718,230,2079,4233,2309,12.455904761,6.5654070678,0.3200601156,2.8930651322,5.8904976935,3.2131252479
53061,2012,8907,4705,3716,2249,4202,5965,12.253118306,6.4725408816,5.1120004072,3.0938882981,5.7805774249,8.2058887053
53061,2013,9342,4864,5661,2196,4478,7857,12.655329883,6.5891163079,7.6687885319,2.9748559647,6.0662135746,10.643644497
53061,2014,9396,5011,5745,2567,4385,8312,12.515501186,6.6746675653,7.6523578453,3.4192519737,5.8408336208,11.071609819
53061,2015,9730,5074,4834,2848,4656,7682,12.747573801,6.6476042619,6.3331728423,3.7312528454,6.0999695395,10.064425688
53061,2016,9943,5477,10250,2767,4466,13017,12.777003193,7.0380817147,13.171505857,3.5556640688,5.7389214785,16.727169925
53061,2017,10064,5612,7534,2679,4452,10213,12.670443207,7.0654339507,9.4852065903,3.3728256511,5.6050092567,12.858032241
42109,2010,101,111,4,2,-10,6,NA,NA,NA,NA,NA,NA
42109,2011,406,327,-21,20,79,-1,10.217306507,8.2292099204,-0.528481371,0.5033155915,1.9880965863,-0.02516578
42109,2012,436,329,16,27,107,43,10.942539121,8.2570994742,0.4015610687,0.6776343034,2.6854396466,1.079195372
42109,2013,496,371,159,27,125,186,12.377874549,9.2584505197,3.9679073656,0.6737955904,3.1194240295,4.641702956
42109,2014,440,368,84,36,72,120,10.91283374,9.1270973102,2.0833591686,0.8928682151,1.7857364303,2.9762273838
42109,2015,472,321,151,37,151,188,11.631775448,7.910593048,3.7211823995,0.9118129058,3.7211823995,4.6329953054
42109,2016,456,356,-213,37,100,-176,11.202279762,8.7456394635,-5.232643836,0.9089569105,2.4566402987,-4.323686926
42109,2017,445,353,7,36,92,43,10.924534787,8.6659792802,0.1718466146,0.8837825895,2.2585555065,1.0556292041
35053,2010,52,73,-59,5,-21,-54,NA,NA,NA,NA,NA,NA
35053,2011,262,165,-134,12,97,-122,14.738559334,9.2819171378,-7.538041797,0.6750485191,5.4566421962,-6.862993278
35053,2012,205,174,-362,23,31,-339,11.638469399,9.8785057341,-20.551833769999998,1.3057794936,1.7599636653,-19.24605428
35053,2013,231,158,-87,26,73,-61,13.222289001,9.0438167196,-4.97982313,1.4882230045,4.1784722818,-3.491600126
35053,2014,216,187,-324,31,29,-293,12.450644148,10.779029887,-18.67596622,1.7868980027,1.6716142606,-16.88906822
35053,2015,189,177,-188,32,12,-156,11.021693492,10.321903429,-10.96337765,1.8661068346,0.699790063,-9.097270819
35053,2016,221,153,-260,33,68,-227,13.001912046,9.0013237241,-15.29636711,1.9414619797,4.0005883218,-13.35490513
35053,2017,197,173,-176,33,24,-143,11.685499896,10.261885696,-10.43983747,1.9574695258,1.4236142006,-8.482367945
06095,2010,1190,638,-80,309,552,229,NA,NA,NA,NA,NA,NA
06095,2011,5172,2875,-696,1018,2297,322,12.451729086,6.9216398147,-1.675638717,2.4508623761,5.5300892711,0.7752236592
06095,2012,5067,2925,124,1420,2142,1544,12.108698691,6.9899237561,0.2963249729,3.3933988833,5.1187749352,3.6897238562
06095,2013,5142,2965,921,1072,2177,1993,12.175442875,7.0206511328,2.1807823586,2.5383264804,5.1547917424,4.7191088390000004
06095,2014,5254,3042,2275,1137,2212,3412,12.299020222,7.1209782099,5.325517892,2.6615885025,5.1780420119,7.9871063945
06095,2015,5282,3211,1401,1331,2071,2732,12.216332232,7.4264753499,3.2402653271,3.0783677019,4.7898568825,6.318633029
06095,2016,5087,3485,2723,1240,1602,3963,11.626511738,7.9650861818,6.2235092318,2.8340622282,3.6614255562,9.0575714601
06095,2017,5160,3511,2336,1154,1649,3490,11.650801105,7.9275121475,5.2744711981,2.6056248984,3.7232889579,7.8800960965
23025,2010,135,172,32,4,-37,36,NA,NA,NA,NA,NA,NA
23025,2011,493,569,-228,11,-76,-217,9.4676601629,10.927177754,-4.378552773,0.2112459671,-1.459517591,-4.167306806
23025,2012,497,532,-77,6,-35,-71,9.5821082566,10.256904613,-1.484551983,0.1156793753,-0.674796356,-1.368872608
23025,2013,479,530,-72,16,-51,-56,9.2550550183,10.240457536,-1.391156495,0.3091458879,-0.985402518,-1.082010608
23025,2014,508,594,-402,19,-86,-383,9.8701147304,11.541039665,-7.810602602,0.3691578344,-1.670924935,-7.441444767
23025,2015,447,589,-371,21,-142,-350,8.7663388278,11.551171297,-7.275865112,0.4118414214,-2.784832469,-6.864023691
23025,2016,474,554,-24,23,-80,-1,9.3483748817,10.926159672,-0.473335437,0.4536131272,-1.57778479,-0.01972231
23025,2017,461,532,15,23,-71,38,9.1026666272,10.504595761,0.2961822113,0.4541460573,-1.401929133,0.7503282686
24039,2010,65,96,11,12,-31,23,NA,NA,NA,NA,NA,NA
24039,2011,241,285,-192,35,-44,-157,9.1415999697,10.810605773,-7.282934416,1.3276182529,-1.669005804,-5.955316163
24039,2012,275,233,-303,34,42,-269,10.515247108,8.9092820954,-11.58589045,1.3000669152,1.6059650129,-10.28582354
24039,2013,277,246,-144,45,31,-99,10.650364304,9.4584462772,-5.536651479,1.7302035873,1.1919180268,-3.806447892
24039,2014,261,241,-454,37,20,-417,10.123538196,9.3477881427,-17.60952621,1.4351375987,0.7757500533,-16.17438861
24039,2015,246,275,96,38,-29,134,9.5943837754,10.725429017,3.744149766,1.4820592824,-1.131045242,5.2262090484
24039,2016,237,261,126,39,-24,165,9.1994177584,10.131004367,4.8908296943,1.5138282387,-0.931586608,6.404657933
24039,2017,246,271,71,39,-25,110,9.5070626655,10.47322757,2.7439083303,1.5072172518,-0.966164905,4.2511255821
34035,2010,849,458,33,425,391,458,NA,NA,NA,NA,NA,NA
34035,2011,3661,2175,-802,1665,1486,863,11.249990397,6.6836189876,-2.464488473,5.1164255698,4.5663714095,2.6519370972
34035,2012,3400,2210,-878,1692,1190,814,10.378747987,6.7461861917,-2.680159039,5.1649534101,3.6325617955,2.4847943711
34035,2013,3444,2300,-415,1737,1144,1322,10.442423406,6.9737438544,-1.258305956,5.2666926413,3.4686795519,4.008386685
34035,2014,3322,2284,-1612,1893,1038,281,10.015466388,6.8860100034,-4.860003558,5.7071878005,3.1294563851,0.847184243
34035,2015,3411,2361,-2058,2058,1050,0,10.2471821,7.092816458,-6.182556658,6.1825566584,3.154365642,0
34035,2016,3213,2517,-1820,2094,696,274,9.6230449914,7.5385011651,-5.450962304,6.2716016844,2.0845438263,0.8206393799
34035,2017,3238,2535,-1732,2083,703,351,9.668485604,7.5693672039,-5.171654437,6.219720665,2.0991184001,1.0480662282
42111,2010,224,172,-9,2,52,-7,NA,NA,NA,NA,NA,NA
42111,2011,647,1000,-125,11,-353,-114,8.3438114582,12.896153722,-1.612019215,0.1418576909,-4.552342264,-1.470161524
42111,2012,702,862,-105,23,-160,-82,9.0959152603,11.16905834,-1.360500146,0.2980143176,-2.073143079,-1.062485828
42111,2013,666,977,-90,38,-311,-52,8.664541729,12.7105965,-1.170884017,0.4943732518,-4.046054771,-0.676510766
42111,2014,713,934,-200,41,-221,-159,9.3220283583,12.211464918,-2.614874715,0.5360493165,-2.88943656,-2.078825398
42111,2015,660,1006,-433,43,-346,-390,8.6930751753,13.250353979,-5.703184168,0.566367019,-4.557278804,-5.136817149
42111,2016,705,964,-270,48,-259,-222,9.3611201477,12.800169961,-3.585109844,0.6373528611,-3.439049813,-2.947756983
42111,2017,671,937,-349,48,-266,-301,8.9723275234,12.52916675,-4.666680038,0.64183565,-3.556839227,-4.024844388
48425,2010,19,20,7,0,-1,7,NA,NA,NA,NA,NA,NA
48425,2011,79,75,-85,3,4,-82,9.3402695673,8.8673445259,-10.04965713,0.354693781,0.4729250414,-9.694963348
48425,2012,98,80,108,0,18,108,11.553878802,9.4317377977,12.732846027,0,2.1221410045,12.732846027
48425,2013,84,81,12,-1,3,11,9.8222637979,9.4714686623,1.4031805426,-0.116931712,0.3507951356,1.2862488307
48425,2014,85,94,5,-1,-9,4,9.9345488546,10.986442263,0.5843852267,-0.116877045,-1.051893408,0.4675081814
48425,2015,82,86,65,-1,-4,64,9.5537690784,10.019806594,7.5731096353,-0.116509379,-0.466037516,7.4566002563
48425,2016,84,78,62,-1,6,61,9.7149135488,9.0209911525,7.1705314289,-0.115653733,0.6939223963,7.0548776962
48425,2017,80,92,179,-1,-12,178,9.1298145506,10.499286733,20.427960057,-0.114122682,-1.369472183,20.313837375
06097,2010,1420,951,386,123,469,509,NA,NA,NA,NA,NA,NA
06097,2011,5307,3875,1113,507,1432,1620,10.912466882,7.9679308774,2.288595372,1.0425137948,2.9445360043,3.3311091668
06097,2012,5045,3852,1291,489,1193,1780,10.311048252,7.8727765844,2.6385655687,0.9994256879,2.438271668,3.6379912566
06097,2013,5069,3911,2514,615,1158,3129,10.284586207,7.9350989656,5.1007002811,1.247784675,2.3494872417,6.3484849561
06097,2014,4996,4010,2839,733,986,3572,10.046552782,8.0637863599,5.7089998693,1.4740038409,1.9827664217,7.1830037101
06097,2015,5070,4045,655,929,1025,1584,10.123205602,8.0766009191,1.3078303095,1.8549226833,2.0466046828,3.1627529928
06097,2016,5033,4326,96,945,707,1041,10.006670451,8.6010046435,0.1908683416,1.8788602377,1.4056658074,2.0697285793
06097,2017,4963,4369,-1126,943,594,-183,9.846733793,8.6682208224,-2.23401617,1.8709389415,1.1785129706,-0.363077228
51175,2010,44,62,76,0,-18,76,NA,NA,NA,NA,NA,NA
51175,2011,185,199,9,3,-14,12,9.9283548448,10.679689806,0.4830010465,0.1610003488,-0.751334961,0.6440013953
51175,2012,173,183,-121,2,-10,-119,9.3173555945,9.8559310623,-6.516763161,0.1077150936,-0.538575468,-6.409048068
51175,2013,171,182,-174,6,-11,-168,9.2856561049,9.8829790122,-9.448562352,0.3258124949,-0.597322907,-9.122749857
51175,2014,156,170,-96,6,-14,-90,8.5364852664,9.302580098,-5.253221702,0.3283263564,-0.766094832,-4.924895346
51175,2015,172,160,-111,6,12,-105,9.4632884928,8.803059063,-6.107122225,0.3301147149,0.6602294297,-5.77700751
51175,2016,114,179,-50,6,-65,-44,6.3074028992,9.9037291136,-2.76640478,0.3319685736,-3.596326214,-2.434436207
51175,2017,118,210,-183,6,-92,-177,6.5978920294,11.742011239,-10.23232408,0.3354860354,-5.144119209,-9.896838044
02240,2010,42,19,10,0,23,10,NA,NA,NA,NA,NA,NA
02240,2011,122,39,-11,17,83,6,17.171006334,5.4890921886,-1.548205489,2.3926812104,11.681914145,0.8444757213
02240,2012,127,39,-106,37,88,-69,17.736191607,5.4465470288,-14.80343551,5.1672369248,12.289644578,-9.636198589
02240,2013,96,47,-266,21,49,-245,13.566986998,6.6421707179,-37.59185981,2.9677784059,6.9248162804,-34.6240814
02240,2014,110,47,-134,17,63,-117,15.817096844,6.758214106,-19.26809979,2.4444604213,9.0588827378,-16.82363937
02240,2015,123,57,-212,21,66,-191,17.909143856,8.2993593477,-30.86779266,3.057658707,9.6097845079,-27.81013395
02240,2016,88,35,-37,18,53,-19,12.896607313,5.129332454,-5.422437166,2.6379424049,7.7672748589,-2.784494761
02240,2017,101,33,-38,18,68,-20,14.714452214,4.8076923077,-5.536130536,2.6223776224,9.9067599068,-2.913752914
13255,2010,228,187,-57,11,41,-46,NA,NA,NA,NA,NA,NA
13255,2011,910,676,-315,36,234,-279,14.209092258,10.555325677,-4.918531935,0.5621179355,3.6537665805,-4.356414
13255,2012,832,676,-542,38,156,-504,13.030438289,10.58723111,-8.48857879,0.5951402103,2.4432071793,-7.893438579
13255,2013,812,705,-294,14,107,-280,12.768801352,11.086212997,-4.623186697,0.2201517475,1.6825883555,-4.403034949
13255,2014,832,719,74,15,113,89,13.081761006,11.305031447,1.1635220126,0.2358490566,1.7767295597,1.3993710692
13255,2015,829,748,42,17,81,59,13.001576186,11.731217114,0.6587047042,0.2666185708,1.2703590725,0.925323275
13255,2016,808,759,662,14,49,676,12.587532423,11.82417959,10.313052555,0.2181008093,0.7633528326,10.531153364
13255,2017,802,767,776,14,35,790,12.344823871,11.806084674,11.944617611,0.2154956785,0.5387391964,12.160113289
45083,2010,901,593,118,52,308,170,NA,NA,NA,NA,NA,NA
45083,2011,3684,2741,358,198,943,556,12.904830379,9.6015581076,1.2540524635,0.6935820888,3.3032722713,1.9476345523
45083,2012,3573,2755,1233,159,818,1392,12.436715635,9.5894630771,4.29176333,0.5534390669,2.8472525579,4.8452023968
45083,2013,3514,2893,1535,116,621,1651,12.13722595,9.9923149323,5.3018331909,0.4006597069,2.1449110173,5.7024928978
45083,2014,3519,2942,1898,157,577,2055,12.052608145,10.07637771,6.5006678768,0.5377264787,1.9762304346,7.0383943556
45083,2015,3569,3092,2837,192,477,3029,12.096582859,10.479863884,9.6155801547,0.6507548078,1.6167189756,10.266334962
45083,2016,3669,3014,3410,201,655,3611,12.273632764,10.08250999,11.407219331,0.6723903477,2.1911227748,12.079609679
45083,2017,3661,3025,4936,201,636,5137,12.044347941,9.9519673641,16.238978813,0.6612712199,2.0923805764,16.900250033
18147,2010,49,56,-31,0,-7,-31,NA,NA,NA,NA,NA,NA
18147,2011,235,187,2,4,48,6,11.222540592,8.9302769819,0.0955109838,0.1910219675,2.2922636103,0.2865329513
18147,2012,234,184,-237,0,50,-237,11.209043878,8.8139490324,-11.35274957,0,2.3950948458,-11.35274957
18147,2013,206,207,-19,-1,-1,-20,9.9169575159,9.9650980864,-0.914670839,-0.04814057,-0.04814057,-0.962811409
18147,2014,218,149,-71,0,69,-71,10.500457589,7.1769182602,-3.419873802,0,3.3235393285,-3.419873802
18147,2015,246,190,-177,1,56,-176,11.88348389,9.1783005652,-8.550311579,0.0483068451,2.7051833245,-8.502004734
18147,2016,186,215,-119,1,-29,-118,9.0436135557,10.453639325,-5.785967813,0.0486215783,-1.410025769,-5.737346234
18147,2017,185,238,-47,1,-53,-46,9.0493310832,11.64184215,-2.299019248,0.0489153032,-2.592511067,-2.250103945
21215,2010,38,12,31,-1,26,30,NA,NA,NA,NA,NA,NA
21215,2011,216,131,183,-3,85,180,12.52246507,7.5946431677,10.609310685,-0.173923126,4.9278219027,10.435387559
21215,2012,196,127,-12,-1,69,-13,11.258221086,7.2948677446,-0.689278842,-0.057439904,3.9633533416,-0.746718746
21215,2013,155,132,136,-2,23,134,8.8485471256,7.535536907,7.7638865102,-0.114174802,1.3130102186,7.6497117086
21215,2014,204,117,53,-1,87,52,11.54825927,6.6232663459,3.0002830456,-0.056609114,4.9249929239,2.9436739315
21215,2015,205,144,191,-1,61,190,11.479127586,8.0633871826,10.695187166,-0.055995744,3.4157404037,10.639191421
21215,2016,184,151,224,-2,33,222,10.159291058,8.3372442923,12.367832593,-0.110427077,1.8220467659,12.257405516
21215,2017,189,154,234,-2,35,232,10.286833941,8.3818646928,12.736080118,-0.108855386,1.9049692484,12.627224732
46115,2010,17,7,-3,-1,10,-4,NA,NA,NA,NA,NA,NA
46115,2011,76,79,73,4,-3,77,11.768349334,12.232889439,11.303809229,0.6193868071,-0.464540105,11.923196036
46115,2012,87,84,129,6,3,135,13.251085218,12.794151245,19.648160841,0.9138679461,0.456933973,20.562028787
46115,2013,73,78,-67,-1,-5,-68,11.059768199,11.817286569,-10.15074616,-0.151503674,-0.75751837,-10.30224983
46115,2014,87,70,-25,-1,17,-26,13.261184361,10.669918451,-3.810685161,-0.152427406,2.5912659096,-3.963112568
46115,2015,67,75,-91,-1,-8,-92,10.297394913,11.526934604,-13.98601399,-0.153692461,-1.229539691,-14.13970645
46115,2016,72,74,-50,-1,-2,-51,11.196641008,11.507658813,-7.775445144,-0.155508903,-0.311017806,-7.930954047
46115,2017,74,72,5,-1,2,4,11.549867333,11.237708756,0.7803964414,-0.156079288,0.3121585766,0.6243171531
53063,2010,1494,904,110,143,590,253,NA,NA,NA,NA,NA,NA
53063,2011,5882,4134,-996,566,1748,-430,12.444766036,8.7464574626,-2.107274222,1.1975072385,3.6983085739,-0.909766983
53063,2012,5829,3995,-470,793,1834,323,12.28887392,8.422379707,-0.990868201,1.6718265601,3.8664942134,0.6809583593
53063,2013,6104,4396,692,700,1708,1392,12.799610811,9.2180683366,1.4510699019,1.4678452765,3.5815424747,2.9189151785
53063,2014,5943,4094,1933,767,1849,2700,12.364120541,8.5173665651,4.0215118638,1.595705949,3.8467539763,5.6172178128
53063,2015,5954,4305,3458,875,1649,4333,12.253272719,8.859647137,7.1165295702,1.800741288,3.3936255816,8.9172708582
53063,2016,6104,4598,6196,829,1506,7025,12.377120981,9.3233948675,12.563669987,1.6809687571,3.0537261136,14.244638744
53063,2017,6122,4663,6460,776,1459,7236,12.200213434,9.2926486839,12.873795946,1.5464497917,2.9075647501,14.420245738
51177,2010,394,130,212,46,264,258,NA,NA,NA,NA,NA,NA
51177,2011,1623,761,550,152,862,702,13.11451566,6.1491968066,4.4442289667,1.2282232781,6.9653188532,5.6724522447
51177,2012,1550,788,314,234,762,548,12.381823483,6.2947592934,2.5083177895,1.8692559323,6.0870641898,4.3775737218
51177,2013,1563,764,641,183,799,824,12.342169474,6.032896659,5.0616318828,1.445052472,6.3092728149,6.5066843547
51177,2014,1582,796,485,185,786,670,12.343704282,6.2108651126,3.7842582659,1.4434799571,6.132839169,5.227738223
51177,2015,1574,848,221,216,726,437,12.158571252,6.5504881968,1.70714374,1.6685205784,5.6080830552,3.3756643184
51177,2016,1630,903,449,199,727,648,12.469543332,6.9079740052,3.4348619361,1.5223552902,5.5615693265,4.9572172263
51177,2017,1587,946,806,185,641,991,12.002813514,7.1547962093,6.095946876,1.3991937619,4.8480173046,7.4951406379
22087,2010,146,41,748,5,105,753,NA,NA,NA,NA,NA,NA
22087,2011,612,268,2258,15,344,2273,16.036054921,7.0223247039,59.165705901,0.3930405618,9.013730217,59.558746463
22087,2012,623,344,1639,23,279,1662,15.383855594,8.4944563795,40.472133738,0.5679433044,6.8893992148,41.040077043
22087,2013,648,309,1529,46,339,1575,15.260703688,7.2770948142,36.008666572,1.0833215581,7.9836088738,37.091988131
22087,2014,675,328,590,68,347,658,15.361507476,7.4645547439,13.427095423,1.547529642,7.8969527321,14.974625065
22087,2015,651,346,600,83,305,683,14.485014352,7.6986405002,13.350243642,1.8467837038,6.7863738513,15.197027346
22087,2016,662,361,-13,86,301,73,14.509112029,7.9120686443,-0.28492214,1.8848695385,6.5970433849,1.599947399
22087,2017,636,377,44,86,259,130,13.823682838,8.1942270909,0.9563554164,1.8692401322,5.6294557468,2.8255955486
29183,2010,1208,537,536,81,671,617,NA,NA,NA,NA,NA,NA
29183,2011,4609,2248,905,408,2361,1313,12.676296508,6.182754296,2.4890536645,1.1221369007,6.4935422121,3.6111905652
29183,2012,4395,2356,1172,499,2039,1671,11.967943883,6.415580384,3.1914517021,1.3588177469,5.5523634987,4.5502694489
29183,2013,4548,2414,2678,462,2134,3140,12.235937281,6.4946245816,7.2048900703,1.2429646051,5.7413126998,8.4478546754
29183,2014,4570,2578,3052,522,1992,3574,12.11819081,6.8360384918,8.0929361819,1.3841784689,5.282152318,9.4771146508
29183,2015,4475,2753,2851,568,1722,3419,11.700126414,7.1978654786,7.4540917107,1.4850663247,4.502260935,8.9391580354
29183,2016,4561,2718,3327,586,1843,3913,11.757684966,7.0066625163,8.5765880028,1.5106343762,4.7510224494,10.087222379
29183,2017,4521,2779,2397,582,1742,2979,11.499442324,7.0685578896,6.0969173304,1.4803528937,4.4308844345,7.5772702242
22089,2010,151,142,-91,4,9,-87,NA,NA,NA,NA,NA,NA
22089,2011,603,409,-706,57,194,-649,11.464859161,7.7763306747,-13.4232016,1.0837429058,3.6885284863,-12.3394587
22089,2012,598,348,-256,57,250,-199,11.411342646,6.6407144493,-4.885123273,1.0877032288,4.7706281963,-3.797420044
22089,2013,682,389,-149,72,293,-77,12.980833286,7.4040236776,-2.835988504,1.3704105522,5.5768096081,-1.465577952
22089,2014,673,445,-192,52,228,-140,12.773064587,8.4457856479,-3.644024369,0.9869232667,4.3272789387,-2.657101103
22089,2015,660,426,-380,57,234,-323,12.526214901,8.0851023449,-7.212063125,1.0818094687,4.4411125556,-6.130253656
22089,2016,656,413,-84,58,243,-26,12.434722446,7.8285676375,-1.592251045,1.0994114358,4.6061548085,-0.492839609
22089,2017,662,430,-407,58,232,-349,12.536335489,8.142936949,-7.707384508,1.098349635,4.39339854,-6.609034873
01115,2010,278,192,122,11,86,133,NA,NA,NA,NA,NA,NA
01115,2011,1102,826,88,46,276,134,13.11709567,9.8318702574,1.0474631751,0.5475375688,3.2852254129,1.5950007439
01115,2012,1059,803,491,23,256,514,12.518766328,9.4925112007,5.8042627641,0.2718901091,3.0262551275,6.0761528732
01115,2013,1046,892,859,32,154,891,12.233631962,10.432504503,10.046548619,0.3742602512,1.801127459,10.42080887
01115,2014,996,909,91,27,87,118,11.564720635,10.554549255,1.056616042,0.313501463,1.0101713808,1.370117505
01115,2015,1026,912,405,27,114,432,11.862848818,10.544754505,4.6827034808,0.3121802321,1.3180943131,4.9948837129
01115,2016,1029,934,603,27,95,630,11.811294766,10.720844812,6.9214876033,0.3099173554,1.0904499541,7.2314049587
01115,2017,1038,970,623,28,68,651,11.816872627,11.042742243,7.0924004303,0.3187595699,0.774130384,7.4111600002
17163,2010,838,510,-104,73,328,-31,NA,NA,NA,NA,NA,NA
17163,2011,3547,2441,-1515,39,1106,-1476,13.129305335,9.0354198824,-5.607808735,0.1443594328,4.0938854526,-5.463449302
17163,2012,3404,2468,-2656,322,936,-2334,12.64041293,9.1646707143,-9.862789877,1.1957147366,3.4757422158,-8.667075141
17163,2013,3366,2510,-2882,131,856,-2751,12.5744812,9.3766927545,-10.76638586,0.4893811756,3.1977884454,-10.27700469
17163,2014,3392,2537,-2183,142,855,-2041,12.743567635,9.5313770905,-8.201417496,0.5334866168,3.2121905449,-7.66793088
17163,2015,3429,2464,-2557,205,965,-2352,12.944311902,9.3014828013,-9.652553378,0.7738652493,3.6428291004,-8.878688129
17163,2016,3402,2628,-1978,105,774,-1873,12.902565153,9.9670609117,-7.501844172,0.3982273195,2.9355042411,-7.103616852
17163,2017,3305,2637,-1360,50,668,-1310,12.576127428,10.034265666,-5.175047898,0.1902591139,2.5418617615,-4.984788784
26147,2010,404,424,-384,25,-20,-359,NA,NA,NA,NA,NA,NA
26147,2011,1625,1674,-1206,80,-49,-1126,10.024676126,10.326958667,-7.439851943,0.493522517,-0.302282542,-6.946329426
26147,2012,1627,1632,-1086,94,-5,-992,10.103456413,10.134505757,-6.743917434,0.58372766,-0.031049344,-6.160189774
26147,2013,1551,1701,-286,94,-150,-192,9.6716563101,10.60701959,-1.783425986,0.5861609885,-0.93536328,-1.197264998
26147,2014,1578,1711,-115,103,-133,-12,9.8561858809,10.686903702,-0.718289846,0.6433378617,-0.830717821,-0.074951984
26147,2015,1570,1771,-169,111,-201,-58,9.8198648987,11.077057793,-1.057042782,0.694270703,-1.257192895,-0.362772079
26147,2016,1531,1743,-133,112,-212,-21,9.5912594871,10.919376412,-0.833205429,0.701646677,-1.328116924,-0.131558752
26147,2017,1521,1690,-93,112,-169,19,9.540326855,10.600363172,-0.583333595,0.7025092753,-1.060036317,0.1191756806
29185,2010,25,47,40,0,-22,40,NA,NA,NA,NA,NA,NA
29185,2011,97,124,-102,-4,-27,-106,9.9400522621,12.706870933,-10.45242609,-0.409899062,-2.766818671,-10.86232515
29185,2012,86,145,-104,-3,-59,-107,8.9480803246,15.086879617,-10.82093435,-0.312142337,-6.138799292,-11.13307668
29185,2013,87,147,27,-6,-60,21,9.1497081559,15.459851712,2.8395646001,-0.631014356,-6.310143556,2.2085502445
29185,2014,98,137,-11,-5,-39,-16,10.3599556,14.482795074,-1.162852159,-0.528569163,-4.122839474,-1.691421322
29185,2015,96,158,44,-5,-62,39,10.191623759,16.773714104,4.6711608896,-0.530813737,-6.582090344,4.1403471522
29185,2016,100,151,-57,-5,-51,-62,10.694615261,16.148869044,-6.095930699,-0.534730763,-5.454253783,-6.630661462
29185,2017,92,147,130,-5,-55,125,9.8633074243,15.759849906,13.93728223,-0.536049317,-5.896542482,13.401232913
55109,2010,313,152,-94,-8,161,-102,NA,NA,NA,NA,NA,NA
55109,2011,1117,571,-157,-18,546,-175,13.203309693,6.7494089835,-1.855791962,-0.212765957,6.4539007092,-2.06855792
55109,2012,1011,537,-214,4,474,-210,11.905603052,6.3237476153,-2.520078193,0.0471042653,5.581855437,-2.472973928
55109,2013,1032,546,99,21,486,120,12.091388401,6.3971880492,1.1599297012,0.2460456942,5.6942003515,1.4059753954
55109,2014,1057,539,361,35,518,396,12.276137604,6.2600171889,4.1927016794,0.4064946227,6.0161204153,4.5991963021
55109,2015,1072,570,67,40,502,107,12.342267661,6.5625863498,0.7713917288,0.4605323754,5.7796813116,1.2319241043
55109,2016,1011,592,30,41,419,71,11.567373371,6.773377879,0.3432455006,0.4691021842,4.793995492,0.8123476848
55109,2017,989,601,628,42,388,670,11.216458366,6.8160682287,7.1222809445,0.4763308912,4.4003901377,7.5986118357
05123,2010,93,36,-124,3,57,-121,NA,NA,NA,NA,NA,NA
05123,2011,352,283,-298,9,69,-289,12.532265243,10.075656431,-10.60970182,0.3204272363,2.4566088117,-10.28927459
05123,2012,365,261,-141,29,104,-112,13.046664165,9.3292584848,-5.039944239,1.0365842761,3.7174056798,-4.003359963
05123,2013,329,297,-537,16,32,-521,11.863551132,10.709649502,-19.36391173,0.5769508149,1.1539016299,-18.78696091
05123,2014,355,278,-513,16,77,-497,13.01105023,10.18893511,-18.80188385,0.5864135315,2.8221151203,-18.21547032
05123,2015,359,276,-550,18,83,-532,13.367092378,10.276650408,-20.47883233,0.6702163309,3.0904419704,-19.808616
05123,2016,349,291,-409,19,58,-390,13.184737439,10.993577635,-15.45145448,0.7177937287,2.1911598036,-14.73366075
05123,2017,334,303,-426,19,31,-407,12.788605123,11.601638779,-16.31121492,0.727495501,1.1869663438,-15.58371942
29187,2010,196,187,144,3,9,147,NA,NA,NA,NA,NA,NA
29187,2011,737,742,50,7,-5,57,11.242725407,11.318998986,0.7627357807,0.1067830093,-0.076273578,0.86951879
29187,2012,756,732,201,4,24,205,11.509126616,11.143757517,3.0599662034,0.0608948498,0.3653690989,3.1208610532
29187,2013,753,793,351,-5,-40,346,11.417394469,12.023896167,5.3220524017,-0.075812712,-0.606501698,5.2462396895
29187,2014,737,745,-302,0,-8,-302,11.175132676,11.296436694,-4.579226687,0,-0.121304018,-4.579226687
29187,2015,718,793,522,2,-75,524,10.875821746,12.011875549,7.9069344724,0.0302947681,-1.136053804,7.9372292405
29187,2016,707,751,193,2,-44,195,10.660836129,11.324311079,2.9102423945,0.0301579523,-0.66347495,2.9404003468
29187,2017,683,751,379,2,-68,381,10.263114397,11.28491788,5.6950517664,0.0300530436,-1.021803483,5.72510481
22091,2010,24,9,-21,-2,15,-23,NA,NA,NA,NA,NA,NA
22091,2011,120,138,-227,-2,-18,-229,10.835703644,12.46105919,-20.49753939,-0.180595061,-1.625355547,-20.67813445
22091,2012,117,100,7,0,17,7,10.669341601,9.1190953857,0.638336677,0,1.5502462156,0.638336677
22091,2013,115,142,-186,4,-27,-182,10.57519886,13.058071635,-17.10423468,0.3678330038,-2.482872776,-16.73640167
22091,2014,112,119,-257,4,-7,-253,10.522854324,11.18053272,-24.14619251,0.3758162259,-0.657678395,-23.77037629
22091,2015,118,122,-60,4,-4,-56,11.253635973,11.635115159,-5.722187783,0.3814791855,-0.381479186,-5.340708598
22091,2016,127,91,-55,4,36,-51,12.156599981,8.710634632,-5.264669283,0.3828850388,3.4459653489,-4.881784244
22091,2017,118,103,-94,4,15,-90,11.345062975,9.9028939525,-9.037592539,0.3845784059,1.4421690222,-8.653014133
22093,2010,56,18,-99,6,38,-93,NA,NA,NA,NA,NA,NA
22093,2011,283,181,-390,12,102,-378,12.911762022,8.258052742,-17.79359431,0.5474952094,4.65370928,-17.2460991
22093,2012,292,179,-266,4,113,-262,13.449403528,8.2446686012,-12.2518539,0.1842384045,5.204734927,-12.06761549
22093,2013,232,207,-48,2,25,-46,10.72757959,9.5715904099,-2.219499225,0.0924791344,1.1559891799,-2.127020091
22093,2014,317,193,-218,1,124,-217,14.69701887,8.9480272613,-10.10709815,0.0463628356,5.7489916083,-10.06073531
22093,2015,271,201,-106,1,70,-105,12.602013532,9.3468808854,-4.929200865,0.046501895,3.2551326467,-4.88269897
22093,2016,242,213,-83,0,29,-83,11.27731954,9.9259052146,-3.867840999,0,1.351414325,-3.867840999
22093,2017,253,226,-91,0,27,-91,11.822706138,10.560994416,-4.252435805,0,1.2617117222,-4.252435805
22095,2010,114,125,-222,8,-11,-214,NA,NA,NA,NA,NA,NA
22095,2011,634,415,-858,63,219,-795,13.986631075,9.1552869024,-18.92827991,1.3898387346,4.8313441726,-17.53844117
22095,2012,631,368,-649,50,263,-599,14.056582758,8.1978168857,-14.45756293,1.113833816,5.8587658721,-13.34372912
22095,2013,555,405,-1422,93,150,-1329,12.569927298,9.1726496501,-32.2061921,2.1063121419,3.3972776482000002,-30.09987996
22095,2014,574,365,-116,76,209,-40,13.14689479,8.3599592309,-2.656863756,1.7407038399,4.7869355596,-0.916159916
22095,2015,580,400,-422,80,180,-342,13.283253939,9.1608647856,-9.664712349,1.8321729571,4.1223891535,-7.832539392
22095,2016,557,422,-327,87,135,-240,12.79503819,9.6939068512,-7.511629243,1.9985068627,3.1011313387,-5.51312238
22095,2017,552,425,-256,88,127,-168,12.701188435,9.7789947193,-5.890406231,2.0248271419,2.9221937161,-3.865579089
12109,2010,430,311,1015,14,119,1029,NA,NA,NA,NA,NA,NA
12109,2011,1849,1512,4351,73,337,4424,9.5477841034,7.8075984664,22.467500613,0.3769541588,1.740185637,22.844454772
12109,2012,1813,1480,5374,168,333,5542,9.1069831925,7.4342719939,26.994444389,0.8438903344,1.6727111986,27.838334723
12109,2013,1968,1683,6758,235,285,6993,9.5637045748,8.1787168696,32.841217234,1.142007406,1.3849877052,33.98322464
12109,2014,2042,1692,7696,259,350,7955,9.5541997305,7.9166042821,36.008384489,1.2118206318,1.6375954484,37.220205121
12109,2015,2165,1820,7849,295,345,8144,9.7401209755,8.188000081,35.311875075,1.3271758373,1.5521208945,36.639050912
12109,2016,2161,1968,7984,289,193,8273,9.3626386957,8.5264567113,34.591072349,1.252106702,0.8361819844,35.843179051
12109,2017,2169,1934,8230,275,235,8505,9.0590529969,8.0775511738,34.373446826,1.1485659632,0.9815018231,35.522012789
18141,2010,874,604,-511,85,270,-426,NA,NA,NA,NA,NA,NA
18141,2011,3542,2542,-1423,303,1000,-1120,13.279619982,9.5304330873,-5.335092952,1.1360036292,3.7491868951,-4.199089323
18141,2012,3509,2523,-1654,368,986,-1286,13.165991295,9.4664565511,-6.205913252,1.3807594177,3.6995347441,-4.825153835
18141,2013,3589,2524,-975,483,1065,-492,13.459490272,9.4655206036,-3.656451105,1.8113496242,3.9939696683,-1.845101481
18141,2014,3446,2632,-559,580,814,21,12.890338605,9.8454356381,-2.091032873,2.1695868807,3.0449029671,0.0785540078
18141,2015,3502,2659,-839,643,843,-196,13.064994805,9.9199946278,-3.130077282,2.3988554139,3.1450001772,-0.731221868
18141,2016,3474,2518,-362,667,956,305,12.915242328,9.3611341917,-1.345802453,2.4796967855,3.5541081363,1.1338943322
18141,2017,3467,2438,-872,669,1029,-203,12.839623218,9.0288437858,-3.229348557,2.4775621381,3.8107794322,-0.751786419
26149,2010,218,122,-117,6,96,-111,NA,NA,NA,NA,NA,NA
26149,2011,843,625,-497,39,218,-458,13.782617226,10.218429141,-8.125694853,0.6376299784,3.5641880845,-7.488064875
26149,2012,841,586,-409,42,255,-367,13.788580563,9.6077386564,-6.705742509,0.6886092552,4.1808419068,-6.017133254
26149,2013,804,639,-202,30,165,-172,13.194712268,10.486842213,-3.315089401,0.49234001,2.7078700551,-2.822749391
26149,2014,810,681,-136,46,129,-90,13.290889997,11.174192701,-2.231556839,0.7547912838,2.1166972959,-1.476765555
26149,2015,834,663,-395,52,171,-343,13.700880536,10.891707189,-6.489026153,0.8542515442,2.8091733474,-5.634774609
26149,2016,755,587,-174,53,168,-121,12.416027365,9.6532557126,-2.861442068,0.8715886759,2.762771652,-1.989853392
26149,2017,772,569,-137,53,203,-84,12.678704867,9.3447967219,-2.249977418,0.8704292201,3.3339081451,-1.379548198
22097,2010,302,189,-1,0,113,-1,NA,NA,NA,NA,NA,NA
22097,2011,1345,878,-527,-3,467,-530,16.115311343,10.519883538,-6.314326452,-0.035944932,5.5954278046,-6.350271384
22097,2012,1250,901,-302,-7,349,-309,14.979567869,10.79727252,-3.619063597,-0.08388558,4.1822953491,-3.702949177
22097,2013,1284,941,-388,-8,343,-396,15.389040702,11.278105374,-4.650270866,-0.095881874,4.1109353277,-4.74615274
22097,2014,1323,950,-97,-10,373,-107,15.837388447,11.372274395,-1.16116907,-0.119708152,4.4651140519,-1.280877221
22097,2015,1276,1002,-298,-7,274,-305,15.2549465,11.9791978,-3.562675593,-0.083687011,3.2757486999,-3.646362604
22097,2016,1388,1052,-247,-9,336,-256,16.590170205,12.574105948,-2.952285332,-0.10757315,4.016064257,-3.059858482
22097,2017,1328,1014,-511,-9,314,-520,15.885167464,12.129186603,-6.112440191,-0.107655502,3.7559808612,-6.220095694
36089,2010,310,282,-177,29,28,-148,NA,NA,NA,NA,NA,NA
36089,2011,1271,1009,74,166,262,240,11.341075484,9.00326134,0.6602986513,1.481210488,2.3378141438,2.1415091393
36089,2012,1218,1036,-257,213,182,-44,10.838227443,9.2187221926,-2.286883787,1.8953550454,1.61950525,-0.391528742
36089,2013,1248,995,-819,182,253,-637,11.117495357,8.863708237,-7.295856328,1.6213014062,2.2537871196,-5.674554922
36089,2014,1224,970,-904,179,254,-725,10.944793176,8.6735697552,-8.083409339,1.6005865837,2.2712234204,-6.482822755
36089,2015,1133,918,-1218,195,215,-1023,10.188665671,8.2552472078,-10.95304041,1.7535655834,1.9334184637,-9.19947483
36089,2016,1158,990,-1170,186,168,-984,10.48951049,8.9677162216,-10.59821008,1.6848436538,1.5217942679,-8.913366426
36089,2017,1127,1066,-615,186,61,-429,10.263555726,9.7080305266,-5.600786842,1.6938965084,0.555525199,-3.906890334
29510,2010,1240,683,-797,247,557,-550,NA,NA,NA,NA,NA,NA
29510,2011,4820,3083,-2976,987,1737,-1989,15.098666023,9.657507749,-9.322329893,3.0917807812,5.4411582744,-6.230549112
29510,2012,4885,2910,-2645,944,1975,-1701,15.302326674,9.1156132286,-8.285497247,2.9570924013,6.1867134455,-5.328404846
29510,2013,4634,3011,-3213,816,1623,-2397,14.528057586,9.4397888196,-10.0730792,2.558242337,5.0882687659,-7.514836865
29510,2014,4797,2941,-3558,859,1856,-2699,15.077627623,9.2439655701,-11.18328103,2.6999545817,5.8336620531,-8.483326445
29510,2015,4574,3010,-3971,943,1564,-3028,14.429272432,9.4954328861,-12.52703123,2.9748150204,4.9338395461,-9.552216206
29510,2016,4444,2979,-5534,955,1465,-4579,14.12136301,9.466143206,-17.58497365,3.03463134,4.6552198042,-14.55034231
29510,2017,4318,3045,-6741,951,1273,-5790,13.889380317,9.7946185889,-21.68325908,3.0590089583,4.0947617286,-18.62425012
27137,2010,492,485,-122,35,7,-87,NA,NA,NA,NA,NA,NA
27137,2011,2059,2119,190,138,-60,328,10.282172989,10.581799205,0.9488163516,0.6891402975,-0.299626216,1.6379566491
27137,2012,2046,2094,-113,150,-48,37,10.212103289,10.451683425,-0.56401157,0.7486879244,-0.239580136,0.1846763547
27137,2013,2083,2081,-14,155,2,141,10.394989645,10.385008858,-0.069865509,0.7735109913,0.009980787,0.7036454824
27137,2014,2051,2033,50,191,18,241,10.226621126,10.136870185,0.2493081698,0.9523572087,0.0897509411,1.2016653786
27137,2015,2064,2063,-504,204,1,-300,10.293956291,10.288968909,-2.51364049,1.0174259124,0.0049873819,-1.496214577
27137,2016,1937,2081,-379,202,-144,-177,9.6762671689,10.395617955,-1.893291305,1.0090892969,-0.719350786,-0.884202008
27137,2017,1956,2048,-120,204,-92,84,9.7795599198,10.239539221,-0.599973001,1.0199541021,-0.459979301,0.4199811009
29189,2010,2841,2220,-1195,379,621,-816,NA,NA,NA,NA,NA,NA
29189,2011,11831,9283,-3787,1883,2548,-1904,11.842908044,9.2923434513,-3.7908116610000002,1.8848952622,2.5505645927,-1.905916399
29189,2012,11760,9267,-3108,1876,2493,-1232,11.761117306,9.2678804486,-3.108295288,1.8761782369,2.4932368575,-1.232117051
29189,2013,11342,9539,-3493,1889,1803,-1604,11.335419789,9.5334658231,-3.49097349,1.8879040717,1.8019539657,-1.603069418
29189,2014,11714,9317,-4054,2027,2397,-2027,11.704484254,9.3094314322,-4.050706775,2.0253533877,2.3950528221,-2.025353388
29189,2015,11839,10075,-3745,2194,1764,-1551,11.826617531,10.064462508,-3.741083086,2.1917052846,1.7621550237,-1.549377801
29189,2016,11544,9971,-6706,2220,1573,-4486,11.54779345,9.9742765498,-6.708203645,2.2207295096,1.5735169003,-4.487474135
29189,2017,11440,9953,-5188,2207,1487,-2981,11.469005114,9.9782349562,-5.201153718,2.2125956544,1.4907701577,-2.988558063
12111,2010,717,617,726,172,100,898,NA,NA,NA,NA,NA,NA
12111,2011,3081,2706,1153,703,375,1856,11.027911605,9.685663357,4.1269659463,2.5162680488,1.3422482479,6.643233995
12111,2012,3046,2815,1742,745,231,2487,10.807627077,9.988007295,6.1808556689,2.643362499,0.8196197816,8.8242181679
12111,2013,2908,2830,1669,784,78,2453,10.223291738,9.9490768979,5.8674944674,2.7562107025,0.2742148403,8.6237051698
12111,2014,2993,2938,3836,920,55,4756,10.386915194,10.196043047,13.312464645,3.1927704572,0.1908721469,16.505235102
12111,2015,2978,3123,6359,1030,-145,7389,10.120250186,10.613009177,21.610030534,3.5002880091,-0.492758992,25.110318543
12111,2016,3099,3235,7216,1063,-136,8279,10.261453491,10.711778652,23.893723262,3.5198209295,-0.450325161,27.413544191
12111,2017,3096,3348,6591,1063,-252,7654,9.9937861633,10.807233874,21.275531202,3.4313290348,-0.813447711,24.706860237
22099,2010,157,61,7,3,96,10,NA,NA,NA,NA,NA,NA
22099,2011,690,423,219,32,267,251,13.137977323,8.0541513152,4.1698797589,0.609297499,5.0838260075,4.779177258
22099,2012,709,415,-458,42,294,-416,13.449044435,7.8721487172,-8.687817139,0.7966993882,5.5768957177,-7.89111775
22099,2013,748,461,-78,56,287,-22,14.170423976,8.733376274,-1.477664532,1.0608873565,5.437047702,-0.416777176
22099,2014,745,498,75,48,247,123,14.030660289,9.3788843271,1.4124825794,0.9039888508,4.6517759614,2.3164714302
22099,2015,779,478,240,50,301,290,14.540499678,8.9221551298,4.4797431614,0.9332798253,5.6183445482,5.4130229867
22099,2016,773,516,-370,54,257,-316,14.357755138,9.5842194712,-6.872405435,1.0029997121,4.7735356669,-5.869405723
22099,2017,746,514,78,54,232,132,13.817373588,9.5202815336,1.4447119837,1.0001852195,4.2970920541,2.4448972032
22101,2010,190,152,-142,6,38,-136,NA,NA,NA,NA,NA,NA
22101,2011,718,551,-645,45,167,-600,13.211765464,10.138833942,-11.86850797,0.8280354399,3.0729315215,-11.04047253
22101,2012,739,518,-907,75,221,-832,13.725854383,9.6210995542,-16.846211,1.3930163447,4.1047548291,-15.45319465
22101,2013,756,595,-226,73,161,-153,14.118306177,11.111629861,-4.220551846,1.3632755964,3.0066763154,-2.85727625
22101,2014,810,524,-674,102,286,-572,15.165273396,9.8106213081,-12.61900527,1.9097010943,5.354652088,-10.70930418
22101,2015,804,555,-722,112,249,-610,15.142241014,10.452666372,-13.5978831,2.1093669074,4.6895746424,-11.48851619
22101,2016,760,557,-1067,118,203,-949,14.463242431,10.600034255,-20.30563115,2.2456086932,3.8632081755,-18.06002246
22101,2017,754,546,-1534,119,208,-1415,14.619911389,10.586832385,-29.74395765,2.3073865454,4.0330790038,-27.43657111
24037,2010,364,200,370,59,164,429,NA,NA,NA,NA,NA,NA
24037,2011,1484,646,867,104,838,971,13.911478376,6.0558052768,8.1275281347,0.9749284037,7.855673099,9.1024565383
24037,2012,1391,696,266,297,695,563,12.854872098,6.4320567795,2.4582285968,2.7447138844,6.4228153186,5.2029424811
24037,2013,1381,754,-391,211,627,-180,12.663567256,6.9140693058,-3.585412598,1.9348390232,5.7494979505,-1.650573574
24037,2014,1391,754,-69,187,637,118,12.686339157,6.8767072064,-0.629300792,1.7054963496,5.8096319502,1.0761955575
24037,2015,1516,783,149,216,733,365,13.712259628,7.0822554677,1.3477088949,1.9537256463,6.6300041607,3.3014345411
24037,2016,1429,856,-7,168,573,161,12.819880234,7.6793684258,-0.062798574,1.5071657658,5.1405118084,1.4443671922
24037,2017,1441,843,96,143,598,239,12.837302118,7.5099553679,0.8552262341,1.2739307445,5.3273467497,2.1291569786
22103,2010,649,458,563,36,191,599,NA,NA,NA,NA,NA,NA
22103,2011,2707,1911,1249,221,796,1470,11.487058494,8.1092607248,5.3000872032,0.9378056621,3.3777977692,6.2378928653
22103,2012,2675,1951,1417,238,724,1655,11.241408727,8.1988741782,5.9547948285,1.000170197,3.0425345489,6.9549650256
22103,2013,2689,2120,2151,209,569,2360,11.175924175,8.8110670327,8.9399081072,0.8686382122,2.3648571423,9.8085463194
22103,2014,2992,2102,2292,251,890,2543,12.272731934,8.6220864054,9.401437698,1.029564076,3.6506455285,10.431001774
22103,2015,2953,2161,2729,283,792,3012,11.935388042,8.7342951432,11.030028434,1.1438248614,3.2010928984,12.173853295
22103,2016,3028,2261,2393,296,767,2689,12.061534539,9.0063175673,9.5321176199,1.1790667846,3.0552169722,10.711184404
22103,2017,3029,2317,2556,298,712,2854,11.899453741,9.1023553376,10.041268987,1.17069568,2.7970984033,11.211964667
20185,2010,8,9,-9,0,-1,-9,NA,NA,NA,NA,NA,NA
20185,2011,48,63,-35,2,-15,-33,10.89547157,14.300306435,-7.944614686,0.4539779821,-3.404834866,-7.490636704
20185,2012,45,56,-20,1,-11,-19,10.304556904,12.823448592,-4.579803068,0.2289901534,-2.518891688,-4.350812915
20185,2013,38,63,18,-1,-25,17,8.7406555492,14.491086832,4.1403105233,-0.230017251,-5.750431282,3.910293272
20185,2014,54,57,-55,0,-3,-55,12.515934639,13.211264341,-12.74771121,0,-0.695329702,-12.74771121
20185,2015,48,64,-50,0,-16,-50,11.286150952,15.04820127,-11.75640724,0,-3.762050317,-11.75640724
20185,2016,61,49,-32,0,12,-32,14.489311164,11.638954869,-7.600950119,0,2.8503562945,-7.600950119
20185,2017,51,46,2,0,5,2,12.132746521,10.943261568,0.4757939812,0,1.189484953,0.4757939812
51179,2010,433,197,501,92,236,593,NA,NA,NA,NA,NA,NA
51179,2011,1733,570,1105,127,1163,1232,13.227543516,4.3506634762,8.4341809494,0.9693583535,8.87688004,9.4035393029
51179,2012,1625,582,-372,477,1043,105,12.23722904,4.3828106468,-2.801384125,3.5920973858,7.8544183927,0.790713261
51179,2013,1703,691,1255,335,1012,1590,12.645069314,5.1307944192,9.3185918902,2.487432895,7.5142748947,11.806024785
51179,2014,1691,672,1444,372,1019,1816,12.308028241,4.8911856758,10.510226363,2.707620642,7.416842565,13.217847005
51179,2015,1712,652,573,471,1060,1044,12.2419939,4.6622546864,4.097349594,3.3679784621,7.5797392141,7.4653280561
51179,2016,1666,754,1310,366,912,1676,11.717211501,5.3029876779,9.2134136049,2.5741292972,6.4142238227,11.787542902
51179,2017,1674,762,1977,293,912,2270,11.539813736,5.2528901236,13.628561384,2.0198120816,6.2869236125,15.648373465
06099,2010,1923,908,-418,213,1015,-205,NA,NA,NA,NA,NA,NA
06099,2011,7786,3672,-2350,1020,4114,-1330,15.07051359,7.1074911253,-4.548639473,1.9743030904,7.9630224645,-2.574336383
06099,2012,7695,3811,-1265,721,3884,-544,14.806861378,7.3331967138,-2.434136406,1.3873615405,7.4736646645,-1.046774865
06099,2013,7504,3866,-1180,841,3638,-339,14.348349003,7.392153151,-2.256270232,1.6080705639,6.9561958519,-0.648199668
06099,2014,7495,3964,505,966,3531,1471,14.219731371,7.5206157646,0.9581006461,1.8327232161,6.6991156067,2.7908238622
06099,2015,7676,4187,886,1148,3489,2034,14.421198184,7.866278895,1.6645624793,2.1567920161,6.5549192894,3.8213544954
06099,2016,7737,4261,1718,1173,3476,2891,14.376324496,7.9174768872,3.1922612749,2.1795823489,6.4588476085,5.3718436238
06099,2017,7740,3987,1664,1162,3753,2826,14.211587401,7.3206200218,3.055307679,2.1335742326,6.8909673794,5.1888819116
46117,2010,6,9,9,0,-3,9,NA,NA,NA,NA,NA,NA
46117,2011,37,20,-11,0,17,-11,12.439065389,6.7238191293,-3.698100521,0,5.7152462599,-3.698100521
46117,2012,41,19,-24,0,22,-24,13.772253947,6.3822640242,-8.061807188,0,7.3899899227,-8.061807188
46117,2013,30,19,-9,0,11,-9,10.075566751,6.3811922754,-3.022670025,0,3.6943744752,-3.022670025
46117,2014,37,21,-15,0,16,-15,12.418190972,7.0481624434,-5.034401745,0,5.3700285283,-5.034401745
46117,2015,38,21,-22,0,17,-22,12.762384551,7.0528967254,-7.38874895,0,5.7094878254,-7.38874895
46117,2016,50,11,10,0,39,10,16.669444907,3.6672778796,3.3338889815,0,13.002167028,3.3338889815
46117,2017,41,14,-39,0,27,-39,13.587406794,4.6396023198,-12.92460646,0,8.9478044739,-12.92460646
37167,2010,140,135,-20,13,5,-7,NA,NA,NA,NA,NA,NA
37167,2011,680,625,-127,31,55,-96,11.229460821,10.321195607,-2.097266947,0.5119313021,0.9082652134,-1.585335645
37167,2012,634,690,-5,17,-56,12,10.478299673,11.40382772,-0.082636433,0.2809638714,-0.925528047,0.1983274386
37167,2013,628,644,179,33,-16,212,10.367655556,10.631799647,2.9551120136,0.5447971869,-0.264144091,3.4999092005
37167,2014,695,671,-68,42,24,-26,11.456736396,11.061108089,-1.12094687,0.6923495376,0.3956283072,-0.428597333
37167,2015,700,712,2,45,-12,47,11.537447257,11.735232068,0.032964135,0.741693038,-0.19778481,0.774657173
37167,2016,669,698,181,45,-29,226,11.006457451,11.483568461,2.9778307901,0.7403446716,-0.477111011,3.7181754617
37167,2017,680,693,568,47,-13,615,11.11456171,11.327045978,9.2839280169,0.7682123535,-0.212484268,10.05214037
20187,2010,4,6,11,0,-2,11,NA,NA,NA,NA,NA,NA
20187,2011,29,21,-40,-2,8,-42,13.013237604,9.4233789545,-17.94929325,-0.897464662,3.5898586493,-18.84675791
20187,2012,27,18,-68,0,9,-68,12.368300504,8.2455336693,-31.14979386,0,4.1227668346,-31.14979386
20187,2013,34,16,-1,5,18,4,15.704387991,7.3903002309,-0.461893764,2.3094688222,8.3140877598,1.8475750577
20187,2014,32,20,-62,5,12,-57,14.852634022,9.2828962636,-28.77697842,2.3207240659,5.5697377582,-26.45625435
20187,2015,27,18,-83,6,9,-77,12.860204811,8.5734698738,-39.5332222,2.8578232913,4.2867349369,-36.6753989
20187,2016,44,18,2,6,26,8,21.123379741,8.6413826212,0.9601536246,2.8804608737,12.48199712,3.8406144983
20187,2017,39,17,-68,6,22,-62,18.75,8.1730769231,-32.69230769,2.8846153846,10.576923077,-29.80769231
31167,2010,26,2,-11,0,24,-11,NA,NA,NA,NA,NA,NA
31167,2011,84,48,-8,6,36,-2,13.639684988,7.7941057076,-1.299017618,0.9742632134,5.8455792807,-0.324754404
31167,2012,78,50,-119,5,28,-114,12.719119446,8.1532816959,-19.40481044,0.8153281696,4.5658377497,-18.58948227
31167,2013,60,55,-10,2,5,-8,9.853834784,9.0326818854,-1.642305797,0.3284611595,0.8211528987,-1.313844638
31167,2014,75,38,-31,3,37,-28,12.31122784,6.2376887722,-5.08864084,0.4924491136,6.0735390676,-4.596191727
31167,2015,73,47,-187,4,26,-183,12.127253094,7.8079574716,-31.06570313,0.6645070189,4.3192956226,-30.40119611
31167,2016,68,36,8,4,32,12,11.399832355,6.0352053646,1.3411567477,0.6705783738,5.3646269908,2.0117351215
31167,2017,62,29,-37,4,33,-33,10.354906054,4.8434237996,-6.17954071,0.6680584551,5.5114822547,-5.511482255
17175,2010,17,18,-22,0,-1,-22,NA,NA,NA,NA,NA,NA
17175,2011,60,76,-116,1,-16,-115,10.155721056,12.863913338,-19.63439404,0.1692620176,-2.708192282,-19.46513202
17175,2012,65,85,-83,-1,-20,-84,11.22043846,14.672881063,-14.3276368,-0.17262213,-3.452442603,-14.50025893
17175,2013,57,84,-6,0,-27,-6,9.9563318777,14.672489083,-1.048034934,0,-4.716157205,-1.048034934
17175,2014,73,71,-109,0,2,-109,12.907788878,12.554150827,-19.2732738,0,0.3536380515,-19.2732738
17175,2015,58,89,-68,0,-31,-68,10.441983977,16.023044378,-12.24232604,0,-5.581060401,-12.24232604
17175,2016,64,95,32,0,-31,32,11.623683255,17.253904831,5.8118416273,0,-5.630221576,5.8118416273
17175,2017,68,87,-52,0,-19,-52,12.431444241,15.904936015,-9.506398537,0,-3.473491773,-9.506398537
38089,2010,74,35,98,9,39,107,NA,NA,NA,NA,NA,NA
38089,2011,297,239,697,35,58,732,11.997333926,9.6544202298,28.155359415,1.4138272303,2.3429136959,29.569186645
38089,2012,410,211,1448,44,199,1492,15.751056473,8.1060315021,55.628121398,1.6903572801,7.6450249712,57.318478678
38089,2013,437,236,1149,48,201,1197,15.825306004,8.5463895126,41.609328601,1.7382487144,7.2789164916,43.347577316
38089,2014,518,243,1646,42,275,1688,17.658990574,8.2840438407,56.113317538,1.4318100465,9.3749467333,57.545127585
38089,2015,553,244,1134,46,309,1180,17.78478163,7.8471730881,36.470058532,1.4793850904,9.9376085418,37.949443623
38089,2016,536,219,-1363,49,317,-1314,17.095652729,6.9849775141,-43.47271393,1.5628488502,10.110675214,-41.90986508
38089,2017,510,228,-984,49,282,-935,16.70351265,7.4674527143,-32.22795382,1.6048472939,9.2360599361,-30.62310653
39151,2010,1061,974,-330,45,87,-285,NA,NA,NA,NA,NA,NA
39151,2011,4074,4098,-964,120,-24,-844,10.866376114,10.930390112,-2.571228909,0.3200699886,-0.064013998,-2.25115892
39151,2012,4079,3947,188,134,132,322,10.887015519,10.534702195,0.5017795826,0.3576514046,0.352313324,0.8594309873
39151,2013,4046,4174,217,133,-128,350,10.790944781,11.132329094,0.5787530938,0.3547196381,-0.341384313,0.9334727319
39151,2014,4323,3925,40,156,398,196,11.519183985,10.458662304,0.1065850935,0.4156818648,1.0605216807,0.5222669584
39151,2015,4238,4220,-985,172,18,-813,11.297296433,11.249313579,-2.625728406,0.4585028283,0.0479828541,-2.167225578
39151,2016,4204,4116,-1444,171,88,-1273,11.23693112,11.001714674,-3.859688044,0.457068321,0.2352164459,-3.402619723
39151,2017,4163,4077,-1232,171,86,-1061,11.159810742,10.929269372,-3.302639163,0.4584020266,0.2305413701,-2.844237136
18149,2010,62,81,4,0,-19,4,NA,NA,NA,NA,NA,NA
18149,2011,271,265,-182,-4,6,-186,11.653407869,11.395398839,-7.82627392,-0.17200602,0.2580090303,-7.99827994
18149,2012,266,274,4,-2,-8,2,11.485319516,11.83074266,0.1727115717,-0.086355786,-0.345423143,0.0863557858
18149,2013,253,247,-22,-1,6,-23,10.930850489,10.671620833,-0.950508738,-0.043204943,0.2592296559,-0.993713681
18149,2014,253,302,-132,-2,-49,-134,10.978996702,13.105363652,-5.728172192,-0.086790488,-2.12636695,-5.81496268
18149,2015,285,297,-80,-2,-12,-82,12.443513,12.96745039,-3.49291593,-0.087322898,-0.523937389,-3.580238828
18149,2016,245,256,151,-2,-11,149,10.687722206,11.167579122,6.5871267477,-0.087246712,-0.479856915,6.4998800358
18149,2017,256,281,-71,-2,-25,-73,11.158330609,12.248011332999999,-3.094693255,-0.087174458,-1.089680724,-3.181867713
48427,2010,325,106,-36,-4,219,-40,NA,NA,NA,NA,NA,NA
48427,2011,1447,388,-687,55,1059,-632,23.580793143,6.322977014,-11.19558043,0.8962982881,17.257816128,-10.29928215
48427,2012,1322,365,-816,89,957,-727,21.42538795,5.9154815445,-13.22474778,1.4424050889,15.509906406,-11.78234269
48427,2013,1363,377,-648,125,986,-523,21.963855519,6.0751089733,-10.44209712,2.0142934262,15.888746545,-8.427803695
48427,2014,1384,381,-539,153,1003,-386,22.107919875,6.0860675378,-8.609948564,2.4440113734,16.021852337,-6.165937191
48427,2015,1335,389,-556,206,946,-350,21.119073608,6.1537974784,-8.795659121,3.2588233433,14.96527613,-5.536835777
48427,2016,1265,432,-636,221,833,-415,19.852012272,6.7795014242,-9.980932652,3.4682171638,13.072510848,-6.512715488
48427,2017,1266,400,-567,223,866,-344,19.721930132,6.2312575457,-8.832807571,3.4739260817,13.490672586,-5.358881489
51790,2010,77,106,15,8,-29,23,NA,NA,NA,NA,NA,NA
51790,2011,295,313,268,32,-18,300,12.35136493,13.105007536,11.220901022,1.3398090772,-0.753642606,12.560710099
51790,2012,274,367,-164,34,-93,-130,11.456046828,15.344413087,-6.856903941,1.421553256,-3.888366259,-5.435350685
51790,2013,243,351,370,33,-108,403,10.142961494,14.650944381,15.444015444,1.3774392153,-4.507982886,16.821454659
51790,2014,295,345,183,37,-50,220,12.192601777,14.259144451,7.5635461872,1.5292415788,-2.066542674,9.0927877661
51790,2015,324,400,-48,38,-76,-10,13.36826687,16.504033173,-1.980483981,1.5678831514,-3.135766303,-0.412600829
51790,2016,367,328,-7,34,39,27,15.149951495,13.540011146,-0.288963653,1.4035377407,1.6099403496,1.1145740882
51790,2017,368,315,182,34,53,216,15.086604489,12.913805473,7.4613098288,1.3938710669,2.1727990161,8.8551808958
29186,2010,46,54,-9,0,-8,-9,NA,NA,NA,NA,NA,NA
29186,2011,193,185,28,27,8,55,10.633022974,10.192275908,1.542614732,1.4875213487,0.4407470663,3.0301360807
29186,2012,150,203,-315,39,-53,-276,8.3240843507,11.265260821,-17.48057714,2.1642619312,-2.941176471,-15.31631521
29186,2013,160,190,75,43,-30,118,8.9377985085,10.613635729,4.1895930509,2.4020333492,-1.67583722,6.5916264
29186,2014,190,175,-51,19,15,-32,10.593515653,9.7571854702,-2.843522623,1.0593515653,0.8363301832,-1.784171057
29186,2015,194,217,-109,20,-23,-89,10.855879802,12.142917098,-6.099437621,1.1191628662,-1.287037296,-4.980274754
29186,2016,175,185,56,21,-10,77,9.8052948592,10.365597423,3.137694355,1.1766353831,-0.560302563,4.3143297381
29186,2017,171,181,-47,21,-10,-26,9.573664026,10.133527419,-2.631357949,1.175713126,-0.559863393,-1.455644823
27145,2010,485,226,-195,39,259,-156,NA,NA,NA,NA,NA,NA
27145,2011,1947,921,-659,220,1026,-439,12.890625,6.0977224576,-4.363082627,1.4565677966,6.7929025424,-2.906514831
27145,2012,1865,995,-650,325,870,-325,12.301502234,6.5629998516,-4.287386838,2.1436934189,5.7385023828,-2.143693419
27145,2013,1932,942,-696,437,990,-259,12.689946895,6.1873343558,-4.571533664,2.8703451311,6.5026125395,-1.701188533
27145,2014,1995,936,-319,522,1059,203,13.019218847,6.108265083,-2.081769831,3.4065324502,6.9109537638,1.3247626195
27145,2015,2010,1039,259,569,971,828,12.988943243,6.7141850892,1.6736996517,3.6769695051,6.2747581536,5.3506691568
27145,2016,1954,999,-616,596,955,-20,12.517336254,6.3996002652,-3.946099863,3.8179797378,6.1177359893,-0.128120125
27145,2017,1972,968,-341,591,1004,250,12.544808568,6.1578979176,-2.169259494,3.7596256914,6.38691065,1.5903661977
27147,2010,123,92,-124,5,31,-119,NA,NA,NA,NA,NA,NA
27147,2011,484,262,-185,31,222,-154,13.24956542,7.1722854132,-5.064400005,0.8486291901,6.0772800066,-4.215770815
27147,2012,442,302,-420,14,140,-406,12.130693124,8.2883921343,-11.52690297,0.3842300989,3.8423009894,-11.14267287
27147,2013,466,287,-136,13,179,-123,12.825276253,7.8988289367,-3.742999078,0.3577866766,4.9264473159,-3.385212401
27147,2014,497,303,-77,12,194,-65,13.644287656,8.3183484098,-2.113903721,0.329439541,5.3259392459,-1.78446418
27147,2015,492,311,-61,15,181,-46,13.459171112,8.507728081,-1.66871837,0.4103405827,4.951443031,-1.258377787
27147,2016,441,293,-80,14,148,-66,12.028803666,7.9919262452,-2.182095903,0.381866783,4.0368774208,-1.80022912
27147,2017,442,304,35,14,138,49,12.012501699,8.2619921185,0.9512161979,0.3804864791,3.7505095801,1.331702677
38091,2010,5,0,10,0,5,10,NA,NA,NA,NA,NA,NA
38091,2011,18,19,-21,0,-1,-21,9.0886139864,9.5935369856,-10.60338298,0,-0.504922999,-10.60338298
38091,2012,20,19,-20,0,1,-20,10.201479214,9.6914052538,-10.20147921,0,0.5100739607,-10.20147921
38091,2013,23,23,-34,0,0,-34,11.8893771,11.8893771,-17.57560093,0,0,-17.57560093
38091,2014,15,18,-3,0,-3,-3,7.8328981723,9.3994778068,-1.566579634,0,-1.566579634,-1.566579634
38091,2015,25,20,-1,0,5,-1,13.061650993,10.449320794,-0.52246604,0,2.6123301985,-0.52246604
38091,2016,28,17,-12,0,11,-12,14.625228519,8.8796030295,-6.26795508,0,5.7456254897,-6.26795508
38091,2017,28,15,-10,0,13,-10,14.621409922,7.8328981723,-5.221932115,0,6.7885117493,-5.221932115
13257,2010,66,92,-12,6,-26,-6,NA,NA,NA,NA,NA,NA
13257,2011,305,324,-363,14,-19,-349,11.751107686,12.483143903,-13.98574456,0.5393951069,-0.732036217,-13.44634945
13257,2012,311,349,10,-8,-38,2,12.075559611,13.551029917,0.3882816595,-0.310625328,-1.475470306,0.0776563319
13257,2013,312,374,-90,2,-62,-88,12.159476207,14.575782377,-3.507541214,0.0779453603,-2.416306169,-3.429595853
13257,2014,305,293,-152,-1,12,-153,11.955158357,11.484791471,-5.957980558,-0.039197241,0.4703668862,-5.997177799
13257,2015,303,337,78,3,-34,81,11.899619055,13.23488984,3.0632682716,0.1178180104,-1.335270785,3.1810862821
13257,2016,343,336,229,4,7,233,13.39608272,13.122693277,8.9437403581,0.156222539,0.2733894433,9.0999628971
13257,2017,333,329,158,4,4,162,12.903475801,12.748479095,6.1223698996,0.1549967063,0.1549967063,6.277366606
40137,2010,145,117,29,2,28,31,NA,NA,NA,NA,NA,NA
40137,2011,549,555,16,2,-6,18,12.171599601,12.304622547,0.3547278572,0.0443409822,-0.133022946,0.3990688394
40137,2012,552,558,-229,14,-6,-215,12.267348186,12.400688927,-5.089171621,0.311128396,-0.133340741,-4.778043225
40137,2013,524,569,138,19,-45,157,11.660250562,12.661607957,3.0708293464,0.4227953448,-1.001357396,3.4936246912
40137,2014,600,576,-463,22,24,-441,13.397642015,12.861736334,-10.33851375,0.4912468739,0.5359056806,-9.847266881
40137,2015,534,601,49,23,-67,72,11.97980931,13.482893999,1.0992708918,0.5159842961,-1.503084689,1.6152551878999999
40137,2016,520,521,-604,25,-1,-579,11.74252261,11.765104384,-13.63939165,0.5645443563,-0.022581774,-13.07484729
40137,2017,494,538,-644,25,-44,-619,11.314056685,12.32178643,-14.749499,0.5725737189,-1.007729745,-14.17692528
48429,2010,33,13,-36,0,20,-36,NA,NA,NA,NA,NA,NA
48429,2011,104,150,-45,2,-46,-43,10.866158186,15.672343538,-4.701703061,0.2089645805,-4.806185352,-4.492738481
48429,2012,102,104,73,2,-2,75,10.665551315,10.874679772,7.6331886862,0.2091284572,-0.209128457,7.8423171433
48429,2013,99,126,-216,-1,-27,-217,10.441936505,13.289737369,-22.78240692,-0.105474106,-2.847800865,-22.88788103
48429,2014,110,103,-31,1,7,-30,11.765335045,11.016631905,-3.315685331,0.1069575913,0.7487031392,-3.208727739
48429,2015,91,106,58,1,-15,59,9.7217029005,11.324181401,6.1962502003,0.1068319,-1.6024785,6.3030821003
48429,2016,109,107,20,3,2,23,11.601298494,11.388430632,2.1286786227,0.3193017934,0.2128678623,2.4479804162
48429,2017,96,96,-75,4,0,-71,10.242731395,10.242731395,-8.002133902,0.4267804748,0,-7.575353428
17177,2010,115,165,-55,2,-50,-53,NA,NA,NA,NA,NA,NA
17177,2011,486,523,-262,5,-37,-257,10.239986515,11.019573966,-5.520321949,0.1053496555,-0.779587451,-5.414972293
17177,2012,518,518,-446,9,0,-437,10.997876858,10.997876858,-9.469214437,0.1910828025,0,-9.278131635
17177,2013,482,537,-189,28,-55,-161,10.30453977,11.480368997,-4.040576798,0.59860397,-1.175829227,-3.441972828
17177,2014,484,519,-402,30,-35,-372,10.416330396,11.169577428,-8.651580205,0.6456403138,-0.753247033,-8.005939891
17177,2015,526,545,-612,31,-19,-581,11.442991711,11.856331716,-13.3138991,0.6743968499,-0.413340005,-12.63950225
17177,2016,518,536,-142,32,-18,-110,11.358403684,11.753097248,-3.113693674,0.7016774476,-0.394693564,-2.412016226
17177,2017,497,553,-463,32,-56,-431,10.972029053,12.208314016,-10.22142747,0.7064485507,-1.236284964,-9.514978917
48431,2010,4,7,-4,0,-3,-4,NA,NA,NA,NA,NA,NA
48431,2011,12,13,31,1,-1,32,10.407632264,11.274934952,26.886383348,0.8673026886,-0.867302689,27.753686036
48431,2012,11,16,22,1,-5,23,9.337860781,13.582342954,18.675721562,0.8488964346,-4.244482173,19.524617997
48431,2013,15,11,35,1,4,36,12.432656444,9.1172813925,29.009531703,0.828843763,3.3153750518,29.838375466
48431,2014,19,13,98,2,6,100,14.837953924,10.152284264,76.532604451,1.5618898868,4.6856696603,78.094494338
48431,2015,13,9,-12,3,4,-9,9.7524381095,6.751687922,-9.002250563,2.2505626407,3.0007501875,-6.751687922
48431,2016,21,7,4,3,14,7,15.659955257,5.2199850858,2.9828486204,2.2371364653,10.439970172,5.2199850858
48431,2017,16,13,-63,3,3,-60,12.093726379,9.8261526833,-47.61904762,2.2675736961,2.2675736961,-45.35147392
18151,2010,84,64,-58,0,20,-58,NA,NA,NA,NA,NA,NA
18151,2011,366,292,-116,-4,74,-120,10.726217689,8.557528867,-3.399566262,-0.117226423,2.1686888225,-3.516792685
18151,2012,356,284,13,5,72,18,10.427192713,8.3183222764,0.3807682732,0.1464493359,2.1088704363,0.5272176091
18151,2013,379,313,131,14,66,145,11.053429771,9.1285580961,3.8205786281,0.4083061129,1.9248716752,4.228884741
18151,2014,385,310,42,16,75,58,11.173995066,8.9972427804,1.2189812799,0.4643738209,2.1767522856,1.6833551009
18151,2015,389,330,-76,18,59,-58,11.270135589,9.5607834048,-2.20187739,0.5214972766,1.7093521845,-1.680380114
18151,2016,413,324,-232,18,89,-214,11.988040986,9.4046616934,-6.7342022,0.5224812052,2.5833792923,-6.211720995
18151,2017,404,312,-13,19,92,6,11.731908468,9.0602857475,-0.377511906,0.5517481705,2.6716227204,0.1742362644
36101,2010,314,214,-83,16,100,-67,NA,NA,NA,NA,NA,NA
36101,2011,1104,959,-57,65,145,8,11.142117507,9.6787053344,-0.575272371,0.6560123532,1.4634121726,0.0807399819
36101,2012,1127,982,-398,51,145,-347,11.377862133,9.9139845738,-4.018091507,0.5148810726,1.4638775593,-3.503210435
36101,2013,1114,948,-281,54,166,-227,11.262251743,9.5840346966,-2.840837289,0.545926027,1.678217046,-2.294911262
36101,2014,1058,1016,-777,54,42,-723,10.736266357,10.310062966,-7.884762721,0.5479757876,0.4262033903,-7.336786934
36101,2015,1094,1009,-862,59,85,-803,11.180206742,10.311543512,-8.809267104,0.6029544769,0.8686632295,-8.206312627
36101,2016,1054,1006,-770,58,48,-712,10.84780651,10.353788756,-7.924868133,0.5969381191,0.4940177538,-7.327930014
36101,2017,1033,1003,-639,59,30,-580,10.698510183,10.387808048,-6.617955476,0.6110475322,0.310702135,-6.006907944
20189,2010,12,5,15,3,7,18,NA,NA,NA,NA,NA,NA
20189,2011,95,42,-184,13,53,-171,16.682764071,7.3755377996,-32.31187988,2.282904557,9.307226271,-30.02897533
20189,2012,82,46,64,15,36,79,14.398595259,8.077260755,11.237928007,2.6338893766,6.321334504,13.871817384
20189,2013,98,46,-1,15,52,14,16.937435188,7.9502246803,-0.172830971,2.5924645697,8.9872105081,2.4196335983
20189,2014,76,49,-46,30,27,-16,13.0472103,8.4120171674,-7.896995708,5.1502145923,4.635193133,-2.746781116
20189,2015,80,54,-106,32,26,-74,13.772918998,9.2967203237,-18.24911767,5.5091675992,4.4761986744,-12.73995007
20189,2016,69,40,-195,35,29,-160,12.061882703,6.9923957696,-34.08792938,6.1183462984,5.069486933,-27.96958308
20189,2017,76,29,-126,35,47,-91,13.490725126,5.147776693,-22.36620218,6.2128339398,8.3429484335,-16.15336824
27149,2010,33,38,-16,3,-5,-13,NA,NA,NA,NA,NA,NA
27149,2011,103,94,-18,15,9,-3,10.607621009,9.6807415036,-1.853759011,1.5447991761,0.9268795057,-0.308959835
27149,2012,130,76,-36,6,54,-30,13.368296571,7.8153118412,-3.70198982,0.6169983033,5.5529847293,-3.084991516
27149,2013,113,87,-31,16,26,-15,11.601047174,8.9317796828,-3.182588163,1.6426261486,2.6692674914,-1.539962014
27149,2014,123,82,26,27,41,53,12.561915948,8.3746106317,2.6553643466,2.7574937446,4.1873053158,5.4128580912
27149,2015,121,93,-64,30,28,-34,12.302374053,9.4555436938,-6.507040822,3.0501753851,2.8468303594,-3.456865436
27149,2016,94,60,-151,31,34,-120,9.6016343207,6.1287027579,-15.42390194,3.1664964249,3.4729315628,-12.25740552
27149,2017,102,71,-176,31,31,-145,10.525772664,7.3267633249,-18.16211754,3.199009339,3.199009339,-14.9631082
53065,2010,104,133,-47,14,-29,-33,NA,NA,NA,NA,NA,NA
53065,2011,425,403,-72,24,22,-48,9.7819207089,9.2755624604,-1.65717245,0.5523908165,0.5063582485,-1.104781633
53065,2012,454,431,-8,22,23,14,10.448911955,9.9195617901,-0.184121797,0.5063349406,0.5293501651,0.322213144
53065,2013,427,420,-237,23,7,-214,9.8473317651,9.6859000969,-5.465615055,0.5304183386,0.1614316683,-4.935196716
53065,2014,458,420,169,30,38,199,10.559321252,9.6832203624,3.8963434315,0.6916585973,0.8761008899,4.5880020289
53065,2015,430,468,117,33,-38,150,9.8752956847,10.747996234,2.6869990584,0.7578715293,-0.872700549,3.4448705877
53065,2016,453,506,642,30,-53,672,10.317731466,11.524883271,14.622480355,0.6832934745,-1.207151805,15.30577383
53065,2017,446,477,518,31,-31,549,10.028782155,10.725849973,11.647778377,0.697067818,-0.697067818,12.344846195
13259,2010,11,26,46,2,-15,48,NA,NA,NA,NA,NA,NA
13259,2011,64,66,-52,28,-2,-24,10.517666393,10.846343468,-8.545603944,4.6014790468,-0.328677075,-3.944124897
13259,2012,45,69,24,46,-24,70,7.3824952834,11.319826101,3.9373308178,7.5465507341,-3.937330818,11.483881552
13259,2013,40,65,-641,88,-25,-553,6.8487287047,11.129184145,-109.7508775,15.06720315,-4.28045544,-94.68367434
13259,2014,46,76,234,93,-30,327,8.0475857243,13.296011197,40.937718684,16.270118964,-5.248425472,57.207837649
13259,2015,52,69,-84,96,-17,12,8.8608673426,11.757689358,-14.31370878,16.358524325,-2.8968220160000002,2.0448155406
13259,2016,37,42,-88,101,-5,13,6.3021631749,7.1538068472,-14.98892863,17.20320218,-0.851643672,2.2142735479
13259,2017,41,59,27,101,-18,128,6.9139966273,9.9494097808,4.5531197302,17.032040472,-3.035413153,21.585160202
47161,2010,34,31,29,4,3,33,NA,NA,NA,NA,NA,NA
47161,2011,136,149,-109,0,-13,-109,10.234413214,11.212702713,-8.202581179,0,-0.978289498,-8.202581179
47161,2012,130,154,84,26,-24,110,9.7954262894,11.603812681,6.3293523716,1.9590852579,-1.808386392,8.2884376295
47161,2013,126,159,13,4,-33,17,9.4694122952,11.949496468,0.9770028559,0.3006162633,-2.480084173,1.2776191192
47161,2014,138,171,-49,3,-33,-46,10.409202338,12.898359419,-3.69602112,0.2262870074,-2.489157081,-3.469734113
47161,2015,123,174,32,0,-51,32,9.3125378558,13.17383404,2.4227740763,0,-3.861296184,2.4227740763
47161,2016,136,146,-12,-3,-10,-15,10.313969361,11.072349462,-0.91005612,-0.22751403,-0.7583801,-1.13757015
47161,2017,133,162,214,-3,-29,211,10.026763165,12.21304987,16.1332881,-0.22616759,-2.186286705,15.90712051
30095,2010,30,11,-2,0,19,-2,NA,NA,NA,NA,NA,NA
30095,2011,80,84,44,0,-4,44,8.737917099,9.174812954,4.8058544045,0,-0.436895855,4.8058544045
30095,2012,81,81,11,0,0,11,8.8220878941,8.8220878941,1.198061319,0,0,1.198061319
30095,2013,83,91,76,9,-8,85,8.9972899729,9.864498645,8.2384823848,0.9756097561,-0.867208672,9.2140921409
30095,2014,93,91,-35,8,2,-27,10.053510621,9.8373060916,-3.783579266,0.8648181179,0.2162045295,-2.918761148
30095,2015,87,96,183,9,-9,192,9.3247588424,10.289389068,19.61414791,0.9646302251,-0.964630225,20.578778135
30095,2016,77,88,-52,9,-11,-43,8.1962850604,9.3671829262,-5.535153547,0.9580073447,-1.170897866,-4.577146203
30095,2017,76,84,50,9,-8,59,8.0911316938,8.9428297668,5.3231129565,0.9581603322,-0.851698073,6.2812732886
29207,2010,81,78,56,1,3,57,NA,NA,NA,NA,NA,NA
29207,2011,366,382,-164,1,-16,-163,12.225878109,12.760342725,-5.478262322,0.0334040385,-0.534464617,-5.444858283
29207,2012,354,397,15,0,-43,15,11.867048826,13.308526508,0.5028410519,0,-1.441477682,0.5028410519
29207,2013,381,365,-23,-6,16,-29,12.782875644,12.246061968,-0.771669658,-0.201305128,0.5368136753,-0.972974787
29207,2014,387,365,-25,-3,22,-28,12.990282463,12.251816793,-0.839165534,-0.100699864,0.7384656697,-0.939865398
29207,2015,364,420,11,-3,-56,8,12.231182796,14.112903226,0.3696236559,-0.100806452,-1.88172043,0.2688172043
29207,2016,308,392,-163,-2,-84,-165,10.402418224,13.239441377,-5.505175879,-0.06754817,-2.837023152,-5.572724049
29207,2017,309,378,-43,-2,-69,-45,10.500917556,12.845782641,-1.461292734,-0.067967104,-2.344865085,-1.529259838
37169,2010,107,145,-27,1,-38,-26,NA,NA,NA,NA,NA,NA
37169,2011,429,498,-132,4,-69,-128,9.0793650794,10.53968254,-2.793650794,0.0846560847,-1.46031746,-2.708994709
37169,2012,388,477,-333,2,-89,-331,8.2651670075,10.161042945,-7.093558282,0.0426039536,-1.895875937,-7.050954329
37169,2013,383,496,-97,3,-113,-94,8.2133321896000009,10.636586857,-2.080138962,0.0643341947,-2.423254667,-2.015804767
37169,2014,393,477,-105,0,-84,-105,8.4644460957,10.273640681,-2.261493232,0,-1.809194585,-2.261493232
37169,2015,405,565,-17,2,-160,-15,8.7580823043,12.218065437,-0.367623208,0.0432497892,-3.459983133,-0.324373419
37169,2016,399,532,-131,3,-133,-128,8.6697666333,11.559688844,-2.846464734,0.0651862153,-2.889922211,-2.781278519
37169,2017,396,555,-15,3,-159,-12,8.6455331412,12.11684569,-0.327482316,0.0654964632,-3.471312549,-0.261985853
05137,2010,21,50,25,-1,-29,24,NA,NA,NA,NA,NA,NA
05137,2011,129,174,154,-8,-45,146,10.366858199,13.983204082,12.375939245,-0.642905935,-3.616345883,11.733033311
05137,2012,129,173,94,-6,-44,88,10.304337407,13.818995127,7.5085869478,-0.479271507,-3.51465772,7.0293154405
05137,2013,124,174,-59,-9,-50,-68,9.934703361,13.940632136,-4.726995954,-0.721067179,-4.005928775,-5.448063133
05137,2014,112,163,20,-10,-51,10,9.0322580645,13.14516129,1.6129032258,-0.806451613,-4.112903226,0.8064516129
05137,2015,135,179,57,-9,-44,48,10.905565878,14.459972534,4.6045722595,-0.727037725,-3.554406656,3.8775345343
05137,2016,110,153,171,-9,-43,162,8.8424437299,12.29903537,13.745980707,-0.723472669,-3.45659164,13.022508039
05137,2017,120,159,87,-9,-39,78,9.5858129968,12.701202221,6.9497144227,-0.718935975,-3.115389224,6.2307784479
28131,2010,55,25,83,0,30,83,NA,NA,NA,NA,NA,NA
28131,2011,206,171,-48,2,35,-46,11.51030899,9.5546739677,-2.682013745,0.1117505727,1.9556350226,-2.570263173
28131,2012,210,207,139,6,3,145,11.688745408,11.521763331,7.7368362462,0.3339641545,0.1669820773,8.0708004008
28131,2013,204,176,-127,12,28,-115,11.334277856,9.7785926605,-7.056143568,0.6667222269,1.555685196,-6.389421341
28131,2014,209,172,-139,-2,37,-141,11.673695088,9.6070600721,-7.763845058,-0.111710001,2.0666350155,-7.875555059
28131,2015,239,153,99,1,86,100,13.31958648,8.5267645666,5.5173182489,0.0557304874,4.7928219132,5.5730487363
28131,2016,203,184,-102,1,19,-101,11.282165287,10.226199077,-5.668871228,0.0555771689,1.0559662091,-5.613294059
28131,2017,206,183,137,1,23,138,11.424451654,10.148906081,7.597814935,0.0554585032,1.275545573,7.6532734381
29209,2010,84,64,10,2,20,12,NA,NA,NA,NA,NA,NA
29209,2011,242,336,-26,-3,-94,-29,7.521601293,10.443215018,-0.808105924,-0.093242991,-2.921613725,-0.901348915
29209,2012,269,342,-150,4,-73,-146,8.4059873129,10.687166026,-4.68735352,0.1249960939,-2.281178713,-4.562357426
29209,2013,234,388,-76,0,-154,-76,7.3649754501,12.212010575,-2.392043309,0,-4.847035125,-2.392043309
29209,2014,265,437,-43,11,-172,-32,8.3994991997,13.851249624,-1.362937606,0.3486584573,-5.451750424,-1.014279149
29209,2015,230,405,34,12,-175,46,7.3295092416,12.906309751,1.0834926705,0.3824091778,-5.57680051,1.4659018483
29209,2016,251,359,318,12,-108,330,7.9873983675,11.424207227,10.119492752,0.381867651,-3.436808859,10.501360404
29209,2017,243,370,280,12,-127,292,7.6858602312,11.702750146,8.8561352458000009,0.3795486534,-4.016889915,9.2356838992
48433,2010,0,8,11,0,-8,11,NA,NA,NA,NA,NA,NA
48433,2011,10,19,-25,1,-9,-24,6.7590402163,12.842176411,-16.89760054,0.6759040216,-6.083136195,-16.22169652
48433,2012,11,28,4,1,-17,5,7.5471698113,19.210977702,2.7444253859,0.6861063465,-11.66380789,3.4305317324
48433,2013,16,23,-29,2,-7,-27,11.149825784,16.027874564,-20.20905923,1.393728223,-4.87804878,-18.81533101
48433,2014,17,26,-24,2,-9,-22,12.121212121,18.538324421,-17.11229947,1.4260249554,-6.417112299,-15.68627451
48433,2015,16,23,16,2,-7,18,11.486001436,16.511127064,11.486001436,1.4357501795,-5.025125628,12.921751615
48433,2016,15,19,5,2,-4,7,10.71046055,13.566583363,3.5701535166,1.4280614066,-2.856122813,4.9982149232
48433,2017,15,9,-23,2,6,-21,10.752688172,6.4516129032,-16.4874552,1.4336917563,4.3010752688,-15.05376344
32029,2010,3,4,-16,0,-1,-16,NA,NA,NA,NA,NA,NA
32029,2011,20,33,-80,0,-13,-80,5.0658561297,8.358662614,-20.26342452,0,-3.292806484,-20.26342452
32029,2012,23,34,-56,-1,-11,-57,5.9454568954,8.7889362802,-14.47589505,-0.258498126,-2.843479385,-14.73439318
32029,2013,12,35,-20,-1,-23,-21,3.1475409836,9.1803278689,-5.245901639,-0.262295082,-6.032786885,-5.508196721
32029,2014,22,30,17,-1,-8,16,5.7986294149,7.9072219294,4.4807590933,-0.263574064,-2.108592514,4.217185029
32029,2015,14,19,78,-1,-5,77,3.6505867014,4.9543676662,20.338983051,-0.260756193,-1.303780965,20.078226858
32029,2016,20,22,121,-1,-2,120,5.0884111436,5.597252258,30.784887419,-0.254420557,-0.508841114,30.530466862
32029,2017,20,18,16,-1,2,15,5.0031269543,4.5028142589,4.0025015635,-0.250156348,0.5003126954,3.7523452158
19169,2010,257,86,-207,112,171,-95,NA,NA,NA,NA,NA,NA
19169,2011,990,494,61,612,496,673,10.974149781,5.4759898905,0.6761849865,6.7840198643,5.49815989,7.4602048508
19169,2012,906,437,-167,639,469,472,9.9272984271,4.788332685,-1.829866266,7.0017038575,5.1389657421,5.1718375912
19169,2013,956,477,494,747,479,1241,10.324420061,5.1514104281,5.3350036719,8.0673031232,5.1730096332,13.402306795
19169,2014,952,536,562,860,416,1422,10.086241604,5.6788082978,5.9542728795,9.1115207764,4.4074333058,15.065793656
19169,2015,895,505,-245,904,390,659,9.339552745,5.2698035042,-2.556637344,9.4334700352,4.0697492408,6.8768326916
19169,2016,893,521,-826,918,372,92,9.2460292808,5.3943799052,-8.552318237,9.5048766851,3.8516493757,0.9525584477
19169,2017,890,514,-604,910,376,306,9.1602424891,5.2902973476,-6.216614004,9.3660906349,3.8699451415,3.1494766311
33017,2010,319,204,-86,15,115,-71,NA,NA,NA,NA,NA,NA
33017,2011,1296,924,312,123,372,435,10.487303565,7.4770590235,2.5247212287,0.9953227921,3.0102445419,3.5200440208
33017,2012,1216,892,27,133,324,160,9.7898325826,7.1813574537,0.2173729274,1.0707629387,2.6084751289,1.2881358661
33017,2013,1268,944,-303,162,324,-141,10.181999221,7.5802896409,-2.433080256,1.3008547901,2.6017095802,-1.132225465
33017,2014,1251,1051,981,183,200,1164,9.983042394,8.387032419,7.8284289277,1.4603491272,1.5960099751,9.2887780549
33017,2015,1199,1073,-54,195,126,141,9.5062159076,8.5072307497,-0.428136496,1.5460484587,0.9989851579,1.1179119625
33017,2016,1225,1094,676,207,131,883,9.663817484,8.6303806755,5.3328494851,1.632987934,1.0334368085,6.9658374191
33017,2017,1240,1033,929,204,207,1133,9.6919295147,8.0740025715,7.2611310638,1.5944787266,1.6179269432,8.8556097904
38093,2010,65,39,8,2,26,10,NA,NA,NA,NA,NA,NA
38093,2011,217,247,-85,0,-30,-85,10.296315627,11.7197694,-4.033119024,0,-1.423453773,-4.033119024
38093,2012,236,256,-24,3,-20,-21,11.240771612,12.193379376,-1.143129317,0.1428911646,-0.952607764,-1.000238152
38093,2013,228,238,123,2,-10,125,10.841654779,11.317165953,5.8487874465,0.0951022349,-0.475511175,5.9438896814
38093,2014,252,238,-6,6,14,0,11.946525078,11.282829241,-0.284441073,0.2844410733,0.6636958377,0
38093,2015,224,240,-85,7,-16,-78,10.6400665,11.40007125,-4.037525235,0.3325020781,-0.76000475,-3.705023156
38093,2016,233,245,10,7,-12,17,11.091540915,11.662779074,0.4760317989,0.3332222592,-0.571238159,0.8092540582
38093,2017,225,226,72,7,-1,79,10.689851767,10.73736222,3.4207525656,0.3325731661,-0.047510452,3.7533257317
56035,2010,34,3,-26,0,31,-26,NA,NA,NA,NA,NA,NA
56035,2011,134,53,-158,8,81,-150,13.109621875,5.1851489507,-15.45761385,0.7826639926,7.9244729247,-14.67494986
56035,2012,138,38,186,1,100,187,13.352685051,3.6768263183,17.997097242,0.0967585873,9.6758587325,18.09385583
56035,2013,132,48,-401,-2,84,-403,12.782646589,4.6482351232,-38.83213093,-0.193676463,8.1344114656,-39.02580739
56035,2014,123,57,-83,-1,66,-84,12.102130172,5.6083042259,-8.166478083,-0.098391302,6.4938259458,-8.264869386
56035,2015,144,47,-199,0,97,-199,14.249666023,4.6509326604,-19.6922468,0,9.598733363,-19.6922468
56035,2016,106,46,-112,-1,60,-113,10.569348888,4.5866985741,-11.16761392,-0.099710839,5.9826503141,-11.26732476
56035,2017,119,51,-270,-1,68,-271,12.01959497,5.1512549871,-27.27134993,-0.101005,6.8683399828,-27.37235493
51800,2010,275,227,168,30,48,198,NA,NA,NA,NA,NA,NA
51800,2011,1130,690,-537,26,440,-511,13.327514831,8.1380400297,-6.33351811,0.3066507837,5.1894748016,-6.026867326
51800,2012,1094,697,-38,152,397,114,12.8702097,8.1997588306,-0.447045675,1.7881827005,4.6704508691,1.3411370254
51800,2013,1050,754,122,109,296,231,12.279193783,8.8176305834,1.4267253729,1.2746972594,3.4615631998,2.7014226323
51800,2014,1099,691,587,116,408,703,12.730958587,8.0046336519,6.7998841587,1.3437590501,4.7263249348,8.1436432088
51800,2015,1184,698,595,143,486,738,13.532743181,7.9779178549,6.8006606356,1.6344444889,5.5548253259000004,8.4351051245
51800,2016,1266,797,606,117,469,723,14.273071134,8.9854958088,6.8321335761,1.3190752944,5.2875753254,8.1512088705
51800,2017,1239,809,420,91,430,511,13.802630186,9.0123711225,4.6788576903,1.0137524996,4.7902590639,5.6926101899
25025,2010,2262,1029,126,1847,1233,1973,NA,NA,NA,NA,NA,NA
25025,2011,9694,4639,-1790,8064,5055,6274,13.260723553,6.3458321193,-2.448596571,11.03099595,6.9148914342,8.5823993784
25025,2012,9547,4522,-35,8281,5025,8246,12.84389229,6.0835949445,-0.047086648,11.140700959,6.7602973455,11.093614311
25025,2013,9582,4676,-2629,9219,4906,6590,12.680071036,6.1878534924,-3.479013437,12.199705164,6.4922175435,8.7206917269
25025,2014,9277,4548,-4296,9890,4729,5594,12.103113254,5.9334870195,-5.604718609,12.902855458,6.1696262347,7.2981368485
25025,2015,9481,4776,-5611,10687,4705,5076,12.210474529,6.15095732,-7.22634454,13.763668526,6.0595172091,6.5373239858
25025,2016,9340,4929,-5602,11025,4411,5423,11.87924128,6.2690342902,-7.125001033,14.022337807,5.6102069901,6.8973367733
25025,2017,9391,5159,-8411,10973,4232,2562,11.819239018,6.492967106,-10.58583957,13.81029813,5.3262719117,3.2244585628
36103,2010,4372,2707,-1141,1055,1665,-86,NA,NA,NA,NA,NA,NA
36103,2011,16465,11576,-3857,4434,4889,577,10.995861776,7.7308287834,-2.575829874,2.9611692144,3.2650329926,0.3853393407
36103,2012,16057,11465,-9851,4375,4592,-5476,10.707000793,7.6449999433,-6.568765324,2.9173026386,3.0620008495,-3.651462686
36103,2013,15617,11946,-6037,4255,3671,-1782,10.410032079,7.9630046244,-4.024163646,2.8363121277,2.4470274549,-1.187851519
36103,2014,15554,11645,-8723,4341,3909,-4382,10.363319154,7.7588306253,-5.811960459,2.8923214894,2.6044885285,-2.91963897
36103,2015,15788,11943,-10332,4784,3845,-5548,10.526789539,7.9631015624,-6.888952972,3.1897745855,2.5636879768,-3.699178386
36103,2016,15742,12490,-12777,4897,3252,-7880,10.518223982,8.3453574856,-8.537120304,3.2719948445,2.1728664967,-5.265125459
36103,2017,15513,12780,-9000,4867,2733,-4133,10.386012459,8.5562585717,-6.025534205,3.2584749975,1.8297538871,-2.767059208
18153,2010,53,94,-48,0,-41,-48,NA,NA,NA,NA,NA,NA
18153,2011,227,239,-161,3,-12,-158,10.654525827,11.217760672,-7.556734177,0.1408087114,-0.563234845,-7.415925465
18153,2012,243,231,-29,1,12,-28,11.455239711,10.889548862,-1.367086221,0.0471409042,0.56569085,-1.319945317
18153,2013,239,221,-79,-1,18,-80,11.288227654,10.438068249,-3.731255166,-0.047231078,0.8501594049,-3.778486244
18153,2014,246,240,-149,0,6,-149,11.67564489,11.390873063,-7.071833693,0,0.2847718266,-7.071833693
18153,2015,227,266,-83,3,-39,-80,10.841273253,12.70387086,-3.96398978,0.143276739,-1.862597607,-3.820713041
18153,2016,199,221,-122,3,-22,-119,9.5638591854,10.621170251,-5.863270455,0.1441787817,-1.057311066,-5.719091674
18153,2017,197,202,12,3,-5,15,9.497866596,9.7389291999,0.5785502495,0.1446375624,-0.241062604,0.7231878119
29211,2010,27,9,4,0,18,4,NA,NA,NA,NA,NA,NA
29211,2011,79,77,-91,12,2,-79,11.792804896,11.494252874,-13.58411703,1.7913121361,0.2985520227,-11.7928049
29211,2012,92,82,-140,22,10,-118,13.92251816,12.409200969,-21.18644068,3.3292978208,1.5133171913,-17.85714286
29211,2013,85,77,-89,20,8,-69,13.024823782,11.798958014,-13.63775667,3.0646644192,1.2258657677,-10.57309225
29211,2014,81,97,-28,22,-16,-6,12.490362375,14.957594449,-4.31765613,3.3924441017999998,-2.467232074,-0.925212028
29211,2015,85,74,-139,23,11,-116,13.237813425,11.524684629,-21.64771842,3.5819965737,1.7131287961,-18.06572185
29211,2016,81,49,-82,24,32,-58,12.743864065,7.7092511013,-12.90119572,3.7759597231,5.0346129641,-9.125235997
29211,2017,85,65,-159,24,20,-135,13.522112631,10.340439071,-25.2943048,3.8180082724,3.1816735603,-21.47629653
33019,2010,130,101,-8,3,29,-5,NA,NA,NA,NA,NA,NA
33019,2011,413,420,-274,16,-7,-258,9.4658553076,9.6262935332,-6.280010543,0.3667159441,-0.160438226,-5.913294599
33019,2012,408,391,-328,22,17,-306,9.4108963416999991,9.0187756608,-7.565622549,0.5074502929,0.3921206809,-7.058172256
33019,2013,384,472,-110,14,-88,-96,8.9066196595,10.947719998,-2.551375423,0.3247205084,-2.041100339,-2.226654915
33019,2014,384,405,114,10,-21,124,8.9162361409,9.4038428049,2.6470076043,0.2321936495,-0.487606664,2.8792012538
33019,2015,420,436,13,10,-16,23,9.7411633732,10.112255311,0.3015121996,0.2319324613,-0.371091938,0.5334446609
33019,2016,375,449,-16,11,-74,-5,8.7055436902,10.423437645,-0.371436531,0.2553626149,-1.717893955,-0.116073916
33019,2017,395,413,49,11,-18,60,9.1739923124,9.5920476583,1.1380395527,0.2554782669,-0.418055346,1.3935178196
36105,2010,209,150,-110,35,59,-75,NA,NA,NA,NA,NA,NA
36105,2011,843,728,-698,183,115,-515,10.904857383,9.4172433866,-9.02917017,2.3672466205,1.4876139965,-6.66192355
36105,2012,869,765,-377,178,104,-199,11.276634398,9.9270717085,-4.89216475,2.3098284498,1.3495626898,-2.582336301
36105,2013,916,738,-322,206,178,-116,11.889310005,9.5789419033,-4.179429936,2.6737967914,2.3103681013,-1.505633145
36105,2014,784,721,-1548,237,63,-1311,10.253392186,9.4294588851,-20.24521824,3.0995586072,0.8239333006,-17.14565964
36105,2015,814,711,-1073,242,103,-831,10.782313826,9.4179669908,-14.21305004,3.2055527592,1.3643468355,-11.00749728
36105,2016,776,674,-120,253,102,133,10.311881254,8.9564535633,-1.594620812,3.3619922129,1.3554276906,1.7673714005
36105,2017,778,738,-173,252,40,79,10.314540453,9.7842298896,-2.293593186,3.3409565477,0.5303105631,1.0473633622
42113,2010,13,40,3,0,-27,3,NA,NA,NA,NA,NA,NA
42113,2011,50,123,67,8,-73,75,7.806401249,19.203747073,10.460577674,1.2490241998,-11.39734582,11.709601874
42113,2012,65,109,29,6,-44,35,10.154663334,17.028589283,4.5305421028,0.9373535385,-6.873925949,5.4678956413
42113,2013,36,107,-45,7,-71,-38,5.6764427625,16.871649322,-7.095553453,1.1037527594,-11.19520656,-5.991800694
42113,2014,51,116,27,8,-65,35,8.1300813008,18.491949625,4.3041606887,1.2753068707,-10.36186832,5.5794675594
42113,2015,43,96,26,8,-53,34,6.8827531012,15.366146459,4.1616646659,1.2805122049,-8.483393357,5.4421768707
42113,2016,35,103,-88,8,-68,-80,5.6790524095,16.712639948,-14.27876034,1.2980691222,-11.03358754,-12.98069122
42113,2017,39,99,52,8,-60,60,6.4049926096,16.258827394,8.5399901462,1.3138446379,-9.853834784,9.853834784
47163,2010,397,483,57,2,-86,59,NA,NA,NA,NA,NA,NA
47163,2011,1553,1955,553,-9,-402,544,9.9031998878,12.466681121,3.5263809002,-0.057391371,-2.563481233,3.4689895293
47163,2012,1522,1967,6,-25,-445,-19,9.7169817344,12.558017787,0.0383061041,-0.159608767,-2.841036052,-0.121302663
47163,2013,1631,2102,401,-28,-471,373,10.43322512,13.446130719,2.5651276967,-0.179111161,-3.012905599,2.3860165358
47163,2014,1578,1983,678,-14,-405,664,10.090062439,12.679717248,4.3352739759,-0.089518932,-2.589654809,4.2457550442
47163,2015,1530,2058,362,-6,-528,356,9.7816392877,13.157263826,2.3143486419,-0.03835937,-3.375624538,2.2759892722
47163,2016,1534,2033,529,-6,-499,523,9.8127956552,13.004832834,3.3839432214,-0.038381209,-3.192037179,3.3455620128
47163,2017,1498,1900,1238,-7,-402,1231,9.55683221,12.121482776,7.8981029879,-0.044658094,-2.564650566,7.8534448935
46119,2010,9,0,0,1,9,1,NA,NA,NA,NA,NA,NA
46119,2011,15,13,-9,5,2,-4,10.889292196,9.4373865699,-6.533575318,3.6297640653,1.4519056261,-2.903811252
46119,2012,19,10,40,2,9,42,13.542409123,7.1275837491,28.510334996,1.4255167498,6.4148253742,29.935851746
46119,2013,13,15,7,5,-2,12,9.0655509066,10.460251046,4.8814504881,3.4867503487,-1.394700139,8.3682008368
46119,2014,15,6,-42,1,9,-41,10.533707865,4.2134831461,-29.49438202,0.702247191,6.3202247191,-28.79213483
46119,2015,14,7,-11,1,7,-10,9.946714032,4.973357016,-7.815275311,0.7104795737,4.973357016,-7.104795737
46119,2016,13,6,6,1,7,7,9.203539823,4.2477876106,4.2477876106,0.7079646018,4.9557522124,4.9557522124
46119,2017,13,3,-24,1,10,-23,9.2002830856,2.1231422505,-16.985138,0.7077140835,7.0771408351,-16.27742392
54089,2010,31,33,18,-1,-2,17,NA,NA,NA,NA,NA,NA
54089,2011,126,213,1,3,-87,4,9.0654003885,15.324843514,0.0719476221,0.2158428664,-6.259443125,0.2877904885
54089,2012,116,179,47,-2,-63,45,8.3778708652,12.927921421,3.3944821609,-0.144446049,-4.550050556,3.2500361115
54089,2013,110,186,-164,-4,-76,-168,8.0207080098,13.562288089,-11.95814649,-0.291662109,-5.541580079,-12.2498086
54089,2014,96,199,-155,-7,-103,-162,7.1309192201,14.7818013,-11.51346332,-0.51996286,-7.65088208,-12.03342618
54089,2015,97,201,-92,-7,-104,-99,7.3315445372,15.192169608,-6.95362987,-0.529080534,-7.860625071,-7.482710404
54089,2016,129,175,-72,-7,-46,-79,9.8721971378,13.392515497,-5.510063519,-0.53570062,-3.520318359,-6.045764139
54089,2017,116,150,30,-7,-34,23,8.9241066277,11.539793053,2.3079586106,-0.538523676,-2.615686425,1.7694349348
08117,2010,64,3,-16,27,61,11,NA,NA,NA,NA,NA,NA
08117,2011,307,54,-474,134,253,-340,10.953332382,1.9266447838,-16.91165977,4.7809333524,9.0266875981,-12.13072642
08117,2012,309,56,-124,113,253,-11,10.993115961,1.9922799153,-4.411476955,4.0201362577,9.000836046,-0.391340698
08117,2013,248,54,175,51,194,226,8.719499332,1.898600661,6.1528725125,1.7931228465,6.820898671,7.945995359
08117,2014,268,69,275,47,199,322,9.2667830777,2.385850867,9.5088259193,1.6251447935,6.8809322107,11.133970713
08117,2015,274,69,390,56,205,446,9.2821572546,2.3374775568,13.211829669,1.8970832345,6.9446796978,15.108912904
08117,2016,296,48,169,60,248,229,9.8365013957,1.5951083344,5.6161105942,1.9938854181,8.2413930613,7.6099960122
08117,2017,291,58,-42,60,233,18,9.5539832887,1.9042303462,-1.378925423,1.9698934616,7.6497529425,0.5909680385
39153,2010,1570,1274,-573,171,296,-402,NA,NA,NA,NA,NA,NA
39153,2011,6068,5371,-1894,872,697,-1022,11.206520023,9.9192846148,-3.497882156,1.610429377,1.287235408,-1.887452779
39153,2012,6116,5645,-1854,845,471,-1009,11.304896725,10.434293985,-3.426958556,1.5619093741,0.8706027399,-1.865049182
39153,2013,6125,5614,-448,884,511,436,11.318310624,10.374040138,-0.827853577,1.6335325048,0.9442704864,0.8056789277
39153,2014,6200,5477,-1193,1041,723,-152,11.442323308,10.108000768,-2.201724469,1.9212029942,1.3343225406,-0.280521475
39153,2015,6086,5995,-1980,1110,91,-870,11.235363889,11.0673688,-3.655277769,2.0491708704,0.1679950894,-1.606106898
39153,2016,6041,5784,-2236,1108,257,-1128,11.169827229,10.694633454,-4.134370747,2.0486953435,0.4751937755,-2.085675404
39153,2017,5945,5735,-452,1101,210,649,10.992749778,10.604444066,-0.835781817,2.0358313718,0.3883057112,1.2000495552
49043,2010,112,46,89,15,66,104,NA,NA,NA,NA,NA,NA
49043,2011,476,128,532,52,348,584,12.875652574,3.462360356,14.39043523,1.4065838946,9.4132922178,15.797019124
49043,2012,434,116,106,42,318,148,11.52156311,3.0794961307,2.8140223263,1.1149899784,8.442066979,3.9290123047
49043,2013,411,151,241,62,260,303,10.764798324,3.9549502357,6.3122053431,1.6238868518,6.809848088,7.9360921949
49043,2014,410,148,312,67,262,379,10.572460031,3.8164002063,8.0453842187,1.727694688,6.7560598247,9.7730789067
49043,2015,443,141,127,77,302,204,11.258227655,3.5833185087,3.2275280185,1.9568476963,7.6749091464,5.1843757148
49043,2016,430,160,441,81,270,522,10.751478328,4.0005500756,11.026516146,2.0252784758,6.7509282526,13.051794622
49043,2017,439,164,358,81,275,439,10.773534897,4.0247374104,8.785707274,1.9878276234,6.748797487,10.773534897
20191,2010,70,38,-54,0,32,-54,NA,NA,NA,NA,NA,NA
20191,2011,296,291,-348,4,5,-344,12.358565404,12.149805854,-14.52966473,0.1670076406,0.2087595507,-14.36265709
20191,2012,272,287,-147,10,-15,-137,11.471952763000001,12.104597216,-6.199915647,0.4217629692,-0.632644454,-5.778152678
20191,2013,279,260,-132,12,19,-120,11.829552682,11.023955904,-5.596777613,0.5087979648,0.8055967776,-5.087979648
20191,2014,245,259,-152,10,-14,-142,10.44464339,11.041480155,-6.479942022,0.4263119751,-0.596836765,-6.053630046
20191,2015,277,246,-15,12,31,-3,11.841402159,10.516191087,-0.641231164,0.5129849311,1.3252110719,-0.128246233
20191,2016,287,259,-243,14,28,-229,12.315218091,11.113733399,-10.42717072,0.6007423459,1.2014846918,-9.826428372
20191,2017,280,247,-91,14,33,-77,12.078857685,10.655278029,-3.925628748,0.6039428843,1.4235796558,-3.321685863
47165,2010,467,302,390,15,165,405,NA,NA,NA,NA,NA,NA
47165,2011,1860,1313,1745,71,547,1816,11.453801461,8.0853985584,10.745636317,0.437215002,3.3684029029,11.182851319
47165,2012,1938,1255,1445,63,683,1508,11.768027762,7.6206784529,8.7744066649,0.3825519861,4.1473493094,9.156958651
47165,2013,1960,1421,2245,33,539,2278,11.72227771,8.49865134,13.426792581,0.1973648798,3.2236263703,13.624157461
47165,2014,2111,1381,2721,71,730,2792,12.388279549,8.1043174123,15.968028732,0.4166593311,4.2839621368,16.384688063
47165,2015,2128,1468,2244,90,660,2334,12.251853899,8.4519368062,12.919718115,0.5181705126,3.7999170927,13.437888628
47165,2016,2064,1532,3281,100,532,3381,11.651110214,8.6480139768,18.520975103,0.5644917739,3.0030962374,19.085466877000002
47165,2017,2128,1604,3803,98,524,3901,11.735736365,8.8459215834,20.973216822,0.5404615431,2.8898147816,21.513678365
01119,2010,27,57,-2,0,-30,-2,NA,NA,NA,NA,NA,NA
01119,2011,129,160,-232,20,-31,-212,9.4779765622,11.755629845,-17.04566327,1.4694537306,-2.277653282,-15.57620954
01119,2012,126,154,-62,28,-28,-34,9.3614175861,11.441732605,-4.606411828,2.0803150191,-2.080315019,-2.526096809
01119,2013,136,152,-73,36,-16,-37,10.147739143,11.341590807,-5.446948217,2.6861662438,-1.193851664,-2.760781973
01119,2014,169,161,-163,30,8,-133,12.692928762,12.092080063,-12.24229224,2.2531826205,0.6008486988,-9.989109617
01119,2015,166,156,-122,32,10,-90,12.562909146,11.80610739,-9.232981421,2.4217656185,0.7568017558,-6.811215802
01119,2016,151,147,-281,36,4,-245,11.568221865,11.261778901,-21.52761817,2.7579866697,0.3064429633,-18.7696315
01119,2017,139,157,-265,36,-18,-229,10.851321285,12.256528358,-20.6877708,2.8104141458,-1.405207073,-17.87735665
12119,2010,101,281,982,-5,-180,977,NA,NA,NA,NA,NA,NA
12119,2011,443,1208,4350,4,-765,4354,4.6084627188,12.56664326,45.252399157,0.0416114015,-7.958180541,45.294010559
12119,2012,437,1301,4474,2,-864,4476,4.3771347296,13.031240923,44.813045264,0.0200326532,-8.654106193,44.833077917
12119,2013,456,1371,6071,1,-915,6072,4.3711656442,13.142254601,58.195935583,0.0095858896,-8.771088957,58.205521472
12119,2014,468,1437,6143,22,-969,6165,4.2685930061,13.106769551,56.029843667,0.200660355,-8.838176545,56.230504022
12119,2015,522,1597,5822,29,-1075,5851,4.5481476318,13.914543617,50.72665807,0.2526748684,-9.366395985,50.979332938
12119,2016,481,1847,6235,31,-1366,6266,4.0195377949,15.434690867,52.10357204,0.2590554504,-11.41515307,52.362627491
12119,2017,494,1857,4356,32,-1363,4388,3.9953737777,15.019046772,35.230461894,0.2588096374,-11.02367299,35.489271532
13261,2010,117,124,-133,3,-7,-130,NA,NA,NA,NA,NA,NA
13261,2011,420,334,-725,13,86,-712,12.969367589,10.313735178,-22.38759881,0.4014328063,2.6556324111,-21.98616601
13261,2012,462,353,-611,10,109,-601,14.509366707,11.086161142,-19.1887945,0.3140555564,3.4232055651,-18.87473894
13261,2013,382,303,-330,3,79,-327,12.13565245,9.6259232785,-10.48367882,0.0953061711,2.5097291716,-10.38837265
13261,2014,376,311,-246,8,65,-238,12.024496714,9.9457938247,-7.867090935,0.2558403556,2.0787028894,-7.61125058
13261,2015,374,342,-536,8,32,-528,12.087716747,11.053473603,-17.32357266,0.258560786,1.0342431441,-17.06501188
13261,2016,373,374,-349,8,-1,-341,12.219292067,12.252051563,-11.43306416,0.2620759693,-0.032759496,-11.17098819
13261,2017,372,341,-546,8,31,-538,12.358393409,11.328527291,-18.13893226,0.2657719013,1.0298661174,-17.87316036
45085,2010,365,192,-105,61,173,-44,NA,NA,NA,NA,NA,NA
45085,2011,1515,1055,-863,102,460,-761,14.101090391,9.8195711965,-8.032502315,0.9493803432,4.2815191947,-7.083121972
45085,2012,1569,979,-189,233,590,44,14.581852146,9.0985552907,-1.756513738,2.1654375717,5.4832968555,0.4089238333
45085,2013,1521,1046,-735,139,475,-596,14.103443799,9.6990152625,-6.815273631,1.2888748771,4.404428537,-5.526398754
45085,2014,1507,1025,-708,141,482,-567,13.986987554,9.5133790594,-6.57119256,1.3086697048,4.4736084943,-5.262522855
45085,2015,1496,1155,-958,185,341,-773,13.917703207,10.745285564,-8.912539888,1.7211063458,3.1724176427,-7.191433542
45085,2016,1437,1083,-475,133,354,-342,13.394667301,10.094937151,-4.427604014,1.2397291238,3.2997301492,-3.18787489
45085,2017,1446,1055,-943,114,391,-829,13.505561938,9.8536430459,-8.807569092,1.0647538457,3.6519188919,-7.742815247
28133,2010,90,38,-512,1,52,-511,NA,NA,NA,NA,NA,NA
28133,2011,371,327,-522,-2,44,-524,12.904796689,11.374308672,-18.15715329,-0.069567637,1.530488017,-18.22672093
28133,2012,356,292,-169,-3,64,-172,12.509004023,10.260194311,-5.938263146,-0.105412955,2.248809712,-6.043676101
28133,2013,320,299,-529,3,21,-526,11.365654413,10.619783342,-18.78884745,0.1065530101,0.7458710709,-18.68229444
28133,2014,332,304,-555,7,28,-548,12.00636482,10.993779835,-20.07088095,0.2531462462,1.0125849848,-19.8177347
28133,2015,330,281,-562,8,49,-554,12.154696133,10.349907919,-20.69981584,0.2946593002,1.8047882136,-20.40515654
28133,2016,291,307,-506,8,-16,-498,10.921168678,11.521645306,-18.99007337,0.3002383142,-0.600476628,-18.68983506
28133,2017,284,293,-408,8,-9,-400,10.845904144,11.189612373,-15.58143976,0.3055184266,-0.34370823,-15.27592133
37171,2010,196,183,5,19,13,24,NA,NA,NA,NA,NA,NA
37171,2011,797,874,-206,49,-77,-157,10.8204244,11.865810446,-2.796747084,0.6652456657,-1.045386046,-2.131501419
37171,2012,799,802,-192,8,-3,-184,10.87940742,10.920256258,-2.614325688,0.108930237,-0.040848839,-2.505395451
37171,2013,727,862,-514,19,-135,-495,9.9545404754,11.80304524,-7.038010735,0.2601599299,-1.848504765,-6.777850805
37171,2014,746,830,-88,24,-84,-64,10.27017725,11.426604715,-1.21149544,0.3304078472,-1.156427465,-0.881087592
37171,2015,741,916,-384,34,-175,-350,10.249955044,12.670659677,-5.311717594,0.4703083286,-2.420704633,-4.841409265
37171,2016,754,892,123,38,-138,161,10.466552839,12.382181874,1.7074084871,0.5274920529,-1.915629034,2.23490054
37171,2017,731,875,289,37,-144,326,10.133566225,12.129781733,4.0062936239,0.5129164847,-1.996215508,4.5192101086
51181,2010,15,42,7,0,-27,7,NA,NA,NA,NA,NA,NA
51181,2011,60,69,-114,-1,-9,-115,8.5910652921,9.8797250859,-16.32302405,-0.143184422,-1.288659794,-16.46620848
51181,2012,63,72,-74,-1,-9,-75,9.1556459817,10.463595408,-10.75425084,-0.145327714,-1.307949426,-10.89957855
51181,2013,69,78,-45,1,-9,-44,10.126953842,11.447860864,-6.604535114,0.146767447,-1.320907023,-6.457767667
51181,2014,58,57,-7,0,1,-7,8.5488982239,8.4015034269,-1.031763579,0,0.147394797,-1.031763579
51181,2015,54,77,-89,0,-23,-89,8.0291428147,11.448962902,-13.23321686,0,-3.419820088,-13.23321686
51181,2016,58,69,-90,0,-11,-90,8.7613293051,10.422960725,-13.59516616,0,-1.66163142,-13.59516616
51181,2017,56,59,-25,0,-3,-25,8.5430968726,9.0007627765,-3.813882532,0,-0.457665904,-3.813882532
42115,2010,117,91,5,0,26,5,NA,NA,NA,NA,NA,NA
42115,2011,372,482,10,4,-110,14,8.586464777,11.125473179,0.2308189456,0.0923275782,-2.539008402,0.3231465239
42115,2012,393,446,-250,3,-53,-247,9.1137831476,10.342868407,-5.797571977,0.0695708637,-1.229085259,-5.728001113
42115,2013,361,456,-418,-3,-95,-421,8.4513636896,10.675406766,-9.785789535,-0.070232939,-2.224043076,-9.856022475
42115,2014,377,440,-264,1,-63,-263,8.9132670552,10.402752001,-6.2416512,0.0236426182,-1.489484946,-6.218008582
42115,2015,331,453,-253,5,-122,-248,7.8906277936,10.798955863,-6.03120493,0.1191937733,-2.908328069,-5.912011157
42115,2016,375,474,-432,6,-99,-426,9.0360357104,11.421549138,-10.40951314,0.1445765714,-2.385513428,-10.26493657
42115,2017,357,430,-185,6,-73,-179,8.6837016407,10.45936052,-4.499957433,0.1459445654,-1.775658879,-4.354012867
10005,2010,576,469,581,78,107,659,NA,NA,NA,NA,NA,NA
10005,2011,2247,2094,2054,308,153,2362,11.281224819,10.513077334,10.312254463,1.5463361122,0.7681474843,11.858590575
10005,2012,2243,2060,2304,334,183,2638,11.110588247,10.204106905,11.412748694,1.6544522847,0.9064813416,13.067200979
10005,2013,2203,2231,2917,246,-28,3163,10.752005935,10.888663296,14.236768639,1.2006325284,-0.136657361,15.437401167
10005,2014,2250,2285,3876,258,-35,4134,10.787383077,10.955186814,18.583065247,1.2369532595,-0.167803737,19.820018506
10005,2015,2193,2482,4443,293,-289,4736,10.299062612,11.656303421,20.865816317,1.3760261492,-1.357240809,22.241842466
10005,2016,2377,2489,4699,311,-112,5010,10.921680478,11.43629058,21.590650637,1.4289619809,-0.514610102,23.019612618
10005,2017,2307,2620,5196,311,-313,5507,10.358878798,11.764309689,23.331050818,1.3964505012,-1.40543089,24.727501319
34037,2010,385,287,-200,31,98,-169,NA,NA,NA,NA,NA,NA
34037,2011,1333,1111,-1034,144,222,-890,8.9769145813,7.481884546,-6.963338092,0.9697492121,1.4950300353,-5.99358888
34037,2012,1323,1125,-1448,102,198,-1346,8.963080644,7.6216672143,-9.809932557,0.6910311608,1.3414134297,-9.118901396
34037,2013,1253,1132,-1516,93,121,-1423,8.5583631874,7.7318971494,-10.35473152,0.6352176987,0.8264660381,-9.719513819
34037,2014,1221,1205,-1092,99,16,-993,8.4039108126,8.2937858551,-7.516028343,0.681398174,0.1101249574,-6.834630169
34037,2015,1196,1170,-1663,107,26,-1556,8.3022980567,8.1218133163,-11.54408166,0.7427641238,0.1804847404,-10.80131754
34037,2016,1186,1200,-1107,104,-14,-1003,8.3056129416,8.4036555902,-7.752372282,0.7283168178,-0.098042649,-7.024055464
34037,2017,1183,1239,-655,104,-56,-551,8.3318660422,8.7262739022,-4.613163362,0.73247174,-0.39440786,-3.880691622
51183,2010,31,17,-82,2,14,-80,NA,NA,NA,NA,NA,NA
51183,2011,102,142,105,6,-40,111,8.4657841225,11.785699465,8.7147777732,0.4979873013,-3.319915342,9.2127650745
51183,2012,105,137,-141,5,-32,-136,8.7492708941,11.415715357,-11.74902091,0.4166319473,-2.666444463,-11.33238897
51183,2013,111,152,-119,4,-41,-115,9.375,12.837837838,-10.05067568,0.3378378378,-3.462837838,-9.712837838
51183,2014,91,114,-19,5,-23,-14,7.7492974538,9.707911096,-1.617985183,0.4257855744,-1.958613642,-1.192199608
51183,2015,100,134,-5,5,-34,0,8.5426277123,11.447121134,-0.427131386,0.4271313856,-2.904493422,0
51183,2016,90,143,-215,5,-53,-210,7.7871512005,12.372918019,-18.60263898,0.4326195111,-4.585766818,-18.17001947
51183,2017,88,136,-9,5,-48,-4,7.7196368262,11.930347822,-0.789508312,0.4386157288,-4.210710996,-0.350892583
06101,2010,324,219,-200,105,105,-95,NA,NA,NA,NA,NA,NA
06101,2011,1335,733,-1187,362,602,-825,14.102807885,7.7433394604,-12.53935053,3.8241321755,6.3594684245,-8.715218356
06101,2012,1322,730,-1190,355,592,-835,13.996675525,7.7288752898,-12.59912547,3.7585626409,6.267800235,-8.840562832
06101,2013,1226,738,-393,266,488,-127,12.97052538,7.8077061425,-4.157762214,2.8141596665,5.1628192378,-1.343602548
06101,2014,1294,736,-565,283,558,-282,13.643672404,7.7602340723,-5.957244906,2.9838943512,5.883438332,-2.973350555
06101,2015,1307,801,-295,338,506,43,13.721280583,8.4091398216,-3.09699906,3.5484260421,5.3121407612,0.4514269817
06101,2016,1320,823,-302,339,497,37,13.780000209,8.5916213423,-3.152697017,3.5389545991,5.1883788665,0.3862575816
06101,2017,1275,804,-198,322,471,124,13.232592654,8.3443172501,-2.0549438,3.3418783017,4.888275404,1.2869345013
48435,2010,9,18,-63,0,-9,-63,NA,NA,NA,NA,NA,NA
48435,2011,57,32,-100,0,25,-100,14.161490683,7.950310559,-24.8447205,0,6.2111801242,-24.8447205
48435,2012,44,32,-87,0,12,-87,11.136421159,8.0992153885,-22.01974184,0,3.0372057707,-22.01974184
48435,2013,62,39,37,6,23,43,15.706143129,9.8796706776,9.3730208993,1.519949335,5.8264724509,10.892970234
48435,2014,53,29,-52,6,24,-46,13.350125945,7.3047858942,-13.09823678,1.5113350126,6.0453400504,-11.58690176
48435,2015,44,33,-82,6,11,-76,11.203055379,8.4022915341,-20.87842139,1.5276893698,2.8007638447,-19.35073202
48435,2016,62,26,-73,7,36,-66,15.97732251,6.7001675042,-18.81200876,1.8038912511,9.2771550058,-17.00811751
48435,2017,55,25,-137,8,30,-129,14.412997904,6.5513626834,-35.90146751,2.0964360587,7.8616352201,-33.80503145
12121,2010,122,69,615,16,53,631,NA,NA,NA,NA,NA,NA
12121,2011,483,527,1005,37,-44,1042,11.274641394,12.301730879,23.459657559,0.8636888853,-1.027089485,24.323346444
12121,2012,477,533,198,29,-56,227,10.980536596,12.269656196,4.557958587,0.6675797931,-1.2891196,5.2255383801
12121,2013,473,554,125,11,-81,136,10.860206413,12.719988061,2.8700334072,0.2525629398,-1.859781648,3.122596347
12121,2014,463,546,284,8,-83,292,10.59884626,12.498855416,6.5012361505,0.1831334127,-1.900009157,6.6843695632
12121,2015,439,568,11,16,-129,27,10.038186267,12.987903871,0.2515263074,0.3658564471,-2.949717605,0.6173827544
12121,2016,454,555,242,16,-101,258,10.375601339,12.683829831,5.5306068813,0.3656599591,-2.308228492,5.8962668404
12121,2017,454,551,438,16,-97,454,10.315251349,12.51917069,9.9517182619,0.3635330872,-2.203919341,10.315251349
37173,2010,51,26,3,2,25,5,NA,NA,NA,NA,NA,NA
37173,2011,175,203,23,11,-28,34,12.490632026,14.48913315,1.6416259234,0.7851254416,-1.998501124,2.426751365
37173,2012,210,162,-3,0,48,-3,14.963126581,11.542983362,-0.213758951,0,3.4201432185,-0.213758951
37173,2013,190,200,-65,2,-10,-63,13.553518565,14.266861647,-4.636730035,0.1426686165,-0.713343082,-4.494061419
37173,2014,205,162,215,0,43,215,14.526643991,11.479591837,15.235260771,0,3.0470521542,15.235260771
37173,2015,222,182,48,1,40,49,15.536970291,12.737516184,3.3593449277,0.0699863527,2.7994541064,3.4293312804
37173,2016,182,183,-145,1,-1,-144,12.762525858,12.832649627,-10.16794643,0.0701237685,-0.070123768,-10.09782266
37173,2017,191,207,121,1,-16,122,13.412450406,14.53600646,8.4968926653,0.0702222534,-1.123556055,8.5671149187
30097,2010,15,14,-35,0,1,-35,NA,NA,NA,NA,NA,NA
30097,2011,26,50,-11,0,-24,-11,7.2192142163,13.883104262,-3.054282938,0,-6.663890046,-3.054282938
30097,2012,26,34,5,1,-8,6,7.2554764895,9.4879307939,1.3952839403,0.2790567881,-2.232454304,1.6743407283
30097,2013,38,47,78,3,-9,81,10.501589056,12.988807517,21.555893326,0.8290728202,-2.487218461,22.384966146
30097,2014,26,49,3,3,-23,6,7.1311025782,13.439385628,0.8228195283,0.8228195283,-6.30828305,1.6456390565
30097,2015,31,40,-11,3,-9,-8,8.5446527012,11.025358324,-3.031973539,0.8269018743,-2.480705623,-2.205071665
30097,2016,35,31,3,3,4,6,9.6591693114,8.5552642473,0.8279287981,0.8279287981,1.1039050642,1.6558575962
30097,2017,33,33,60,3,0,63,9.0176253587,9.0176253587,16.39568247,0.8197841235,0,17.215466594
56037,2010,166,76,-345,-6,90,-351,NA,NA,NA,NA,NA,NA
56037,2011,640,251,63,-4,389,59,14.614875203,5.7317713685,1.4386517778,-0.09134297,8.8831038341,1.3473088077
56037,2012,595,272,712,-24,323,688,13.362528774,6.1085845826,15.990118466,-0.538992757,7.2539441918,15.451125709
56037,2013,658,296,-278,17,362,-261,14.591903489,6.5641389557,-6.164968344,0.3769944671,8.0277645337,-5.787973877
56037,2014,630,265,-545,3,365,-542,13.980427402,5.8806559705,-12.09417926,0.0665734638,8.0997714311,-12.0276058
56037,2015,641,261,-649,12,380,-637,14.29001371,5.8185547245,-14.46836022,0.2675197574,8.4714589859,-14.20084046
56037,2016,623,299,-826,14,324,-812,14.003618913,6.7208379694,-18.56659586,0.3146880655,7.2827809434,-18.2519078
56037,2017,607,299,-1038,14,308,-1024,13.830187175,6.8125633694,-23.6503036,0.3189829002,7.0176238052,-23.3313207
27151,2010,25,38,-14,0,-13,-14,NA,NA,NA,NA,NA,NA
27151,2011,121,122,-80,6,-1,-74,12.45112163,12.554023462,-8.232146532,0.6174109899,-0.102901832,-7.614735542
27151,2012,111,102,-59,5,9,-54,11.493062746,10.561192794,-6.108925243,0.5177055291,0.9318699524,-5.591219714
27151,2013,97,99,-91,6,-2,-85,10.111539664,10.320025018,-9.486083603,0.6254560617,-0.208485354,-8.860627541
27151,2014,112,102,-94,11,10,-83,11.772743995,10.721606139,-9.880695853,1.1562516424,1.0511378567,-8.724444211
27151,2015,101,116,-111,11,-15,-100,10.721868365,12.314225053,-11.78343949,1.1677282378,-1.592356688,-10.61571125
27151,2016,110,102,62,11,8,73,11.697772106,10.847025044,6.5932897325,1.1697772106,0.8507470623,7.7630669432
27151,2017,112,96,-64,11,16,-53,11.882658745,10.185136067,-6.790090711,1.167046841,1.6975226778,-5.62304387
48437,2010,25,6,38,1,19,39,NA,NA,NA,NA,NA,NA
48437,2011,112,84,-145,2,28,-143,14.255711831,10.691783873,-18.4560555,0.2545662827,3.5639279577,-18.20148921
48437,2012,119,79,0,4,40,4,15.215445595,10.101010101,0,0.5114435494,5.1144354942,0.5114435494
48437,2013,107,84,-153,4,23,-149,13.754097307,10.797609101,-19.66707372,0.5141718619,2.9564882062,-19.15290186
48437,2014,107,75,-207,5,32,-202,14.015325169,9.8238260528,-27.11375991,0.6549217369,4.1914991159,-26.45883817
48437,2015,92,91,-77,5,1,-72,12.23973924,12.106698596,-10.24412958,0.6652032196,0.1330406439,-9.578926362
48437,2016,102,76,-72,5,26,-67,13.672005898,10.186984787,-9.650827693,0.6701963675,3.4850211112,-8.980631325
48437,2017,95,63,39,5,32,44,12.70478101,8.4252758275,5.2156469408,0.6686726847,4.2795051822,5.8843196255
18155,2010,34,14,9,2,20,11,NA,NA,NA,NA,NA,NA
18155,2011,126,109,-106,2,17,-104,11.827654182,10.23185957,-9.950248756,0.1877405426,1.5957946118,-9.762508214
18155,2012,126,112,-188,0,14,-188,11.970927747,10.640824664,-17.86138426,0,1.330103083,-17.86138426
18155,2013,112,88,100,13,24,113,10.65753164,8.3737748596,9.5156532496,1.2370349224,2.2837567799,10.752688172
18155,2014,135,110,-71,20,25,-51,12.778645464,10.412229637,-6.720620948,1.8931326613,2.3664158266,-4.827488286
18155,2015,130,120,33,20,10,53,12.28385146,11.338939809,3.1182084475,1.8898233015,0.9449116508,5.008031749
18155,2016,125,95,-17,20,30,3,11.758619068,8.9365504915,-1.599172193,1.8813790508,2.8220685763,0.2822068576
18155,2017,117,109,22,20,8,42,10.963782036,10.214121726,2.061565853,1.8741507754,0.7496603102,3.9357166284
13263,2010,11,6,-15,0,5,-15,NA,NA,NA,NA,NA,NA
13263,2011,70,71,-29,-1,-1,-30,10.236911378,10.383152969,-4.241006142,-0.146241591,-0.146241591,-4.387247733
13263,2012,69,78,-206,0,-9,-206,10.270149587,11.609734316,-30.66160601,0,-1.339584729,-30.66160601
13263,2013,47,81,-51,0,-34,-51,7.1520961729,12.325952979,-7.760785209,0,-5.173856806,-7.760785209
13263,2014,62,74,-6,0,-12,-6,9.5106611443,11.351434269,-0.920386562,0,-1.840773125,-0.920386562
13263,2015,50,91,7,0,-41,7,7.7023800354,14.018331664,1.078333205,0,-6.315951629,1.078333205
13263,2016,41,64,-97,0,-23,-97,6.3927652608,9.978950651,-15.12434708,0,-3.58618539,-15.12434708
13263,2017,44,68,-78,0,-24,-78,6.9830185685,10.791937788,-12.37898746,0,-3.808919219,-12.37898746
24041,2010,92,72,74,5,20,79,NA,NA,NA,NA,NA,NA
24041,2011,355,421,111,31,-66,142,9.3632958801,11.104077649,2.9276784301,0.8176399219,-1.740781769,3.7453183521
24041,2012,318,415,121,25,-97,146,8.3750329207,10.929681327,3.1867263629,0.6584145378,-2.554648407,3.8451409007
24041,2013,331,458,9,43,-127,52,8.7218877222,12.068352196,0.2371510257,1.1330549005,-3.346464473,1.3702059261
24041,2014,348,440,-279,43,-92,-236,9.2195199491,11.656864304,-7.391511683,1.1391935569,-2.437344354,-6.252318126
24041,2015,316,457,25,46,-141,71,8.4166788744,12.172222296,0.6658764932,1.2252127475,-3.755543422,1.8910892408
24041,2016,324,476,-196,49,-152,-147,8.6734215845,12.74243418,-5.246884662,1.3117211656,-4.069012595,-3.935163497
24041,2017,319,474,7,49,-155,56,8.5860013189,12.757882837,0.1884075525,1.3188528672,-4.171881519,1.5072604196
13265,2010,3,2,-15,0,1,-15,NA,NA,NA,NA,NA,NA
13265,2011,17,29,15,0,-12,15,9.973599296,17.013787034,8.8002346729,0,-7.040187738,8.8002346729
13265,2012,12,24,-19,0,-12,-19,7.0984915705,14.196983141,-11.23927832,0,-7.098491571,-11.23927832
13265,2013,22,21,11,2,1,13,13.079667063,12.485136742,6.5398335315,1.1890606421,0.594530321,7.7288941736
13265,2014,16,23,11,2,-7,13,9.4562647754,13.593380615,6.5011820331,1.1820330969,-4.137115839,7.68321513
13265,2015,12,26,-39,2,-14,-37,7.1856287425,15.568862275,-23.35329341,1.1976047904,-8.383233533,-22.15568862
13265,2016,14,18,-18,3,-4,-15,8.5600733721,11.005808621,-11.00580862,1.8343014369,-2.445735249,-9.171507184
13265,2017,13,19,5,3,-6,8,7.9901659496,11.677934849,3.0731407498,1.8438844499,-3.6877689,4.9170251998
01121,2010,202,198,-185,-8,4,-193,NA,NA,NA,NA,NA,NA
01121,2011,854,928,-261,26,-74,-235,10.421051989,11.324047127,-3.184888254,0.3172685617,-0.902995137,-2.867619693
01121,2012,895,946,322,16,-51,338,10.923692818,11.54616023,3.930088366,0.195283894,-0.622467412,4.1253722599
01121,2013,875,1012,-465,28,-137,-437,10.698848804,12.373982845,-5.685673936,0.3423631617,-1.675134041,-5.343310774
01121,2014,859,972,44,34,-113,78,10.543629021,11.930625621,0.5400694726,0.4173264106,-1.3869966,0.9573958832
01121,2015,868,919,-373,33,-51,-340,10.683602885,11.311326096,-4.590995249,0.4061738424,-0.627723211,-4.184821407
01121,2016,848,1075,-471,36,-227,-435,10.505906475,13.318218704,-5.835238148,0.4460054636,-2.812312229,-5.389232685
01121,2017,838,1044,-148,36,-206,-112,10.445556587,13.013318708,-1.84479997,0.4487351279,-2.567762121,-1.396064842
28135,2010,44,61,-29,0,-17,-29,NA,NA,NA,NA,NA,NA
28135,2011,173,138,-46,-8,35,-54,11.286902626,9.0034252161,-3.001141739,-0.521937694,2.2834774099,-3.523079432
28135,2012,154,160,-270,-10,-6,-280,10.145930098,10.541226076,-17.788319,-0.65882663,-0.395295978,-18.44714563
28135,2013,144,159,-44,-19,-15,-63,9.6,10.6,-2.933333333,-1.266666667,-1,-4.2
28135,2014,164,152,-268,-8,12,-276,11.058292033,10.249148714,-18.07086747,-0.53942888,0.8091433195,-18.61029635
28135,2015,165,161,-109,-4,4,-113,11.265874642,10.992762529,-7.442305066,-0.273112113,0.2731121125,-7.715417179
28135,2016,154,123,-235,-4,31,-239,10.630220197,8.4903706772,-16.22143991,-0.276109616,2.1398495203,-16.49754953
28135,2017,145,156,-247,-3,-11,-250,10.172583135,10.944296338,-17.3284692,-0.210467237,-0.771713203,-17.53893644
01123,2010,128,162,-112,2,-34,-110,NA,NA,NA,NA,NA,NA
01123,2011,466,506,-44,2,-40,-42,11.246394999,12.211750793,-1.061891373,0.0482677897,-0.965355794,-1.013623584
01123,2012,498,528,-336,9,-30,-327,12.082393187,12.810248199,-8.151976126,0.2183565034,-0.727855011,-7.933619623
01123,2013,445,526,61,3,-81,64,10.845590475,12.819731663,1.4866989191,0.0731163403,-1.974141188,1.5598152594
01123,2014,455,513,-66,-2,-58,-68,11.110161525,12.526401895,-1.61158387,-0.048835875,-1.41624037,-1.660419744
01123,2015,475,478,-262,-2,-3,-264,11.656012662,11.729629584,-6.429211195,-0.049077948,-0.073616922,-6.478289143
01123,2016,468,556,48,-1,-88,47,11.528371371,13.696099321,1.1823970637,-0.024633272,-2.16772795,1.1577637916
01123,2017,452,561,219,-2,-109,217,11.125469202,13.808381023,5.3904375115,-0.04922774,-2.682911821,5.3412097717
19171,2010,57,65,-42,0,-8,-42,NA,NA,NA,NA,NA,NA
19171,2011,212,217,-106,5,-5,-101,12.001811594,12.284873188,-6.000905797,0.2830615942,-0.283061594,-5.717844203
19171,2012,215,191,-138,2,24,-136,12.246874199,10.879781265,-7.86078437,0.1139244112,1.3670929338,-7.746859958
19171,2013,199,205,-63,-1,-6,-64,11.394217005,11.737761237,-3.607214429,-0.057257372,-0.343544231,-3.664471801
19171,2014,253,221,-155,2,32,-153,14.566600455,12.724184587,-8.92420186,0.1151509917,1.8424158678,-8.809050868
19171,2015,232,218,-120,3,14,-117,13.44459898,12.633286973,-6.954102921,0.173852573,0.8113120074,-6.780250348
19171,2016,211,195,-44,3,16,-41,12.273507256,11.342814763,-2.559404357,0.1745048425,0.9306924934,-2.384899514
19171,2017,218,180,-163,4,38,-159,12.734760639,10.514939977,-9.521862313,0.2336653328,2.2198206619,-9.28819698
29213,2010,146,112,162,24,34,186,NA,NA,NA,NA,NA,NA
29213,2011,610,485,534,54,125,588,11.67184884,9.2800765367,10.21765128,1.033245635,2.3917723033,11.250896915
29213,2012,617,490,106,41,127,147,11.695573879,9.2882191261,2.0092882191,0.7771775187,2.4073547531,2.7864657378
29213,2013,622,558,271,38,64,309,11.719706819,10.513820587,5.1061745143,0.7159949504,1.2058862322,5.8221694647
29213,2014,629,530,464,47,99,511,11.742413635,9.8942436037,8.6621302493,0.8774140554,1.8481700316,9.5395443047
29213,2015,660,574,295,52,86,347,12.202336932,10.612335453,5.454074841,0.9613962432,1.5900014791,6.4154710842
29213,2016,646,587,331,60,59,391,11.847776249,10.765703806,6.070609812,1.1004126547,1.0820724438,7.1710224668
29213,2017,649,538,435,61,111,496,11.788854174,9.7725786529,7.9016202863,1.1080433045,2.0162755213,9.0096635908
22105,2010,394,200,166,17,194,183,NA,NA,NA,NA,NA,NA
22105,2011,1850,1073,310,65,777,375,15.156852946,8.7909747085,2.5397969801,0.5325380765,6.3658782372,3.0723350566
22105,2012,1895,1141,190,83,754,273,15.389862994,9.2664029951,1.5430469492,0.6740678778,6.1234599985,2.2171148271
22105,2013,1927,1170,954,89,757,1043,15.472940421,9.3945720251,7.6601894974,0.7146298378,6.0783683957,8.3748193352
22105,2014,1956,1192,658,90,764,748,15.499391831,9.4454371486,5.2140080904,0.7131622008,6.0539546825,5.9271702912
22105,2015,1924,1203,952,103,721,1055,15.049532831,9.4098690206,7.4465463903,0.8056662586,5.6396638103,8.252212649
22105,2016,1995,1240,1020,112,755,1132,15.38414084,9.5620725021,7.8655757679,0.8636710647,5.822068338,8.7292468326
22105,2017,1959,1300,1100,113,659,1213,14.890544238,9.8814229249,8.3612040134,0.858923685,5.0091213135,9.2201276984
35055,2010,76,79,-38,2,-3,-36,NA,NA,NA,NA,NA,NA
35055,2011,337,252,-123,12,85,-111,10.248612484,7.6636508781,-3.7405915,0.3649357561,2.5849616057,-3.375655744
35055,2012,326,280,-209,12,46,-197,9.9409944044,8.5382774025,-6.373214204,0.3659261744,1.4027170018,-6.00728803
35055,2013,298,281,80,26,17,106,9.0911864303,8.5725617011,2.4405869612,0.7931907624,0.5186247292,3.2337777235
35055,2014,312,265,-52,25,47,-27,9.4985843456,8.0677078576,-1.583097391,0.7611045149,1.430876488,-0.821992876
35055,2015,305,289,-201,32,16,-169,9.3055894557,8.8174273859,-6.132536002,0.9763241396,0.4881620698,-5.156211862
35055,2016,275,313,165,34,-38,199,8.3899016093,9.5492334681,5.0339409656,1.0372969262,-1.159331859,6.0712378918
35055,2017,280,300,-72,34,-20,-38,8.5298239201,9.1390970572,-2.193383294,1.0357643332,-0.609273137,-1.157618961
48439,2010,6693,2607,1807,933,4086,2740,NA,NA,NA,NA,NA,NA
48439,2011,27472,11134,9231,4918,16338,14149,14.99034729,6.07536862,5.0369793184,2.6835515424,8.9149786702,7.7205308608
48439,2012,27707,11087,12719,5109,16620,17828,14.855209028,5.9443354563,6.8193382041,2.7392089696,8.9108735712,9.5585471737
48439,2013,27476,11727,9532,5479,15749,15011,14.478075801,6.1793709024,5.0227477993,2.8870788074,8.2987048983,7.9098266067
48439,2014,28168,11858,9513,6524,16310,16037,14.600450796,6.1464124373,4.9309176519,3.3816153433,8.4540383583,8.3125329952
48439,2015,28572,12366,14650,7403,16206,22053,14.544084785,6.2946994416,7.4573303266,3.7683697207,8.2493853429,11.225700047
48439,2016,28764,12867,14571,7617,15897,22188,14.362653506,6.4248457328,7.2756996326,3.8033768514,7.9378077729,11.079076484
48439,2017,28961,13274,9512,7562,15687,17074,14.209730042,6.5128951546,4.6670678553,3.7102993189,7.696834887,8.3773671742
28137,2010,76,40,74,1,36,75,NA,NA,NA,NA,NA,NA
28137,2011,369,288,-346,5,81,-341,12.781212657,9.97558061,-11.98455171,0.1731871634,2.8056320466,-11.81136454
28137,2012,341,242,-316,-1,99,-317,11.907048204,8.4501632418,-11.03409746,-0.03491803,3.4568849626000002,-11.06901549
28137,2013,310,294,-194,2,16,-192,10.898799374,10.336280697,-6.820538963,0.0703148347,0.56251867739999994,-6.750224129
28137,2014,326,268,-169,3,58,-166,11.519231109,9.4697973534,-5.971625943,0.1060051943,2.0494337556,-5.865620749
28137,2015,326,308,113,4,18,117,11.514348786,10.878587196,3.9911699779,0.1412803532,0.6357615894,4.1324503311
28137,2016,337,277,-197,4,60,-193,11.902869757,9.7836644592,-6.958057395,0.1412803532,2.119205298,-6.816777042
28137,2017,329,298,160,4,31,164,11.607599626,10.513874433,5.6450332528,0.1411258313,1.0937251927,5.7861590841
13267,2010,80,68,-52,5,12,-47,NA,NA,NA,NA,NA,NA
13267,2011,340,230,-163,17,110,-146,13.351921302,9.0321820574,-6.401068154,0.6675960651,4.3197392448,-5.733472089
13267,2012,350,231,-104,16,119,-88,13.745434552,9.0719868044,-4.084357695,0.6283627224,4.6734477477,-3.455994973
13267,2013,315,204,60,8,111,68,12.319846686,7.9785673778,2.3466374641,0.3128849952,4.3412793085,2.6595224593
13267,2014,253,221,-353,7,32,-346,9.9194291427,8.6647977887,-13.84015212,0.2744506087,1.254631354,-13.56570152
13267,2015,254,266,34,10,-12,44,10.012811668,10.485857889,1.3402976249,0.3942051838,-0.473046221,1.7345028087
13267,2016,263,225,-150,10,38,-140,10.382125375,8.8820464235,-5.921364282,0.3947576188,1.5000789515,-5.526606664
13267,2017,280,239,3,11,41,14,11.06391386,9.4438407587,0.1185419342,0.4346537588,1.6200731009,0.553195693
12123,2010,58,37,-2,4,21,2,NA,NA,NA,NA,NA,NA
12123,2011,255,219,16,14,36,30,11.273458741,9.6819116249,0.707354274,0.6189349897,1.5915471164,1.3262892637
12123,2012,255,230,56,14,25,70,11.232985331,10.131712259,2.4668516805,0.6167129201,1.1012730717,3.0835646007
12123,2013,224,240,119,13,-16,132,9.8213307026,10.522854324,5.2175819358,0.5699879426,-0.701523622,5.7875698783
12123,2014,240,224,-333,19,16,-314,10.563380282,9.8591549296,-14.65669014,0.8362676056,0.7042253521,-13.82042254
12123,2015,223,286,-173,19,-63,-154,9.9258896579000009,12.730064763,-7.70035386,0.8457036031,-2.804175105,-6.854650257
12123,2016,244,238,-266,20,6,-246,10.972209731,10.702401295,-11.96150733,0.8993614534,0.269808436,-11.06214588
12123,2017,239,247,-299,20,-8,-279,10.875747992,11.239789766,-13.6060613,0.9101044345,-0.364041774,-12.69595686
13269,2010,22,48,-117,0,-26,-117,NA,NA,NA,NA,NA,NA
13269,2011,82,101,-330,-2,-19,-332,9.529343405,11.737361999,-38.34979663,-0.23242301,-2.208018594,-38.58221964
13269,2012,94,82,-89,-1,12,-90,11.195140832,9.7659739177,-10.59965462,-0.119097243,1.4291669148,-10.71875186
13269,2013,88,95,25,1,-7,26,10.516880789,11.353450852,2.9877502241,0.119510009,-0.836570063,3.107260233
13269,2014,94,104,6,1,-10,7,11.223210555,12.417169124,0.7163751418,0.119395857,-1.19395857,0.8357709987
13269,2015,88,100,-123,1,-12,-122,10.592200289,12.036591237,-14.80500722,0.1203659124,-1.444390948,-14.68464131
13269,2016,78,87,-35,1,-9,-34,9.4884739371,10.583297853,-4.257648562,0.1216471018,-1.094823916,-4.13600146
13269,2017,78,81,-55,1,-3,-54,9.5465393795,9.913713971,-6.731534178,0.1223915305,-0.367174592,-6.609142647
19173,2010,23,12,-8,0,11,-8,NA,NA,NA,NA,NA,NA
19173,2011,71,88,-4,5,-17,1,11.250198067,13.943907463,-0.633813976,0.7922674695,-2.693709396,0.1584534939
19173,2012,68,57,-54,3,11,-51,10.823716673,9.0728213291,-8.595304417,0.4775169121,1.7508953442,-8.117787505
19173,2013,85,96,-32,7,-11,-25,13.613068546,15.374759769,-5.124919923,1.1210762332,-1.761691224,-4.00384369
19173,2014,74,83,-68,13,-9,-55,11.94511703,13.397901533,-10.97659403,2.0984665052,-1.452784504,-8.878127522
19173,2015,86,75,76,13,11,89,13.84083045,12.070491671,12.23143156,2.0922185564,1.7703387785,14.323650117
19173,2016,74,67,-47,14,7,-33,11.84,10.72,-7.52,2.24,1.12,-5.28
19173,2017,74,60,-86,14,14,-72,11.92106323,9.6657269432,-13.85420862,2.2553362867,2.2553362867,-11.59887233
21217,2010,76,90,148,9,-14,157,NA,NA,NA,NA,NA,NA
21217,2011,311,280,247,37,31,284,12.523658036,11.275319132,9.9464422341,1.4899528853,1.2483389039,11.436395119
21217,2012,315,260,7,25,55,32,12.582635962,10.385667778,0.2796141325,0.9986219018,2.1969681839,1.2782360343
21217,2013,340,305,0,41,35,41,13.539074166,12.145345943,0,1.6326530612,1.393728223,1.6326530612
21217,2014,364,277,83,55,87,138,14.40984937,10.96573702,3.2857623562,2.1773124047,3.4441123493,5.463074761
21217,2015,305,277,146,58,28,204,11.967119848,10.868499009,5.7285229435,2.275714594,1.0986208385,8.0042375375
21217,2016,328,330,-224,61,-2,-163,12.853168228,12.931541205,-8.777773424,2.3903757984,-0.078372977,-6.387397625
21217,2017,327,318,-35,61,9,26,12.846451512,12.492879452,-1.375002455,2.3964328508,0.35357206,1.0214303954
48441,2010,484,326,90,81,158,171,NA,NA,NA,NA,NA,NA
48441,2011,2021,1135,-46,200,886,154,15.270520943,8.5759729196,-0.347572471,1.5111846554,6.6945480236,1.1636121847
48441,2012,2047,1271,-12,489,776,477,15.336032935,9.5222754567,-0.089903466,3.6635662457,5.8137574779,3.5736627796
48441,2013,2066,1312,-1305,331,754,-974,15.418600833,9.7914832007,-9.739242056,2.4702598624,5.6271176321,-7.268982193
48441,2014,2062,1224,-236,317,838,81,15.348714303,9.1109729909,-1.756690871,2.359622907,6.2377413124,0.6029320362
48441,2015,2105,1328,-30,392,777,362,15.551754836,9.81127336,-0.221640211,2.8960987629,5.7404814764,2.6744585514
48441,2016,2083,1357,-1006,328,726,-678,15.323105669,9.9824553015,-7.40040533,2.4128558135,5.3406503676,-4.987549517
48441,2017,2057,1371,-608,257,686,-351,15.111000103,10.071551357,-4.466450201,1.887956746,5.039448746,-2.578493455
54091,2010,49,69,19,0,-20,19,NA,NA,NA,NA,NA,NA
54091,2011,173,203,72,0,-30,72,10.232448098,12.006861063,4.2585911161,0,-1.774412965,4.2585911161
54091,2012,181,197,58,-1,-16,57,10.679726221,11.623790418,3.4222327118,-0.059004012,-0.944064196,3.3632286996
54091,2013,184,186,19,3,-2,22,10.837873656,10.955676631,1.119128258,0.1767044618,-0.117802975,1.2958327198
54091,2014,177,180,114,2,-3,116,10.385800205,10.561830717,6.6891594543,0.1173536746,-0.176030512,6.8065131289
54091,2015,163,205,-134,2,-42,-132,9.5823168043,12.05138003,-7.877487434,0.1175744393,-2.469063226,-7.759912995
54091,2016,187,194,28,3,-7,31,11.042220254,11.455565397,1.6533805728,0.1771479185,-0.413345143,1.8305284913
54091,2017,179,193,-5,3,-14,-2,10.567641763,11.39416123,-0.295185524,0.1771113145,-0.826519467,-0.11807421
55119,2010,65,67,-31,2,-2,-29,NA,NA,NA,NA,NA,NA
55119,2011,235,190,-52,2,45,-50,11.376564278,9.1980732457,-2.517367415,0.0968218236,2.1784910319,-2.420545591
55119,2012,218,153,-372,6,65,-366,10.628702372,7.4595938666,-18.13705175,0.2925330928,3.1691085054,-17.84451866
55119,2013,211,182,25,1,29,26,10.346433913,8.9244121902,1.2258807954,0.0490352318,1.4220217226,1.2749160272
55119,2014,226,171,-74,5,55,-69,11.071104906,8.3768094643,-3.625052049,0.2449359492,2.6942954417,-3.3801161
55119,2015,232,183,-167,6,49,-161,11.399371069,8.991745283,-8.205581761,0.2948113208,2.4076257862,-7.91077044
55119,2016,240,187,-78,5,53,-73,11.830819284,9.2181800256,-3.845016267,0.2464754018,2.6126392586,-3.598540866
55119,2017,235,184,-10,5,51,-5,11.57749532,9.0649325057,-0.492659375,0.2463296877,2.5125628141,-0.246329688
17179,2010,401,298,3,3,103,6,NA,NA,NA,NA,NA,NA
17179,2011,1657,1389,84,15,268,99,12.214404446,10.238870112,0.6191973286,0.1105709515,1.9755343341,0.7297682801
17179,2012,1601,1365,49,14,236,63,11.774526279,10.038868439,0.3603696363,0.1029627532,1.7356578401,0.4633323895
17179,2013,1628,1379,-130,34,249,-96,11.954677965,10.126229063,-0.954611877,0.2496677216,1.8284489026,-0.704944155
17179,2014,1626,1370,-1224,44,256,-1180,11.973887205,10.088699552,-9.013553468,0.3240166279,1.8851876535,-8.68953684
17179,2015,1549,1448,-1100,50,101,-1050,11.485389309,10.73650337,-8.156183499,0.3707356136,0.7488859395,-7.785447886
17179,2016,1529,1472,-526,46,57,-480,11.395140856,10.970338351,-3.920107319,0.3428230735,0.4248025041,-3.577284245
17179,2017,1490,1419,-556,46,71,-510,11.140478442,10.609623429,-4.15711813,0.3439342338,0.530855013,-3.813183896
51185,2010,118,162,95,2,-44,97,NA,NA,NA,NA,NA,NA
51185,2011,445,683,-157,7,-238,-150,9.9033036976,15.19990208,-3.493974563,0.1557823054,-5.296598382,-3.338192258
51185,2012,425,635,-247,-2,-210,-249,9.5489524237,14.267258327,-5.549626467,-0.044936247,-4.718305903,-5.594562714
51185,2013,453,638,-56,-3,-185,-59,10.260243256,14.450408824,-1.268374442,-0.067948631,-4.190165568,-1.336323073
51185,2014,436,584,-500,-2,-148,-502,9.9763176862,13.362774149,-11.44073129,-0.045762925,-3.386456462,-11.48649422
51185,2015,474,582,-375,-2,-108,-377,10.987482615,13.490959666,-8.692628651,-0.046360686,-2.503477051,-8.738989337
51185,2016,412,607,-656,-1,-195,-657,9.7005085704,14.291768695,-15.44546996,-0.023544924,-4.591260124,-15.46901488
51185,2017,402,628,-728,-1,-226,-729,9.6703190965,15.106866648,-17.51241866,-0.02405552,-5.436547552,-17.53647418
06103,2010,179,163,93,16,16,109,NA,NA,NA,NA,NA,NA
06103,2011,734,617,-369,38,117,-331,11.567252384,9.72342605,-5.815144591,0.5988495784,1.8438263336,-5.216295012
06103,2012,723,606,-215,-1,117,-216,11.422883686,9.5743672386,-3.396846463,-0.015799286,1.8485164471,-3.412645748
06103,2013,726,690,-353,-5,36,-358,11.509468361,10.938750921,-5.596201558,-0.079266311,0.5707174394,-5.675467869
06103,2014,808,676,-220,-5,132,-225,12.852325507,10.752688172,-3.499395559,-0.079531717,2.0996373354,-3.578927276
06103,2015,816,677,178,0,139,178,12.957728586,10.750468447,2.8265633436,0,2.2072601391,2.8265633436
06103,2016,821,628,125,1,193,126,12.972853396,9.9232057643,1.975160383,0.0158012831,3.0496476314,1.9909616661
06103,2017,813,613,285,0,200,285,12.765957447,9.6255005103,4.4751511345,0,3.1404569365,4.4751511345
13271,2010,35,16,5,7,19,12,NA,NA,NA,NA,NA,NA
13271,2011,156,144,-301,21,12,-280,9.5133552872,8.7815587267,-18.35589706,1.280643981,0.7317965606,-17.07525308
13271,2012,117,154,118,46,-37,164,7.1638501102,9.4293411707,7.2250795983,2.8165564536,-2.26549106,10.041636052
13271,2013,130,147,237,40,-17,277,7.863537382,8.8918461166,14.335833535,2.4195499637,-1.028308735,16.755383499
13271,2014,132,154,-174,41,-22,-133,7.95731983,9.2835398017,-10.48919432,2.4715917654,-1.326219972,-8.017602556
13271,2015,133,152,-52,52,-19,0,8.0596291359,9.2110047267,-3.151133196,3.151133196,-1.151375591,0
13271,2016,131,128,-519,55,3,-464,8.0548467427,7.8703846036,-31.91195007,3.3818058843,0.1844621391,-28.53014419
13271,2017,127,164,-62,55,-37,-7,7.9317990195,10.242638104,-3.872216844,3.4350310714,-2.310839084,-0.437185773
08119,2010,49,25,84,-3,24,81,NA,NA,NA,NA,NA,NA
08119,2011,222,132,-186,-10,90,-196,9.4815067908,5.6376526864,-7.943965149,-0.4270949,3.8438541044,-8.37106005
08119,2012,153,143,77,-8,10,69,6.538182129,6.1108499637,3.2904576727,-0.341865732,0.4273321653,2.9485919405
08119,2013,166,125,-113,-13,41,-126,7.0955332336,5.3430220133,-4.8300919,-0.555674289,1.7525112203,-5.385766189
08119,2014,192,173,77,-12,19,65,8.2082852379,7.3960070112,3.2918643923,-0.513017827,0.8122782267,2.7788465649
08119,2015,192,180,-53,-12,12,-65,8.2037258588,7.6909929927,-2.264570159,-0.512732866,0.5127328662,-2.777303025
08119,2016,188,169,655,-12,19,643,7.9296454858,7.1282451441,27.627222304,-0.506147584,0.8014003416,27.12107472
08119,2017,200,170,582,-12,30,570,8.2159142259,6.983527092,23.908310397,-0.492954854,1.2323871339,23.415355544
22107,2010,12,7,-27,0,5,-27,NA,NA,NA,NA,NA,NA
22107,2011,70,58,-154,0,12,-154,13.561949046,11.237043495,-29.8362879,0,2.3249055507,-29.8362879
22107,2012,72,49,-119,0,23,-119,14.27014171,9.7116242196000009,-23.5853731,0,4.5585174908,-23.5853731
22107,2013,54,59,-60,0,-5,-60,10.872848082,11.879593275,-12.08094231,0,-1.006745193,-12.08094231
22107,2014,68,61,-88,0,7,-88,13.894564773,12.464241929,-17.98120147,0,1.4303228443,-17.98120147
22107,2015,56,49,-89,0,7,-89,11.632737848,10.178645617,-18.48774408,0,1.454092231,-18.48774408
22107,2016,60,40,-116,0,20,-116,12.697069093,8.4647127288,-24.54766691,0,4.2323563644,-24.54766691
22107,2017,58,50,-70,0,8,-70,12.483857081,10.76194576,-15.06672406,0,1.7219113216,-15.06672406
22109,2010,393,235,-213,14,158,-199,NA,NA,NA,NA,NA,NA
22109,2011,1673,963,-693,58,710,-635,14.997288297,8.6326291869,-6.212265863,0.5199298991,6.3646591098,-5.692335964
22109,2012,1667,960,-678,96,707,-582,14.929717482,8.5977977099,-6.072194633,0.859779771,6.3319197718,-5.212414862
22109,2013,1571,1046,337,112,525,449,14.00153295,9.3224719702,3.0035115239,0.9981996756,4.6790609793,4.0017111994
22109,2014,1709,1032,58,115,677,173,15.110788873,9.1248297936,0.5128295814,1.0168172735,5.9859590797,1.5296468549
22109,2015,1757,1090,-381,135,667,-246,15.450228632,9.5849454801,-3.350334154,1.1871262751,5.8652831516,-2.1632078789999998
22109,2016,1718,1032,-1641,148,686,-1493,15.133163915,9.0904686612,-14.4549022,1.3036718623,6.0426952535,-13.15123034
22109,2017,1662,1090,-1763,151,572,-1612,14.759623283,9.6798973398,-15.6565679,1.340976604,5.0797259435,-14.3155913
13273,2010,29,7,-3,0,22,-3,NA,NA,NA,NA,NA,NA
13273,2011,128,102,-165,1,26,-164,13.5335166,10.78452104,-17.44554874,0.1057305984,2.7489955593,-17.33981814
13273,2012,137,99,-208,1,38,-207,14.716940595,10.634869481,-22.3439682,0.1074229241,4.082071114,-22.23654528
13273,2013,141,107,-93,0,34,-93,15.329419439,11.632963688,-10.11089367,0,3.6964557513,-10.11089367
13273,2014,121,104,-103,0,17,-103,13.25809456,11.39538706,-11.28581603,0,1.8627075001,-11.28581603
13273,2015,104,105,-64,0,-1,-64,11.490443045,11.600928074,-7.071041874,0,-0.110485029,-7.071041874
13273,2016,110,94,-146,0,16,-146,12.286384452,10.499273986,-16.307383,0,1.7871104658,-16.307383
13273,2017,102,97,-165,0,5,-165,11.57972413,11.012090594,-18.73190668,0,0.5676335358,-18.73190668
48443,2010,6,0,18,1,6,19,NA,NA,NA,NA,NA,NA
48443,2011,14,17,-59,1,-3,-58,14.278429373,17.33809281,-60.17338093,1.0198878123,-3.059663437,-59.15349312
48443,2012,13,9,-36,2,4,-34,13.896312133,9.6205237841,-38.48209514,2.1378941742,4.2757883485,-36.34420096
48443,2013,8,15,-26,2,-7,-24,8.8300220751,16.556291391,-28.69757174,2.2075055188,-7.726269316,-26.49006623
48443,2014,11,7,11,2,4,13,12.235817575,7.786429366,12.235817575,2.2246941046,4.4493882091,14.46051168
48443,2015,13,16,-43,2,-3,-41,14.680971203,18.068887634,-48.56013552,2.2586109543,-3.387916431,-46.30152456
48443,2016,9,11,-47,2,-2,-45,10.701545779,13.079667063,-55.88585018,2.3781212842,-2.378121284,-53.50772889
48443,2017,8,10,-8,2,-2,-6,9.828009828,12.285012285,-9.828009828,2.457002457,-2.457002457,-7.371007371
48445,2010,44,14,-4,4,30,0,NA,NA,NA,NA,NA,NA
48445,2011,191,143,-98,14,48,-84,15.083909181,11.293188549,-7.739387957,1.1056268509,3.7907206318,-6.633761106
48445,2012,200,135,-114,11,65,-103,15.838447832,10.690952287,-9.027915264,0.8711146308,5.1474955454,-8.156800634
48445,2013,179,109,-3,20,70,17,14.147401699,8.6148982415,-0.237107291,1.5807152737,5.5325034578,1.3436079826
48445,2014,221,125,-26,19,96,-7,17.348981434,9.8127723044,-2.041056639,1.4915413903,7.5362091298,-0.549515249
48445,2015,195,129,-115,21,66,-94,15.271958335,10.102987822,-9.006539531,1.6446724361,5.1689705134,-7.361867095
48445,2016,193,109,-37,25,84,-12,15.089324108,8.5219498847,-2.892771979,1.9545756616,6.5673742231,-0.938196318
48445,2017,188,121,-204,25,67,-179,14.721428292,9.4749618261,-15.97431581,1.9576367409,5.2464664657,-14.01667907
16081,2010,48,18,-47,1,30,-46,NA,NA,NA,NA,NA,NA
16081,2011,159,35,-123,9,124,-114,15.653458036,3.4457297563,-12.10927886,0.8860447945,12.20772828,-11.22323406
16081,2012,151,33,-202,6,118,-196,14.912107446,3.2589373889,-19.94864705,0.5925340707,11.653170057,-19.35611298
16081,2013,159,44,128,15,115,143,15.559252373,4.3057050592,12.525687445,1.4678539975,11.253547314,13.993541442
16081,2014,149,31,-86,12,118,-74,14.366984862,2.989104233,-8.292353679,1.1570726063,11.377880629,-7.135281072
16081,2015,149,47,156,17,102,173,14.148032094,4.46280207,14.812704743,1.614205004,9.6852300242,16.426909747
16081,2016,150,28,274,19,122,293,13.788665717,2.5738842671,25.187296043,1.7465643241,11.21478145,26.933860367
16081,2017,164,41,151,19,123,170,14.599189923,3.6497974807,13.441937063,1.6913695642,10.949392442,15.133306627
30099,2010,16,24,8,2,-8,10,NA,NA,NA,NA,NA,NA
30099,2011,72,65,-27,5,7,-22,11.872372001,10.718113612,-4.4521395,0.8244702778,1.154258389,-3.627669223
30099,2012,75,61,-18,1,14,-17,12.383389747,10.071823661,-2.972013539,0.1651118633,2.311566086,-2.806901676
30099,2013,78,73,-27,4,5,-23,12.900024808,12.073100141,-4.465393203,0.6615397337,0.8269246672,-3.803853469
30099,2014,80,59,-45,4,21,-41,13.272501037,9.7884695147,-7.465781833,0.6636250518,3.4840315222,-6.802156781
30099,2015,78,67,19,4,11,23,12.926748426,11.103745442,3.1488233344,0.6629101757,1.8230029831,3.8117335101
30099,2016,85,58,-70,5,27,-65,14.09384845,9.6169789421,-11.60669872,0.8290499088,4.4768695075,-10.77764881
30099,2017,75,61,56,5,14,61,12.399768538,10.085145077,9.2584938414,0.8266512358,2.3146234604,10.085145077
56039,2010,76,10,-71,2,66,-69,NA,NA,NA,NA,NA,NA
56039,2011,260,87,-42,50,173,8,12.157770452,4.0681770358,-1.963947535,2.3380327792,8.0895934161,0.3740852447
56039,2012,230,61,29,35,169,64,10.651846706,2.8250549959,1.3430589325,1.6209331944,7.8267917101,2.9639921269
56039,2013,261,97,404,36,164,440,11.854206881,4.4055864653,18.349040536,1.6350630181,7.4486204156,19.984103554
56039,2014,243,79,313,3,164,316,10.765788716,3.4999889241,13.867044725,0.1329109718,7.2657997918,13.999955696
56039,2015,262,94,36,11,168,47,11.429568556,4.1006849016,1.5704750687,0.4798673821,7.328883654,2.0503424508
56039,2016,253,80,-32,10,173,-22,10.950247787,3.4625289446,-1.385011578,0.4328161181,7.4877188426,-0.95219546
56039,2017,262,82,-104,9,180,-95,11.282161697,3.5310582409,-4.47841533,0.3875551728,7.7511034557,-4.090860157
29215,2010,71,91,44,1,-20,45,NA,NA,NA,NA,NA,NA
29215,2011,295,282,-137,3,13,-134,11.357948639,10.857428868,-5.274708351,0.1155045624,0.5005197705,-5.159203789
29215,2012,283,276,-145,2,7,-143,10.949893596,10.679048172,-5.610369511,0.077384407,0.2708454246,-5.532985104
29215,2013,301,293,-105,-6,8,-111,11.701362567,11.390362898,-4.081870663,-0.233249752,0.3109996696,-4.315120415
29215,2014,295,301,-8,0,-6,-8,11.496044581,11.729862437,-0.311757141,0,-0.233817856,-0.311757141
29215,2015,290,317,41,0,-27,41,11.302958257,12.355302646,1.5980044432,0,-1.052344389,1.5980044432
29215,2016,305,282,168,0,23,168,11.841441162,10.948480025,6.5224987382,0,0.8929611368,6.5224987382
29215,2017,292,272,-136,0,20,-136,11.320681567,10.545292419,-5.272646209,0,0.7753891484,-5.272646209
40139,2010,73,19,85,33,54,118,NA,NA,NA,NA,NA,NA
40139,2011,286,105,75,110,181,185,13.616778156,4.9991668055,3.5708334325,5.2372223677,8.6176113505,8.8080558002
40139,2012,345,143,36,73,202,109,16.164929132,6.7002459881,1.6867752138,3.4204052946,9.464683144,5.1071805084
40139,2013,371,136,157,65,235,222,17.074742268,6.2592047128,7.2256995582,2.9915316642,10.815537555,10.217231222
40139,2014,400,166,-608,79,234,-529,18.333486112,7.6083967366,-27.86689889,3.6208635072,10.725089376,-24.24603538
40139,2015,388,199,-587,90,189,-497,18.023039762,9.2437755481,-27.26681531,4.1806020067,8.779264214,-23.0862133
40139,2016,361,140,-562,91,221,-471,16.984239003,6.5866854858,-26.44083745,4.2813455657,10.397553517,-22.15949188
40139,2017,346,134,-538,91,212,-447,16.464038448,6.3762461041,-25.60015227,4.3301372796,10.087792344,-21.27001499
31169,2010,12,7,2,0,5,2,NA,NA,NA,NA,NA,NA
31169,2011,52,76,-42,1,-24,-41,9.9980772928,14.612574505,-8.075370121,0.1922707172,-4.614497212,-7.883099404
31169,2012,50,72,-2,0,-22,-2,9.6974398759,13.964313421,-0.387897595,0,-4.266873545,-0.387897595
31169,2013,60,92,66,1,-32,67,11.624527754,17.824275889,12.786980529,0.1937421292,-6.199748135,12.980722658
31169,2014,68,81,46,0,-13,46,13.086989992,15.58891455,8.8529638183,0,-2.501924557,8.8529638183
31169,2015,52,77,-59,0,-25,-59,10.055109736,14.889297109,-11.4086822,0,-4.834187373,-11.4086822
31169,2016,60,65,-25,0,-5,-25,11.731352038,12.708964708,-4.888063349,0,-0.97761267,-4.888063349
31169,2017,50,79,-25,0,-29,-25,9.858044164,15.575709779,-4.929022082,0,-5.717665615,-4.929022082
13275,2010,158,142,13,6,16,19,NA,NA,NA,NA,NA,NA
13275,2011,555,500,-224,21,55,-203,12.422916364,11.191816544,-5.013933812,0.4700562948,1.2310998198,-4.543877517
13275,2012,593,495,-151,12,98,-139,13.301481556,11.103260321,-3.387055169,0.2691699472,2.1982212353,-3.117885221
13275,2013,597,498,148,12,99,160,13.359141614,11.143806572,3.3118140014,0.2685254596,2.2153350415,3.5803394609
13275,2014,611,484,-52,24,127,-28,13.6192408,10.788400241,-1.159084323,0.5349619954,2.830840559,-0.624122328
13275,2015,568,487,-58,25,81,-33,12.642028066,10.839203641,-1.290911317,0.5564272916,1.8028244249,-0.734484025
13275,2016,559,505,60,27,54,87,12.416703687,11.217236784,1.332741004,0.5997334518,1.1994669036,1.9324744558
13275,2017,567,512,-395,28,55,-367,12.618366734,11.394362906,-8.790572945,0.6231292214,1.2240038278,-8.167443724
20193,2010,24,30,30,2,-6,32,NA,NA,NA,NA,NA,NA
20193,2011,105,74,-29,7,31,-22,13.233348037,9.326359569,-3.654924696,0.8822232025,3.9069884681,-2.772701493
20193,2012,113,71,-52,3,42,-49,14.240705734,8.947700063,-6.553245117,0.3780718336,5.2930056711,-6.175173283
20193,2013,96,72,-21,0,24,-21,12.102874433,9.0771558245,-2.647503782,0,3.0257186082,-2.647503782
20193,2014,131,81,-160,1,50,-159,16.623310704,10.278535626,-20.30328025,0.1268955016,6.3447750777,-20.17638475
20193,2015,127,78,-2,1,49,-1,16.175253136,9.9344074381,-0.254728396,0.1273641979,6.2408456983,-0.127364198
20193,2016,98,71,-93,1,27,-92,12.495218666,9.0526584215,-11.85770751,0.1275022313,3.4425602448,-11.73020528
20193,2017,108,60,-71,1,48,-70,13.847041477,7.6928008206,-9.103147638,0.128213347,6.1542406565,-8.974934291
31171,2010,3,0,-4,0,3,-4,NA,NA,NA,NA,NA,NA
31171,2011,14,10,45,2,4,47,20.817843866,14.869888476,66.914498141,2.9739776952,5.9479553903,69.888475836
31171,2012,5,8,5,2,-3,7,7.1479628306,11.436740529,7.1479628306,2.8591851322,-4.288777698,10.007147963
31171,2013,11,4,-4,1,7,-3,15.647226174,5.6899004267,-5.689900427,1.4224751067,9.9573257468,-4.26742532
31171,2014,7,3,-8,1,4,-7,9.9573257468,4.2674253201,-11.37980085,1.4224751067,5.6899004267,-9.957325747
31171,2015,5,4,-9,1,1,-8,7.1736011478,5.7388809182,-12.91248207,1.4347202296,1.4347202296,-11.47776184
31171,2016,7,3,23,1,4,24,9.8939929329,4.2402826855,32.508833922,1.4134275618,5.6537102473,33.922261484
31171,2017,6,3,-2,1,3,-1,8.2930200415,4.1465100207,-2.764340014,1.3821700069,4.1465100207,-1.382170007
48447,2010,5,0,-6,0,5,-6,NA,NA,NA,NA,NA,NA
48447,2011,14,22,3,3,-8,6,8.547008547,13.431013431,1.8315018315,1.8315018315,-4.884004884,3.663003663
48447,2012,14,23,-21,2,-9,-19,8.6233446258,14.166923314,-12.93501694,1.2319063751,-5.543578688,-11.70311056
48447,2013,20,19,-7,0,1,-7,12.437810945,11.815920398,-4.353233831,0,0.6218905473,-4.353233831
48447,2014,15,20,13,0,-5,13,9.3225605966,12.430080796,8.0795525171,0,-3.107520199,8.0795525171
48447,2015,8,22,-40,0,-14,-40,5.0457269,13.875748975,-25.2286345,0,-8.830022075,-25.2286345
48447,2016,17,19,-11,0,-2,-11,10.943031864,12.230447377,-7.080785323,0,-1.287415513,-7.080785323
48447,2017,14,12,-23,0,2,-23,9.1056910569,7.8048780488,-14.95934959,0,1.3008130081,-14.95934959
31173,2010,39,19,11,0,20,11,NA,NA,NA,NA,NA,NA
31173,2011,136,78,-130,4,58,-126,19.605016578,11.244053625,-18.74008938,0.5766181346,8.3609629523,-18.16347124
31173,2012,137,56,-61,0,81,-61,19.812002892,8.0983369487,-8.821402748,0,11.713665944,-8.821402748
31173,2013,133,78,-112,4,55,-108,19.273965655,11.30352873,-16.23070792,0.57966814,7.9704369249,-15.65103978
31173,2014,162,78,1,5,84,6,23.41378812,11.273305391,0.1445295563,0.7226477815,12.140482729,0.8671773378
31173,2015,166,76,15,5,90,20,23.653462525,10.829296096,2.1373610715,0.7124536905,12.824166429,2.849814762
31173,2016,158,80,-15,5,78,-10,22.233166819,11.257299655,-2.110743685,0.7035812285,10.975867164,-1.407162457
31173,2017,163,84,-2,5,79,3,22.697208104,11.696720741,-0.278493351,0.6962333774,11.000487363,0.4177400265
53067,2010,762,478,294,123,284,417,NA,NA,NA,NA,NA,NA
53067,2011,3002,1907,1784,395,1095,2179,11.791160557,7.4902542248,7.007138719,1.5514684944,4.3009063325,8.5586072133
53067,2012,3124,1930,226,807,1194,1033,12.140006451,7.5000680058,0.8782463053,3.1360387983,4.639938445,4.0142851036
53067,2013,3106,2039,1708,601,1067,2309,11.941124796,7.8390062647,6.5664652771,2.3105653581,4.1021185308,8.8770306352
53067,2014,3135,1991,1385,660,1144,2045,11.902795733,7.5593193955,5.2584918949,2.5058517333,4.3434763377,7.7643436282
53067,2015,3152,2141,1415,764,1011,2179,11.824796433,8.0320079832,5.3084032211,2.8661625872,3.7927884498,8.1745658083
53067,2016,3098,2229,4229,671,869,4900,11.430236998,8.2240149353,15.6031221,2.4756904538,3.2062220632,18.078812554
53067,2017,3171,2256,5143,588,915,5731,11.437104043,8.1368989975,18.549677103,2.1207875047,3.3002050455,20.670464608
13277,2010,126,56,46,8,70,54,NA,NA,NA,NA,NA,NA
13277,2011,558,389,709,33,169,742,13.700816402,9.5512859861,17.408384998,0.8102633356,4.1495304156,18.218648333
13277,2012,564,377,-404,18,187,-386,13.721793078,9.1721914725,-9.829085822,0.4379295663,4.5496016057,-9.391156256
13277,2013,565,376,-992,12,189,-980,13.907863481,9.2554985292,-24.41876208,0.2953882509,4.6523649522,-24.12337383
13277,2014,569,406,111,18,163,129,14.087819854,10.052117506,2.7482390225,0.445660382,4.0357023484,3.1938994045
13277,2015,603,409,-122,20,194,-102,14.859170548,10.078608216,-3.006333013,0.4928414775,4.7805623321,-2.513491535
13277,2016,569,404,-161,22,165,-139,14.001673311,9.9414341257,-3.961809144,0.5413652247,4.060239185,-3.4204439190000002
13277,2017,580,410,-244,23,170,-221,14.277274518,10.092556124,-6.006301694,0.5661677826,4.1847183931,-5.440133911
41057,2010,56,79,20,3,-23,23,NA,NA,NA,NA,NA,NA
41057,2011,254,285,137,27,-31,164,10.031397484,11.255701902,5.410635651,1.0663296538,-1.224304417,6.4769653048
41057,2012,250,279,-91,19,-29,-72,9.8669929352,11.011564116,-3.591585428,0.7498914631,-1.14457118,-2.841693965
41057,2013,262,287,64,18,-25,82,10.350208387,11.337823691,2.5282951785,0.7110830189,-0.987615304,3.2393781974
41057,2014,231,267,20,22,-36,42,9.1147631543,10.535245724,0.7891569831,0.8680726814,-1.420482569,1.6572296644
41057,2015,242,295,297,25,-53,322,9.4974588411,11.577480819,11.655972214,0.9811424423,-2.080021978,12.637114656
41057,2016,269,312,612,25,-43,637,10.381090207,12.040520984,23.617945007,0.9647853353,-1.659430777,24.582730342
41057,2017,259,303,497,26,-44,523,9.7922456001,11.455793115,18.790525341,0.9830053498,-1.663547515,19.773530691
40141,2010,25,11,-8,2,14,-6,NA,NA,NA,NA,NA,NA
40141,2011,114,103,0,0,11,0,14.242878561,12.868565717,0,0,1.3743128436,0
40141,2012,100,96,-187,2,4,-185,12.623074981,12.118151982,-23.60515021,0.25246149959999997,0.50492299919999994,-23.35268871
40141,2013,103,95,-113,7,8,-106,13.229721919,12.202170702,-14.51416094,0.8991073149,1.027551217,-13.61505363
40141,2014,101,104,-66,11,-3,-55,13.104119364,13.493350633,-8.563087901,1.4271813169,-0.389231268,-7.135906584
40141,2015,95,97,-113,14,-2,-99,12.453300125,12.715474864,-14.81287278,1.8352231762,-0.262174739,-12.9776496
40141,2016,87,80,-72,16,7,-56,11.517077045,10.590415674,-9.531374106,2.1180831348,0.9266613715,-7.413290972
40141,2017,84,72,-125,16,12,-109,11.227694981,9.6237385551,-16.70787944,2.1386085678,1.6039564259,-14.56927087
36107,2010,132,123,-44,0,9,-44,NA,NA,NA,NA,NA,NA
36107,2011,470,414,-177,-17,56,-194,9.2263599066,8.127048939,-3.47460788,-0.333719401,1.0993109676,-3.808327281
36107,2012,473,440,-625,-10,33,-635,9.3521694858,8.699692545,-12.35751782,-0.197720285,0.6524769409,-12.5552381
36107,2013,518,406,-270,-13,112,-283,10.319547374,8.088293888,-5.378914655,-0.25898478,2.2312534863,-5.637899434
36107,2014,492,410,-360,-13,82,-373,9.8467942881,8.2056619067,-7.20497143,-0.260179524,1.6411323813,-7.465150954
36107,2015,531,471,-552,-13,60,-565,10.711800127,9.5014272314,-11.13543064,-0.262247461,1.2103728957,-11.3976781
36107,2016,462,460,-531,-16,2,-547,9.4188642318,9.3780899277,-10.82557772,-0.326194432,0.040774304,-11.15177215
36107,2017,459,444,-198,-16,15,-214,9.4293109824,9.1211635646,-4.067545914,-0.328690579,0.3081474177,-4.396236493
42117,2010,124,85,40,0,39,40,NA,NA,NA,NA,NA,NA
42117,2011,461,483,292,2,-22,294,10.948038378,11.470504417,6.9345492543,0.0474969127,-0.52246604,6.982046167
42117,2012,436,380,176,3,56,179,10.292486013,8.9705153325,4.1547649961,0.0708198579,1.3219706806,4.225584854
42117,2013,462,451,-225,1,11,-224,10.903684124,10.644072597,-5.310235774,0.0236010479,0.2596115268,-5.286634727
42117,2014,405,453,-287,3,-48,-284,9.6204095206,10.760606205,-6.817426006,0.0712622927,-1.140196684,-6.746163713
42117,2015,441,440,-408,4,1,-404,10.567177054,10.543215201,-9.776435914,0.0958474109,0.0239618527,-9.680588503
42117,2016,423,468,-268,6,-45,-262,10.222206112,11.309674847,-6.476480468,0.1449958314,-1.087468735,-6.331484636
42117,2017,427,465,-401,6,-38,-395,10.412094611,11.338697879,-9.778102902,0.1463057791,-0.926603267,-9.631797123
28139,2010,67,89,-28,5,-22,-23,NA,NA,NA,NA,NA,NA
28139,2011,262,262,-173,13,0,-160,11.852253964,11.852253964,-7.826106625,0.5880889371,0,-7.238017688
28139,2012,261,262,-129,8,-1,-121,11.882540405,11.92806738,-5.87297974,0.3642157979,-0.045526975,-5.508763943
28139,2013,276,259,79,-8,17,71,12.575177693,11.800619646,3.5994168034,-0.364497904,0.7745580463,3.2349188992
28139,2014,278,268,-24,-5,10,-29,12.647573986,12.192625281,-1.091876891,-0.227474352,0.4549487045,-1.319351243
28139,2015,280,266,14,-3,14,11,12.738853503,12.101910828,0.6369426752,-0.136487716,0.6369426752,0.5004549591
28139,2016,280,264,41,-3,16,38,12.716868017,11.990189845,1.8621128168,-0.136252157,0.7266781724,1.7258606595
28139,2017,275,250,-98,-3,25,-101,12.496023992,11.360021811,-4.45312855,-0.136320262,1.1360021811,-4.589448812
18157,2010,556,234,-348,257,322,-91,NA,NA,NA,NA,NA,NA
18157,2011,2132,1082,218,1266,1050,1484,12.231854457,6.2077235096,1.25072433,7.2633807423,6.0241309474,8.5141050723
18157,2012,2279,1154,321,1455,1125,1776,12.876360945,6.5201055421,1.8136515416,8.2207569876,6.3562554028,10.034408529
18157,2013,2302,1114,198,1570,1188,1768,12.796353428,6.1925011812,1.1006420412,8.7273131549,6.6038522471,9.8279551961
18157,2014,2211,1114,-439,1703,1097,1264,12.112878219,6.1030060318,-2.405044567,9.3298198134,6.0098721875,6.9247752461
18157,2015,2383,1193,-636,1819,1190,1183,12.888709804,6.452467812,-3.439873871,9.8382556162,6.4362419919,6.3983817449
18157,2016,2417,1149,-510,1836,1268,1326,12.899266177,6.1320880587,-2.721814543,9.7985323549,6.7671781187,7.0767178119
18157,2017,2394,1138,-1177,1823,1256,646,12.62455143,6.0011443307,-6.206807449,9.6134324383,6.6234070996,3.4066249891
18159,2010,39,54,-44,0,-15,-44,NA,NA,NA,NA,NA,NA
18159,2011,153,164,-50,-1,-11,-51,9.6575666719,10.351901531,-3.15606754,-0.063121351,-0.694334859,-3.219188891
18159,2012,147,179,-128,-1,-32,-129,9.3434182928,11.37735969,-8.135765588,-0.063560669,-2.033941397,-8.199326257
18159,2013,132,180,-65,1,-48,-64,8.4626234133,11.539941018,-4.167200923,0.0641107834,-3.077317605,-4.10309014
18159,2014,170,169,-152,1,1,-151,10.991497753,10.926841884,-9.827692109,0.0646558691,0.0646558691,-9.76303624
18159,2015,150,182,-130,2,-32,-128,9.7952786757,11.884938126,-8.489241519,0.1306037157,-2.089659451,-8.358637803
18159,2016,135,149,-69,3,-14,-66,8.8847938399,9.8061798677,-4.541116851,0.1974398631,-0.921386028,-4.343676988
18159,2017,143,160,-11,3,-17,-8,9.4445545208,10.56733373,-0.726504194,0.1981375074,-1.122779209,-0.528366686
47167,2010,202,138,-6,3,64,-3,NA,NA,NA,NA,NA,NA
47167,2011,739,522,-70,25,217,-45,12.084345132,8.535897373,-1.144660567,0.4088073455,3.5484477585,-0.735853222
47167,2012,758,483,-38,35,275,-3,12.350305499,7.8696537678,-0.619144603,0.5702647658,4.4806517312,-0.048879837
47167,2013,741,524,-213,23,217,-190,12.044471896,8.517278372,-3.462176132,0.3738500049,3.5271935243,-3.088326127
47167,2014,750,533,-215,29,217,-186,12.185116287,8.6595559744,-3.493066669,0.4711578297,3.5255603123,-3.021908839
47167,2015,724,597,-199,33,127,-166,11.763654532,9.7001405464,-3.233380182,0.5361886734,2.0635139856,-2.697191509
47167,2016,719,642,-462,35,77,-427,11.719545888,10.464462392,-7.530500974,0.570492498,1.2550834957,-6.960008476
47167,2017,717,607,47,36,110,83,11.702110297,9.9068074619,0.7670839386,0.5875536551,1.7953028349,1.3546375936
28141,2010,51,42,15,0,9,15,NA,NA,NA,NA,NA,NA
28141,2011,188,261,78,1,-73,79,9.581570766,13.302074308,3.9753325519,0.0509658019,-3.720503542,4.0262983538
28141,2012,211,300,77,-4,-89,73,10.75734788,15.294807413,3.925667236,-0.203930766,-4.537459532,3.7217364705
28141,2013,204,294,-20,3,-90,-17,10.433982047,15.037209421,-1.022939416,0.1534409125,-4.603227374,-0.869498504
28141,2014,188,294,16,9,-106,25,9.6633256232,15.111796453,0.8224106913,0.4626060139,-5.44847083,1.2850167052
28141,2015,194,297,146,11,-103,157,9.9794238683,15.277777778,7.5102880658,0.5658436214,-5.298353909,8.0761316872
28141,2016,215,284,53,10,-69,63,11.046317466,14.591414699,2.7230457009,0.5137822077,-3.545097233,3.2368279086
28141,2017,203,277,146,10,-74,156,10.409722578,14.204399774,7.4867955489,0.51279421569999994,-3.794677196,7.9995897646
48449,2010,120,62,21,4,58,25,NA,NA,NA,NA,NA,NA
48449,2011,493,258,-241,12,235,-229,15.207366164,7.9584188041,-7.434026867,0.3701590141,7.2489473603,-7.063867853
48449,2012,520,269,-58,22,251,-36,15.985981524,8.2696712114,-1.783051785,0.6763299875,7.7163103125,-1.106721798
48449,2013,481,264,-278,48,217,-230,14.741713533,8.0910860138,-8.520158757,1.471106548,6.6506275189,-7.049052209
48449,2014,502,261,-476,65,241,-411,15.426455449,8.0205276339,-14.62747568,1.9974494108,7.4059278153,-12.63002627
48449,2015,536,309,-49,84,227,35,16.446762811,9.4814360233,-1.50352869,2.5774777539,6.9653267874,1.0739490641
48449,2016,505,270,-436,95,235,-341,15.458789317,8.2650952782,-13.3465983,2.9080890794,7.1936940384,-10.43850922
48449,2017,502,254,-53,95,248,42,15.323799203,7.7534760909,-1.61785131,2.89992216,7.5703231124,1.2820708497
21219,2010,47,50,-35,6,-3,-29,NA,NA,NA,NA,NA,NA
21219,2011,158,135,-54,12,23,-42,12.721929224,10.870002818,-4.348001127,0.9662224727,1.8519264061,-3.381778655
21219,2012,196,123,104,9,73,113,15.675610829,9.8372455712,8.3176710521,0.7197984564,5.8383652577,9.0374695085
21219,2013,192,120,-223,2,72,-221,15.331177387,9.5819858666,-17.80652374,0.1596997644,5.7491915199,-17.64682397
21219,2014,154,127,-68,0,27,-68,12.389878917,10.217627419,-5.470855626,0,2.1722514985,-5.470855626
21219,2015,186,111,-65,1,75,-64,14.982480164,8.9411575174,-5.235812961,0.0805509686,6.0413226469,-5.155261992
21219,2016,215,143,-134,3,72,-131,17.351303365,11.540634331,-10.8143007,0.2421112097,5.810669034,-10.57218949
21219,2017,210,128,-204,3,82,-201,17.06970128,10.404389352,-16.58199553,0.2438528754,6.6653119285,-16.33814265
27153,2010,77,33,-42,1,44,-41,NA,NA,NA,NA,NA,NA
27153,2011,308,204,-125,13,104,-112,12.372210729,8.1945811324,-5.021189419,0.5222036996,4.1776295969,-4.49898572
27153,2012,337,194,-391,6,143,-385,13.603245403,7.8309483924,-15.78299392,0.2421942802,5.7722970109,-15.54079964
27153,2013,332,203,-291,-1,129,-292,13.509114583,8.2600911458,-11.84082031,-0.040690104,5.2490234375,-11.88151042
27153,2014,298,226,-211,2,72,-209,12.198366729,9.2511103379,-8.63709859,0.0818682331,2.9472563908,-8.555230357
27153,2015,317,241,-102,3,76,-99,13.017945875,9.896924151,-4.188739682,0.1231982259,3.121021724,-4.065541456
27153,2016,320,220,-36,3,100,-33,13.130090475,9.0269372012,-1.477135178,0.1230945982,4.1031532733,-1.35404058
27153,2017,318,201,-8,3,117,-5,13.001083424,8.2176659376,-0.327071281,0.1226517304,4.783417486,-0.204419551
46121,2010,66,37,4,0,29,4,NA,NA,NA,NA,NA,NA
46121,2011,275,62,-9,-4,213,-13,28.228289879,6.3641962636,-0.923834941,-0.410593307,21.864093615,-1.334428249
46121,2012,285,105,-118,0,180,-118,28.868067865,10.63560395,-11.95239301,0,18.232463915,-11.95239301
46121,2013,290,115,-89,0,175,-89,29.157450231,11.562437161,-8.948320933,0,17.595013071,-8.948320933
46121,2014,276,77,-257,-2,199,-259,27.709452337,7.7305356157,-25.80191757,-0.200793133,19.978916721,-26.00271071
46121,2015,261,92,-109,-2,169,-111,26.196928636,9.2341664157,-10.94047978,-0.200742748,16.96276222,-11.14122252
46121,2016,265,120,-37,-2,145,-39,26.378658172,11.945052757,-3.683057934,-0.199084213,14.433605415,-3.882142146
46121,2017,268,124,-176,-2,144,-178,26.582027376,12.299146995,-17.4568538,-0.198373339,14.282880381,-17.65522714
09013,2010,337,286,381,62,51,443,NA,NA,NA,NA,NA,NA
09013,2011,1181,1007,-662,330,174,-332,7.7119731485,6.5757467913,-4.322884187,2.1549120567,1.1362263572,-2.16797213
09013,2012,1125,942,-1652,335,183,-1317,7.3761785494,6.176320172,-10.83150841,2.1964620569,1.1998583774,-8.635046355
09013,2013,1125,984,-583,380,141,-203,7.4042141496,6.4762193095,-3.83702831,2.5009790016,0.9279948401,-1.336049309
09013,2014,1127,1004,-706,430,123,-276,7.4228732513,6.6127460021,-4.649998683,2.8321521722,0.8101272493,-1.817846511
09013,2015,1177,1025,-637,458,152,-179,7.7570724795,6.7553095085,-4.198177714,3.0184700048,1.001762971,-1.179707709
09013,2016,1095,988,-1144,461,107,-683,7.2310161063,6.5244236649,-7.554595823,3.0442907991,0.7065924414,-4.510305023
09013,2017,1119,1004,-257,459,115,202,7.3957555369,6.635691295,-1.698578349,3.0336477135,0.760064242,1.3350693641
48451,2010,396,201,192,53,195,245,NA,NA,NA,NA,NA,NA
48451,2011,1515,989,473,77,526,550,13.622263184,8.8926853392,4.2530234231,0.6923526503,4.7295778447,4.9453760734
48451,2012,1533,1005,784,242,528,1026,13.622368053,8.9305152596,6.966690511,2.1504325302,4.6918527931,9.1171230412
48451,2013,1530,975,752,95,555,847,13.418698474,8.5511313805,6.5953341519,0.8331871601,4.8675670935,7.4285213121
48451,2014,1576,1084,1105,65,492,1170,13.637759981,9.3802866872,9.5620081082,0.5624710652,4.2574732934,10.124479173
48451,2015,1727,1043,404,117,684,521,14.760746841,8.914568011,3.4530062094,1.0000042735,5.8461788298,4.453010483
48451,2016,1652,1000,-520,63,652,-457,14.036280216,8.4965376609,-4.418199584,0.5352818726,5.5397425549,-3.882917711
48451,2017,1624,1040,-379,26,584,-353,13.773742531,8.8206232958,-3.214438682,0.2205155824,4.9531192353,-2.993923099
36109,2010,247,121,-156,197,126,41,NA,NA,NA,NA,NA,NA
36109,2011,845,692,-913,970,153,57,8.2944378187,6.7926046989,-8.961919205,9.5214256617,1.5018331198,0.5595064564
36109,2012,934,652,-207,1007,282,800,9.1097954685,6.3593004769,-2.018980366,9.8218030372,2.7504949916,7.8028226711
36109,2013,917,675,-138,983,242,845,8.8509241832,6.5151295787,-1.331982047,9.4879590753,2.3357946045,8.1559770281
36109,2014,856,690,-1130,1085,166,-45,8.2138282101,6.6209596553,-10.84302088,10.411219168,1.5928685548,-0.431801717
36109,2015,861,714,-1319,1151,147,-168,8.2562605181,6.8466550638,-12.64809248,11.037114816,1.4096054543,-1.610977662
36109,2016,789,627,-1049,1160,162,111,7.5558790293,6.0044818142,-10.04577579,11.108770183,1.5513972151,1.0629943882
36109,2017,806,621,-1098,1148,185,50,7.699545765,5.9322802979,-10.48895937,10.966598683,1.7672654672,0.4776393154
49045,2010,267,99,108,1,168,109,NA,NA,NA,NA,NA,NA
49045,2011,999,311,5,-3,688,2,16.977524748,5.2852954922,0.0849725963,-0.050983558,11.692229256,0.0339890385
49045,2012,985,320,-100,47,665,-53,16.558517971,5.3794170057,-1.681067814,0.7901018727,11.179100965,-0.890965942
49045,2013,996,349,186,27,647,213,16.541003753,5.795994287,3.0889826286,0.4484007042,10.745009466,3.5373833328
49045,2014,983,319,111,40,664,151,16.10313872,5.2257388113,1.8183605268,0.6552650547,10.877399908,2.4736255815
49045,2015,954,362,556,48,592,604,15.376060731,5.8345219963,8.9613100275,0.7736382758,9.5415387343,9.7349483032
49045,2016,967,337,1294,33,630,1327,15.19962276,5.2970763911,20.339515876,0.5187048098,9.9025463691,20.858220685
49045,2017,989,330,2160,33,659,2193,14.978607398,4.9979175344,32.713642043,0.4997917534,9.9806898641,33.213433797
30101,2010,16,5,8,0,11,8,NA,NA,NA,NA,NA,NA
30101,2011,66,57,-204,-3,9,-207,12.578616352,10.863350486,-38.87935963,-0.57175528900000006,1.7152658662,-39.45111492
30101,2012,55,45,55,-1,10,54,10.610591299,8.6813928813,10.610591299,-0.192919842,1.9291984181,10.417671458
30101,2013,40,41,-98,-2,-1,-100,7.7414360364,7.9349719373,-18.96651829,-0.387071802,-0.193535901,-19.35359009
30101,2014,59,54,-8,-2,5,-10,11.533574431,10.556152869,-1.563874499,-0.390968625,0.9774215619,-1.954843124
30101,2015,58,48,-44,-2,10,-46,11.384826774,9.421925606,-8.636765139,-0.392580234,1.9629011679,-9.029345372
30101,2016,57,42,-129,-2,15,-131,11.357975491,8.3690345721,-25.7048919,-0.398525456,2.9889409186,-26.10341736
30101,2017,59,38,-95,-2,21,-97,11.983345181,7.7180867269,-19.29521682,-0.406215091,4.2652584544,-19.70143191
13279,2010,95,40,22,6,55,28,NA,NA,NA,NA,NA,NA
13279,2011,410,276,-177,0,134,-177,15.054434633,10.134204777,-6.499109585,0,4.9202298555,-6.499109585
13279,2012,409,327,-106,0,82,-106,15.034277417,12.020070209,-3.896414196,0,3.0142072084,-3.896414196
13279,2013,393,293,-86,9,100,-77,14.446670465,10.770672891,-3.161357914,0.3308397816,3.6759975738,-2.830518132
13279,2014,395,313,-124,11,82,-113,14.524461768,11.509257046,-4.559577871,0.4044786821,3.0152047214,-4.155099189
13279,2015,418,327,-63,11,91,-52,15.369624768,12.023605979,-2.316474546,0.4044638097,3.3460187892,-1.912010737
13279,2016,391,316,-108,13,75,-95,14.372358022,11.615511854,-3.969858482,0.4778533358,2.756846168,-3.492005146
13279,2017,389,318,-279,13,71,-266,14.355832749,11.735616489,-10.29634277,0.4797579068,2.6202162601,-9.816584862
35057,2010,41,12,-16,7,29,-9,NA,NA,NA,NA,NA,NA
35057,2011,173,141,-43,22,32,-21,10.547172687,8.5962505716,-2.621551593,1.3412589544,1.9509221155,-1.280292638
35057,2012,172,163,-358,25,9,-333,10.583964064,10.030151991,-22.02941357,1.5383668697,0.5538120731,-20.4910467
35057,2013,141,145,-415,21,-4,-394,8.8684822945,9.1200704447,-26.10227058,1.3208377885,-0.25158815,-24.78143279
35057,2014,135,165,-164,37,-30,-127,8.6388942215,10.558648493,-10.49465668,2.3676969348,-1.919754271,-8.126959749
35057,2015,160,157,-118,46,3,-72,10.311936066,10.118587265,-7.605052849,2.964681619,0.1933488012,-4.64037123
35057,2016,166,148,-126,53,18,-73,10.741555584,9.5768085932000009,-8.153228937,3.429532807,1.1647469911,-4.72369613
35057,2017,167,153,15,53,14,68,10.797879219,9.8926677874,0.9698693909,3.4268718479,0.9052114315,4.3967412388
38095,2010,2,4,0,0,-2,0,NA,NA,NA,NA,NA,NA
38095,2011,14,25,28,0,-11,28,6.2180768377,11.103708639,12.436153675,0,-4.885631801,12.436153675
38095,2012,31,28,26,0,3,26,13.623379477,12.304987915,11.426060207,0,1.3183915623,11.426060207
38095,2013,27,42,-11,0,-15,-11,11.855104281,18.441273326,-4.8298573,0,-6.586169045,-4.8298573
38095,2014,31,30,9,1,1,10,13.656387665,13.215859031,3.9647577093,0.4405286344,0.4405286344,4.4052863436
38095,2015,25,31,-22,1,-6,-21,11.049723757,13.701657459,-9.723756906,0.4419889503,-2.651933702,-9.281767956
38095,2016,20,17,-6,1,3,-5,8.896797153,7.5622775801,-2.669039146,0.4448398577,1.334519573,-2.224199288
38095,2017,22,17,0,1,5,1,9.7777777778,7.5555555556,0,0.4444444444,2.2222222222,0.4444444444
13281,2010,21,25,58,0,-4,58,NA,NA,NA,NA,NA,NA
13281,2011,76,171,137,3,-95,140,7.201061209,16.20238772,12.980860337,0.2842524161,-9.001326511,13.265112753
13281,2012,75,163,65,3,-88,68,7.0962248084,15.422461917,6.1500615006,0.2838489923,-8.326237109,6.433910493
13281,2013,84,160,294,2,-76,296,7.8703269933,14.991099035,27.546144477,0.1873887379,-7.120772042,27.733533215
13281,2014,83,162,359,2,-79,361,7.5916948687,14.817524925,32.836366962,0.1829324065,-7.225830056,33.019299369
13281,2015,77,154,136,2,-77,138,6.9297574585,13.859514917,12.239571615,0.1799937002,-6.929757458,12.419565315
13281,2016,94,173,283,2,-79,285,8.3585274764,15.383247377,25.164502934,0.1778410101,-7.0247199,25.342343945
13281,2017,95,182,239,2,-87,241,8.3132793699,15.926493109,20.914460731,0.1750164078,-7.613213739,21.089477138
38097,2010,23,26,-14,0,-3,-14,NA,NA,NA,NA,NA,NA
38097,2011,86,77,-49,0,9,-49,10.637639928,9.5243985404,-6.060980889,0,1.1132413878,-6.060980889
38097,2012,105,104,1,2,1,3,13.016797868,12.892828364,0.1239695035,0.247939007,0.1239695035,0.3719085105
38097,2013,91,81,103,2,10,105,11.197932689,9.9673906356,12.674583154,0.2461084108,1.2305420538,12.920691565
38097,2014,95,100,-147,3,-5,-144,11.710323575,12.326656394,-18.1201849,0.3697996918,-0.61633282,-17.75038521
38097,2015,93,107,-41,3,-14,-38,11.603967808,13.350801672,-5.115727743,0.3743215422,-1.746833864,-4.741406201
38097,2016,103,89,20,3,14,23,12.863744224,11.115274135,2.4978144124,0.3746721619,1.7484700887,2.8724865742
38097,2017,100,91,-23,3,9,-20,12.470382841,11.348048385,-2.868188053,0.3741114852,1.1223344557,-2.494076568
37175,2010,59,83,20,5,-24,25,NA,NA,NA,NA,NA,NA
37175,2011,278,416,-129,7,-138,-122,8.436769749,12.624806531,-3.914903948,0.2124366484,-4.188036782,-3.7024673
37175,2012,255,368,156,-7,-113,149,7.7659849858,11.207382254,4.7509555207,-0.213183902,-3.441397268,4.5377716191
37175,2013,234,424,184,6,-190,190,7.1227456054,12.906171524,5.6007914162,0.1826345027,-5.783425919,5.7834259189
37175,2014,291,388,213,10,-97,223,8.840685381,11.787580508,6.4710171345,0.3038036213,-2.946895127,6.7748207559
37175,2015,286,399,316,15,-113,331,8.6434864077,12.058570198,9.5501458211,0.4533297067,-3.41508379,10.003475528
37175,2016,277,415,397,17,-138,414,8.3097091602,12.449564265,11.909583165,0.5099821506,-4.139855105,12.419565315
37175,2017,266,410,607,18,-144,625,7.8900143859,12.161300369,18.004656888,0.5339107479,-4.271285983,18.538567636
27155,2010,9,21,-12,0,-12,-12,NA,NA,NA,NA,NA,NA
27155,2011,30,66,-10,1,-36,-9,8.5433575395,18.795386587,-2.847785847,0.2847785847,-10.25202905,-2.563007262
27155,2012,32,57,-60,0,-25,-60,9.2834348709,16.536118364,-17.40644038,0,-7.252683493,-17.40644038
27155,2013,29,50,17,0,-21,17,8.5218924478,14.692918014,4.9955921246,0,-6.171025566,4.9955921246
27155,2014,32,54,-2,0,-22,-2,9.4409204897,15.931553326,-0.590057531,0,-6.490632837,-0.590057531
27155,2015,34,53,10,0,-19,10,10.081541883,15.7153447,2.9651593773,0,-5.633802817,2.9651593773
27155,2016,32,43,-35,0,-11,-35,9.5679473763,12.856929287,-10.46494244,0,-3.288981911,-10.46494244
27155,2017,32,27,-8,0,5,-8,9.637102846,8.1313055263,-2.409275711,0,1.5057973197,-2.409275711
48453,2010,3861,1114,2177,920,2747,3097,NA,NA,NA,NA,NA,NA
48453,2011,15636,4663,15313,4380,10973,19693,14.946881502,4.4574896676,14.638116938,4.1869622012,10.489391834,18.825079139
48453,2012,15577,4719,18965,4402,10858,23367,14.435030317,4.3730441076,17.574651727,4.0792837808,10.061986209,21.653935508
48453,2013,15838,5130,9589,4903,10708,14492,14.278148024,4.6247568735,8.6445991539,4.4201136356,9.6533911503,13.06471279
48453,2014,15987,4941,12325,5668,11046,17993,14.064724831,4.3468946888,10.843043319,4.9864802866,9.7178301421,15.829523606
48453,2015,16388,5335,9213,6455,11053,15668,14.068891036,4.5800301243,7.9092441491,5.5415359798,9.4888609117,13.450780129
48453,2016,16330,5605,8862,6646,10725,15508,13.70613805,4.7044031703,7.4380768769,5.5781379964,9.0017348798,13.016214873
48453,2017,16354,5783,4870,6623,10571,11493,13.452995953,4.7571649501,4.006120233,5.4481589944,8.6958310026,9.4542792274
30103,2010,2,3,1,0,-1,1,NA,NA,NA,NA,NA,NA
30103,2011,7,6,-5,0,1,-5,9.7833682739,8.3857442348,-6.988120196,0,1.3976240391,-6.988120196
30103,2012,7,9,10,0,-2,10,9.756097561,12.543554007,13.93728223,0,-2.787456446,13.93728223
30103,2013,7,5,-31,0,2,-31,9.8939929329,7.0671378092,-43.81625442,0,2.8268551237,-43.81625442
30103,2014,8,14,1,0,-6,1,11.577424023,20.260492041,1.4471780029,0,-8.683068017,1.4471780029
30103,2015,8,8,-4,0,0,-4,11.644832606,11.644832606,-5.822416303,0,0,-5.822416303
30103,2016,13,11,-2,0,2,-2,18.97810219,16.058394161,-2.919708029,0,2.9197080292,-2.919708029
30103,2017,10,5,-10,0,5,-10,14.662756598,7.3313782991,-14.6627566,0,7.3313782991,-14.6627566
20195,2010,4,7,3,0,-3,3,NA,NA,NA,NA,NA,NA
20195,2011,33,41,-45,1,-8,-44,11.07568384,13.760698104,-15.10320524,0.335626783,-2.685014264,-14.76757845
20195,2012,29,54,10,1,-25,11,9.8405157788,18.323719036,3.393281303,0.3393281303,-8.483203258,3.7326094333
20195,2013,28,37,15,0,-9,15,9.5141012572,12.572205233,5.0968399592,0,-3.058103976,5.0968399592
20195,2014,30,49,-31,0,-19,-31,10.273972603,16.780821918,-10.61643836,0,-6.506849315,-10.61643836
20195,2015,45,45,11,0,0,11,15.514566454,15.514566454,3.7924495777,0,0,3.7924495777
20195,2016,45,47,-40,0,-2,-40,15.600624025,16.293985093,-13.86722136,0,-0.693361068,-13.86722136
20195,2017,46,44,19,0,2,19,16.008352184,15.312336871,6.6121454672,0,0.6960153123,6.6121454672
55121,2010,94,81,15,6,13,21,NA,NA,NA,NA,NA,NA
55121,2011,372,245,6,30,127,36,12.860402406,8.4698886815,0.2074258453,1.0371292263,4.3905137247,1.2445550716
55121,2012,394,271,152,28,123,180,13.513745262,9.2949872237,5.2134245683,0.9603676836,4.2187580388,6.1737922519
55121,2013,414,305,46,35,109,81,14.082111636,10.374502534,1.5646790707,1.1905166842,3.7076091024,2.755195755
55121,2014,395,254,-212,36,141,-176,13.400960119,8.617326254,-7.192414039,1.2213533273,4.7836338654,-5.971060711
55121,2015,415,264,-143,40,151,-103,14.076863064,8.954920118,-4.850581731,1.3568060785,5.1219429463,-3.493775652
55121,2016,412,300,-33,41,112,8,13.935867948,10.147476661,-1.116222433,1.3868218103,3.7883912867,0.2705993776
55121,2017,407,261,-342,42,146,-300,13.774197915,8.8330851496,-11.57438744,1.4214160011,4.9411127657,-10.15297144
13283,2010,25,5,-10,0,20,-10,NA,NA,NA,NA,NA,NA
13283,2011,69,89,-50,2,-20,-48,10.06270964,12.979437072,-7.29181858,0.2916727432,-2.916727432,-7.000145836
13283,2012,79,56,-59,3,23,-56,11.60655256,8.2274296628,-8.668184823,0.4407551605,3.3791228972,-8.227429663
13283,2013,71,79,-100,2,-8,-98,10.538033395,11.72541744,-14.84230056,0.2968460111,-1.187384045,-14.54545455
13283,2014,77,63,101,6,14,107,11.413325428,9.3381753502,14.970725561,0.8893500334,2.0751500778,15.860075595
13283,2015,82,72,-24,6,10,-18,12.053505806,10.583566074,-3.527855358,0.8819638395,1.4699397325,-2.645891518
13283,2016,81,46,-113,6,35,-107,11.977818854,6.8022181146,-16.70979667,0.887245841,5.1756007394,-15.82255083
13283,2017,69,63,3,6,6,9,10.247271107,9.3562040544,0.4455335264,0.8910670528,0.8910670528,1.3366005792
21221,2010,28,61,29,0,-33,29,NA,NA,NA,NA,NA,NA
21221,2011,140,169,-78,0,-29,-78,9.8073555166,11.838879159,-5.464098074,0,-2.031523643,-5.464098074
21221,2012,154,142,185,-1,12,184,10.754189944,9.9162011173,12.918994413,-0.069832402,0.8379888268,12.849162011
21221,2013,145,189,-70,4,-44,-66,10.095032548,13.158352769,-4.873463989,0.2784836565,-3.063320221,-4.5949803319999996
21221,2014,147,190,-133,4,-43,-129,10.336099002,13.359583743,-9.35170862,0.2812543946,-3.023484742,-9.070454226
21221,2015,146,162,102,4,-16,106,10.294739811,11.422930475,7.1922154844,0.2820476661,-1.128190664,7.4742631505
21221,2016,160,165,87,4,-5,91,11.211940717,11.562313864,6.0964927648,0.2802985179,-0.350373147,6.3767912827
21221,2017,160,168,135,4,-8,139,11.127725423,11.684111695,9.389018326,0.2781931356,-0.556386271,9.6672114616000009
21223,2010,27,8,-14,-1,19,-15,NA,NA,NA,NA,NA,NA
21223,2011,99,73,-30,8,26,-22,11.231493562,8.2818083839,-3.403482897,0.9075954393,2.9496851778,-2.495887458
21223,2012,110,75,2,-2,35,0,12.451890423,8.4899252887,0.2263980077,-0.226398008,3.9619651347,0
21223,2013,100,89,-40,-4,11,-44,11.31925972,10.074141151,-4.527703888,-0.452770389,1.2451185692,-4.980474277
21223,2014,93,89,-84,-4,4,-88,10.596479234,10.140716687,-9.571013502,-0.455762548,0.4557625477,-10.02677605
21223,2015,99,100,14,-4,-1,10,11.327879169,11.442302191,1.6019223068,-0.457692088,-0.114423022,1.1442302191
21223,2016,97,99,-111,-4,-2,-115,11.168038685,11.398307524,-12.77992056,-0.460537678,-0.230268839,-13.24045823
21223,2017,92,97,-56,-4,-5,-60,10.705143123,11.28694438,-6.516174075,-0.465441005,-0.581801257,-6.98161508
06105,2010,33,54,-7,0,-21,-7,NA,NA,NA,NA,NA,NA
06105,2011,111,161,-19,-1,-50,-20,8.0945088602,11.740684022,-1.385546562,-0.072923503,-3.646175162,-1.458470065
06105,2012,113,146,-160,-1,-33,-161,8.3213667661,10.751500423,-11.78246622,-0.073640414,-2.430133657,-11.85610663
06105,2013,119,157,-21,1,-38,-20,8.8462682129,11.67112697,-1.561106155,0.0743383883,-2.824858757,-1.486767767
06105,2014,110,166,-250,0,-56,-250,8.2881253767,12.507534659,-18.83664858,0,-4.219409283,-18.83664858
06105,2015,101,153,22,1,-52,23,7.7058060578,11.673151751,1.6784924086,0.0762951095,-3.967345693,1.7547875181
06105,2016,107,174,-189,2,-67,-187,8.2526705488,13.420230612,-14.57714704,0.1542555243,-5.167560063,-14.42289152
06105,2017,99,164,-68,2,-65,-66,7.750117426,12.838578362,-5.323312979,0.1565680288,-5.088460936,-5.166744951
48455,2010,43,29,38,0,14,38,NA,NA,NA,NA,NA,NA
48455,2011,180,230,11,-3,-50,8,12.238237694,15.637748164,0.7478923035,-0.203970628,-3.39951047,0.5439216753
48455,2012,107,214,-209,-2,-107,-211,7.3648346354,14.729669271,-14.38551812,-0.13766046,-7.364834635,-14.52317858
48455,2013,114,233,194,-6,-119,188,7.9136440943,16.174377842,13.467078546,-0.416507584,-8.260733748,13.050570962
48455,2014,157,208,-107,-5,-51,-112,10.934289794,14.486192847,-7.452031897,-0.34822579,-3.551903054,-7.800257687
48455,2015,152,219,300,-4,-67,296,10.561789945,15.217315777,20.84563805,-0.277941841,-4.655525831,20.56769621
48455,2016,137,230,103,-4,-93,99,9.4417643005,15.851137147,7.0985527223,-0.27567195,-6.409372846,6.8228807719
48455,2017,150,215,224,-4,-65,220,10.281014393,14.736120631,15.352981494,-0.274160384,-4.455106237,15.07882111
46123,2010,13,13,0,-1,0,-1,NA,NA,NA,NA,NA,NA
46123,2011,60,72,-3,-1,-12,-4,10.639241067,12.767089281,-0.531962053,-0.177320684,-2.127848213,-0.709282738
46123,2012,74,75,-113,-2,-1,-115,13.275923933,13.45532831,-20.27269465,-0.358808755,-0.179404377,-20.63150341
46123,2013,67,60,2,-2,7,0,12.137681159,10.869565217,0.3623188406,-0.362318841,1.268115942,0
46123,2014,65,82,5,-2,-17,3,11.783901378,14.865844815,0.9064539521,-0.362581581,-3.081943437,0.5438723713
46123,2015,69,62,-93,-2,7,-95,12.626955806,11.345960289,-17.01894043,-0.365998719,1.2809955165,-17.38493915
46123,2016,75,72,70,-2,3,68,13.748854262,13.198900092,12.832263978,-0.366636114,0.5499541705,12.465627864
46123,2017,76,65,-39,-2,11,-41,13.881278539,11.872146119,-7.123287671,-0.365296804,2.0091324201,-7.488584475
13285,2010,184,205,35,6,-21,41,NA,NA,NA,NA,NA,NA
13285,2011,941,629,253,24,312,277,13.97282649,9.3399658475,3.7567748162,0.3563738956,4.632860643,4.1131487119
13285,2012,894,616,371,25,278,396,13.152764802,9.0627551658,5.4582502703,0.367806622,4.0900096365,5.8260568923
13285,2013,866,680,266,53,186,319,12.63191674,9.9188260778,3.8800113775,0.7730849737,2.7130906624,4.6530963512
13285,2014,898,639,151,58,259,209,13.007329297,9.2557721834,2.1872012515,0.840117037,3.7515571135,3.0273182885
13285,2015,995,689,-99,62,306,-37,14.337795582,9.9283830713,-1.426574636,0.893410378,4.4094125106,-0.533164258
13285,2016,909,709,-14,63,200,49,13.050688068,10.17924955,-0.201000696,0.9045031335,2.8714385189,0.7035024371
13285,2017,913,738,-227,63,175,-164,13.083790717,10.575944741,-3.253034494,0.9028245511,2.5078459753,-2.350209943
47169,2010,19,8,-1,1,11,0,NA,NA,NA,NA,NA,NA
47169,2011,89,92,-57,-4,-3,-61,11.349145626,11.731701097,-7.26855394,-0.510073961,-0.382555471,-7.778627901
47169,2012,91,90,-22,-2,1,-24,11.668910688,11.5406809,-2.821055331,-0.256459576,0.1282297878,-3.077514907
47169,2013,84,92,22,1,-8,23,10.77752117,11.803951758,2.822684116,0.1283038235,-1.026430588,2.9509879394
47169,2014,96,86,176,2,10,178,12.156515131999999,10.890211473,22.286944409,0.2532607319,1.2663036596,22.540205141
47169,2015,115,110,40,2,5,42,14.345412587,13.721698996,4.9897087258,0.2494854363,0.6237135907,5.239194162
47169,2016,96,90,1895,2,6,1897,10.672595887,10.005558644,210.67259589,0.2223457476,0.6670372429,210.89494163
47169,2017,107,84,109,2,23,111,10.682374083,8.3861628313,10.882044626,0.1996705436,2.2962112514,11.08171517
39155,2010,498,642,-347,6,-144,-341,NA,NA,NA,NA,NA,NA
39155,2011,2115,2437,-681,-19,-322,-700,10.104291577,11.642628167,-3.253438564,-0.090771414,-1.53833659,-3.344209978
39155,2012,2053,2545,-1129,-1,-492,-1130,9.8705244888,12.235988711,-5.428067291,-0.004807854,-2.365464222,-5.432875145
39155,2013,2152,2540,-453,-8,-388,-461,10.408857202,12.28554707,-2.191083788,-0.038694636,-1.876689867,-2.229778425
39155,2014,2084,2418,-994,5,-334,-989,10.134067291,11.758241224,-4.833619428,0.024313981,-1.624173932,-4.809305447
39155,2015,2103,2606,-1140,8,-503,-1132,10.300996792,12.76481105,-5.583992555,0.0391859127,-2.463814259,-5.544806642
39155,2016,2089,2542,-1185,6,-453,-1179,10.315107015,12.551939699,-5.851317287,0.029626923,-2.236832684,-5.821690364
39155,2017,2059,2459,-923,5,-400,-918,10.241717465,12.231366317,-4.591114726,0.0248706106,-1.989648852,-4.566244115
54093,2010,21,21,-13,0,0,-13,NA,NA,NA,NA,NA,NA
54093,2011,60,94,35,0,-34,35,8.4186894907,13.189280202,4.9109022029,0,-4.770590711,4.9109022029
54093,2012,57,92,-15,0,-35,-15,8.0259081949,12.954097437,-2.112081104,0,-4.928189242,-2.112081104
54093,2013,77,83,8,0,-6,8,10.878779316,11.726476406,1.1302627861,0,-0.84769709,1.1302627861
54093,2014,62,92,3,0,-30,3,8.7744126804,13.020096235,0.4245683555,0,-4.245683555,0.4245683555
54093,2015,69,75,41,0,-6,41,9.7595473833,10.608203678,5.7991513437,0,-0.848656294,5.7991513437
54093,2016,61,101,-5,0,-40,-5,8.6353340883,14.297848245,-0.70781427,0,-5.662514156,-0.70781427
54093,2017,55,116,-65,0,-61,-65,7.8819145887,16.623674405,-9.314989968,0,-8.741759817,-9.314989968
06107,2010,1854,641,-300,-23,1213,-323,NA,NA,NA,NA,NA,NA
06107,2011,8152,2845,-1158,169,5307,-989,18.31050136,6.3902571601,-2.601025586,0.3795969983,11.9202442,-2.221428587
06107,2012,8022,2814,-1855,80,5208,-1775,17.863644411,6.2663045838,-4.130772922,0.1781465411,11.597339827,-3.952626381
06107,2013,7767,2836,-2196,158,4931,-2038,17.175230695,6.2712700206,-4.85603278,0.3493866937,10.903960674,-4.506646087
06107,2014,7584,2794,-2227,228,4790,-1999,16.666025722,6.1398834213,-4.893887036,0.5010355834,10.526142301,-4.392851453
06107,2015,7513,2908,-2889,433,4605,-2456,16.420906767,6.3559159961,-6.314388347,0.946393269,10.064990771,-5.367995078
06107,2016,7422,3024,-2620,455,4398,-2165,16.144679999,6.5779456101,-5.699145998,0.9897371867,9.5667343893,-4.709408811
06107,2017,7292,2983,-1111,466,4309,-645,15.760897757,6.4474435011,-2.40131067,1.0072104162,9.3134542562,-1.394100254
40143,2010,2396,1321,346,166,1075,512,NA,NA,NA,NA,NA,NA
40143,2011,9449,5613,-855,976,3836,121,15.569068484,9.2485111018,-1.408779083,1.6081501577,6.3205573822,0.1993710749
40143,2012,9487,5321,981,1045,4166,2026,15.504104003,8.6958298095,1.6031965877,1.707788414,6.808274194,3.3109850017
40143,2013,9200,5736,3928,1239,3464,5167,14.855949768,9.2623617246,6.3428446399,2.0007088872,5.5935880429,8.343553527
40143,2014,9285,5644,2132,1512,3641,3644,14.803689682,8.9986025381,3.3991886271,2.4106816154,5.8050871441,5.8098702425
40143,2015,9651,5784,3484,1737,3867,5221,15.189933187,9.1035720188,5.4835485673,2.7339046675,6.0863611682,8.2174532348
40143,2016,9583,5892,-342,1808,3691,1466,14.915941208,9.1708990501,-0.532323061,2.8141523222,5.7450421578,2.2818292613
40143,2017,9555,5986,-4151,1811,3569,-2340,14.798948043,9.2712195696,-6.429140066,2.8049078918,5.5277284738,-3.624232174
28143,2010,48,10,-71,10,38,-61,NA,NA,NA,NA,NA,NA
28143,2011,190,131,-258,14,59,-244,17.806100932,12.276838011,-24.17881074,1.3120284898,5.5292629211,-22.86678225
28143,2012,203,97,-267,5,106,-262,19.324131366,9.2336982389,-25.41646835,0.4759638267,10.090433127,-24.94050452
28143,2013,203,115,-70,1,88,-69,19.446307118,11.016380879,-6.705623144,0.0957946163,8.4299262381,-6.609828528
28143,2014,194,87,-72,6,107,-66,18.53001576,8.3098524285,-6.877119251,0.5730932709,10.220163332,-6.30402598
28143,2015,192,100,-332,6,92,-326,18.505132283,9.6380897306,-31.99845791,0.5782853838,8.8670425522,-31.42017252
28143,2016,187,99,-198,7,88,-191,18.318965517,9.6982758621,-19.39655172,0.6857366771,8.6206896552,-18.71081505
28143,2017,181,91,-229,7,90,-222,17.938553023,9.0188305253,-22.69573835,0.6937561943,8.9197224975,-22.00198216
06109,2010,130,120,-206,10,10,-196,NA,NA,NA,NA,NA,NA
06109,2011,445,608,-241,53,-163,-188,8.0894382839,11.052535903,-4.381021632,0.9634611889,-2.963097619,-3.417560444
06109,2012,463,626,-489,50,-163,-439,8.490038416,11.478972027,-8.966800833,0.9168508009,-2.988933611,-8.049950032
06109,2013,459,600,-124,52,-141,-72,8.4799778301,11.08493834,-2.290887257,0.9606946561,-2.60496051,-1.330192601
06109,2014,460,706,28,62,-246,90,8.5287846482,13.089830351,0.5191434134,1.1495318439,-4.561045703,1.6686752573
06109,2015,470,701,-92,69,-231,-23,8.7489878166,13.049022254,-1.712567828,1.2844258709,-4.300034438,-0.428141957
06109,2016,461,680,344,75,-219,419,8.5866487856,12.665772612,6.4073908508,1.3969602146,-4.079123827,7.8043510654
06109,2017,466,532,455,75,-66,530,8.6268338964,9.8486601564,8.4231961864,1.3884389318,-1.22182626,9.8116351182
13287,2010,26,42,-12,0,-16,-12,NA,NA,NA,NA,NA,NA
13287,2011,120,119,31,-1,1,30,13.449899126,13.337816633,3.4745572742,-0.112082493,0.1120824927,3.3624747814
13287,2012,102,86,-525,-5,16,-530,11.73898032,9.8975716423,-60.42122224,-0.575440212,1.8414086776,-60.99666245
13287,2013,114,91,-266,-4,23,-270,13.697807149,10.934214479,-31.96155002,-0.480624812,2.7635926705,-32.44217483
13287,2014,120,118,-140,-3,2,-143,14.753796029,14.507899428,-17.21276203,-0.368844901,0.2458966005,-17.58160693
13287,2015,100,143,-37,-1,-43,-38,12.465719272,17.825978559,-4.612316131,-0.124657193,-5.360259287,-4.736973323
13287,2016,127,91,-44,-1,36,-45,15.9217702,11.408512505,-5.516203849,-0.125368269,4.5132576945,-5.641572118
13287,2017,117,91,-34,-1,26,-35,14.686499718,11.422833114,-4.267871713,-0.125525639,3.2636666039,-4.393397351
46125,2010,26,28,4,0,-2,4,NA,NA,NA,NA,NA,NA
46125,2011,91,102,16,0,-11,16,10.896246183,12.213374843,1.9158235048,0,-1.31712866,1.9158235048
46125,2012,90,100,-48,2,-10,-46,10.810161552,12.011290613,-5.765419494,0.2402258123,-1.201129061,-5.525193682
46125,2013,80,85,13,2,-5,15,9.6356519121,10.237880157,1.5657934357,0.2408912978,-0.602228245,1.8066847335
46125,2014,87,104,-104,2,-17,-102,10.547372249,12.608353034,-12.60835303,0.2424683276,-2.060980784,-12.36588471
46125,2015,92,131,-23,2,-39,-21,11.275891653,16.055889202,-2.818972913,0.2451280794,-4.779997549,-2.573844834
46125,2016,90,93,142,2,-3,144,10.978287387,11.3442303,17.321297878,0.2439619419,-0.365942913,17.565259819
46125,2017,90,94,51,2,-4,53,10.854489537,11.336911295,6.1508774046,0.2412108786,-0.482421757,6.3920882832
01125,2010,561,323,60,51,238,111,NA,NA,NA,NA,NA,NA
01125,2011,2405,1724,799,226,681,1025,12.280056779,8.8028348805,4.0797361192,1.1539679136,3.4772218988,5.2337040328
01125,2012,2451,1587,828,201,864,1029,12.400833806,8.0294260504,4.1892657654,1.0169594431,4.3714077552,5.2062252085
01125,2013,2400,1654,1115,288,746,1403,12.019561837,8.2834813659,5.5840881034,1.4423474204,3.736080471,7.0264355238
01125,2014,2467,1606,885,306,861,1191,12.226338417,7.9592620585,4.3860192539,1.5165219115,4.2670763589,5.9025411654
01125,2015,2485,1768,619,348,717,967,12.20302694,8.6820730905,3.0397077166,1.7089148391,3.5209538495,4.7486225557
01125,2016,2600,1776,626,356,824,982,12.659614612,8.6474905966,3.048045672,1.7333933854,4.0121240155,4.7814390573
01125,2017,2537,1799,445,355,738,800,12.253286098,8.6888694086,2.1492756458,1.7145906837,3.564416689,3.8638663295
39157,2010,278,258,-65,13,20,-52,NA,NA,NA,NA,NA,NA
39157,2011,1076,942,-278,85,134,-193,11.630546398,10.182132627,-3.004918121,0.9187699292,1.4484137707,-2.086148192
39157,2012,1128,977,-264,51,151,-213,12.201519781,10.568160307,-2.855674842,0.5516644582,1.6333594743,-2.304010384
39157,2013,1125,1028,46,42,97,88,12.162227904,11.113573587,0.4972999854,0.4540565084,1.0486543171,0.9513564938
39157,2014,1086,1010,-83,46,76,-37,11.727925097,10.907186324,-0.896333134,0.4967629415,0.8207387729,-0.399570192
39157,2015,1191,1015,-157,51,176,-106,12.855801302,10.956035534,-1.694677418,0.5505003076,1.8997657675,-1.14417711
39157,2016,1190,1044,-388,56,146,-332,12.853886951,11.276855442,-4.191015241,0.6048887977,1.5770315082,-3.586126443
39157,2017,1141,1002,-382,56,139,-326,12.34968774,10.845212196,-4.134601855,0.6061196437,1.5044755442,-3.528482211
26157,2010,156,104,-78,2,52,-76,NA,NA,NA,NA,NA,NA
26157,2011,506,545,-284,11,-39,-273,9.1087469172,9.810804486,-5.112419218,0.1980162373,-0.702057569,-4.914402981
26157,2012,532,516,-737,11,16,-726,9.664029646,9.3733821379,-13.38795084,0.1998201619,0.2906475082,-13.18813068
26157,2013,570,578,-501,12,-8,-489,10.466973943,10.61387884,-9.199919202,0.2203573462,-0.146904897,-8.979561856
26157,2014,549,557,-295,8,-8,-287,10.154443725,10.302413761,-5.45639508,0.1479700361,-0.147970036,-5.308425044
26157,2015,585,594,-197,8,-9,-189,10.870070144,11.037301993,-3.660519348,0.1486505319,-0.167231848,-3.511868816
26157,2016,548,622,-414,6,-74,-408,10.247587703,11.631386042,-7.74179071,0.1121998654,-1.383798339,-7.629590844
26157,2017,543,638,-383,6,-95,-377,10.245379673,12.037849414,-7.226483269,0.1132086152,-1.79246974,-7.113274654
13289,2010,13,18,-53,0,-5,-53,NA,NA,NA,NA,NA,NA
13289,2011,107,118,-144,4,-11,-140,12.029906122,13.266625443,-16.1897802,0.4497161167,-1.236719321,-15.74006408
13289,2012,108,80,-308,2,28,-306,12.435949105,9.2118141516,-35.46548448,0.2302953538,3.2241349531,-35.23518913
13289,2013,95,118,-14,1,-23,-13,11.136510169,13.832717895,-1.64116992,0.1172264228,-2.696207725,-1.523943497
13289,2014,87,119,-104,1,-32,-103,10.302563799,14.092012553,-12.31570845,0.1184202736,-3.789448754,-12.19728818
13289,2015,85,102,-45,2,-17,-43,10.183909423,12.220691308,-5.391481459,0.2396213982,-2.036781885,-5.151860061
13289,2016,98,96,-87,3,2,-84,11.841469309,11.59980667,-10.51232479,0.3624939584,0.241662639,-10.14983084
13289,2017,80,125,-18,3,-45,-15,9.7507465415,15.235541471,-2.193917972,0.3656529953,-5.48479493,-1.828264977
16083,2010,339,145,80,58,194,138,NA,NA,NA,NA,NA,NA
16083,2011,1178,716,-132,163,462,31,15.14168011,9.2032622737,-1.69669081,2.0951560763,5.9384178358,0.398465266
16083,2012,1191,665,-277,138,526,-139,15.22385198,8.5003035823,-3.540727958,1.7639727735,6.7235483974,-1.776755185
16083,2013,1204,733,639,152,471,791,15.230095884,9.2721430921,8.08308245,1.9227363574,5.9579527918,10.005818807
16083,2014,1210,721,461,208,489,669,15.07600299,8.9833042612,5.7438325442,2.5915773735,6.0926987291,8.3354099178
16083,2015,1238,766,533,226,472,759,15.199975444,9.4048313331,6.5440928205,2.7747935787,5.7951441112,9.3188863992
16083,2016,1205,757,801,230,448,1031,14.553579516,9.1427881277,9.674205139,2.7778616504,5.4107913886,12.452066789
16083,2017,1219,755,896,229,464,1125,14.455116803,8.9529230404,10.624925886,2.7155223527,5.5021937626,13.340448239
48457,2010,53,49,-2,1,4,-1,NA,NA,NA,NA,NA,NA
48457,2011,217,253,-64,-2,-36,-66,9.9949334439,11.653079084,-2.947814472,-0.092119202,-1.65814564,-3.039933674
48457,2012,215,270,-125,5,-55,-120,9.9666234007,12.516224736,-5.794548489,0.2317819396,-2.549601335,-5.562766549
48457,2013,244,282,45,7,-38,52,11.354382373,13.122687824,2.0940459294,0.3257404779,-1.768305451,2.4197864073
48457,2014,212,288,24,8,-76,32,9.8735533149,13.413129032,1.1177607526,0.3725869175,-3.539575717,1.4903476702
48457,2015,211,267,-34,9,-56,-25,9.8570494254,12.473138372,-1.588339718,0.4204428665,-2.616088947,-1.167896851
48457,2016,213,270,118,9,-57,127,9.9537361559,12.617412029,5.5142763681,0.420580401,-2.663675873,5.934856769
48457,2017,209,233,122,9,-24,131,9.7270379075,10.844018337,5.6779838503,0.4188676611,-1.11698043,6.0968515114
54095,2010,21,13,-21,0,8,-21,NA,NA,NA,NA,NA,NA
54095,2011,74,161,-10,0,-87,-10,8.0878736543,17.596589978,-1.092955899,0,-9.508716323,-1.092955899
54095,2012,91,125,-31,0,-34,-31,10.035842294,13.785497656,-3.418803419,0,-3.749655363,-3.418803419
54095,2013,104,117,-31,-1,-13,-32,11.540168664,12.982689747,-3.439857967,-0.11096316,-1.442521083,-3.550821127
54095,2014,87,116,104,0,-29,104,9.6366858662,12.848914488,11.519716438,0,-3.212228622,11.519716438
54095,2015,87,118,-102,0,-31,-102,9.6655927119,13.109654483,-11.33207421,0,-3.444061771,-11.33207421
54095,2016,88,97,32,0,-9,32,9.8362488124,10.842228805,3.57681775,0,-1.005979992,3.57681775
54095,2017,84,107,-140,0,-23,-140,9.4631893201,12.054300682,-15.7719822,0,-2.591111361,-15.7719822
37177,2010,15,4,-3,0,11,-3,NA,NA,NA,NA,NA,NA
37177,2011,44,65,-59,-1,-21,-60,10.055993601,14.855445092,-13.48417324,-0.228545309,-4.799451491,-13.71271855
37177,2012,38,46,-214,0,-8,-214,8.9877010407,10.879848628,-50.61494797,0,-1.892147588,-50.61494797
37177,2013,38,36,-20,1,2,-19,9.2434930674,8.7569934323,-4.864996351,0.2432498176,0.4864996351,-4.621746534
37177,2014,51,32,-4,3,19,-1,12.405740696,7.783994162,-0.97299927,0.7297494527,4.6217465337,-0.243249818
37177,2015,37,44,22,3,-7,25,8.9610075079,10.656333253,5.3281666263,0.7265681763,-1.695325745,6.0547348026
37177,2016,45,35,-112,2,10,-110,11.006481595,8.5605967959,-27.39390975,0.4891769598,2.4458847988,-26.90473279
37177,2017,45,41,6,2,4,8,11.123470523,10.134717587,1.483129403,0.4943764677,0.9887529354,1.9775058707
56041,2010,72,49,-52,1,23,-51,NA,NA,NA,NA,NA,NA
56041,2011,324,139,-373,-16,185,-389,15.431510764,6.6203086302,-17.76528863,-0.762049914,8.8112021337,-18.52733854
56041,2012,311,115,-80,-16,196,-96,14.845577355,5.4895221729,-3.818798033,-0.763759607,9.3560551816,-4.58255764
56041,2013,316,136,-207,-14,180,-221,15.062322744,6.4825186492,-9.866774709,-0.667318096,8.5798040945,-10.5340928
56041,2014,323,148,-296,-3,175,-299,15.452697046,7.080492764,-14.16098553,-0.143523502,8.3722042818,-14.30450903
56041,2015,305,150,-222,-1,155,-223,14.654654655,7.2072072072,-10.66666667,-0.048048048,7.4474474474,-10.71471471
56041,2016,301,137,-233,-1,164,-234,14.509170664,6.603841797,-11.23135138,-0.048203225,7.9053288665,-11.2795546
56041,2017,295,140,-372,-1,155,-373,14.31830316,6.7951269233,-18.05562297,-0.048536621,7.5231762365,-18.10415959
49047,2010,160,29,-272,2,131,-270,NA,NA,NA,NA,NA,NA
49047,2011,620,214,367,-3,406,364,18.869360116,6.5129726851,11.16944381,-0.091303355,12.356387431,11.078140455
49047,2012,661,203,909,12,458,921,19.472676388,5.9802621888,26.778612461,0.3535130358,13.492414199,27.132125497
49047,2013,737,225,517,7,512,524,20.957147326,6.3980436204,14.701282452,0.199050246,14.559103705,14.900332698
49047,2014,757,204,640,13,553,653,20.855430815,5.6202217784,17.632068324,0.3581513878,15.235209036,17.990219712
49047,2015,722,244,372,20,478,392,19.335573975,6.5344599028,9.9623732944,0.5356114674,12.801114072,10.497984762
49047,2016,600,240,-1959,18,360,-1941,16.222793024,6.4891172097,-52.96741922,0.4866837907,9.7336758145,-52.48073543
49047,2017,565,229,-1402,18,336,-1384,15.838753084,6.4196008074,-39.3025342,0.5045974434,9.4191522763,-38.79793676
36111,2010,420,416,-160,83,4,-77,NA,NA,NA,NA,NA,NA
36111,2011,1738,1578,-423,366,160,-57,9.5247490026,8.6479021439,-2.318163883,2.0057871893,0.8768468587,-0.312376693
36111,2012,1637,1613,-1212,356,24,-856,8.9894427589,8.8576488516,-6.655592318,1.9549429579,0.1317939073,-4.70064936
36111,2013,1596,1617,-1105,397,-21,-708,8.8017780033,8.9175908717,-6.093962841,2.1894147038,-0.115812868,-3.904548137
36111,2014,1561,1620,-531,410,-59,-121,8.6307944091,8.9570063694,-2.935907643,2.2668966737,-0.32621196,-0.66901097
36111,2015,1537,1722,-1056,433,-185,-623,8.5219633228,9.5477038659,-5.855037911,2.4007873252,-1.025740543,-3.454250586
36111,2016,1528,1700,-686,453,-172,-233,8.5007427023,9.4576325877,-3.816432915,2.5201809189,-0.956889885,-1.296251996
36111,2017,1518,1698,-397,453,-180,56,8.4576961971,9.4605850742,-2.211927135,2.5239370074,-1.002888877,0.3120098729
41059,2010,300,127,48,-10,173,38,NA,NA,NA,NA,NA,NA
41059,2011,1090,671,289,-43,419,246,14.263375186,8.7804814216,3.781757274,-0.562683608,5.482893764,3.2190736658
41059,2012,1088,591,-215,-45,497,-260,14.155515512,7.6892552091,-2.797275584,-0.585476285,6.4662603028,-3.382751869
41059,2013,1110,614,-553,-25,496,-578,14.42813877,7.9809704548,-7.188072739,-0.32495808,6.4471683153,-7.513030819
41059,2014,1086,636,-662,-16,450,-678,14.144032091,8.283245313,-8.621868549,-0.20838353,5.8607867781,-8.830252079
41059,2015,1017,670,-537,2,347,-535,13.281010245,8.7495347729,-7.012686825,0.0261180142,4.5314754719,-6.986568811
41059,2016,1011,660,-187,3,351,-184,13.204466793,8.6201266897,-2.442369229,0.039182394,4.5843401032,-2.403186835
41059,2017,987,651,0,5,336,5,12.848718383,8.4746865928,0,0.0650897588,4.3740317898,0.0650897588
47171,2010,31,42,-17,3,-11,-14,NA,NA,NA,NA,NA,NA
47171,2011,166,256,89,5,-90,94,9.0779831565,13.999781253,4.8671114514,0.2734332276,-4.921798097,5.140544679
47171,2012,158,234,11,8,-76,19,8.6539778173,12.816650691,0.6024921265,0.438176092,-4.162672874,1.0406682185
47171,2013,165,274,-71,-2,-109,-73,9.0984284533,15.108905431,-3.915081334,-0.110283981,-6.010476978,-4.025365316
47171,2014,158,277,-17,1,-119,-16,8.7904751307,15.411149438,-0.945810615,0.0556359185,-6.620674307,-0.890174697
47171,2015,156,294,12,1,-138,13,8.7434144154,16.477973321,0.6725703396,0.0560475283,-7.734558906,0.728617868
47171,2016,149,263,1,1,-114,2,8.4076289358,14.840311477,0.0564270398,0.0564270398,-6.432682541,0.1128540797
47171,2017,155,266,205,1,-111,206,8.751129178,15.018066847,11.574074074,0.0564588979,-6.266937669,11.630532972
05139,2010,111,81,-104,3,30,-101,NA,NA,NA,NA,NA,NA
05139,2011,524,580,-123,0,-56,-123,12.632898575,13.982979339,-2.965355963,0,-1.350080764,-2.965355963
05139,2012,528,478,-585,-14,50,-599,12.840935345,11.62493768,-14.22717268,-0.340479346,1.2159976653,-14.56765203
05139,2013,485,516,-216,-8,-31,-224,11.910170303,12.67143892,-5.304323269,-0.196456417,-0.761268617,-5.500779686
05139,2014,522,577,-409,-9,-55,-418,12.933277174,14.295978791,-10.13354476,-0.222987537,-1.362701618,-10.3565323
05139,2015,547,521,-72,-7,26,-79,13.640557592,12.992194708,-1.795466447,-0.174559238,0.6483628837,-1.970025685
05139,2016,587,537,-251,-6,50,-257,14.686014511,13.435076307,-6.279709782,-0.150112584,1.2509382037,-6.429822367
05139,2017,576,546,-442,-6,30,-448,14.524181754,13.767713954,-11.14529225,-0.15129356,0.7564677997,-11.29658581
12125,2010,42,23,-13,3,19,-10,NA,NA,NA,NA,NA,NA
12125,2011,175,197,-242,9,-22,-233,11.348529555,12.775201842,-15.69339516,0.5836386628,-1.426672287,-15.10975649
12125,2012,164,159,-55,13,5,-42,10.735091968,10.407802579,-3.600183282,0.8509524121,0.3272893893,-2.74923087
12125,2013,185,217,-79,17,-32,-62,12.1626508,14.266460669,-5.193780612,1.1176489925,-2.103809868,-4.07613162
12125,2014,185,217,124,15,-32,139,12.157455477,14.260366695,8.1487809687,0.9857396333,-2.102911218,9.134520602
12125,2015,145,249,103,15,-104,118,9.491081656,16.298478154,6.7419407626,0.9818360334,-6.807396498,7.7237767959
12125,2016,144,235,58,15,-91,73,9.4268600046,15.384111813,3.7969297241,0.9819645838,-5.957251808,4.7788943079
12125,2017,147,213,299,15,-66,314,9.5504158004,13.838357588,19.425675676,0.9745322245,-4.287941788,20.4002079
13291,2010,40,49,21,1,-9,22,NA,NA,NA,NA,NA,NA
13291,2011,165,301,15,6,-136,21,7.7424804092,14.124161231,0.7038618554,0.2815447422,-6.381680822,0.9854065975
13291,2012,167,282,190,2,-115,192,7.843689822,13.245033113,8.9239584801,0.0939364051,-5.401343291,9.0178948852
13291,2013,139,309,257,4,-170,261,6.5026197605,14.455464072,12.022829341,0.1871257485,-7.952844311,12.20995509
13291,2014,155,315,484,4,-160,488,7.1790833932,14.589750122,22.417266853,0.1852666682,-7.410666728,22.602533522
13291,2015,180,309,372,3,-129,375,8.2249994288,14.119582353,16.998332153,0.1370833238,-5.894582924,17.135415477
13291,2016,171,293,767,4,-122,771,7.6561450638,13.118423998,34.340720842,0.1790911126,-5.462278934,34.519811954
13291,2017,170,270,892,4,-100,896,7.3722327024,11.708840174,38.68253865,0.1734642989,-4.336607472,38.856002949
17181,2010,33,73,-35,0,-40,-35,NA,NA,NA,NA,NA,NA
17181,2011,183,192,-35,4,-9,-31,10.33197832,10.840108401,-1.976061427,0.2258355917,-0.508130081,-1.750225836
17181,2012,183,238,-31,7,-55,-24,10.368271955,13.484419263,-1.756373938,0.3966005666,-3.116147309,-1.359773371
17181,2013,188,235,-23,2,-47,-21,10.697621486,13.372026858,-1.308751565,0.1138044839,-2.674405372,-1.194947081
17181,2014,188,239,-94,4,-51,-90,10.762229155,13.681770043,-5.381114578,0.228983599,-2.919540888,-5.152130979
17181,2015,197,237,-78,4,-40,-74,11.360687408,13.667425968,-4.498140192,0.230673856,-2.30673856,-4.267466336
17181,2016,196,207,-159,2,-11,-157,11.396011396,12.035583464,-9.24472353,0.1162858306,-0.639572068,-9.1284377
17181,2017,192,226,-82,2,-34,-80,11.256045728,13.249303825,-4.80726953,0.1172504763,-1.993258098,-4.690019053
18161,2010,19,8,11,0,11,11,NA,NA,NA,NA,NA,NA
18161,2011,80,73,-49,-1,7,-50,10.643959553,9.7126130921,-6.519425226,-0.133049494,0.9313464609,-6.652474721
18161,2012,72,59,-159,-1,13,-160,9.6995823791,7.948268894,-21.41991109,-0.134716422,1.7513134851,-21.55462751
18161,2013,63,77,-32,0,-14,-32,8.5959885387,10.506208214,-4.366216401,0,-1.910219675,-4.366216401
18161,2014,76,76,-57,-1,0,-58,10.442429239,10.442429239,-7.831821929,-0.137400385,0,-7.969222314
18161,2015,80,72,-55,-1,8,-56,11.073430687,9.9660876185,-7.612983597,-0.138417884,1.1073430687,-7.751401481
18161,2016,65,65,-31,-1,0,-32,9.0478841871,9.0478841871,-4.315144766,-0.139198218,0,-4.454342984
18161,2017,61,65,37,-1,-4,36,8.491091314,9.0478841871,5.1503340757,-0.139198218,-0.556792873,5.0111358575
19175,2010,49,52,-22,2,-3,-20,NA,NA,NA,NA,NA,NA
19175,2011,145,137,25,6,8,31,11.572226656,10.933758978,1.9952114924,0.4788507582,0.6384676776,2.4740622506
19175,2012,121,150,55,6,-29,61,9.6303076127,11.938397867,4.3774125512,0.4775359147,-2.308090254,4.8549484659
19175,2013,141,124,2,10,17,12,11.196252035,9.8463493072,0.1588120856,0.794060428,1.3499027276,0.9528725136
19175,2014,148,178,24,13,-30,37,11.735786218,14.114661803,1.9031004678,1.0308460867,-2.378875585,2.9339465546
19175,2015,112,150,-168,14,-38,-154,8.945686901,11.980830671,-13.41853035,1.1182108626,-3.03514377,-12.30031949
19175,2016,138,140,-50,16,-2,-34,11.122305057,11.283497884,-4.029820673,1.2895426154,-0.161192827,-2.740278058
19175,2017,123,137,60,16,-14,76,9.9033816425,11.030595813,4.8309178744,1.2882447665,-1.127214171,6.1191626409
21225,2010,40,51,249,0,-11,249,NA,NA,NA,NA,NA,NA
21225,2011,167,161,-12,-7,6,-19,10.936834867,10.543894692,-0.78588035,-0.458430204,0.3929401749,-1.244310554
21225,2012,163,140,-206,-2,23,-208,10.743120778,9.2272202999,-13.57719558,-0.131817433,1.5159004778,-13.70901302
21225,2013,184,159,-36,-3,25,-39,12.205233657,10.546913867,-2.387980498,-0.198998375,1.6583197904,-2.586978873
21225,2014,186,166,1,-4,20,-3,12.33789924,11.011243408,0.0663327916,-0.265331166,1.3266558323,-0.198998375
21225,2015,176,188,-102,-3,-12,-105,11.71420014,12.512895604,-6.788911445,-0.199673866,-0.798695464,-6.988585311
21225,2016,168,172,-167,-3,-4,-170,11.29108139,11.559916661,-11.22387257,-0.201626453,-0.268835271,-11.42549903
21225,2017,166,173,-115,-3,-7,-118,11.26951799,11.744738629,-7.807196198,-0.203665988,-0.475220638,-8.010862186
28145,2010,78,73,2,1,5,3,NA,NA,NA,NA,NA,NA
28145,2011,335,268,63,23,67,86,12.309388205,9.847510564,2.3148998714,0.8451221753,2.461877641,3.1600220467
28145,2012,345,287,-48,34,58,-14,12.63296655,10.509163478,-1.757630129,1.2449880078,2.1238030722,-0.512642121
28145,2013,394,253,252,25,141,277,14.306982824,9.1869712045,9.1506590653,0.9078034787,5.1200116199,10.058462544
28145,2014,387,285,223,41,102,264,13.854828605,10.203168352,7.9835317283,1.4678242191,3.6516602524,9.4513559474
28145,2015,346,318,79,46,28,125,12.273638282,11.280395878,2.802362498,1.6317553786,0.9932424044,4.4341178766
28145,2016,388,276,-98,46,112,-52,13.712670083,9.7543735642,-3.463509454,1.6257289274,3.9582965188,-1.837780527
28145,2017,379,277,82,47,102,129,13.326066701,9.739631863,2.8832123205,1.6525729154,3.5864348376,4.5357852358
34039,2010,1740,1016,-333,954,724,621,NA,NA,NA,NA,NA,NA
34039,2011,6992,3946,-3356,3850,3046,494,12.959631822,7.3138883251,-6.220326715,7.1359528768,5.6457434968,0.9156261613
34039,2012,6786,3915,-1903,3657,2871,1754,12.483696322,7.2021324935,-3.500806676,6.7275092027,5.2815638286,3.2267025271
34039,2013,6753,4029,-1919,3824,2724,1905,12.319182297,7.3499164036,-3.500742015,6.9759444843,4.9692658931,3.4752024693
34039,2014,6873,3775,-3479,3984,3098,505,12.445112401,6.8354865871,-6.29951201,7.2139280961,5.6096258137,0.9144160865
34039,2015,6763,3976,-4181,4395,2787,214,12.173061589,7.1566010465,-7.525590789,7.9107800803,5.0164605424,0.3851892917
34039,2016,6820,3969,-3346,4519,2851,1173,12.198404728,7.0990422821,-5.984730531,8.0827845989,5.0993624455,2.0980540683
34039,2017,6758,4038,-4463,4518,2720,55,12.014243581,7.1786794288,-7.934236328,8.0320142791,4.8355641521,0.0977779516
35059,2010,15,15,-12,0,0,-12,NA,NA,NA,NA,NA,NA
35059,2011,48,53,-127,-7,-5,-134,10.727455582,11.844898871,-28.38305956,-1.564420606,-1.11744329,-29.94748017
35059,2012,36,55,12,-1,-19,11,8.1781008632,12.494320763,2.7260336211,-0.227169468,-4.3162199,2.4988641527
35059,2013,44,41,-58,-3,3,-61,10.070954452,9.3842984665,-13.27534905,-0.686655985,0.6866559854,-13.96200504
35059,2014,39,46,-93,-2,-7,-95,9.0887904917,10.720111862,-21.67326963,-0.46609182,-1.63132137,-22.13936145
35059,2015,39,54,-70,-1,-15,-71,9.2879256966,12.860204811,-16.67063587,-0.238151941,-3.572279114,-16.90878781
35059,2016,37,35,-4,-1,2,-5,8.9049338147,8.4235860409,-0.962695548,-0.240673887,0.4813477738,-1.203369434
35059,2017,40,37,34,-1,3,33,9.5923261391,8.8729016787,8.1534772182,-0.239808153,0.7194244604,7.9136690647
37179,2010,590,302,435,35,288,470,NA,NA,NA,NA,NA,NA
37179,2011,2368,1214,1592,134,1154,1726,11.632933779,5.9638435842,7.8207899391,0.6582825702,5.6690901945,8.4790725093
37179,2012,2384,1157,1898,91,1227,1989,11.538815239,5.6000038721,9.1865232059,0.4404497427,5.9388113665,9.6269729486
37179,2013,2336,1277,2968,102,1059,3070,11.108257963,6.0724509496,14.113574329,0.4850352364,5.035807013,14.598609566
37179,2014,2355,1319,4352,124,1036,4476,10.945343001,6.1303216211,20.226807957,0.5763153002,4.8150213794,20.803123257
37179,2015,2365,1329,3087,159,1036,3246,10.745237906,6.0382330558,14.02560229,0.722407115,4.7070048501,14.748009405
37179,2016,2394,1414,3151,168,980,3319,10.668758231,6.3014302999,14.042296234,0.7486847881,4.3673279306,14.790981022
37179,2017,2400,1402,3664,169,998,3833,10.482500775,6.1235275362,16.003284517,0.7381427629,4.358973239,16.74142728
39159,2010,164,54,17,6,110,23,NA,NA,NA,NA,NA,NA
39159,2011,600,327,330,35,273,365,11.383687176,6.2041095111,6.261027947,0.6640484186,5.1795776652,6.9250763656
39159,2012,600,318,-649,46,282,-603,11.347625037,6.0142412694,-12.27434775,0.8699845861,5.3333837672,-11.40436316
39159,2013,606,353,302,56,253,358,11.427709367,6.6567349941,5.6949970771,1.0560259481,4.7709743725,6.7510230251
39159,2014,591,355,20,75,236,95,11.047967996,6.636258272,0.3738737055,1.4020263955,4.4117097245,1.7759001009
39159,2015,660,377,242,82,283,324,12.232642621,6.9874337399,4.4853022945,1.5198131742,5.2452088816,6.0051154687
39159,2016,661,360,820,81,301,901,12.049949868,6.5627563577,14.948500592,1.4766201805,5.4871935102,16.425120773
39159,2017,678,344,871,81,334,952,12.085884649,6.1320712675,15.526261843,1.443888874,5.9538133818,16.970150717
41061,2010,73,89,1,4,-16,5,NA,NA,NA,NA,NA,NA
41061,2011,293,251,87,21,42,108,11.354828709,9.7271740815,3.3715702992,0.8138273136,1.6276546272,4.1853976128
41061,2012,316,255,-167,2,61,-165,12.235968326,9.873961782,-6.466476932,0.0774428375,2.3620065439,-6.389034094
41061,2013,311,262,-336,9,49,-327,12.13137775,10.220003121,-13.10656889,0.3510688095,1.9113746294,-12.75550008
41061,2014,284,232,46,16,52,62,11.113285071,9.0784582274,1.8000391313,0.6261005674,2.0348268441,2.4261396987
41061,2015,292,277,37,18,15,55,11.387123192,10.802168233,1.4428888976,0.7019459502,0.5849549585,2.1448348477
41061,2016,318,271,305,17,47,322,12.297221524,10.479707651,11.794504921,0.6573986349,1.817513873,12.451903556
41061,2017,315,275,126,16,40,142,12.053955802,10.523294748,4.8215823209,0.6122644217,1.5306610542,5.4338467426
42119,2010,93,72,18,8,21,26,NA,NA,NA,NA,NA,NA
42119,2011,426,406,56,25,20,81,9.4588893576,9.0148100451,1.2434220752,0.5550991407,0.4440793126,1.7985212159
42119,2012,382,360,19,34,22,53,8.4664058777,7.9788118219,0.4211039573,0.7535544498,0.4875940558,1.1746584071
42119,2013,434,371,-523,35,63,-488,9.6553872166,8.2537987497,-11.63540902,0.7786602594,1.4015884669,-10.85674876
42119,2014,397,363,145,47,34,192,8.8510372658,8.0930139231,3.2327466084,1.0478557972,0.7580233427,4.2806024056
42119,2015,424,353,447,50,71,497,9.3701657459,7.8011049724,9.8784530387,1.1049723757,1.5690607735,10.983425414
42119,2016,377,403,-127,56,-26,-71,8.2879001055,8.8594794231,-2.791945128,1.2310939149,-0.571579318,-1.560851214
42119,2017,397,410,-897,55,-13,-842,8.8187926917,9.1075692786,-19.92558449,1.2217470984,-0.288776587,-18.7038374
45087,2010,78,58,-63,-1,20,-64,NA,NA,NA,NA,NA,NA
45087,2011,309,365,-208,-3,-56,-211,10.731775084,12.676692252,-7.22397805,-0.104191991,-1.944917167,-7.328170041
45087,2012,298,385,-372,-5,-87,-377,10.481516654,13.541556751,-13.08430938,-0.175864373,-3.060040097,-13.26017375
45087,2013,303,387,-121,-3,-84,-124,10.783877569,13.77346739,-4.306432957,-0.106771065,-2.989589821,-4.413204022
45087,2014,316,381,-9,-1,-65,-10,11.304285612,13.629534235,-0.321957502,-0.035773056,-2.325248623,-0.357730557
45087,2015,317,385,-112,-1,-68,-113,11.393656213,13.837721269,-4.025518915,-0.035942133,-2.444065055,-4.061461048
45087,2016,324,391,23,-1,-67,22,11.693373755,14.111447957,0.830085174,-0.03609066,-2.418074202,0.7939945142
45087,2017,320,378,-87,-1,-58,-88,11.589583862,13.690195936,-3.150918112,-0.03621745,-2.100612075,-3.187135562
46127,2010,51,36,77,0,15,77,NA,NA,NA,NA,NA,NA
46127,2011,179,121,94,-2,58,92,12.286783128,8.3055908295,6.4522771734,-0.137282493,3.9811922985,6.3149946803
46127,2012,171,108,102,-10,63,92,11.614875191,7.335710647,6.9281711666,-0.679232467,4.2791645441,6.2489386993
46127,2013,156,116,-72,-8,40,-80,10.55408971,7.8479128611,-4.871118328,-0.54123537,2.7061768487,-5.412353697
46127,2014,148,115,200,-6,33,194,9.9495798319,7.731092437,13.445378151,-0.403361345,2.218487395,13.042016807
46127,2015,146,131,-125,-6,15,-131,9.7786410368,8.7739861358,-8.372124175,-0.40186196,1.004654901,-8.773986136
46127,2016,172,106,60,-6,66,54,11.518885615,7.0988481114,4.0182159121,-0.401821591,4.4200375033,3.6163943209
46127,2017,163,107,-13,-6,56,-19,10.859065321,7.1283434929,-0.866060424,-0.399720196,3.7307218281,-1.26578062
47173,2010,50,19,-20,-1,31,-21,NA,NA,NA,NA,NA,NA
47173,2011,210,193,65,-6,17,59,10.963481166,10.075961262,3.3934584562,-0.313242319,0.8875199039,3.0802161372
47173,2012,222,199,-110,-2,23,-112,11.594505667,10.393273098,-5.74502533,-0.104455006,1.2012325691,-5.849480336
47173,2013,229,212,-63,-1,17,-64,12.003040071,11.111984695,-3.302146395,-0.052415022,0.8910553765,-3.354561417
47173,2014,158,256,33,5,-98,38,8.3061718011,13.458101146,1.7348333509,0.262853538,-5.151929345,1.9976868889
47173,2015,207,208,164,7,-1,171,10.851615947,10.904039213,8.597415533,0.3669628581,-0.052423265,8.9643783911
47173,2016,222,231,74,6,-9,80,11.564608132,12.033443596,3.8548693772,0.31255697650000003,-0.468835465,4.1674263538
47173,2017,218,200,185,6,18,191,11.273723949,10.342866008,9.5671510576,0.3102859802,0.9308579407,9.8774370378
22111,2010,69,40,27,1,29,28,NA,NA,NA,NA,NA,NA
22111,2011,297,244,-151,14,53,-137,13.02888728,10.703866991,-6.624114409,0.6141563028,2.3250202891,-6.009958106
22111,2012,302,243,-302,11,59,-291,13.339517215,10.733452594,-13.33951722,0.4858764549,2.6060646216,-12.85364076
22111,2013,267,260,-101,19,7,-82,11.873526927,11.562235959,-4.491483969,0.8449326277,0.3112909681,-3.646551341
22111,2014,278,298,108,18,-20,126,12.354182869,13.242973003,4.7994667259,0.799911121,-0.888790134,5.5993778469
22111,2015,278,262,-91,20,16,-71,12.340472756,11.630229719,-4.039507269,0.8878037954,0.7102430363,-3.151703474
22111,2016,305,230,11,24,75,35,13.523100115,10.197747628,0.4877183648,1.064112796,3.3253524874,1.5518311608
22111,2017,291,240,-111,24,51,-87,12.881806109,10.624169987,-4.913678619,1.0624169987,2.2576361222,-3.85126162
48459,2010,109,76,24,9,33,33,NA,NA,NA,NA,NA,NA
48459,2011,515,458,258,40,57,298,13.019352066,11.578375235,6.5223161807,1.011211811,1.4409768306,7.5335279916
48459,2012,467,446,129,43,21,172,11.725860922,11.198573814,3.2390493767,1.0796831256,0.5272871078,4.3187325022
48459,2013,483,400,-265,20,83,-245,12.12395045,10.040538675,-6.651856872,0.5020269337,2.083411775,-6.149829938
48459,2014,475,445,428,26,30,454,11.874703132,11.124721882,10.699732507,0.6499837504,0.7499812505,11.349716257
48459,2015,475,481,121,27,-6,148,11.782799593,11.931634956,3.0015131595,0.6697591348,-0.148835363,3.6712722943
48459,2016,479,459,438,25,20,463,11.791494861,11.299156871,10.782201982,0.6154224875,0.49233799,11.397624469
48459,2017,472,443,365,26,29,391,11.491874125,10.785805588,8.8867246941,0.6330269645,0.7060685373,9.5197516587
54097,2010,65,80,2,0,-15,2,NA,NA,NA,NA,NA,NA
54097,2011,256,261,44,-11,-5,33,10.556265721,10.762442786,1.8143581708,-0.453589543,-0.206177065,1.3607686281
54097,2012,277,254,161,-13,23,148,11.376237217,10.431639903,6.6121811984,-0.53390283,0.9445973141,6.0782783687
54097,2013,314,257,107,-2,57,105,12.808223369,10.483163713,4.3645856703,-0.081581041000000007,2.3250596561,4.2830046297
54097,2014,265,267,69,-4,-2,65,10.761202818,10.842419443,2.801973564,-0.16243325,-0.081216625,2.6395403139
54097,2015,270,250,29,-4,20,25,10.94224924,10.131712259,1.1752786221,-0.162107396,0.8105369807,1.0131712259
54097,2016,237,285,-33,-5,-48,-38,9.6136294493,11.560693642,-1.338606632,-0.202819187,-1.947064192,-1.541425819
54097,2017,244,280,-103,-5,-36,-108,9.9439633214,11.411105451,-4.197656648,-0.20376974,-1.467142129,-4.401426388
13293,2010,82,119,-63,5,-37,-58,NA,NA,NA,NA,NA,NA
13293,2011,341,347,-125,1,-6,-124,12.632436838,12.854708454,-4.630658665,0.0370452693,-0.222271616,-4.593613396
13293,2012,305,313,-351,-3,-8,-354,11.401869159,11.700934579,-13.12149533,-0.112149533,-0.299065421,-13.23364486
13293,2013,332,367,-90,-5,-35,-95,12.525465932,13.845921678,-3.395457632,-0.188636535,-1.320455746,-3.584094167
13293,2014,308,358,-208,-5,-50,-213,11.707020411,13.607510738,-7.906039758,-0.190049033,-1.900490327,-8.096088791
13293,2015,361,367,74,-4,-6,70,13.773894464,14.002823458,2.8234575909,-0.152619329,-0.228928994,2.6708382617
13293,2016,310,374,41,-4,-64,37,11.820105618,14.260385488,1.5633042915,-0.152517492,-2.44027987,1.4107867996
13293,2017,315,375,-12,-4,-60,-16,12.034843738,14.327194926,-0.458470238,-0.152823413,-2.292351188,-0.61129365
48461,2010,7,14,-6,0,-7,-6,NA,NA,NA,NA,NA,NA
48461,2011,41,37,-62,3,4,-59,12.386706949,11.178247734,-18.73111782,0.9063444109,1.2084592145,-17.82477341
48461,2012,53,42,-36,2,11,-34,16.200519639,12.838147639,-11.00412655,0.6113403637,3.3623720006,-10.39278618
48461,2013,55,31,88,10,24,98,16.55379985,9.3303235515,26.486079759,3.0097817908,7.223476298,29.49586155
48461,2014,53,33,64,10,20,74,15.445140609,9.6167856622,18.65073583,2.9141774734,5.8283549468,21.564913303
48461,2015,48,33,144,10,15,154,13.466124281,9.2579604433,40.398372843,2.8054425586,4.2081638378,43.203815402
48461,2016,65,22,-6,10,43,4,17.694296992,5.9888389819,-1.633319722,2.7221995372,11.70545801,1.0888798149
48461,2017,60,13,-91,10,47,-81,16.304347826,3.5326086957,-24.72826087,2.7173913043,12.77173913,-22.01086957
49049,2010,3253,458,441,84,2795,525,NA,NA,NA,NA,NA,NA
49049,2011,12122,1995,262,562,10127,824,23.071176731,3.7969804965,0.4986510727,1.0696255835,19.274196234,1.5682766562
49049,2012,11547,2101,-1078,601,9446,-477,21.570356312,3.9247699498,-2.013756309,1.1226971632,17.645586362,-0.891059146
49049,2013,12175,2197,1357,579,9978,1936,22.310609497,4.0259884241,2.4866938059,1.0610137904,18.284621072,3.5477075963
49049,2014,11811,2183,-856,580,9628,-276,21.232456842,3.9243462269,-1.53881831,1.042657266,17.308110615,-0.496161044
49049,2015,11925,2384,1921,706,9541,2627,21.032729043,4.2047820577,3.3881654081,1.2452081094,16.827946985,4.6333735175
49049,2016,12177,2378,6909,715,9799,7624,20.931437809,4.0876208517,11.876102802,1.2290365471,16.843816958,13.10513935
49049,2017,12397,2249,5058,720,10148,5778,20.715180884,3.7580416075,8.4518339043,1.2031080291,16.957139276,9.6549419333
48463,2010,96,75,8,5,21,13,NA,NA,NA,NA,NA,NA
48463,2011,411,219,-108,45,192,-63,15.508556119,8.2636831877,-4.075241024,1.6980170934,7.2448729317,-2.377223931
48463,2012,382,233,-28,32,149,4,14.339339339,8.7462462462,-1.051051051,1.2012012012,5.5930930931,0.1501501502
48463,2013,427,276,-26,13,151,-13,15.943841831,10.305621418,-0.970819409,0.4854097045,5.6382204133,-0.485409704
48463,2014,387,254,67,18,133,85,14.357262104,9.4231125951,2.4856241885,0.6677796327,4.9341495084,3.1534038212
48463,2015,440,236,-361,18,204,-343,16.300220423,8.7428454998,-13.37358994,0.6668271991,7.5573749236,-12.70676274
48463,2016,399,241,3,21,158,24,14.769299106,8.9208047232,0.1110473617,0.7773315319,5.8484943829,0.8883788936
48463,2017,408,244,-156,20,164,-136,15.044802537,8.9973819094,-5.752424499,0.7374903204,6.0474206276,-5.014934179
48465,2010,205,120,-14,30,85,16,NA,NA,NA,NA,NA,NA
48465,2011,881,332,-595,12,549,-583,17.992994782,6.7805610302,-12.15190908,0.2450805192,11.212433752,-11.90682856
48465,2012,873,328,-726,140,545,-586,17.839444995,6.7025635262,-14.8355522,2.8608502856,11.136881469,-11.97470191
48465,2013,893,371,-552,114,522,-438,18.23695792,7.5766084976,-11.27301318,2.3281222877,10.660349423,-8.944890895
48465,2014,852,319,-873,120,533,-753,17.420106729,6.522316956,-17.84947556,2.453536159,10.897789773,-15.3959394
48465,2015,925,366,-634,168,559,-466,18.932803897,7.4912499744,-12.97664613,3.4386065456,11.441553923,-9.538039585
48465,2016,870,337,-632,147,533,-485,17.780684454,6.8874605299,-12.91654319,3.0043225457,10.893223924,-9.912220644
48465,2017,885,360,-398,125,525,-273,18.032152244,7.3351127774,-8.109374682,2.5469141588,10.697039467,-5.562460523
02261,2010,22,23,20,2,-1,22,NA,NA,NA,NA,NA,NA
02261,2011,136,61,-9,19,75,10,14.021341306,6.2889839682,-0.927882881,1.958863859,7.732357338,1.0309809784
02261,2012,109,55,-95,30,54,-65,11.192688812,5.6476870155,-9.755095754,3.0805565539,5.545001797,-6.6745392
02261,2013,138,44,-74,16,94,-58,14.148041829,4.5109698585,-7.586631126,1.6403526758,9.6370719705,-5.94627845
02261,2014,122,62,-366,2,60,-364,12.674666251,6.4412238325,-38.02399875,0.207781414,6.2334424186,-37.81621734
02261,2015,129,69,-217,4,60,-213,13.719755384,7.3384738102,-23.07896836,0.4254187716,6.381281574,-22.65354959
02261,2016,127,47,-71,3,80,-68,13.606899877,5.0356243639,-7.607007018,0.3214228317,8.5712755129,-7.285584186
02261,2017,131,40,-158,3,91,-155,14.072403051,4.2969169621,-16.972822,0.3222687722,9.7754860887,-16.65055323
35061,2010,216,89,85,5,127,90,NA,NA,NA,NA,NA,NA
35061,2011,966,583,-281,5,383,-276,12.571331897,7.5870460623,-3.656878119,0.0650690057,4.9842858351,-3.591809114
35061,2012,908,590,-545,23,318,-522,11.823917389,7.6829419157,-7.09695482,0.2995045154,4.1409754732,-6.797450305
35061,2013,870,598,-666,7,272,-659,11.372028731,7.8166358402,-8.705484063,0.0914990817,3.5553928905,-8.613984981
35061,2014,806,646,-769,38,160,-731,10.600799663,8.4964225589,-10.11416246,0.4997895623,2.1043771044,-9.614372896
35061,2015,825,673,-364,45,152,-319,10.903323862,8.8944690412,-4.810678649,0.5947267561,2.0088548206,-4.215951893
35061,2016,850,643,-197,50,207,-147,11.241973562,8.504222353,-2.605492696,0.6612925624,2.7377512085,-1.944200134
35061,2017,813,660,104,49,153,153,10.727079609,8.7083303096,1.3722217458,0.6465275533,2.018749299,2.018749299
16085,2010,19,6,-85,0,13,-85,NA,NA,NA,NA,NA,NA
16085,2011,88,70,-167,-4,18,-171,9.0614220254,7.2079493384,-17.19610771,-0.411882819,1.853472687,-17.60799053
16085,2012,79,58,-116,-4,21,-120,8.2407552287,6.0501747249,-12.10034945,-0.417253429,2.1905805038,-12.51760288
16085,2013,92,61,19,-9,31,10,9.6259482082,6.3824221815,1.9879675647,-0.941668846,3.2435260267,1.0462987183
16085,2014,95,59,182,-8,36,174,9.8084765887,6.0915801972,18.790976202,-0.825976976,3.7168963915,17.964999226
16085,2015,81,91,262,-8,-10,254,8.1665574432,9.1747744115,26.415284569,-0.806573575,-1.008216968,25.608710995
16085,2016,91,76,368,-8,15,360,8.8954056696,7.4291300098,35.972629521,-0.782013685,1.4662756598,35.190615836
16085,2017,96,79,260,-8,17,252,9.0978013647,7.486732373,24.639878696,-0.758150114,1.6110689917,23.881728582
30105,2010,18,11,3,0,7,3,NA,NA,NA,NA,NA,NA
30105,2011,82,89,86,1,-7,87,11.054937647,11.998651837,11.594202899,0.1348163128,-0.943714189,11.729019211
30105,2012,66,73,48,-1,-7,47,8.8264794383,9.7626211969,6.4192577733,-0.133734537,-0.936141759,6.2855232364
30105,2013,103,101,113,1,2,114,13.63245318,13.367745351,14.955992323,0.1323539144,0.2647078287,15.088346238
30105,2014,83,94,6,4,-11,10,10.901687791,12.346489788,0.7880738162,0.5253825442,-1.444801996,1.3134563604
30105,2015,83,77,-16,5,6,-11,10.905985152,10.117600683,-2.102358584,0.6569870574,0.7883844688,-1.445371526
30105,2016,95,70,-100,4,25,-96,12.54539452,9.2439749092,-13.20567844,0.5282271377,3.3014196104,-12.6774513
30105,2017,87,63,-132,4,24,-128,11.623246493,8.4168336673,-17.63527054,0.5344021376,3.2064128257,-17.1008684
31175,2010,14,15,6,0,-1,6,NA,NA,NA,NA,NA,NA
31175,2011,57,58,-36,0,-1,-36,13.422818792,13.658306841,-8.477569763,0,-0.235488049,-8.477569763
31175,2012,47,57,-1,0,-10,-1,11.132164851,13.500710564,-0.236854571,0,-2.368545713,-0.236854571
31175,2013,48,56,-27,1,-8,-26,11.431293165,13.336508693,-6.430102405,0.2381519409,-1.905215528,-6.191950464
31175,2014,58,63,29,1,-5,30,13.827631422,15.019668614,6.9138157111,0.2384074383,-1.192037192,7.1522231494
31175,2015,53,48,-63,1,5,-62,12.680942696,11.484627348,-15.07357339,0.2392630697,1.1963153487,-14.83431032
31175,2016,47,44,24,2,3,26,11.280451218,10.560422417,5.7602304092,0.4800192008,0.7200288012,6.24024961
31175,2017,49,53,30,2,-4,32,11.68057211,12.6340882,7.1513706794,0.4767580453,-0.953516091,7.6281287247
05141,2010,41,40,13,0,1,13,NA,NA,NA,NA,NA,NA
05141,2011,197,201,-90,-5,-4,-95,11.4216141,11.653525046,-5.217996289,-0.289888683,-0.231910946,-5.507884972
05141,2012,187,221,-6,-7,-34,-13,10.889503567,12.869413306,-0.349395836,-0.407628476,-1.979909739,-0.757024312
05141,2013,147,239,-81,0,-92,-81,8.6168996747,14.009789267,-4.748087576,0,-5.392889592,-4.748087576
05141,2014,171,241,-11,0,-70,-11,10.100711775,14.235506069,-0.649753389,0,-4.134794294,-0.649753389
05141,2015,157,226,-48,0,-69,-48,9.3296886142,13.429997623,-2.852388876,0,-4.100309009,-2.852388876
05141,2016,156,234,-69,0,-78,-69,9.3438351652,14.015752748,-4.132850169,0,-4.671917583,-4.132850169
05141,2017,146,239,-21,0,-93,-21,8.8142960638,14.428881913,-1.267809708,0,-5.614585849,-1.267809708
19177,2010,31,12,-13,0,19,-13,NA,NA,NA,NA,NA,NA
19177,2011,84,88,-60,0,-4,-60,11.130987875,11.661034917,-7.950705625,0,-0.530047042,-7.950705625
19177,2012,91,90,-64,0,1,-64,12.163336229,12.029673194,-8.554434271,0,0.1336630355,-8.554434271
19177,2013,100,83,-30,0,17,-30,13.435442698,11.151417439,-4.030632809,0,2.2840252586,-4.030632809
19177,2014,89,100,-34,0,-11,-34,12.003506642,13.487086115,-4.585609279,0,-1.483579473,-4.585609279
19177,2015,77,91,-80,0,-14,-80,10.484035673,12.390223977,-10.8925046,0,-1.906188304,-10.8925046
19177,2016,91,87,-46,0,4,-46,12.506871908,11.957119296,-6.32215503,0,0.5497526113,-6.32215503
19177,2017,84,96,-86,0,-12,-86,11.65695254,13.322231474,-11.93449903,0,-1.665278934,-11.93449903
26159,2010,233,186,-182,6,47,-176,NA,NA,NA,NA,NA,NA
26159,2011,944,698,-483,12,246,-471,12.415824916,9.1803451178,-6.352588384,0.1578282828,3.235479798,-6.194760101
26159,2012,966,721,-986,22,245,-964,12.78242747,9.5405074597,-13.047074,0.2911111846,3.2419200106,-12.75596282
26159,2013,886,720,-182,27,166,-155,11.777921051,9.5712225243,-2.41939236,0.3589208447,2.2066985264,-2.060471516
26159,2014,916,683,-370,60,233,-310,12.182390063,9.0835943371,-4.920834414,0.7979731482,3.0987957255,-4.122861266
26159,2015,883,768,-320,68,115,-252,11.760318581,10.228680261,-4.261950109,0.9056643981,1.5316383203,-3.35628571
26159,2016,863,736,-7,71,127,64,11.490273876,9.7993529232,-0.093200367,0.945318013,1.6909209528,0.8521176455
26159,2017,868,776,-7,70,92,63,11.530746443,10.308593594,-0.092989891,0.9298989067,1.2221528488,0.836909016
47175,2010,13,6,3,0,7,3,NA,NA,NA,NA,NA,NA
47175,2011,56,56,-34,0,0,-34,10.086455331,10.086455331,-6.123919308,0,0,-6.123919308
47175,2012,47,56,104,0,-9,104,8.4184130396,10.030449579,18.62797779,0,-1.612036539,18.62797779
47175,2013,62,65,-57,0,-3,-57,11.067475901,11.602998929,-10.17493752,0,-0.535523027,-10.17493752
47175,2014,61,79,98,-1,-18,97,10.867628719,14.07446998,17.45946909,-0.178157848,-3.206841261,17.281311242
47175,2015,66,78,52,-1,-12,51,11.635081534,13.750550903,9.1670339357,-0.176289114,-2.11546937,8.9907448215
47175,2016,68,66,22,-1,2,21,11.921458626,11.570827489,3.8569424965,-0.175315568,0.350631136,3.6816269285
47175,2017,70,55,14,-1,15,13,12.218537267,9.6002792809,2.4437074533,-0.174550532,2.6182579857,2.2691569209
39161,2010,73,91,-68,3,-18,-65,NA,NA,NA,NA,NA,NA
39161,2011,314,264,-110,7,50,-103,10.965410068,9.2193256622,-3.841385693,0.2444518168,1.7460844057,-3.596933876
39161,2012,318,291,-20,3,27,-17,11.113635172,10.170024639,-0.698970766,0.1048456148,0.9436105335,-0.594125151
39161,2013,331,329,-292,1,2,-291,11.624435899,11.554197615,-10.25478937,0.0351191417,0.0702382834,-10.21967023
39161,2014,349,340,-28,-1,9,-29,12.323663906,12.005861685,-0.988718021,-0.035311358,0.3178022211,-1.024029379
39161,2015,315,332,3,-1,-17,2,11.131332049,11.732070604,0.1060126862,-0.035337562,-0.600738555,0.0706751241
39161,2016,345,322,-145,-1,23,-146,12.222123815,11.407315561,-5.136834647,-0.035426446,0.8148082544,-5.172261093
39161,2017,328,306,31,-1,22,30,11.634712591,10.854335527,1.0996222266,-0.035471685,0.780377064,1.0641505418
48467,2010,122,162,69,4,-40,73,NA,NA,NA,NA,NA,NA
48467,2011,565,660,6,-1,-95,5,10.753813797,12.561977179,0.1141997925,-0.019033299,-1.808163382,0.0951664938
48467,2012,527,605,-239,16,-78,-223,10.068492496,11.558705807,-4.566166426,0.3056847817,-1.490213311,-4.260481645
48467,2013,611,684,164,40,-73,204,11.692772871,13.089781741,3.1384856807,0.7654843124,-1.39700887,3.903969993
48467,2014,561,585,410,53,-24,463,10.67890013,11.135751473,7.8045437673,1.008880048,-0.456851342,8.8134238153
48467,2015,564,654,680,64,-90,744,10.625470987,12.321024868,12.810851545,1.2057272042,-1.695553881,14.016578749
48467,2016,656,642,891,65,14,956,12.172154341,11.912382755,16.532605973,1.2060823661,0.2597715866,17.738688339
48467,2017,634,650,755,67,-16,822,11.573672633,11.865752699,13.782528136,1.2230852783,-0.292080066,15.005613414
37181,2010,156,154,-121,-2,2,-123,NA,NA,NA,NA,NA,NA
37181,2011,556,448,-93,-12,108,-105,12.273595214,9.8895155683,-2.052957473,-0.264897738,2.3840796459,-2.317855211
37181,2012,598,432,-346,-20,166,-366,13.229356783,9.5569935291,-7.654443891,-0.442453404,3.6723632542,-8.096897296
37181,2013,560,516,-651,-5,44,-656,12.499023514,11.516957381,-14.53011483,-0.111598424,0.9820661332,-14.64171326
37181,2014,574,498,-45,3,76,-42,12.894529934,11.187240256,-1.010895204,0.0673930136,1.7072896776,-0.94350219
37181,2015,548,491,-157,10,57,-147,12.320005396000001,11.03854498,-3.529636582,0.2248176167,1.2814604152,-3.304818966
37181,2016,547,540,-24,10,7,-14,12.311639789000001,12.154086812,-0.540181636,0.2250756817,0.1575529772,-0.315105954
37181,2017,528,529,-223,11,-1,-212,11.913760619,11.93632456,-5.031758746,0.2482033462,-0.022563941,-4.7835554
18163,2010,628,478,-16,19,150,3,NA,NA,NA,NA,NA,NA
18163,2011,2245,1816,74,119,429,193,12.46301344,10.081439825,0.41080757,0.6606229841,2.3815736151,1.0714305541
18163,2012,2319,1853,48,165,466,213,12.828775402,10.250849858,0.2655373951,0.9127847958,2.5779255444,1.1783221909
18163,2013,2312,1964,152,141,348,293,12.744717034,10.826394574,0.8378879711,0.7772513416,1.9183224601,1.6151393127
18163,2014,2235,1941,5,142,294,147,12.285349926,10.669290473,0.0274840043,0.7805457224,1.6160594534,0.8080297267
18163,2015,2243,1985,-608,159,258,-449,12.322652419,10.905245231,-3.340246398,0.8735183837,1.4174071887,-2.466728014
18163,2016,2212,1952,-561,163,260,-398,12.164138887,10.734357643,-3.085027991,0.8963628565,1.4297812435,-2.188665134
18163,2017,2163,1856,-617,162,307,-455,11.904532583,10.214892499,-3.39579131,0.8916016082,1.6896400846,-2.504189702
42121,2010,160,125,-41,1,35,-40,NA,NA,NA,NA,NA,NA
42121,2011,569,691,-167,3,-122,-164,10.377909098,12.603049537,-3.045888962,0.0547165682,-2.225140439,-2.991172394
42121,2012,546,652,-369,1,-106,-368,10.028100722,11.974948115,-6.777232905,0.0183664848,-1.946847393,-6.758866421
42121,2013,593,662,-299,-2,-69,-301,10.97629823,12.253472897,-5.534423559,-0.037019556,-1.277174668,-5.571443115
42121,2014,540,645,-371,-1,-105,-372,10.074344934,12.033245338,-6.921448094,-0.018656194,-1.958900404,-6.940104288
42121,2015,526,660,-260,0,-134,-260,9.8938201243,12.414299015,-4.89048143,0,-2.5204788910000002,-4.89048143
42121,2016,541,663,-375,0,-122,-375,10.262246882,12.576468914,-7.113387395,0,-2.314222033,-7.113387395
42121,2017,510,672,-545,0,-162,-545,9.7859561935,12.894436396,-10.45754142,0,-3.108480203,-10.45754142
06111,2010,2765,1264,172,333,1501,505,NA,NA,NA,NA,NA,NA
06111,2011,11009,5078,-1446,1262,5931,-184,13.293581793,6.1317838444,-1.746073147,1.5238895651,7.1617979482,-0.222183582
06111,2012,10528,5002,-2595,1255,5526,-1340,12.637646574,6.0043225841,-3.114997422,1.5064823757,6.6333239903,-1.608515047
06111,2013,10535,5361,-1525,1452,5174,-73,12.576716779,6.3999789891,-1.82054989,1.7334022556,6.1767377895,-0.087147634
06111,2014,10330,5309,-2029,1678,5021,-351,12.261680646,6.3017679136,-2.408417234,1.9917812317,5.959912732,-0.416636003
06111,2015,10318,5566,-2580,2077,4752,-503,12.18416295,6.5726934463,-3.04663117,2.4526561782,5.6114695036,-0.593974992
06111,2016,10087,5917,-4073,2077,4170,-1996,11.866912232,6.9610904806,-4.791705514,2.4434992274,4.9058217516,-2.348206287
06111,2017,9898,6012,-2747,2008,3886,-739,11.608385293,7.0508802165,-3.221684623,2.3549846099,4.5575050768,-0.866700013
17183,2010,273,164,-97,6,109,-91,NA,NA,NA,NA,NA,NA
17183,2011,1090,1029,-318,15,61,-303,13.371115936,12.622824127,-3.900931071,0.1840061826,0.7482918093,-3.716924889
17183,2012,1074,930,-738,11,144,-727,13.241114029,11.465769131,-9.098642601,0.1356166241,1.7753448977,-8.963025977
17183,2013,1068,963,-365,20,105,-345,13.234118748,11.933011567,-4.522896388,0.2478299391,1.3011071803,-4.275066449
17183,2014,1025,969,-869,26,56,-843,12.782301812,12.083951664,-10.83689783,0.3242339972,0.6983501478,-10.51266383
17183,2015,1015,1033,-627,32,-18,-595,12.76833955,12.994773158,-7.887437338,0.4025486361,-0.226433608,-7.484888702
17183,2016,1041,928,-775,34,113,-741,13.198349255,11.765675417,-9.825860397,0.4310700045,1.4326738385,-9.394790392
17183,2017,1031,909,-805,33,122,-772,13.178329254,11.618914929,-10.28957813,0.4218087928,1.5594143249,-9.867769335
22113,2010,203,96,19,12,107,31,NA,NA,NA,NA,NA,NA
22113,2011,759,587,-115,42,172,-73,13.049981947,10.092673785,-1.977269992,0.7221333884,2.9573081618,-1.255136604
22113,2012,810,513,118,57,297,175,13.860132441,8.7780838795,2.019130405,0.9753426533,5.0820485618,2.9944730583
22113,2013,805,518,307,45,287,352,13.646380742,8.7811493473,5.2042719105,0.7628411595,4.8652313952,5.96711307
22113,2014,768,522,-22,45,246,23,12.921135647,8.7823343849,-0.370136698,0.7570977918,4.1388012618,0.3869610936
22113,2015,835,595,131,48,240,179,13.96951801,9.9543272046,2.1916249812,0.803038161,4.0151908052,2.9946631422
22113,2016,850,564,-100,49,286,-51,14.143918531,9.3849059429,-1.663990415,0.8153553036,4.7590125881,-0.848635112
22113,2017,807,586,-348,49,221,-299,13.410884919,9.7382633984,-5.78313253,0.8142916494,3.6726215206,-4.968840881
18165,2010,34,67,-63,0,-33,-63,NA,NA,NA,NA,NA,NA
18165,2011,181,237,9,0,-56,9,11.247825006,14.727815063,0.5592841163,0,-3.479990057,0.5592841163
18165,2012,153,216,-85,0,-63,-85,9.5657882397,13.504642221,-5.3143268,0,-3.938853981,-5.3143268
18165,2013,165,182,-64,11,-17,-53,10.386176943,11.4562679,-4.028577723,0.6924117962,-1.070090958,-3.336165927
18165,2014,157,206,-155,9,-49,-146,9.9654067092,13.075629185,-9.838458853,0.5712653528,-3.110222476,-9.2671935
18165,2015,164,228,-8,10,-64,2,10.495664139,14.591533071,-0.511983617,0.6399795207,-4.095868932,0.1279959041
18165,2016,165,207,50,10,-42,60,10.575228329,13.267104631,3.2046146451,0.640922929,-2.691876302,3.8455375741
18165,2017,166,200,-82,10,-34,-72,10.669751896,12.855122766,-5.270600334,0.6427561383,-2.18537087,-4.627844196
29217,2010,47,40,-28,9,7,-19,NA,NA,NA,NA,NA,NA
29217,2011,232,248,-196,47,-16,-149,11.013790975,11.773362767,-9.304754445,2.2312421372,-0.759571791,-7.073512307
29217,2012,253,261,-210,34,-8,-176,12.109898526,12.492820218,-10.05169443,1.6274171932,-0.382921693,-8.424277235
29217,2013,264,251,26,4,13,30,12.679506268,12.055136641,1.2487392536,0.1921137313,0.6243696268,1.440852985
29217,2014,265,269,24,3,-4,27,12.709527349,12.901369272,1.1510515335,0.1438814417,-0.191841922,1.2949329752
29217,2015,261,263,-230,3,-2,-227,12.581041672,12.677448121,-11.0867417,0.1446096744,-0.09640645,-10.94213203
29217,2016,277,247,-112,4,30,-108,13.451499332,11.994658249,-5.438873376,0.1942454777,1.4568410829,-5.244627899
29217,2017,257,220,-157,4,37,-153,12.539337903,10.734063575,-7.660218097,0.1951647923,1.8052743285,-7.4650533039999996
55123,2010,113,92,-18,0,21,-18,NA,NA,NA,NA,NA,NA
55123,2011,393,290,0,3,103,3,13.178411549,9.7245276059,0,0.1005985614,3.4538839428,0.1005985614
55123,2012,409,279,18,7,130,25,13.657233492,9.3163035312,0.6010518407,0.2337423825,4.3409299608,0.8347942232
55123,2013,440,263,-116,5,177,-111,14.639583437,8.7504782818,-3.859526543,0.1663589027,5.8891051555,-3.69316764
55123,2014,416,285,-29,4,131,-25,13.802943079,9.4563432155,-0.962224397,0.1327206065,4.346599864,-0.829503791
55123,2015,435,321,11,4,114,15,14.379689928,10.611219464,0.363624343,0.1322270338,3.7684704638,0.4958513768
55123,2016,412,295,109,4,117,113,13.540160379,9.6950177468,3.5822268963,0.1314578678,3.8451426318,3.713684764
55123,2017,412,319,122,4,93,126,13.441649538,10.407490783,3.9802942808,0.1305014518,3.034158755,4.1107957326
22115,2010,262,100,103,108,162,211,NA,NA,NA,NA,NA,NA
22115,2011,1121,355,-1308,35,766,-1273,21.35970428,6.7642239244,-24.92283068,0.6668953165,14.595480355,-24.25593537
22115,2012,1015,355,671,528,660,1199,19.085045973,6.6750653404,12.616813643,9.9279845063,12.409980633,22.54479815
22115,2013,1191,376,-2450,301,815,-2149,22.271048572,7.0309943434,-45.81365995,5.6285353653,15.240054228,-40.18512459
22115,2014,1002,436,-763,223,566,-540,18.962189168,8.2510124522,-14.43927179,4.2201279285,10.711176715,-10.21914386
22115,2015,1017,402,-2313,315,615,-1998,19.492280712,7.7049133197,-44.33200126,6.0374320789,11.787367392,-38.29456919
22115,2016,1004,330,-719,171,674,-548,19.472836944,6.4004344537,-13.94518901,3.3165887624,13.07240249,-10.62860024
22115,2017,969,370,-1558,66,599,-1492,18.935581893,7.2303047476,-30.4454454,1.2897300361,11.705277145,-29.15571536
48469,2010,315,139,-104,22,176,-82,NA,NA,NA,NA,NA,NA
48469,2011,1257,714,39,76,543,115,14.414063172,8.1874630905,0.4472143705,0.8714946707,6.2266000814,1.3187090412
48469,2012,1293,810,979,61,483,1040,14.643510365,9.1734287672,11.087391066,0.6908384627,5.4700815982,11.778229528
48469,2013,1294,778,422,50,516,472,14.448011165,8.6866713189,4.7117934403,0.558269365,5.7613398465,5.2700628053
48469,2014,1304,771,333,65,533,398,14.405178794,8.5171724313,3.6786231124,0.7180495565,5.888006363,4.3966726688
48469,2015,1352,806,479,72,546,551,14.77030644,8.8053749932,5.2329709947,0.7865843666,5.964931447,6.0195553613
48469,2016,1338,847,-266,76,491,-190,14.507131589,9.1835130461,-2.884078477,0.8240224221,5.3236185427,-2.060056055
48469,2017,1320,835,-859,76,485,-783,14.311813209,9.0533060831,-9.313520869,0.8240134878,5.2585071261,-8.489507381
18167,2010,330,321,-8,38,9,30,NA,NA,NA,NA,NA,NA
18167,2011,1324,1138,88,146,186,234,12.250921826,10.529870875,0.8142606652,1.3509324673,1.7210509514,2.1651931325
18167,2012,1262,1085,-151,152,177,1,11.646793902,10.013289527,-1.393554579,1.4027834176,1.6335043745,0.0092288383
18167,2013,1268,1201,-509,123,67,-386,11.710759029,11.091972866,-4.700927717,1.1359805683,0.6187861632,-3.564947149
18167,2014,1337,1110,-630,133,227,-497,12.382037248,10.279776623,-5.834467813,1.2317209828,2.1022606248,-4.60274683
18167,2015,1289,1145,-654,143,144,-511,11.973155609,10.635580429,-6.074820612,1.328286464,1.3375751805,-4.746534148
18167,2016,1270,1156,-64,143,114,79,11.806155934,10.746390756,-0.59495589,1.3293545658,1.0597651783,0.7343986762
18167,2017,1271,1158,-404,139,113,-265,11.813091061,10.762831982,-3.754908567,1.2919116109,1.0502590794,-2.462996956
55125,2010,56,82,38,0,-26,38,NA,NA,NA,NA,NA,NA
55125,2011,169,279,63,6,-110,69,7.8900067695,13.025514134,2.9412451271,0.2801185835,-5.135507365,3.2213637106
55125,2012,174,295,11,13,-121,24,8.1506464306,13.818624696,0.5152707514,0.6089563425,-5.667978265,1.1242270939
55125,2013,170,287,172,20,-117,192,7.9677540307,13.45144357,8.0614923135,0.9373828271,-5.483689539,8.9988751406
55125,2014,192,276,86,13,-84,99,8.9797254636,12.908355354,4.0221686972,0.6080022449,-3.92862989,4.6301709422
55125,2015,193,311,133,13,-118,146,9.0178487992,14.53135221,6.2143724886,0.6074198673,-5.513503411,6.8217923559
55125,2016,162,282,155,15,-120,170,7.5561463654,13.153291821,7.2296462138,0.699643182,-5.597145456,7.9292893957
55125,2017,169,299,335,15,-130,350,7.8336848448,13.859596264,15.528310195,0.6952974714,-6.025911419,16.223607667
39163,2010,40,44,-20,0,-4,-20,NA,NA,NA,NA,NA,NA
39163,2011,140,128,-37,-1,12,-38,10.454783063,9.5586588007,-2.76304981,-0.074677022,0.8961242626,-2.837726831
39163,2012,129,124,-162,-1,5,-163,9.6999774419,9.324009324,-12.18136702,-0.075193624,0.3759681179,-12.25656064
39163,2013,154,152,81,0,2,81,11.612124868,11.461318052,6.107676067,0,0.1508068165,6.107676067
39163,2014,154,157,-91,0,-3,-91,11.616942632,11.843246709,-6.86455701,0,-0.226304077,-6.86455701
39163,2015,148,134,-143,0,14,-143,11.258177392,10.193214666,-10.87783356,0,1.0649627263,-10.87783356
39163,2016,142,139,-64,0,3,-64,10.879975482,10.650116845,-4.903650921,0,0.2298586369,-4.903650921
39163,2017,144,147,75,0,-3,75,11.028989392,11.258760005,5.7442653085,0,-0.229770612,5.7442653085
51810,2010,1468,682,-188,460,786,272,NA,NA,NA,NA,NA,NA
51810,2011,6193,2779,-522,1116,3414,594,14.046444217,6.3030951849,-1.183956706,2.5312177857,7.7433490325,1.3472610795
51810,2012,6272,2749,-3479,2354,3523,-1125,14.12367675,6.1903678867,-7.834226947,5.3008825046,7.9333088631,-2.533344443
51810,2013,6022,2991,-1561,1502,3031,-59,13.479393674,6.6949296708,-3.494077304,3.3620141643,6.7844640027,-0.13206314
51810,2014,6149,2995,-3459,1431,3154,-2028,13.701270415,6.6734924202,-7.707382398,3.188570168,7.0277779944,-4.51881223
51810,2015,6119,3047,-3333,1779,3072,-1554,13.59446979,6.7694638749,-7.404864816,3.9523715896,6.8250059152,-3.452493227
51810,2016,6030,3198,-3701,1406,2832,-2295,13.366316881,7.0888028834,-8.203770942,3.116590636,6.2775139981,-5.087180306
51810,2017,5935,3280,-4706,1077,2655,-3629,13.161994547,7.2740256299,-10.43645263,2.3884529279,5.8879689168,-8.047999698
12127,2010,1167,1550,151,147,-383,298,NA,NA,NA,NA,NA,NA
12127,2011,4589,6145,738,922,-1556,1660,9.2808034599,12.427661203,1.4925327857,1.864654781,-3.146857743,3.3571875667
12127,2012,4683,6192,2813,975,-1509,3788,9.448971418,12.493707243,5.6758395471,1.9672746386,-3.044735825,7.6431141857
12127,2013,4680,6394,4595,1119,-1714,5714,9.3832705109,12.819793087,9.2128478627,2.2435640388,-3.436522576,11.456411902
12127,2014,4758,6567,6824,1355,-1809,8179,9.4399517487,13.029038069,13.538930377,2.6883427111,-3.589086321,16.227273088
12127,2015,4846,6842,10636,1450,-1996,12086,9.4575658575,13.353005695,20.757463983,2.8298535892,-3.895439837,23.587317572
12127,2016,4975,7100,12139,1500,-2125,13639,9.507429172,13.568391381,23.19812718,2.8665615594,-4.060962209,26.064688739
12127,2017,5066,6949,10000,1498,-1883,11498,9.4892903637,13.016399277,18.731327208,2.8059528158,-3.527108913,21.537280024
17185,2010,17,23,-25,0,-6,-25,NA,NA,NA,NA,NA,NA
17185,2011,146,167,-124,15,-21,-109,12.318076355,14.089854461,-10.46192786,1.2655557899,-1.771778106,-9.196372073
17185,2012,145,147,-129,19,-2,-110,12.358305634,12.528765022,-10.99463053,1.6193641865,-0.170459388,-9.375266343
17185,2013,142,146,-37,24,-4,-13,12.169516219,12.512319493,-3.170930282,2.0568196426,-0.342803274,-1.11411064
17185,2014,132,140,-98,26,-8,-72,11.359235833,12.047674369,-8.433372058,2.2374252399,-0.688438535,-6.195946818
17185,2015,140,135,-12,26,5,14,12.079378775,11.64797239,-1.035375324,2.243313201,0.4314063848,1.2079378775
17185,2016,131,117,-128,26,14,-102,11.337083514,10.125486802,-11.07745565,2.2501081783,1.2115967114,-8.827347469
17185,2017,133,125,-55,26,8,-29,11.565217391,10.869565217,-4.782608696,2.2608695652,0.6956521739,-2.52173913
18169,2010,81,87,-35,2,-6,-33,NA,NA,NA,NA,NA,NA
18169,2011,367,410,-248,10,-43,-238,11.220839576,12.53554285,-7.5824747,0.3057449476,-1.314703275,-7.276729752
18169,2012,352,416,-132,16,-64,-116,10.83827265,12.808867678,-4.064352244,0.4926487568,-1.970595027,-3.571703487
18169,2013,342,446,-17,5,-104,-12,10.57939184,13.796516844,-0.525876203,0.1546694713,-3.217125004,-0.371206731
18169,2014,333,411,-88,5,-78,-83,10.345791779,12.769130394,-2.734023053,0.1553422189,-2.423338615,-2.578680834
18169,2015,325,421,-147,7,-96,-140,10.160060023,13.161185445,-4.595473302,0.218832062,-3.001125422,-4.37664124
18169,2016,350,399,-278,8,-49,-270,11.037353558,12.582583056,-8.766812255,0.252282367,-1.545229498,-8.514529888
18169,2017,326,410,-31,8,-84,-23,10.350192082,13.017112741,-0.984220719,0.2539924437,-2.666920659,-0.730228276
27157,2010,61,27,-28,1,34,-27,NA,NA,NA,NA,NA,NA
27157,2011,263,193,-149,11,70,-138,12.154262079,8.9192873813,-6.885874714,0.5083531668,3.2349746979,-6.377521547
27157,2012,218,164,-129,8,54,-121,10.105458338,7.6022714104,-5.979835439,0.3708425078,2.5031869278,-5.608992931
27157,2013,232,191,-20,6,41,-14,10.765161709,8.8626977866,-0.928031182,0.2784093546,1.9024639228,-0.649621827
27157,2014,229,193,-144,1,36,-143,10.646458542,8.9727794695,-6.694716288,0.0464910853,1.673679072,-6.648225203
27157,2015,225,208,-97,2,17,-95,10.506408909,9.7125913474,-4.529429619,0.0933903014,0.793817562,-4.436039317
27157,2016,240,171,-1,4,69,3,11.209191537,7.9865489702,-0.046704965,0.186819859,3.2226425669,0.1401148942
27157,2017,237,166,87,4,71,91,11.009174312,7.7110672396,4.0413424689,0.1858088491,3.2981070723,4.2271513181
20197,2010,9,5,-11,1,4,-10,NA,NA,NA,NA,NA,NA
20197,2011,90,83,-22,1,7,-21,12.787723785,11.793123046,-3.125888036,0.1420858198,0.9946007388,-2.983802217
20197,2012,80,74,-51,2,6,-49,11.413082246,10.557101077,-7.275839932,0.2853270561,0.8559811684,-6.990512875
20197,2013,110,66,-12,0,44,-12,15.706432498,9.4238594988,-1.713429,0,6.2825729992,-1.713429
20197,2014,83,65,-107,1,18,-106,11.898788617,9.3183284352,-15.33940219,0.143358899,2.5804601821,-15.19604329
20197,2015,90,74,-76,1,16,-75,13.038754075,10.72075335,-11.01050344,0.1448750453,2.3180007244,-10.8656284
20197,2016,77,38,-23,1,39,-22,11.189420911,5.5220518782,-3.342294558,0.1453171547,5.6673690329,-3.196977403
20197,2017,92,50,-59,1,42,-58,13.368206917,7.265329846,-8.573089218,0.1453065969,6.1028770706,-8.427782621
27159,2010,47,64,-10,0,-17,-10,NA,NA,NA,NA,NA,NA
27159,2011,176,192,-157,2,-16,-155,12.816311669,13.981430912,-11.43273257,0.1456399053,-1.165119243,-11.28709266
27159,2012,178,173,-46,1,5,-45,13.061823519,12.694918364,-3.375527426,0.073381031,0.366905155,-3.302146395
27159,2013,159,198,71,2,-39,73,11.671438009,14.534243559,5.2117742054,0.146810541,-2.862805549,5.3585847464
27159,2014,184,191,-44,3,-7,-41,13.515002387,14.029160087,-3.231848397,0.2203532998,-0.5141577,-3.011495097
27159,2015,185,194,85,3,-9,88,13.574494625,14.234875445,6.2369299629,0.2201269399,-0.66038082,6.4570569028
27159,2016,179,208,-75,3,-29,-72,13.14533304,15.275023867,-5.507821106,0.2203128442,-2.129690828,-5.287508262
27159,2017,178,179,105,3,-1,108,13.071415458,13.144850376,7.7106664219,0.2203047549,-0.073434918,7.9309711768
40145,2010,236,104,201,0,132,201,NA,NA,NA,NA,NA,NA
40145,2011,879,619,338,-2,260,336,11.922685656,8.3960664632,4.5846049508,-0.02712784,3.5266191929,4.5574771109
40145,2012,876,585,642,21,291,663,11.75815252,7.8521908955,8.6172761622,0.2818735193,3.9059616249,8.8991496816
40145,2013,927,641,372,13,286,385,12.308468545,8.5110338051,4.9393207106,0.17261067,3.7974347399,5.1119313806
40145,2014,862,660,-223,26,202,-197,11.395860738,8.7253690104,-2.948117105,0.343726658,2.6704917274,-2.604390447
40145,2015,866,603,766,35,263,801,11.369380132,7.9165545264,10.056518685,0.4595015065,3.452825606,10.516020192
40145,2016,837,681,618,32,156,650,10.855256759,8.8320547821,8.0149924454,0.4150157901,2.0232019765,8.4300082355
40145,2017,831,685,970,32,146,1002,10.642589569,8.7727723882,12.42275798,0.4098229437,1.8698171805,12.832580924
53069,2010,9,4,-1,1,5,0,NA,NA,NA,NA,NA,NA
53069,2011,26,46,23,6,-20,29,6.5211938801,11.537496865,5.7687484324,1.5048908954,-5.016302985,7.2736393278
53069,2012,31,55,27,4,-24,31,7.7606709225,13.768932282,6.7592940293,1.0013768932,-6.008261359,7.7606709225
53069,2013,41,52,39,6,-11,45,10.211706102,12.95143213,9.7135740971,1.4943960149,-2.739726027,11.207970112
53069,2014,27,47,16,6,-20,22,6.6931085771,11.650966782,3.9662865642,1.4873574616,-4.957858205,5.4536440258
53069,2015,23,50,3,6,-27,9,5.7121569601,12.417732522,0.7450639513,1.4901279026,-6.705575562,2.235191854
53069,2016,21,31,165,5,-10,170,5.1263273526,7.5674356158,40.278286342,1.2205541316,-2.441108263,41.498840474
53069,2017,23,44,104,5,-21,109,5.4502369668,10.426540284,24.644549763,1.1848341232,-4.976303318,25.829383886
37183,2010,3208,1055,2725,754,2153,3479,NA,NA,NA,NA,NA,NA
37183,2011,12541,4393,11239,3350,8148,14589,13.655797889,4.7835037178,12.23806016,3.6477890859,8.8722941708,15.885849246
37183,2012,12260,4552,11719,3486,7708,15205,13.022970246,4.8352822644,12.448302473,3.7029424371,8.187687982,16.15124491
37183,2013,12298,4784,10815,3481,7514,14296,12.75779078,4.9628615295,11.219345201,3.6111456907,7.7949292502,14.830490892
37183,2014,12616,4845,12247,3749,7771,15996,12.783126597,4.909182654,12.409238383,3.7986637296,7.8739439431,16.207902112
37183,2015,12765,5326,13203,4162,7439,17365,12.621287708,5.2660382554,13.054356569,4.1151429251,7.3552494521,17.169499494
37183,2016,12984,5448,13490,4227,7536,17717,12.526760707,5.2561454355,13.014941616,4.0781436776,7.270615272,17.093085294
37183,2017,13048,5662,11442,4189,7386,15631,12.301623592,5.3381202312,10.787490584,3.9493793092,6.9635033606,14.736869893
12129,2010,68,76,47,0,-8,47,NA,NA,NA,NA,NA,NA
12129,2011,336,224,28,10,112,38,10.874490258,7.2496601722,0.9062075215,0.3236455434,3.6248300861,1.2298530649
12129,2012,311,255,-186,7,56,-179,10.060817805,8.2492236025,-6.017080745,0.2264492754,1.8115942029,-5.79063147
12129,2013,302,259,100,5,43,105,9.765088193,8.374694841,3.2334729116,0.1616736456,1.390393352,3.3951465572
12129,2014,328,246,309,13,82,322,10.511472888,7.8836046661,9.9025765927,0.4166132547,2.627868222,10.319189847
12129,2015,349,259,8,13,90,21,11.092394241,8.231891428,0.2542669167,0.4131837396,2.8605028128,0.6674506563
12129,2016,337,259,279,11,78,290,10.63041181,8.169960412,8.8008453859,0.3469867356,2.4604513982,9.1478321215
12129,2017,342,259,142,11,83,153,10.686665104,8.0931177252,4.4371533474,0.3437231466,2.5935473791,4.780876494
23027,2010,109,112,28,7,-3,35,NA,NA,NA,NA,NA,NA
23027,2011,374,371,-11,40,3,29,9.6314800031,9.5542221421,-0.283278824,1.0301048132,0.077257861,0.7468259895
23027,2012,400,366,14,49,34,63,10.284891494,9.4106757174,0.3599712023,1.2598992081,0.874215777,1.6198704104
23027,2013,375,357,3,56,18,59,9.6217991482,9.159952789,0.0769743932,1.4368553395,0.4618463591,1.5138297326
23027,2014,349,381,-24,54,-32,30,8.9475708243,9.7679784643,-0.61530573,1.3844378926,-0.82040764,0.7691321625
23027,2015,331,413,160,56,-82,216,8.4726239537,10.571582154,4.0955281952,1.4334348683,-2.0989582,5.5289630635
23027,2016,358,398,273,60,-40,333,9.1141689685,10.13251187,6.9501903028,1.5275143523,-1.018342902,8.4777046551
23027,2017,355,415,409,60,-60,469,8.9581992758,10.472261125,10.32085494,1.5140618494,-1.514061849,11.83491679
01127,2010,218,243,5,4,-25,9,NA,NA,NA,NA,NA,NA
01127,2011,815,910,-348,22,-95,-326,12.202882276,13.625304136,-5.210555867,0.3294029571,-1.42242186,-4.88115291
01127,2012,826,1027,-312,24,-201,-288,12.45279321,15.483073398,-4.703718501,0.3618245,-3.030280188,-4.341894
01127,2013,753,1035,-65,23,-282,-42,11.423543422,15.70168319,-0.986096046,0.3489262931,-4.278139768,-0.637169753
01127,2014,808,958,-292,22,-150,-270,12.328819378,14.617585352,-4.455464429,0.3356856761,-2.288765974,-4.119778753
01127,2015,805,1058,-154,26,-253,-128,12.35942118,16.243810694,-2.364411008,0.3991862741,-3.884389514,-1.965224734
01127,2016,802,986,-218,26,-184,-192,12.386100386,15.227799228,-3.366795367,0.4015444015,-2.841698842,-2.965250965
01127,2017,777,974,-329,25,-197,-304,12.082196254,15.145507273,-5.1158849,0.3887450532,-3.063311019,-4.727139847
13295,2010,181,123,75,1,58,76,NA,NA,NA,NA,NA,NA
13295,2011,717,616,-155,-16,101,-171,10.413640853,8.9467263115,-2.251205484,-0.232382502,1.4669145413,-2.483587986
13295,2012,736,690,-368,-15,46,-383,10.721673513,10.051568919,-5.360836757,-0.218512368,0.6701045946,-5.579349124
13295,2013,730,758,206,-29,-28,177,10.649394225,11.05786414,3.0051715209,-0.423058127,-0.408469915,2.5821133942
13295,2014,734,719,64,-23,15,41,10.693473193,10.474941725,0.9324009324,-0.335081585,0.2185314685,0.5973193473
13295,2015,779,772,-135,-23,7,-158,11.358996792,11.256926218,-1.968503937,-0.335374745,0.1020705745,-2.303878682
13295,2016,753,840,-63,-22,-87,-85,11.00676046,12.278457884,-0.920884341,-0.321578659,-1.271697424,-1.242463
13295,2017,751,794,680,-22,-43,658,10.942337814,11.568863148,9.9078424944,-0.320547845,-0.626525334,9.587294649
48471,2010,148,67,263,20,81,283,NA,NA,NA,NA,NA,NA
48471,2011,610,490,-70,124,120,54,8.9279833735,7.1716587754,-1.024522682,1.8148687513,1.7563245981,0.7903460691
48471,2012,565,491,19,103,74,122,8.2479343669,7.1676739365,0.2773641645,1.5036057341,1.0802604304,1.7809698987
48471,2013,635,494,562,114,141,676,9.2014316558,7.1582791149,8.1436292765,1.651910565,2.0431525409,9.7955398415
48471,2014,651,503,291,138,148,429,9.3382200004,7.2152452538,4.1742273735,1.979530507,2.1229747466,6.1537578805
48471,2015,658,496,401,157,162,558,9.3519709492,7.0495100164,5.6993014447,2.2313973237,2.3024609328,7.9306987685
48471,2016,670,537,685,162,133,847,9.4088569643,7.5411286415,9.6195030157,2.2749773555,1.8677283228,11.894480371
48471,2017,663,580,301,159,83,460,9.2117877537,8.0585775221,4.182123852,2.209161769,1.1532102316,6.391285621
53071,2010,162,120,80,17,42,97,NA,NA,NA,NA,NA,NA
53071,2011,684,515,345,7,169,352,11.558935361,8.7029995775,5.8301647655,0.1182931981,2.8559357837,5.9484579637
53071,2012,684,521,-287,25,163,-262,11.517478278,8.7728160571,-4.83262612,0.4209604634,2.7446622213,-4.411665656
53071,2013,675,557,-96,21,118,-75,11.371389584,9.3835022195,-1.617264296,0.3537765648,1.9878873643,-1.263487732
53071,2014,679,562,-24,21,117,-3,11.425110002,9.4564238901,-0.403833049,0.3533539176,1.9686861123,-0.050479130999999997
53071,2015,684,616,309,31,68,340,11.459973863,10.320678216,5.1770934558,0.5193847804,1.1392956472,5.6964782361
53071,2016,660,589,1,33,71,34,11.010919162,9.8264111911,0.0166832109,0.5505459581,1.1845079704,0.5672291689
53071,2017,662,604,480,35,58,515,10.982174703,10.019990212,7.9629061289,0.5806285719,0.9621844906,8.5435347009
20199,2010,2,10,3,0,-8,3,NA,NA,NA,NA,NA,NA
20199,2011,18,18,45,-1,0,44,11.980033278,11.980033278,29.950083195,-0.665557404,0,29.28452579
20199,2012,16,13,-6,0,3,-6,10.498687664,8.530183727,-3.937007874,0,1.968503937,-3.937007874
20199,2013,22,21,35,1,1,36,14.271813169,13.623094389,22.705157314,0.6487187804,0.6487187804,23.353876095
20199,2014,17,21,-55,1,-4,-54,11.10385369,13.716525147,-35.92423253,0.6531678641,-2.612671457,-35.27106466
20199,2015,20,21,3,1,-1,4,13.29787234,13.962765957,1.9946808511,0.664893617,-0.664893617,2.6595744681
20199,2016,21,14,-9,1,7,-8,13.948854201,9.2992361342,-5.978080372,0.6642311524,4.6496180671,-5.31384922
20199,2017,18,14,16,1,4,17,11.885110598,9.2439749092,10.564542753,0.6602839221,2.6411356883,11.224826675
48473,2010,147,34,112,12,113,124,NA,NA,NA,NA,NA,NA
48473,2011,569,287,280,13,282,293,12.990719284,6.552436616,6.3926210888,0.2968002648,6.438282668,6.6894213536
48473,2012,567,260,-40,5,307,-35,12.822107394,5.8796259653,-0.904557841,0.1130697301,6.9424814283,-0.791488111
48473,2013,576,296,741,23,280,764,12.833366754,6.5949245817,16.509591605,0.5124434641,6.2384421719,17.022035069
48473,2014,606,293,1006,45,313,1051,13.143768097,6.3549901856,21.819522617,0.9760223834,6.7887779115,22.795545
48473,2015,683,324,1396,65,359,1461,14.313107076,6.7898194621,29.254901139,1.362155139,7.5232876138,30.617056278
48473,2016,603,309,1053,69,294,1122,12.21921639,6.2615884981,21.338034591,1.3982187908000001,5.9576278914,22.736253382
48473,2017,660,312,828,70,348,898,13.022246337,6.1559709959,16.336999951,1.3811473388,6.8662753416,17.718147289
41063,2010,15,29,17,0,-14,17,NA,NA,NA,NA,NA,NA
41063,2011,59,83,-12,2,-24,-10,8.4364052334,11.868163294,-1.715879031,0.2859798384,-3.431758061,-1.429899192
41063,2012,49,89,-140,1,-40,-139,7.1143375681,12.921960073,-20.32667877,0.1451905626,-5.807622505,-20.1814882
41063,2013,61,92,0,1,-31,1,8.9924080489,13.562320336,0,0.1474165254,-4.569912287,0.1474165254
41063,2014,71,88,27,0,-17,27,10.483573274,12.993724622,3.9867109635,0,-2.510151347,3.9867109635
41063,2015,54,80,59,0,-26,59,7.9487745639,11.775962317,8.6847722087,0,-3.827187753,8.6847722087
41063,2016,63,76,120,0,-13,120,9.1796590412,11.073874399,17.48506484,0,-1.894215358,17.48506484
41063,2017,62,65,137,0,-3,137,8.8780697358,9.3076537553,19.617670223,0,-0.429584019,19.617670223
38099,2010,26,16,-23,0,10,-23,NA,NA,NA,NA,NA,NA
38099,2011,127,133,-89,3,-6,-86,11.476076447,12.018253287,-8.042289794,0.27108842,-0.54217684,-7.771201374
38099,2012,120,124,-8,19,-4,11,10.885834807,11.248695968,-0.72572232,1.7235905112,-0.36286116,0.9978681907
38099,2013,153,163,49,21,-10,70,13.839265524,14.743792682,4.4321830763,1.8995070327,-0.904527158,6.331690109
38099,2014,132,158,-162,27,-26,-135,11.993458114,14.355805924,-14.71924405,2.4532073415,-2.36234781,-12.26603671
38099,2015,159,157,-82,27,2,-55,14.58782513,14.404330474,-7.523280884,2.4771778522,0.1834946557,-5.046103032
38099,2016,150,138,-52,29,12,-23,13.803257569,12.698996963,-4.785129291,2.6686297966,1.1042606055,-2.116499494
38099,2017,151,134,-52,28,17,-24,13.906156467,12.340562693,-4.788875075,2.5786250403,1.5655937745,-2.210250035
28147,2010,50,63,-30,0,-13,-30,NA,NA,NA,NA,NA,NA
28147,2011,213,187,-54,3,26,-51,13.842404549,12.152721365,-3.509341998,0.1949634444,1.6896831844,-3.314378554
28147,2012,173,162,-319,0,11,-319,11.36400959,10.641442507,-20.95444543,0,0.7225670838,-20.95444543
28147,2013,170,172,-216,-2,-2,-218,11.360219185,11.493868823,-14.43416085,-0.133649637,-0.133649637,-14.56781048
28147,2014,178,209,18,-4,-31,14,11.989357761,14.077391978,1.2124069646,-0.26942377,-2.088034217,0.9429831947
28147,2015,179,189,-233,-4,-10,-237,12.165698168,12.845346111,-15.83579706,-0.271859177,-0.679647942,-16.10765623
28147,2016,168,170,-13,-4,-2,-17,11.522633745,11.659807956,-0.891632373,-0.274348422,-0.137174211,-1.165980796
28147,2017,166,178,-55,-4,-12,-59,11.421101517,12.246723313,-3.7840999,-0.275207265,-0.825621796,-4.059307166
12131,2010,137,153,158,13,-16,171,NA,NA,NA,NA,NA,NA
12131,2011,625,565,284,29,60,313,11.281486629,10.198463913,5.1263075243,0.5234609796,1.0830227164,5.6497685039
12131,2012,661,512,1383,28,149,1411,11.722872015,9.0803486712,24.527582446,0.496581568,2.6425233438,25.024164014
12131,2013,695,543,1775,29,152,1804,11.945480483,9.3329437445,30.508241522,0.4984445094,2.6125367388,31.006686032
12131,2014,761,578,1753,33,183,1786,12.643086176,9.6027645329,29.123955409,0.5482547225,3.0403216428,29.672210131
12131,2015,768,595,1643,40,173,1683,12.358194545,9.5743824926,26.438168799,0.6436559659,2.7838120525,27.081824765
12131,2016,772,600,2131,46,172,2177,12.013040062,9.3365596334,33.160347631,0.7158029052,2.6764804282,33.876150536
12131,2017,801,626,2695,46,175,2741,11.971662581,9.3561308065,40.279189335,0.6875112094,2.615531775,40.966700544
13297,2010,260,143,63,1,117,64,NA,NA,NA,NA,NA,NA
13297,2011,1083,766,347,-4,317,343,12.853226362,9.0910169833,4.1182544298,-0.047472674,3.7622093782,4.0707817563
13297,2012,1087,691,-46,36,396,-10,12.821949479,8.150843689,-0.542603198,0.4246459809,4.6711057899,-0.117957217
13297,2013,1047,737,706,45,310,751,12.24575726,8.6199838595,8.2574065194,0.5263219453,3.6257734009,8.7837284647
13297,2014,1058,724,1101,69,334,1170,12.191117077,8.3425035577,12.686597261,0.7950728529,3.8486135197,13.481670114
13297,2015,1040,830,574,75,210,649,11.822749699,9.4354637019,6.5252483914,0.8526021417,2.3872859969,7.3778505332
13297,2016,1077,838,1203,77,239,1280,12.080491744,9.3996769562,13.493808327,0.8636934673,2.6808147882,14.357501795
13297,2017,1181,843,1275,77,338,1352,13.012985439,9.2886932472,14.048735338,0.8484334283,3.7242921917,14.897168767
46129,2010,15,23,12,1,-8,13,NA,NA,NA,NA,NA,NA
46129,2011,69,78,120,6,-9,126,12.539754657,14.17537483,21.808268969,1.0904134484,-1.635620173,22.898682417
46129,2012,66,80,-109,6,-14,-103,11.990189845,14.533563448,-19.8019802,1.0900172586,-2.543373603,-18.71196294
46129,2013,65,76,48,20,-11,68,11.869978086,13.878743608,8.765522279,3.6523009496,-2.008765522,12.417823229
46129,2014,80,87,5,26,-7,31,14.501948699,15.770869211,0.9063717937,4.7131333273,-1.268920511,5.619505121
46129,2015,78,108,-94,28,-30,-66,14.233576642,19.708029197,-17.15328467,5.1094890511,-5.474452555,-12.04379562
46129,2016,76,70,37,27,6,64,13.902862892,12.805268453,6.7684990396,4.9391749748,1.0975944389,11.707674014
46129,2017,77,66,5,27,11,32,13.944223108,11.952191235,0.905469033,4.889532778,1.9920318725,5.7950018109
55127,2010,293,192,-145,14,101,-131,NA,NA,NA,NA,NA,NA
55127,2011,1023,864,306,30,159,336,9.9862847214,8.4341642222,2.9870998287,0.2928529244,1.5521204992,3.2799527531
55127,2012,1035,849,73,21,186,94,10.066673475,8.2575901259,0.7100165833,0.2042513459,1.8090833491,0.9142679291
55127,2013,1038,942,-194,33,96,-161,10.086679364,9.1538072842,-1.885178995,0.3206747775,0.9328720799,-1.564504217
55127,2014,1030,935,285,33,95,318,9.9933539345,9.0716368241,2.7651513314,0.3201754173,0.9217171105,3.0853267487
55127,2015,1091,955,-869,52,136,-817,10.599539488,9.2782403404,-8.442712938,0.5052026154,1.321299148,-7.937510323
55127,2016,989,863,5,52,126,57,9.6315376862,8.4044661508,0.0486933149,0.5064104749,1.2270715353,0.5551037898
55127,2017,996,888,152,52,108,204,9.6766201781,8.6273481106,1.4767532802,0.5052050695,1.0492720675,1.9819583497
19179,2010,110,78,-1,14,32,13,NA,NA,NA,NA,NA,NA
19179,2011,449,404,-305,57,45,-248,12.624949036,11.35964234,-8.575967608,1.6027218153,1.2653066963,-6.973245793
19179,2012,410,404,-123,83,6,-40,11.567543167,11.398262047,-3.47026295,2.3417221533,0.1692811195,-1.128540797
19179,2013,417,398,-54,88,19,34,11.763212457,11.227238748,-1.523293699,2.4824045473,0.5359737091,0.9591108478
19179,2014,442,428,-216,112,14,-104,12.476007678,12.080840014,-6.09687253,3.161341312,0.395167664,-2.935531218
19179,2015,438,444,-65,127,-6,62,12.370260538,12.539716162,-1.835769258,3.5868107039,-0.169455624,1.751041446
19179,2016,454,390,-363,135,64,-228,12.842453644,11.032063703,-10.26830545,3.8187912818,1.810389941,-6.449514165
19179,2017,440,365,-436,135,75,-301,12.515288563,10.38200074,-12.40151321,3.8399180817,2.1332878232,-8.56159513
38101,2010,260,103,194,64,157,258,NA,NA,NA,NA,NA,NA
38101,2011,1064,496,1568,35,568,1603,16.829850841,7.8454943769,24.801885449,0.5536135145,8.9843564638,25.355498964
38101,2012,1116,472,144,411,644,555,17.183506298,7.2675761402,2.217226619,6.3283343085,9.9159301574,8.5455609275
38101,2013,1095,513,1534,258,582,1792,16.39896664,7.6828035494,22.973529522,3.8638661125,8.7161630911,26.837395634
38101,2014,1273,511,569,291,762,860,18.501159047,7.4266239381,8.2695675554,4.2292515969,11.074535109,12.498819152
38101,2015,1301,478,601,368,823,969,18.446443636,6.7774020431,8.5213778827,5.2177488533,11.669041593,13.739126736
38101,2016,1212,434,-2336,279,778,-2057,17.120699519,6.1306795307,-32.99831194,3.9411511269,10.990019988,-29.05716082
38101,2017,1164,480,-2080,181,684,-1899,16.736281354,6.9015593211,-29.90675706,2.602462994,9.8347220325,-27.30429406
48475,2010,28,36,-60,0,-8,-60,NA,NA,NA,NA,NA,NA
48475,2011,134,97,43,1,37,44,12.602868563,9.1229720198,4.0442040912,0.0940512579,3.4798965436,4.1382553492
48475,2012,176,127,99,3,49,102,16.37437782,11.815602177,9.2105875238,0.2791087128,4.5587756431,9.4896962367
48475,2013,200,117,287,11,83,298,18.152114721,10.618987112,26.048284625,0.9983663097,7.5331276094,27.046650935
48475,2014,182,101,264,14,81,278,15.972618369,8.8639255781,23.169072798,1.2286629514,7.1086927904,24.39773575
48475,2015,186,129,-11,16,57,5,16.022741956,11.112546841,-0.947581514,1.3783003833,4.9101951156,0.4307188698
48475,2016,181,117,-133,19,64,-114,15.584639229,10.074048562,-11.45169623,1.6359566041,5.5105906664,-9.815739625
48475,2017,181,91,-228,20,90,-208,15.69749794,7.8921122241,-19.77364381,1.7345301591,7.8053857161,-18.03911366
13299,2010,127,133,18,6,-6,24,NA,NA,NA,NA,NA,NA
13299,2011,512,434,-113,16,78,-97,14.101381219,11.953123924,-3.112218902,0.4406681631,2.1482572951,-2.671550739
13299,2012,502,434,-469,24,68,-445,13.901196278,12.018165707,-12.98737262,0.6645990253,1.8830305716,-12.32277359
13299,2013,480,440,-212,31,40,-181,13.386694184,12.271136335,-5.912456598,0.8645573327,1.1155578486,-5.047899265
13299,2014,458,437,-259,29,21,-230,12.835063825,12.246556532,-7.258256617,0.8127005479,0.5885072933,-6.445556069
13299,2015,476,441,-222,33,35,-189,13.406751257,12.420960723,-6.252728527,0.929459646,0.9857905336,-5.323268881
13299,2016,508,475,280,36,33,316,14.269061697,13.342134461,7.8648371557,1.0111933486,0.9269272362,8.8760305043
13299,2017,501,423,-17,36,78,19,13.985233157,11.807891468,-0.47454883,1.0049269334,2.1773416891,0.5303781038
13301,2010,13,34,-33,0,-21,-33,NA,NA,NA,NA,NA,NA
13301,2011,68,78,-96,-1,-10,-97,11.868400384,13.613753382,-16.75538878,-0.1745353,-1.745352998,-16.92992408
13301,2012,75,66,-142,0,9,-142,13.365410318,11.76156108,-25.30517687,0,1.6038492382,-25.30517687
13301,2013,58,80,-3,1,-22,-2,10.48066498,14.456089628,-0.542103361,0.1807011203,-3.975424648,-0.361402241
13301,2014,42,68,-34,2,-26,-32,7.6467910787,12.380518889,-6.190259445,0.3641329085,-4.733727811,-5.826126536
13301,2015,55,90,-50,2,-35,-48,10.14572957,16.602102933,-9.223390518,0.3689356207,-6.456373363,-8.854454898
13301,2016,55,65,11,2,-10,13,10.222098318,12.080661649,2.0444196636,0.3717126661,-1.858563331,2.4161323297
13301,2017,51,64,-67,2,-13,-65,9.5460926533,11.979410388,-12.54094525,0.3743565746,-2.433317735,-12.16658868
17187,2010,54,30,-16,3,24,-13,NA,NA,NA,NA,NA,NA
17187,2011,192,180,78,23,12,101,10.801080108,10.126012601,4.3879387939,1.2938793879,0.6750675068,5.6818181818
17187,2012,225,192,-167,41,33,-126,12.65039919,10.795007309,-9.389407399,2.3051838525,1.8553918813,-7.084223547
17187,2013,211,181,-165,34,30,-131,11.926968515,10.231191001,-9.326776327,1.9218811825,1.695777514,-7.404895144
17187,2014,217,189,-49,37,28,-12,12.294965863,10.708518655,-2.776282614,2.0963766679,1.5864472081,-0.679905946
17187,2015,214,191,-351,38,23,-313,12.21949409,10.906183978,-20.04225433,2.1698167076,1.3133101125,-17.87243762
17187,2016,238,182,-161,42,56,-119,13.726677625,10.496871125,-9.285693687,2.422354875,3.2298065,-6.863338812
17187,2017,235,180,-235,41,55,-194,13.6334629,10.442652434,-13.6334629,2.3786041655,3.1908104659,-11.25485873
18171,2010,24,4,-9,0,20,-9,NA,NA,NA,NA,NA,NA
18171,2011,96,71,-82,2,25,-80,11.3060888,8.3617948416,-9.657284183,0.2355435167,2.9442939583,-9.421740667
18171,2012,114,72,-124,1,42,-123,13.531960354,8.546501276,-14.71897442,0.1187014066,4.9854590777,-14.60027301
18171,2013,76,72,-29,4,4,-25,9.0757105326,8.5980415572,-3.463100072,0.4776689754,0.4776689754,-2.985431096
18171,2014,87,77,-44,4,10,-40,10.42040963,9.2226613966,-5.270092227,0.4790992933,1.1977482333,-4.790992933
18171,2015,85,90,-63,4,-5,-59,10.23726364,10.839455618,-7.587618933,0.481753583,-0.602191979,-7.10586535
18171,2016,76,78,-99,4,-2,-95,9.2429309821,9.4861660079,-12.04013378,0.4864700517,-0.243235026,-11.55366373
18171,2017,70,84,37,4,-14,41,8.5496183206,10.259541985,4.5190839695,0.4885496183,-1.709923664,5.0076335878
19181,2010,135,68,46,3,67,49,NA,NA,NA,NA,NA,NA
19181,2011,514,386,153,14,128,167,11.057568196,8.3039325359,3.2914551243,0.3011789003,2.7536356596,3.5926340246
19181,2012,514,364,89,21,150,110,10.99335907,7.7851803531,1.9035193721,0.4491450204,3.2081787169,2.3526643924
19181,2013,553,375,269,22,178,291,11.737114113,7.9591641816,5.709373773,0.466937632,3.7779499316,6.176311405
19181,2014,537,403,342,11,134,353,11.28412028,8.4683435248,7.1865347034,0.231145853,2.8157767551,7.4176805564
19181,2015,536,387,476,12,149,488,11.132341946,8.0377170391,9.8861842652,0.2492315361,3.0946249065,10.135415801
19181,2016,569,419,717,11,150,728,11.634921122,8.5677187171,14.661227494,0.2249281763,3.0672024047,14.886155671
19181,2017,570,430,668,11,140,679,11.456595582,8.6426949129,13.426326051,0.2210921954,2.8139006693,13.647418246
21227,2010,368,161,238,80,207,318,NA,NA,NA,NA,NA,NA
21227,2011,1466,913,529,402,553,931,12.740458778,7.9345421995,4.5973415373,3.4936319433,4.8059165787,8.0909734806
21227,2012,1504,921,430,437,583,867,12.906492292,7.9035102398,3.6900210674,3.7500911778,5.0029820519,7.4401122453
21227,2013,1570,967,795,537,603,1332,13.280100151,8.1795266532,6.7246367004,4.5423017712,5.1005734973,11.266938472
21227,2014,1513,921,596,631,592,1227,12.597992481,7.6687052711,4.9625932047,5.254020658,4.9292872101,10.216613863
21227,2015,1657,958,1333,683,699,2016,13.540789893,7.8286522134,10.893103758,5.5813877471,5.7121376797,16.474491505
21227,2016,1680,954,1180,696,726,1876,13.435808028,7.6296195587,9.4370556386,5.5662633258,5.8061884692,15.003318964
21227,2017,1670,945,1088,690,725,1778,13.088492315,7.406362418,8.5271135564,5.4078201782,5.6821298974,13.934933735
28149,2010,158,77,-21,5,81,-16,NA,NA,NA,NA,NA,NA
28149,2011,622,534,-645,16,88,-629,12.806127176,10.994327833,-13.27966564,0.3294180624,1.8117993432,-12.95024758
28149,2012,608,458,-273,29,150,-244,12.598816789,9.4905560678,-5.657034512,0.600930406,3.1082607209,-5.056104106
28149,2013,622,523,-45,32,99,-13,12.89119171,10.839378238,-0.932642487,0.6632124352,2.0518134715,-0.269430052
28149,2014,622,513,-482,24,109,-458,12.926958528,10.661623352,-10.01735371,0.4987893966,2.2653351761,-9.518564318
28149,2015,637,573,-527,26,64,-501,13.346742934,12.00578289,-11.04196786,0.5447650177,1.3409600436,-10.49720284
28149,2016,635,568,-562,27,67,-535,13.431904475,12.014679908,-11.88776428,0.5711203477,1.4172245666,-11.31664393
28149,2017,610,548,-362,26,62,-336,13.00514876,11.683313968,-7.717809592,0.554317816,1.321834792,-7.163491776
29219,2010,104,42,10,-2,62,8,NA,NA,NA,NA,NA,NA
29219,2011,411,258,-154,-10,153,-164,12.615488505,7.9192117622,-4.726971362,-0.306946192,4.6962767427,-5.033917554
29219,2012,395,266,26,-12,129,14,12.100974205,8.1490104773,0.7965198211,-0.367624533,3.9519637277,0.4288952883
29219,2013,422,240,69,-2,182,67,12.853118099,7.3098301987,2.1015761821,-0.060915252,5.5432879007,2.0406609305
29219,2014,388,308,119,-2,80,117,11.739432997,9.3189313485,3.6004962028,-0.060512541,2.420501649,3.5399836616
29219,2015,419,296,209,-1,123,208,12.57767238,8.8854201063,6.2738270345,-0.030018311,3.6922522739,6.2438087233
29219,2016,428,300,210,-1,128,209,12.720301959,8.9160995037,6.2412696526,-0.029720332,3.8042024549,6.2115493209
29219,2017,428,304,435,-1,124,434,12.55352848,8.9165249017,12.758843198,-0.029330674,3.6370035783,12.729512524
34041,2010,253,259,-83,46,-6,-37,NA,NA,NA,NA,NA,NA
34041,2011,1002,959,-617,184,43,-433,9.2425619053,8.8459250172,-5.691278139,1.6972369167,0.3966368882,-3.994041223
34041,2012,1002,932,-762,200,70,-562,9.2798829364,8.6315877213,-7.057156485,1.8522720432,0.6482952151,-5.204884441
34041,2013,940,1005,-739,222,-65,-517,8.7486621062,9.3536227837,-6.877937549,2.066173391,-0.604960678,-4.811764158
34041,2014,1034,878,-197,253,156,56,9.6403514906,8.1859077454,-1.836701396,2.3588094073,1.4544437452,0.5221080111
34041,2015,938,993,-288,276,-55,-12,8.7402161759,9.252702199,-2.683563176,2.5717480432,-0.512486023,-0.111815132
34041,2016,983,993,-716,289,-10,-427,9.1814670733,9.2748695867,-6.687619964,2.699332639,-0.093402513,-3.988287325
34041,2017,952,931,-357,290,21,-67,8.9120635827,8.7154739449,-3.342023844,2.7148092846,0.1965896379,-0.627214559
36113,2010,154,185,8,7,-31,15,NA,NA,NA,NA,NA,NA
36113,2011,616,636,81,14,-20,95,9.3754518405,9.6798496275,1.2328110375,0.2130784509,-0.304397787,1.4458894884
36113,2012,611,661,-278,22,-50,-256,9.3168648978,10.079292467,-4.239097286,0.3354681305,-0.762427569,-3.903629155
36113,2013,596,632,-318,34,-36,-284,9.131930346,9.6835234542,-4.872405789,0.5209490466,-0.551593108,-4.351456742
36113,2014,567,699,-107,46,-132,-61,8.7226072442,10.753267132,-1.6460652120000001,0.7076542032,-2.030659888,-0.938411009
36113,2015,531,766,-263,47,-235,-216,8.210345654,11.843926122,-4.066517716,0.7267160937,-3.633580468,-3.339801622
36113,2016,575,649,98,49,-74,147,8.9170097777,10.064590166,1.519768623,0.7598843115,-1.147580389,2.2796529345
36113,2017,543,653,78,49,-110,127,8.4152776809,10.120030066,1.2088244183,0.7593896986,-1.704752385,1.9682141169
37185,2010,47,64,-27,1,-17,-26,NA,NA,NA,NA,NA,NA
37185,2011,219,215,5,6,4,11,10.436771749,10.246145781,0.23828246,0.285938952,0.190625968,0.5242214121
37185,2012,158,204,-202,16,-46,-186,7.5694061849,9.7731573526,-9.677342084,0.7665221453,-2.203751168,-8.910819939
37185,2013,175,243,-91,-5,-68,-96,8.4637148454,11.752472614,-4.40113172,-0.241820424,-3.288757768,-4.642952144
37185,2014,194,235,-171,-5,-41,-176,9.4698818705,11.471248658,-8.347163917,-0.24406912,-2.001366787,-8.591233037
37185,2015,174,233,-106,-5,-59,-111,8.5750190967,11.482640515,-5.223862208,-0.246408595,-2.907621418,-5.470270803
37185,2016,196,263,-243,-6,-67,-249,9.7767801472,13.118842748,-12.12121212,-0.299289188,-3.342062601,-12.42050131
37185,2017,175,255,81,-6,-80,75,8.8001609172,12.823091622,4.0732173388,-0.301719803,-4.022930705,3.771497536
39165,2010,649,357,274,70,292,344,NA,NA,NA,NA,NA,NA
39165,2011,2486,1386,518,321,1100,839,11.594094754,6.4639643316,2.4158250532,1.4970653322,5.1301304219,3.9128903854
39165,2012,2407,1494,622,378,913,1000,11.127342659,6.9066264782,2.8754495779,1.7474597113,4.2207161811,4.6229092893
39165,2013,2455,1564,573,402,891,975,11.252383397,7.168524494,2.6263200352,1.8425491346,4.0838589029,4.4688691698
39165,2014,2355,1577,844,467,778,1311,10.698491081,7.1641275733,3.8341938312,2.1215266815,3.5343635079,5.9557205127
39165,2015,2344,1645,1406,503,699,1909,10.537507277,7.395136293,6.3207061568,2.2612483619,3.1423709841,8.5819545188
39165,2016,2420,1603,1427,500,817,1927,10.750514759,7.1211054372,6.3392498184,2.2211807353,3.6294093214,8.5604305537
39165,2017,2376,1785,1332,499,591,1831,10.435745062,7.8399852424,5.8503419288,2.191682149,2.5957598197,8.0420240778
42123,2010,99,119,-15,0,-20,-15,NA,NA,NA,NA,NA,NA
42123,2011,396,469,-213,12,-73,-201,9.51042905,11.263614203,-5.11545805,0.2881948197,-1.753185153,-4.82726323
42123,2012,391,510,-128,10,-119,-118,9.4485525108,12.324198927,-3.09313228,0.2416509594,-2.875646416,-2.85148132
42123,2013,417,526,-180,10,-109,-170,10.140557366,12.791206653,-4.377219007,0.2431788337,-2.650649287,-4.134040173
42123,2014,399,480,-196,7,-81,-189,9.7683983744,11.751456691,-4.798511482,0.1713754101,-1.983058317,-4.627136072
42123,2015,405,510,-238,8,-105,-230,9.9896403729,12.579547136,-5.87045533,0.1973262296,-2.589906763,-5.673129101
42123,2016,365,517,-232,9,-152,-223,9.0827651421,12.865176927,-5.77315483,0.2239585925,-3.782411785,-5.549196237
42123,2017,377,516,-208,9,-139,-199,9.4655836901,12.955546907,-5.222391001,0.2259688414,-3.489963217,-4.99642216
47177,2010,110,78,8,0,32,8,NA,NA,NA,NA,NA,NA
47177,2011,510,525,35,14,-15,49,12.790449797,13.166639497,0.8777759665,0.3511103866,-0.3761897,1.2288863531
47177,2012,440,439,-165,11,1,-154,11.05277701,11.027657062,-4.144791379,0.2763194253,0.0251199478,-3.868471954
47177,2013,500,475,76,31,25,107,12.564392512,11.936172886,1.9097876618,0.7789923357,0.6282196256,2.6887799975
47177,2014,488,475,39,30,13,69,12.231649393,11.905806274,0.9775293572,0.7519456594,0.3258431191,1.7294750166
47177,2015,455,481,261,42,-26,303,11.355128525,12.003993012,6.5136011979,1.04816571,-0.648864487,7.5617669079
47177,2016,478,508,174,49,-30,223,11.860159293,12.604520755,4.3172964792,1.2157903878,-0.744361462,5.533086867
47177,2017,454,473,226,48,-19,274,11.202822914,11.67166352,5.5767356356,1.184439427,-0.468840607,6.7611750626
51187,2010,100,111,78,-1,-11,77,NA,NA,NA,NA,NA,NA
51187,2011,453,335,16,-4,118,12,12.060702875,8.9190628328,0.4259850905,-0.106496273,3.1416400426,0.3194888179
51187,2012,447,358,161,-5,89,156,11.842941925,9.4849512505,4.265578635,-0.132471386,2.357990674,4.1331072488
51187,2013,471,368,493,6,103,499,12.339372028,9.640953092,12.915733354,0.1571894526,2.6984189361,13.072922807
51187,2014,503,333,304,3,170,307,12.991709068,8.6008730015,7.8518480254,0.0774853424,4.3908360668,7.9293333678
51187,2015,483,364,-187,3,119,-184,12.408637234,9.3514367558,-4.804172179,0.077072281,3.0572004778,-4.727099899
51187,2016,447,371,95,5,76,100,11.467860487,9.5180676527,2.4372410431,0.1282758444,1.9497928345,2.5655168875
51187,2017,456,361,396,4,95,400,11.598773989,9.1823627415,10.072619517,0.1017436315,2.4164112478,10.174363148
18173,2010,165,128,98,10,37,108,NA,NA,NA,NA,NA,NA
18173,2011,664,499,141,46,165,187,11.065375706,8.3156965021,2.3497258653,0.7665772327,2.7496792041,3.116303098
18173,2012,638,464,-90,59,174,-31,10.589211618,7.7012448133,-1.493775934,0.979253112,2.887966805,-0.514522822
18173,2013,644,574,379,68,70,447,10.631360864,9.4757781611,6.2566549182,1.1225660539,1.1555827026,7.3792209722
18173,2014,616,482,-86,73,134,-13,10.11676986,7.9160439488,-1.412406182,1.1989029217,2.2007259111,-0.21350326
18173,2015,686,552,397,75,134,472,11.200457162,9.0126127597,6.4818972203,1.2245397771,2.1878444018,7.7064369974
18173,2016,686,592,334,78,94,412,11.100593056,9.5795205385,5.4046619255,1.2621665574,1.5210725179,6.6668284829
18173,2017,685,618,342,77,67,419,10.997038024,9.9214153268,5.490491977,1.2361633983,1.0756226972,6.7266553753
49051,2010,79,37,63,10,42,73,NA,NA,NA,NA,NA,NA
49051,2011,370,124,473,61,246,534,15.391975373,5.1583917466,19.676768517,2.5375959398,10.233583626,22.214364457
49051,2012,379,107,623,87,272,710,15.202262289,4.2919315698,24.989470729,3.4897013698,10.910330719,28.479172098
49051,2013,414,103,838,80,311,918,15.892209363,3.9538588511,32.168288517,3.0709583309,11.938350512,35.239246847
49051,2014,422,130,856,64,292,920,15.463823082,4.7637369684,31.367375731,2.3452243537,10.700086114,33.712600084
49051,2015,472,127,936,72,345,1008,16.509557705,4.4421903146,32.739292398,2.5184071075,12.06736739,35.257699505
49051,2016,433,141,931,75,292,1006,14.470957824,4.7122518548,31.114230332,2.5065169441,9.7587059689,33.620747276
49051,2017,438,133,1151,76,305,1227,13.976418782,4.2439810457,36.727986343,2.4251320261,9.7324377363,39.153118369
41065,2010,83,43,29,2,40,31,NA,NA,NA,NA,NA,NA
41065,2011,270,309,-59,12,-39,-47,10.699001427,12.244412744,-2.337929941,0.4755111745,-1.545411317,-1.862418767
41065,2012,300,303,175,6,-3,181,11.8666192,11.985285392,6.9221945334,0.237332384,-0.118666192,7.1595269174
41065,2013,298,304,-46,19,-6,-27,11.754728517,11.991400903,-1.814488295,0.7494625565,-0.236672386,-1.0650257380000001
41065,2014,316,326,-42,14,-10,-28,12.483704026,12.87875795,-1.659226484,0.5530754948,-0.395053925,-1.10615099
41065,2015,305,331,212,20,-26,232,12.009528872,13.033291989,8.3476069537,0.78751009,-1.023763117,9.1351170437
41065,2016,344,314,317,26,30,343,13.39277024,12.224796091,12.341593506,1.0122442623,1.1679741488,13.353837768
41065,2017,333,297,498,27,36,525,12.732278045,11.355815554,19.041064464,1.0323468685,1.3764624914,20.073411333
27161,2010,53,23,-25,1,30,-24,NA,NA,NA,NA,NA,NA
27161,2011,231,164,-27,2,67,-25,12.05510907,8.5586055735,-1.409038722,0.1043732387,3.4965034965,-1.304665484
27161,2012,219,176,-53,3,43,-50,11.419632382,9.1774214574,-2.763655325,0.1564333203,2.2422109243,-2.607222005
27161,2013,211,172,-191,6,39,-185,11.047409618,9.0054713474,-10.00026179,0.3141443493,2.0419382706,-9.686117438
27161,2014,209,157,-168,4,52,-164,11.015653824,8.2749169873,-8.854688241,0.2108259105,2.7407368366,-8.643862331
27161,2015,208,167,-40,9,41,-31,10.991333756,8.8247727753,-2.11371803,0.4755865568,2.1665609808,-1.638131473
27161,2016,222,167,-166,9,55,-157,11.759408851,8.8460417936,-8.793071483,0.4767327913,2.9133670578,-8.316338692
27161,2017,214,149,-116,9,65,-107,11.378439452,7.9223713944,-6.167752227,0.4785325003,3.456068058,-5.689219726
56043,2010,26,34,11,1,-8,12,NA,NA,NA,NA,NA,NA
56043,2011,108,79,-110,3,29,-107,12.708124963,9.295758075,-12.94346061,0.3530034712,3.4123668883,-12.59045714
56043,2012,90,105,-23,0,-15,-23,10.662875422,12.440021326,-2.724957052,0,-1.777145904,-2.724957052
56043,2013,95,77,-10,-1,18,-11,11.277302944,9.1405508072,-1.18708452,-0.118708452,2.1367521368,-1.305792972
56043,2014,89,73,-157,-2,16,-159,10.649117559,8.7346694586,-18.78552199,-0.239306013,1.9144481005,-19.024828
56043,2015,101,95,4,0,6,4,12.180414858,11.456825856,0.4823926676,0,0.7235890014,0.4823926676
56043,2016,92,81,-119,0,11,-119,11.162339238,9.8277117205,-14.43824314,0,1.3346275176,-14.43824314
56043,2017,86,85,-125,0,1,-125,10.583312823,10.460251046,-15.38272213,0,0.123061777,-15.38272213
55129,2010,38,22,8,0,16,8,NA,NA,NA,NA,NA,NA
55129,2011,163,217,-37,1,-54,-36,10.25866952,13.657247152,-2.328655044,0.0629366228,-3.398577632,-2.265718422
55129,2012,154,220,73,2,-66,75,9.7179276835,13.882753834,4.6065501357,0.126206853,-4.16482615,4.7327569887
55129,2013,151,237,-109,4,-86,-105,9.5848673353,15.0437984,-6.918877745,0.2539037705,-5.458931065,-6.664973975
55129,2014,157,200,33,6,-43,39,10.029065125,12.77587914,2.1080200581,0.3832763742,-2.746814015,2.4912964323
55129,2015,151,199,-96,6,-48,-90,9.6909796874,12.771556012,-6.161152649,0.3850720406,-3.080576324,-5.776080608
55129,2016,121,191,161,8,-70,169,7.7758498811,12.274275432,10.346378767,0.5141057773,-4.498425551,10.860484545
55129,2017,138,203,204,8,-65,212,8.7987758225,12.943126753,13.006885998,0.5100739607,-4.144350931,13.516959959
01129,2010,41,25,27,2,16,29,NA,NA,NA,NA,NA,NA
01129,2011,169,200,-265,19,-31,-246,9.6615595701,11.433798308,-15.14978276,1.0862108392,-1.772238738,-14.06357192
01129,2012,166,183,-221,18,-17,-203,9.6245832729,10.610233367,-12.81345122,1.0436295115,-0.985650094,-11.76982171
01129,2013,159,231,-195,14,-72,-181,9.3452450923,13.577054191,-11.46114964,0.8228517691,-4.231809098,-10.63829787
01129,2014,167,212,-5,15,-45,10,9.8995228074,12.567058893,-0.296392898,0.8891786953,-2.667536086,0.5927857969
01129,2015,178,222,-10,15,-44,5,10.575409203,13.189555298,-0.594124113,0.8911861688,-2.614146095,0.2970620563
01129,2016,179,187,-176,18,-8,-158,10.699982067,11.178193556,-10.52065276,1.0759758503,-0.478211489,-9.444676908
01129,2017,170,201,-101,18,-31,-83,10.248063417,12.116827923,-6.088555324,1.0850890677,-1.868764506,-5.003466257
05143,2010,803,328,319,134,475,453,NA,NA,NA,NA,NA,NA
05143,2011,3201,1323,1232,637,1878,1869,15.550006801,6.4269475157,5.9848823427,3.0944562113,9.1230592853,9.0793385539
05143,2012,3320,1439,1143,455,1881,1598,15.848919696,6.8694564584,5.4564202446,2.1720658017,8.9794632372,7.6284860463
05143,2013,3232,1448,2167,321,1784,2488,15.147148076,6.7862222816,10.155900334,1.5044042489,8.3609257944,11.660304583
05143,2014,3217,1421,1601,490,1796,2091,14.791926744,6.5338290031,7.3614779972,2.2530444838,8.2580977407,9.614522481
05143,2015,3154,1525,2182,573,1629,2755,14.229866025,6.8803252025,9.8445046504,2.5851976007,7.3495408229,12.429702251
05143,2016,3208,1569,1509,594,1639,2103,14.211952128,6.9509204764,6.685110898,2.6315148266,7.2610316513,9.3166257246
05143,2017,3240,1531,2078,595,1709,2673,14.09933942,6.6623730407,9.0427244798,2.5892305416,7.4369663792,11.631955021
08121,2010,12,5,3,0,7,3,NA,NA,NA,NA,NA,NA
08121,2011,41,53,-52,3,-12,-49,8.5541414563,11.057792614,-10.84915502,0.6259127895,-2.503651158,-10.22324223
08121,2012,39,50,-54,1,-11,-53,8.2417582418,10.56635672,-11.41166526,0.2113271344,-2.324598478,-11.20033812
08121,2013,34,41,49,1,-7,50,7.2003388395,8.6827615417,10.376958916,0.2117746717,-1.482422702,10.588733587
08121,2014,48,52,-8,1,-4,-7,10.131926121,10.976253298,-1.688654354,0.2110817942,-0.844327177,-1.477572559
08121,2015,47,50,56,1,-3,57,9.8749868684,10.505305179,11.765941801,0.2101061036,-0.630318311,11.976047904
08121,2016,57,59,60,1,-2,61,11.834319527,12.249558808,12.457178449,0.2076196408,-0.415239282,12.66479809
08121,2017,55,47,83,1,8,84,11.242845462,9.6075224857,16.966475879,0.204415372,1.6353229763,17.170891251
12133,2010,61,101,-153,3,-40,-150,NA,NA,NA,NA,NA,NA
12133,2011,222,277,-164,0,-55,-164,9.0192573332,11.253758024,-6.662874787,0,-2.234500691,-6.662874787
12133,2012,242,271,248,5,-29,253,9.8282093977,11.005970028,10.071884011,0.2030621776,-1.17776063,10.274946189
12133,2013,249,246,-246,4,3,-242,10.113317899,9.9914706957,-9.991470696,0.1624629381,0.1218472036,-9.829007758
12133,2014,222,279,-151,5,-57,-146,9.0983606557,11.43442623,-6.18852459,0.2049180328,-2.336065574,-5.983606557
12133,2015,241,261,261,5,-20,266,9.8685557512,10.687523033,10.687523033,0.2047418206,-0.818967282,10.892264854
12133,2016,243,325,-17,5,-82,-12,9.9193795285,13.266659863,-0.693948362,0.2041024594,-3.347280335,-0.489845903
12133,2017,233,302,180,5,-69,185,9.5069057674,12.322255544,7.3443907216,0.2040108534,-2.815349777,7.548401575
13303,2010,52,87,-59,0,-35,-59,NA,NA,NA,NA,NA,NA
13303,2011,233,206,-152,0,27,-152,11.076776801,9.7932018065,-7.226051818,0,1.2835749941,-7.226051818
13303,2012,265,201,-246,0,64,-246,12.68853244,9.6241321523,-11.7787886,0,3.0644002873,-11.7787886
13303,2013,219,179,-267,0,40,-267,10.586358583,8.6527771064,-12.90665635,0,1.9335814763,-12.90665635
13303,2014,257,212,-68,1,45,-67,12.496353204,10.308275795,-3.306428085,0.0486239424,2.1880774093,-3.257804143
13303,2015,232,228,178,1,4,179,11.236227146,11.042499092,8.6208984138999991,0.0484320136,0.1937280542,8.6693304274
13303,2016,232,253,-379,1,-21,-378,11.294209284,12.316529952,-18.45045396,0.0486819366,-1.022320668,-18.40177202
13303,2017,216,237,-8,1,-21,-7,10.625737898,11.65879575,-0.393545848,0.049193231,-1.033057851,-0.344352617
16087,2010,26,46,1,0,-20,1,NA,NA,NA,NA,NA,NA
16087,2011,111,112,-38,-4,-1,-42,10.929499803,11.027963765,-3.741630563,-0.393855849,-0.098463962,-4.135486412
16087,2012,92,122,-72,-1,-30,-73,9.1233637445,12.098373661,-7.1400238,-0.099166997,-2.975009917,-7.239190797
16087,2013,107,123,-93,-2,-16,-95,10.724129291,12.327737409,-9.320972187,-0.200451015,-1.603608118,-9.521423202
16087,2014,118,135,63,-1,-17,62,11.866452132,13.576025744,6.3354786806,-0.100563154,-1.709573612,6.234915527
16087,2015,104,104,-56,0,0,-56,10.465408805,10.465408805,-5.635220126,0,0,-5.635220126
16087,2016,107,107,153,2,0,155,10.714464527,10.714464527,15.320682922,0.200270365,0,15.520953287
16087,2017,115,89,30,2,26,32,11.39459995,8.8184295269,2.9725043349,0.1981669557,2.5761704236,3.1706712906
17189,2010,35,20,-18,0,15,-18,NA,NA,NA,NA,NA,NA
17189,2011,152,158,-133,-1,-6,-134,10.380386533,10.790138633,-9.082838216,-0.068292017,-0.4097521,-9.151130233
17189,2012,134,143,33,0,-9,33,9.1868915398,9.8039215686,2.2624434389,0,-0.617030029,2.2624434389
17189,2013,165,162,-190,1,3,-189,11.374603612,11.167792638,-13.0980284,0.0689369916,0.2068109748,-13.02909141
17189,2014,148,154,-19,1,-6,-18,10.276707287,10.693330556,-1.319307017,0.0694372114,-0.416623268,-1.249869805
17189,2015,170,155,-148,1,15,-147,11.868607533,10.821377457,-10.33267009,0.0698153384,1.0472300764,-10.26285475
17189,2016,186,148,-85,1,38,-84,13.067303639,10.397639455,-5.971617254,0.0702543206,2.6696641843,-5.901362934
17189,2017,182,137,-228,1,45,-227,12.889518414,9.7025495751,-16.14730878,0.0708215297,3.1869688385,-16.07648725
18175,2010,71,52,22,2,19,24,NA,NA,NA,NA,NA,NA
18175,2011,297,302,-105,13,-5,-92,10.512158001,10.689130358,-3.716419495,0.460128128,-0.176972357,-3.256291367
18175,2012,304,303,-288,1,1,-287,10.832383124,10.796750285,-10.2622577,0.0356328392,0.0356328392,-10.22662486
18175,2013,309,290,-149,-2,19,-151,11.09276278,10.410683515,-5.348937392,-0.071797817,0.6820792648,-5.42073521
18175,2014,346,291,56,-3,55,53,12.427491335,10.452023059,2.0113858808,-0.107752815,1.9754682758,1.9036330657
18175,2015,326,302,-135,-3,24,-138,11.711663164,10.849454833,-4.849921862,-0.107776041,0.8622083311,-4.957697904
18175,2016,313,328,-11,-3,-15,-14,11.27420081,11.814497974,-0.39621792,-0.108059433,-0.540297163,-0.504277353
18175,2017,324,291,51,-3,33,48,11.659919028,10.472334683,1.8353576248,-0.107962213,1.1875843455,1.7273954116
19183,2010,73,67,-19,1,6,-18,NA,NA,NA,NA,NA,NA
19183,2011,279,269,122,-1,10,121,12.824932773,12.365257763,5.6080351192,-0.045967501,0.4596750098,5.5620676182
19183,2012,265,227,49,0,38,49,12.122043822,10.383788482,2.2414345181,0,1.7382553406,2.2414345181
19183,2013,301,222,-45,4,79,-41,13.730499042,10.126813247,-2.052732415,0.1824651035,3.6036857951,-1.870267311
19183,2014,309,243,5,8,66,13,14.05887438,11.056008008,0.2274898767,0.3639838027,3.0028663724,0.5914736794
19183,2015,323,254,41,6,69,47,14.633593838,11.507531997,1.8575150074,0.2718314645,3.1260618417,2.1293464719
19183,2016,303,231,-96,6,72,-90,13.698939802,10.443746185,-4.340258155,0.2712661347,3.2551936162,-4.06899202
19183,2017,299,225,93,6,74,99,13.471502591,10.137418337,4.1901329128,0.2703311557,3.3340842532,4.4604640685
20201,2010,8,8,-10,0,0,-10,NA,NA,NA,NA,NA,NA
20201,2011,64,82,44,8,-18,52,11.030679076,14.133057566,7.5835918649,1.3788348845,-3.10237849,8.9624267494
20201,2012,61,66,-94,6,-5,-88,10.564599931,11.430550745,-16.2798753,1.0391409768,-0.865950814,-15.24073433
20201,2013,79,70,-114,2,9,-112,13.912124681,12.327199084,-20.07572422,0.3522056881,1.5849255965,-19.72351853
20201,2014,68,70,-17,2,-2,-15,12.099644128,12.455516014,-3.024911032,0.3558718861,-0.355871886,-2.669039146
20201,2015,75,72,-47,2,3,-45,13.415615777,12.878991146,-8.40711922,0.357749754,0.5366246311,-8.049369466
20201,2016,85,70,-20,3,15,-17,15.264433869,12.570710245,-3.591631499,0.5387447248,2.693723624,-3.052886774
20201,2017,85,84,-87,3,1,-84,15.3804397,15.19949335,-15.7423324,0.5428390482,0.1809463494,-15.19949335
21229,2010,21,54,41,0,-33,41,NA,NA,NA,NA,NA,NA
21229,2011,120,135,34,-2,-15,32,10.227127456,11.505518388,2.8976861124,-0.170452124,-1.278390932,2.7272339882
21229,2012,143,144,75,5,-1,80,12.137158377,12.222033611,6.3656425055,0.424376167,-0.084875233,6.7900186726
21229,2013,166,129,-41,20,37,-21,14.032121724,10.904480135,-3.465765004,1.6906170752,3.1276415892,-1.775147929
21229,2014,148,121,8,25,27,33,12.472085282,10.196772427,0.674166772,2.1067711625,2.2753128555,2.7809379345
21229,2015,131,138,91,28,-7,119,10.960967243,11.546667782,7.6141070159,2.3428021587,-0.58570054,9.9569091746
21229,2016,143,129,80,29,14,109,11.848537576,10.68854089,6.6285524899,2.4028502776,1.1599966857,9.0314027674
21229,2017,140,139,-34,29,1,-5,11.54353562,11.461081794,-2.803430079,2.3911609499,0.0824538259,-0.412269129
23029,2010,87,91,-20,-1,-4,-21,NA,NA,NA,NA,NA,NA
23029,2011,294,406,0,5,-112,5,8.9713466174,12.389002472,0,0.1525739221,-3.417655854,0.1525739221
23029,2012,311,406,-78,12,-95,-66,9.5302301351,12.441393681,-2.39021849,0.3677259216,-2.911163546,-2.022492569
23029,2013,306,448,-145,16,-142,-129,9.4405108982,13.821401577,-4.473444707,0.4936214849,-4.380890678,-3.979823222
23029,2014,286,443,-217,25,-157,-192,8.9091022366,13.799763255,-6.759703445,0.778767678,-4.890661018,-5.980935767
23029,2015,329,418,-116,27,-89,-89,10.333725952,13.129171574,-3.643502159,0.8480565371,-2.795445622,-2.795445622
23029,2016,294,413,-87,26,-119,-61,9.2871922038,13.04629381,-2.748250754,0.8213163173,-3.759101606,-1.9269344369999999
23029,2017,297,398,105,26,-101,131,9.4048354154,12.603112779,3.3249418135,0.8233189253,-3.198277363,4.1482607388
24043,2010,426,365,190,43,61,233,NA,NA,NA,NA,NA,NA
24043,2011,1737,1406,516,192,331,708,11.717524681,9.4846515268,3.4808536186,1.2952013465,2.2328731546,4.7760549651
24043,2012,1743,1419,-208,201,324,-7,11.705371174,9.5295018334,-1.396854391,1.3498448686,2.1758693404,-0.047009523
24043,2013,1729,1520,-446,229,209,-217,11.600056357,10.197851742,-2.992264393,1.5363868743,1.4022046145,-1.455877518
24043,2014,1772,1517,-452,253,255,-199,11.886953197,10.176358916,-3.032112215,1.6971778548,1.7105942806,-1.33493436
24043,2015,1739,1540,-365,274,199,-91,11.659598719,10.325349067,-2.447241824,1.8371075613,1.3342496522,-0.610134263
24043,2016,1702,1494,126,282,208,408,11.384310788,9.9930436644,0.8427868151,1.8862371575,1.3912671233,2.7290239726
24043,2017,1675,1498,319,282,177,601,11.152243099,9.973767261,2.1239197305,1.877571674,1.1784758379,4.0014914045
27163,2010,767,334,295,95,433,390,NA,NA,NA,NA,NA,NA
27163,2011,2878,1317,556,369,1561,925,11.983178582,5.4836157722,2.315026856,1.5364117084,6.4995628097000004,3.8514385644
27163,2012,2720,1335,659,316,1385,975,11.213396711,5.5036340475,2.716775159,1.3027328532,5.7097626635,4.0195080122
27163,2013,2859,1397,618,328,1462,946,11.67308026,5.7038450939,2.5232471496,1.3391991344,5.9692351662,3.862446284
27163,2014,2899,1466,784,401,1433,1185,11.717605308,5.9254947849,3.1688867062,1.6208208791,5.792110523,4.7897075853
27163,2015,2852,1510,306,429,1342,735,11.420356826,6.0465423588,1.2253258025,1.7178587231,5.3738144673,2.9431845257
27163,2016,2803,1596,585,429,1207,1014,11.128845268,6.3366525323,2.3226451951,1.7032731431,4.7921927359,4.0259183382
27163,2017,2819,1613,1761,427,1206,2188,11.069574573,6.3338856995,6.9150481815,1.6767322961,4.7356888739,8.5917804777
28151,2010,189,95,-135,-3,94,-138,NA,NA,NA,NA,NA,NA
28151,2011,818,583,-898,-10,235,-908,16.112353132,11.483498626,-17.68813339,-0.196972532,4.6288545062,-17.88510592
28151,2012,837,603,-668,-4,234,-672,16.664343879,12.005495052,-13.29961973,-0.079638441,4.6588488263,-13.37925817
28151,2013,795,595,-573,9,200,-564,15.953764185,11.940238604,-11.49875079,0.1806086512,4.0135255812,-11.31814214
28151,2014,784,612,-873,30,172,-843,15.894899035,12.407752818,-17.69929446,0.6082231774,3.4871462169,-17.09107128
28151,2015,748,584,-1255,30,164,-1225,15.43079351,12.047571404,-25.88990088,0.6188820926,3.3832221065,-25.27101878
28151,2016,676,587,-881,30,89,-851,14.210188874,12.339320812,-18.51949171,0.6306296837,1.8708680618,-17.88886203
28151,2017,662,621,-1045,30,41,-1015,14.173767824,13.295936282,-22.37399906,0.6423157624,0.877831542,-21.7316833
29221,2010,75,63,-15,0,12,-15,NA,NA,NA,NA,NA,NA
29221,2011,304,237,-169,-1,67,-170,12.090359529,9.4257079224,-6.721285396,-0.03977092,2.6646516067,-6.761056316
29221,2012,307,248,-69,0,59,-69,12.237657704,9.8857951488,-2.750483328,0,2.3518625556,-2.750483328
29221,2013,302,252,11,0,50,11,12.028517943,10.037041463,0.4381248257,0,1.9914764807,0.4381248257
29221,2014,291,296,-57,0,-5,-57,11.592701777,11.791889093,-2.2707354,0,-0.199187316,-2.2707354
29221,2015,297,292,-292,0,5,-292,11.915030189,11.714440455,-11.71444045,0,0.2005897338,-11.71444045
29221,2016,288,305,65,0,-17,65,11.609158336,12.294421154,2.6201225411,0,-0.685262818,2.6201225411
29221,2017,294,280,176,0,14,176,11.794439764,11.232799775,7.0606170016,0,0.5616399888,7.0606170016
31177,2010,54,28,21,0,26,21,NA,NA,NA,NA,NA,NA
31177,2011,198,164,-36,-4,34,-40,9.7647581003,8.0879814568,-1.775410564,-0.19726784,1.6767766435,-1.972678404
31177,2012,207,151,-27,2,56,-25,10.202321398,7.4422730969,-1.330737574,0.0985731536,2.7600483008,-1.23216442
31177,2013,201,190,-114,10,11,-104,9.9215163631,9.3785478059,-5.627128684,0.4936077793,0.5429685572,-5.133520904
31177,2014,236,170,-2,13,66,11,11.653745494,8.3946471779,-0.098760555,0.6419436077,3.2590983161,0.5431830527
31177,2015,224,190,-61,14,34,-47,11.043731203,9.3674505744,-3.007444658,0.6902332002,1.6762806291,-2.317211458
31177,2016,204,172,245,16,32,261,9.9889827396,8.4220834864,11.996572408,0.7834496266,1.5668992533,12.780022035
31177,2017,219,166,86,16,53,102,10.608152292,8.0408825595,4.1657584344,0.775024825,2.5672697329,4.9407832595
36115,2010,129,114,85,0,15,85,NA,NA,NA,NA,NA,NA
36115,2011,638,625,-291,8,13,-283,10.094617259,9.8889275656,-4.604284675,0.1265782728,0.2056896934,-4.477706402
36115,2012,658,603,-145,10,55,-135,10.440467124,9.5677837014,-2.30071084,0.1586697131,0.8726834222,-2.142041127
36115,2013,622,615,-239,13,7,-226,9.8937456258,9.7824012216,-3.801616084,0.2067824648,0.1113444041,-3.59483362
36115,2014,583,576,-303,19,7,-284,9.3105706118,9.1987798841,-4.838941502,0.3034319753,0.1117907278,-4.535509526
36115,2015,604,648,-197,21,-44,-176,9.6848417795,10.390360055,-3.158797733,0.3367246314,-0.705518275,-2.822073101
36115,2016,577,598,-447,22,-21,-425,9.3020256491,9.6405742429,-7.20624864,0.3546699554,-0.338548594,-6.851578684
36115,2017,575,655,-126,22,-80,-104,9.3173237405,10.613647044,-2.041709202,0.3564889083,-1.296323303,-1.685220294
37187,2010,29,73,-33,2,-44,-31,NA,NA,NA,NA,NA,NA
37187,2011,124,133,-218,15,-9,-203,9.5132149296,10.203690207,-16.7248456,1.1507921286,-0.690475277,-15.57405347
37187,2012,133,142,-246,11,-9,-235,10.382108427,11.084657117,-19.20299754,0.8586706218,-0.702548691,-18.34432692
37187,2013,131,176,46,14,-45,60,10.315772896,13.859359005,3.6223324671,1.1024490117,-3.543586109,4.7247814789
37187,2014,136,130,-210,6,6,-204,10.78680203,10.310913706,-16.65609137,0.4758883249,0.4758883249,-16.18020305
37187,2015,115,149,-191,6,-34,-185,9.2730718058,12.014675644,-15.40136274,0.483812442,-2.741603838,-14.9175503
37187,2016,121,156,-130,5,-35,-125,9.9078812692,12.773797339,-10.64483112,0.4094165814,-2.86591607,-10.23541453
37187,2017,118,157,-87,6,-39,-81,9.774685222,13.005301524,-7.206759443,0.4970178926,-3.230616302,-6.709741551
39167,2010,148,149,-71,3,-1,-68,NA,NA,NA,NA,NA,NA
39167,2011,623,735,9,-5,-112,4,10.10600764,11.922818003,0.1459936898,-0.081107605,-1.816810362,0.0648860844
39167,2012,615,719,-46,-7,-104,-53,9.9990244854,11.689916431,-0.747894514,-0.113810035,-1.690891946,-0.861704549
39167,2013,644,711,-20,7,-67,-13,10.492187882,11.583766435,-0.325844344,0.1140455205,-1.091578553,-0.211798824
39167,2014,611,688,-143,11,-77,-132,9.9794205076,11.237056153,-2.335609055,0.179662235,-1.257635645,-2.15594682
39167,2015,572,763,19,14,-191,33,9.3716719915,12.501024003,0.3112967969,0.2293765872,-3.129352011,0.5406733841
39167,2016,608,751,-286,13,-143,-273,10.009301407,12.363462757,-4.708322701,0.2140146682,-2.354161351,-4.494308033
39167,2017,594,728,8,13,-134,21,9.821996974,12.037733665,0.1322827875,0.2149595297,-2.215736691,0.3472423173
40147,2010,160,119,41,9,41,50,NA,NA,NA,NA,NA,NA
40147,2011,666,584,124,58,82,182,13.010734833,11.408812526,2.422419098,1.1330669975,1.6019223068,3.5554860955
40147,2012,624,587,159,76,37,235,12.128044159,11.408913335,3.0903189442,1.4771335834,0.7191308235,4.5674525276
40147,2013,609,604,-56,66,5,10,11.804727706,11.70780876,-1.085492203,1.2793300962,0.0969189467,0.1938378934
40147,2014,616,596,243,74,20,317,11.901196882,11.514794386,4.6947903283,1.4296892358,0.3864024962,6.1244795641
40147,2015,691,671,-51,83,20,32,13.30227544,12.917260232,-0.981788781,1.5978131136,0.3850152081,0.616024333
40147,2016,679,610,-212,89,69,-123,13.072524595,11.744094261,-4.081554071,1.7134826053,1.3284303344,-2.368071466
40147,2017,663,652,-80,89,11,9,12.768907806,12.55705564,-1.540743023,1.7140766134,0.2118521657,0.1733335901
41067,2010,1869,661,166,364,1208,530,NA,NA,NA,NA,NA,NA
41067,2011,7104,2857,2162,1546,4247,3708,13.265227048,5.334847083,4.0370806417,2.8868300981,7.9303799655,6.9239107398
41067,2012,7246,3069,2053,1571,4177,3624,13.334363867,5.6476901334,3.7780084209,2.8910137503,7.6866737332,6.6690221712
41067,2013,7191,3074,1653,1554,4117,3207,13.052060314,5.5794789885,3.0002858712,2.8205954288,7.4725813258,5.8208812999
41067,2014,7090,3178,1311,1899,3912,3210,12.703281621,5.6940802528,2.3489424832,3.4024727502,7.0092013685,5.7514152334
41067,2015,7046,3318,4856,2132,3728,6988,12.426106463,5.8515216072,8.5638905741,3.7599288929,6.5745848559,12.323819467
41067,2016,7070,3399,4513,2126,3671,6639,12.240802733,5.8849347229,7.8136835553,3.680897682,6.3558680106,11.494581237
41067,2017,7066,3448,499,2115,3618,2614,12.061148967,5.885485655,0.8517567697,3.6101514386,6.175663312,4.4619082083
42125,2010,478,532,141,10,-54,151,NA,NA,NA,NA,NA,NA
42125,2011,1894,2490,619,45,-596,664,9.1081995436,11.974348925,2.9767558171,0.2164038962,-2.866149381,3.1931597133
42125,2012,2057,2468,602,100,-411,702,9.8847183312,11.859739835,2.892853882,0.480540512,-1.975021504,3.373394394
42125,2013,2000,2591,282,93,-591,375,9.6102560653,12.450086733,1.3550461052,0.446876907,-2.839830667,1.8019230122
42125,2014,2060,2497,291,123,-437,414,9.9058225559,12.00720336,1.3993176523,0.5914641623,-2.101380804,1.9907818146
42125,2015,2001,2573,296,133,-572,429,9.6277834446,12.379953425,1.4241998499,0.6399276353,-2.75216998,2.0641274851
42125,2016,1923,2537,85,132,-614,217,9.2655051459,12.223913965,0.4095517095,0.6360097136,-2.958408819,1.0455614231
42125,2017,1944,2500,394,132,-556,526,9.3768314124,12.058682372,1.9004483418,0.6366984292,-2.68185096,2.537146771
44009,2010,239,235,-42,26,4,-16,NA,NA,NA,NA,NA,NA
44009,2011,953,1076,-614,128,-123,-486,7.5173735732,8.4876117154,-4.843302596,1.0096787171,-0.970238142,-3.833623879
44009,2012,924,1001,-262,98,-77,-164,7.3131930319,7.9226257845,-2.073654301,0.7756416852,-0.609432753,-1.298012616
44009,2013,899,1062,256,66,-163,322,7.1183394236,8.4089838353,2.027024352,0.5225922158,-1.290644412,2.5496165678
44009,2014,924,1073,42,81,-149,123,7.3136850604,8.4930563526,0.33244023,0.6411347293,-1.179371292,0.9735749593
44009,2015,876,1261,147,84,-385,231,6.9398506665,9.98989919,1.1645639817,0.6654651324,-3.050048523,1.8300291141
44009,2016,875,1220,93,93,-345,186,6.9410565478,9.6778159866,0.7377351531,0.7377351531,-2.736759439,1.4754703062
44009,2017,872,1208,424,91,-336,515,6.9170391582,9.5823203017,3.3633309668,0.7218469764,-2.665281144,4.0851779432
47179,2010,353,302,256,4,51,260,NA,NA,NA,NA,NA,NA
47179,2011,1314,1286,410,37,28,447,10.629176037,10.402679135,3.316561777,0.2992994774,0.2264969018,3.6158612545
47179,2012,1351,1319,803,71,32,874,10.867423069,10.610015565,6.4593195594,0.5711229,0.2574075042,7.0304424594
47179,2013,1372,1394,507,98,-22,605,10.970383164,11.146293098,4.0539243907,0.7835987974,-0.175909934,4.8375231881
47179,2014,1310,1303,285,113,7,398,10.434547113,10.378789991,2.2701113948,0.9000792548,0.055757122,3.1701906495
47179,2015,1318,1435,329,135,-117,464,10.468293303,11.397572754,2.613102046,1.0722455204,-0.929279451,3.6853475664
47179,2016,1336,1343,1026,129,-7,1155,10.549089588,10.604361764,8.1013217946,1.0185872432,-0.055272176,9.1199090378
47179,2017,1324,1315,449,130,9,579,10.383255041,10.312674002,3.5212096022,1.0195038937,0.0705810388,4.5407134959
48477,2010,102,110,13,8,-8,21,NA,NA,NA,NA,NA,NA
48477,2011,437,374,137,47,63,184,12.9165743,11.054459469,4.0493608217,1.3891967782,1.8621148304,5.4385575999
48477,2012,380,381,-114,69,-1,-45,11.198208287,11.227677256,-3.359462486,2.0333588731,-0.029468969,-1.326103613
48477,2013,407,374,201,45,33,246,11.952659246,10.983524713,5.9029103404,1.3215470911,0.9691345335,7.2244574315
48477,2014,406,368,137,51,38,188,11.83638961,10.728550188,3.9940526515,1.4868371185,1.1078394216,5.48088977
48477,2015,417,401,378,61,16,439,12.038106236,11.576212471,10.912240185,1.7609699769,0.4618937644,12.673210162
48477,2016,411,360,-162,65,51,-97,11.795092553,10.331467929,-4.649160568,1.8654039317,1.4636246233,-2.783756637
48477,2017,411,366,113,66,45,179,11.765716249,10.477499141,3.2348562922,1.889385091,1.2882171075,5.1242413833
49053,2010,607,298,-24,9,309,-15,NA,NA,NA,NA,NA,NA
49053,2011,2386,1058,1551,-10,1328,1541,17.06302808,7.5660870529,11.091683383,-0.07151311,9.4969410267,11.020170273
49053,2012,2165,1063,1841,-31,1102,1810,15.16679977,7.4467936054,12.897033892,-0.217168957,7.7200061648,12.679864935
49053,2013,2150,1183,1932,-56,967,1876,14.761769078,8.1224059624,13.264994353,-0.38449259,6.6393631155,12.880501763
49053,2014,2245,1155,3000,-51,1090,2949,15.054181643,7.7450244086,20.116946516,-0.341988091,7.3091572341,19.774958425
49053,2015,2233,1197,2520,-36,1036,2484,14.599065085,7.8258311268,16.475433951,-0.235363342,6.7732339577,16.240070609
49053,2016,2140,1309,3712,-40,831,3672,13.631962493,8.3384293941,23.645721857,-0.254803037,5.2935330989,23.39091882
49053,2017,2176,1275,5535,-39,901,5496,13.394931963,7.8485929473,34.07212703,-0.240074608,5.5463390161,33.832052422
50023,2010,174,143,22,-1,31,21,NA,NA,NA,NA,NA,NA
50023,2011,611,525,-99,7,86,-92,10.257787776,8.8139747668,-1.662063813,0.1175196636,1.4438130094,-1.54454415
50023,2012,615,499,-301,10,116,-291,10.341087748,8.3905736361,-5.061247825,0.1681477683,1.9505141118,-4.893100056
50023,2013,541,526,-195,9,15,-186,9.1235644299,8.8706005363,-3.288530617,0.1517783362,0.2529638936,-3.136752281
50023,2014,567,571,-235,11,-4,-224,9.5951262851,9.6628167703,-3.976816009,0.1861488345,-0.067690485,-3.790667174
50023,2015,576,553,-392,11,23,-381,9.7965848017,9.405401728,-6.667120212,0.187087557,0.3911830737,-6.480032655
50023,2016,530,505,-288,11,25,-277,9.0612230942,8.6338069105,-4.923834436,0.1880631208,0.4274161837,-4.735771315
50023,2017,537,517,-105,11,20,-94,9.2066349492,8.8637435172,-1.800180018,0.1885902876,0.342891432,-1.61158973
51191,2010,142,176,41,-1,-34,40,NA,NA,NA,NA,NA,NA
51191,2011,484,578,-74,13,-94,-61,8.8190009384,10.531782112,-1.348359648,0.2368739921,-1.712781174,-1.111485655
51191,2012,515,626,395,4,-111,399,9.3723270669,11.392382027,7.1884838669,0.0727947733,-2.02005496,7.2612786402
51191,2013,490,635,-180,4,-145,-176,8.9196322927,11.559115318,-3.276599618,0.0728133248,-2.639483025,-3.203786293
51191,2014,456,585,-58,5,-129,-53,8.3398107082,10.699099264000001,-1.060765397,0.0914452929,-2.359288556,-0.969320104
51191,2015,446,580,-139,6,-134,-133,8.1918283757,10.653050354,-2.553058619,0.1102039692,-2.461221978,-2.44285465
51191,2016,568,630,-15,7,-62,-8,10.465705468,11.608088811,-0.276383067,0.1289787646,-1.142383343,-0.147404302
51191,2017,526,620,239,7,-94,246,9.6847842098,11.415525114,4.4005008101,0.128884961,-1.730740904,4.5293857711
55131,2010,372,251,-23,8,121,-15,NA,NA,NA,NA,NA,NA
55131,2011,1387,1017,-53,49,370,-4,10.4946562,7.6950723541,-0.40102147,0.3707556985,2.7995838456,-0.030265771
55131,2012,1318,1036,61,76,282,137,9.9440927713,7.8164492497,0.4602349462,0.5734074739,2.1276435216,1.0336424201
55131,2013,1297,1038,-162,82,259,-80,9.764397216,7.814529152,-1.219608596,0.6173327461,1.9498680639,-0.60227585
55131,2014,1397,1052,247,82,345,329,10.484563975,7.8953194715,1.8537489634,0.6154146356,2.5892445035,2.469163599
55131,2015,1325,1158,66,87,167,153,9.9086163832,8.6597568089,0.4935612689,0.6506034908,1.2488595743,1.1441647597
55131,2016,1356,1068,121,93,288,214,10.110122798,7.9628400796,0.9021569753,0.6933933777,2.1472827181,1.595550353
55131,2017,1346,1102,402,93,244,495,9.9898691149,8.1789270168,2.9836013256,0.6902361276,1.8109420981,3.6738374531
22117,2010,128,83,-96,0,45,-96,NA,NA,NA,NA,NA,NA
22117,2011,578,549,18,-7,29,11,12.26199947,11.646778043,0.3818615752,-0.148501724,0.6152214267,0.2333598515
22117,2012,546,558,-425,-12,-12,-437,11.633853234,11.889542317,-9.05565499,-0.255689082,-0.255689082,-9.311344072
22117,2013,531,557,-222,-15,-26,-237,11.40047663,11.958692058,-4.766300964,-0.322047362,-0.558215428,-5.088348326
22117,2014,599,587,-80,-16,12,-96,12.909760986,12.651134723,-1.72417509,-0.344835018,0.2586262635,-2.069010108
22117,2015,620,601,38,-14,19,24,13.370425481,12.960686636,0.8194776908,-0.301912833,0.4097388454,0.5175648573
22117,2016,657,621,16,-16,36,0,14.157499488,13.381746092,0.3447792874,-0.344779287,0.7757533966,0
22117,2017,631,603,199,-16,28,183,13.561580537,12.959798833,4.2769485369,-0.343875259,0.6017817037,3.9330732777
40149,2010,39,49,-6,0,-10,-6,NA,NA,NA,NA,NA,NA
40149,2011,147,140,-5,0,7,-5,12.659863067,12.057012445,-0.430607587,0,0.6028506222,-0.430607587
40149,2012,136,141,42,-1,-5,41,11.695403534,12.125381606,3.6118157974,-0.085995614,-0.429978071,3.5258201832
40149,2013,148,132,103,0,16,103,12.643629063,11.276750246,8.7992823886,0,1.3668788176,8.7992823886
40149,2014,162,130,-179,3,32,-176,13.851481339,11.11538626,-15.30503185,0.2565089137,2.7360950793,-15.04852294
40149,2015,179,138,81,3,41,84,15.314852841,11.80698152,6.9301848049,0.2566735113,3.507871321,7.1868583162
40149,2016,145,143,-282,3,2,-279,12.486544672,12.314316469,-24.28417653,0.2583423036,0.1722282024,-24.02583423
40149,2017,149,146,-348,3,3,-345,13.181174805,12.915782024,-30.78556263,0.2653927813,0.2653927813,-30.52016985
32031,2010,1415,916,17,94,499,111,NA,NA,NA,NA,NA,NA
32031,2011,5369,3379,164,540,1990,704,12.683211458,7.9822260229,0.3874178952,1.275644289,4.7009854352,1.6630621841
32031,2012,5201,3366,1457,462,1835,1919,12.194450013,7.8920435962,3.4161341413,1.0832216701,4.3024064168,4.4993558114
32031,2013,5429,3552,1740,401,1877,2141,12.614580308,8.2532674993,4.0429857682,0.9317455707,4.3613128086,4.9747313389
32031,2014,5331,3635,3452,448,1696,3900,12.249793769,8.3526543518,7.9321493321,1.0294330535,3.8971394169,8.9615823857
32031,2015,5451,3689,3992,565,1762,4557,12.355403137,8.3616001052,9.0483891623,1.2806462617,3.9938030321,10.329035424
32031,2016,5578,3868,5772,581,1710,6353,12.439966235,8.6263516309,12.872621927,1.2957368918,3.8136146041,14.168358819
32031,2017,5597,3881,5831,577,1716,6408,12.26046422,8.5014939497,12.773051075,1.2639428006,3.75897027,14.036993875
26161,2010,977,548,-390,416,429,26,NA,NA,NA,NA,NA,NA
26161,2011,3823,2059,115,1748,1764,1863,11.007504855,5.9284468995,0.3311177239,5.0329894028,5.0790579557,5.3641071267
26161,2012,3780,2077,-1309,1853,1703,544,10.79329274,5.9306002698,-3.737677301,5.2909977371,4.8626924697,1.5533204366
26161,2013,3665,2140,-42,1944,1525,1902,10.381745125,6.0619193906,-0.11897225,5.5067155586,4.319825734,5.3877433089
26161,2014,3750,2150,248,2133,1600,2381,10.513787781,6.0279049946,0.6953118319,5.98024249,4.4858827867,6.6755543219
26161,2015,3652,2167,-510,2252,1485,1742,10.138108127,6.0156846415,-1.415781803,6.2516482754,4.1224234853,4.8358664723
26161,2016,3688,2244,-792,2282,1444,1490,10.151851103,6.1769940006,-2.18011553,6.2815955032,3.974857102,4.1014799736
26161,2017,3669,2349,-701,2265,1320,1564,10.019402522,6.4147115087,-1.914309394,6.1853220805,3.6046910138,4.2710126861
37189,2010,76,97,-69,-1,-21,-70,NA,NA,NA,NA,NA,NA
37189,2011,360,362,623,1,-2,624,7.0184331348,7.05742443,12.145788453,0.0194956476,-0.038991295,12.1652841
37189,2012,362,314,364,13,48,377,6.9845067433,6.0583843022,7.0230951784,0.2508248278,0.9261224411,7.2739200062
37189,2013,343,320,253,28,23,281,6.5713218319,6.1306792601,4.84706829,0.5364344353,0.4406425718,5.3835027253
37189,2014,354,301,12,25,53,37,6.7572081659,5.7455357569,0.2290579039,0.4772039665,1.011672409,0.7062618704
37189,2015,374,329,597,28,45,625,7.0875617082,6.2347802193,11.313567753,0.5306195931,0.852781489,11.844187347
37189,2016,348,350,958,30,-2,988,6.4921133881,6.5294243846,17.871967316,0.5596649473,-0.037310996,18.431632263
37189,2017,366,349,967,30,17,997,6.7020692181,6.3907709211,17.707379601,0.5493499359,0.311298297,18.256729537
27165,2010,27,40,-10,4,-13,-6,NA,NA,NA,NA,NA,NA
27165,2011,161,126,-89,27,35,-62,14.403292181,11.272141707,-7.962068349,2.4154589372,3.1311504741,-5.546609411
27165,2012,154,112,-101,9,42,-92,13.824057451,10.053859964,-9.066427289,0.8078994614,3.7701974865,-8.258527828
27165,2013,134,127,-95,16,7,-79,12.093862816,11.462093863,-8.57400722,1.4440433213,0.6317689531,-7.129963899
27165,2014,136,125,-130,24,11,-106,12.367009184,11.366736383,-11.82140584,2.1824133855,1.0002728017,-9.638992452
27165,2015,162,116,-91,28,46,-63,14.806013801,10.601837042,-8.31695837,2.5590641137,4.2041767582,-5.757894256
27165,2016,164,108,-108,29,56,-79,15.015564915,9.8882988464,-9.888298846,2.6551913569,5.1272660685,-7.233107489
27165,2017,152,102,-149,29,50,-120,13.976368903,9.378879132,-13.70051952,2.6665440669,4.5974897706,-11.03397545
55133,2010,963,775,-155,55,188,-100,NA,NA,NA,NA,NA,NA
55133,2011,3806,3059,-271,339,747,68,9.748688243,7.8353224739,-0.694139389,0.868314586,1.9133657692,0.1741751972
55133,2012,3801,3100,826,400,701,1226,9.7028765289,7.9134220573,2.1085440707,1.0210867171,1.7894544717,3.1296307878
55133,2013,3756,3182,243,429,574,672,9.5504960867,8.0909687295,0.6178835328,1.090831422,1.4595273572,1.7087149548
55133,2014,3861,3273,140,508,588,648,9.7875064166,8.2969459989,0.3548953376,1.287763082,1.4905604178,1.6426584196
55133,2015,3802,3367,-186,547,435,361,9.614120265,8.5141354372,-0.47033834,1.3831993122,1.0999848278,0.912860972
55133,2016,3813,3257,1289,555,556,1844,9.6037236153,8.2033380055,3.2465774299,1.3978669306,1.4003856098,4.6444443605
55133,2017,3849,3394,1425,548,455,1973,9.6364005077,8.4972572936,3.5676463298,1.3719790798,1.1391432141,4.9396254097
55135,2010,131,160,16,2,-29,18,NA,NA,NA,NA,NA,NA
55135,2011,493,761,154,6,-268,160,9.4196321949,14.540243611,2.9424408885,0.1146405541,-5.120611416,3.0570814426
55135,2012,538,731,-199,20,-193,-179,10.327286688,14.032056819,-3.819944332,0.3839140033,-3.704770131,-3.436030329
55135,2013,517,662,290,14,-145,304,9.9449851883,12.734197669,5.5784249606,0.269303274,-2.78921248,5.8477282345
55135,2014,532,666,-6,16,-134,10,10.231654662,12.808800762,-0.115394601,0.3077189372,-2.577146099,0.1923243358
55135,2015,519,738,-40,19,-219,-21,10.018047928,14.245316707,-0.772103887,0.3667493461,-4.227268779,-0.40535454
55135,2016,495,725,-121,21,-230,-100,9.6081057474,14.072478115,-2.348648072,0.4076166075,-4.464372367,-1.941031464
55135,2017,490,679,41,20,-189,61,9.5536123378,13.238577097,0.79938388950000006,0.3899433607,-3.684964759,1.1893272502
55137,2010,66,45,0,1,21,1,NA,NA,NA,NA,NA,NA
55137,2011,223,269,80,4,-46,84,9.089982676,10.965046367,3.2609803322,0.1630490166,-1.875063691,3.4240293488
55137,2012,237,281,-88,5,-44,-83,9.6788026055,11.475711106,-3.593817001,0.2041941478,-1.796908501,-3.389622853
55137,2013,228,278,-125,12,-50,-113,9.367489061,11.421762978,-5.135684792,0.4930257401,-2.054273917,-4.642659052
55137,2014,223,245,-135,14,-22,-121,9.2207819058,10.130455457,-5.582087701,0.578883169,-0.909673551,-5.003204532
55137,2015,247,272,-119,15,-25,-104,10.271765122,11.311417462,-4.94874514,0.6237914042,-1.03965234,-4.324953735
55137,2016,213,274,196,16,-61,212,8.8541558415,11.389853054,8.1474861264,0.6651009083,-2.535697213,8.8125870347
55137,2017,228,247,241,16,-19,257,9.4018680027,10.185357003,9.9379394239,0.6597802107,-0.783489,10.597719635
13305,2010,104,115,-9,-1,-11,-10,NA,NA,NA,NA,NA,NA
13305,2011,441,292,81,0,149,81,14.60845369,9.6727176361,2.6831853717,0,4.9357360541,2.6831853717
13305,2012,395,287,-74,4,108,-70,13.029208517,9.466792011,-2.440915013,0.1319413521,3.5624165059,-2.308973661
13305,2013,393,306,-438,17,87,-421,13.026184952,10.142525688,-14.51773285,0.5634736493,2.8836592642,-13.9542592
13305,2014,383,328,-166,16,55,-150,12.783711615,10.947930574,-5.540720961,0.5340453939,1.8357810414,-5.006675567
13305,2015,403,331,-582,21,72,-561,13.579539711,11.153418472,-19.61114668,0.7076186946,2.4261212387,-18.90352798
13305,2016,410,353,462,24,57,486,13.798673981,11.880321745,15.548749706,0.8077272574,1.9183522364,16.356476963
13305,2017,382,341,-234,23,41,-211,12.775492458,11.40430086,-7.825825223,0.7692050433,1.3711915989,-7.05662018
17191,2010,55,71,-5,1,-16,-4,NA,NA,NA,NA,NA,NA
17191,2011,192,196,-79,1,-4,-78,11.49907169,11.738635683,-4.731388872,0.0598909984,-0.239563994,-4.671497874
17191,2012,211,211,-3,1,0,-2,12.670009307,12.670009307,-0.180142312,0.0600474375,0,-0.120094875
17191,2013,193,199,6,11,-6,17,11.587763802,11.948005163,0.3602413617,0.6604424965,-0.360241362,1.0206838582
17191,2014,216,244,-48,12,-28,-36,12.991309055,14.675367636,-2.886957568,0.7217393919,-1.684058581,-2.165218176
17191,2015,200,226,-53,14,-26,-39,12.07765935,13.647755065,-3.200579728,0.8454361545,-1.570095715,-2.355143573
17191,2016,233,177,-23,14,56,-9,14.078975196,10.695187166,-1.389770084,0.8459470075,3.3837880298,-0.543823076
17191,2017,229,200,-119,13,29,-106,13.850247974,12.09628644,-7.197290432,0.7862586186,1.7539615338,-6.411031813
18177,2010,171,194,-78,-6,-23,-84,NA,NA,NA,NA,NA,NA
18177,2011,844,734,-344,-29,110,-373,12.274131976,10.674422832,-5.002726777,-0.421741502,1.5997091438,-5.424468278
18177,2012,816,819,-408,-2,-3,-410,11.925378697,11.969222001,-5.962689348,-0.029228869,-0.043843304,-5.991918218
18177,2013,803,832,-420,11,-29,-409,11.808649873,12.235114189,-6.176379759,0.161762327,-0.426464317,-6.014617432
18177,2014,731,870,-306,22,-139,-284,10.818810819,12.876012876,-4.528804529,0.3256003256,-2.057202057,-4.203204203
18177,2015,815,911,-330,25,-96,-305,12.136825959,13.566439815,-4.914297628,0.3722952748,-1.429613855,-4.542002353
18177,2016,770,845,-308,27,-75,-281,11.532125206,12.655384155,-4.612850082,0.4043732215,-1.123258949,-4.208476861
18177,2017,772,861,-343,27,-89,-316,11.62860758,12.969211303,-5.166596373,0.406700006,-1.340603724,-4.759896367
19185,2010,17,11,11,0,6,11,NA,NA,NA,NA,NA,NA
19185,2011,85,86,-90,4,-1,-86,13.330196816,13.487022661,-14.11432604,0.6273033796,-0.156825845,-13.48702266
19185,2012,88,110,15,0,-22,15,13.902053712,17.377567141,2.3696682464,0,-3.475513428,2.3696682464
19185,2013,101,79,35,0,22,35,15.895498898,12.433113,5.5083412024,0,3.4623858986,5.5083412024
19185,2014,89,76,-20,0,13,-20,13.954217623,11.915961116,-3.135779241,0,2.0382565067,-3.135779241
19185,2015,82,87,-13,0,-5,-13,12.883965748,13.669573415,-2.042579936,0,-0.785607668,-2.042579936
19185,2016,86,82,78,0,4,78,13.44590369,12.820512821,12.195121951,0,0.6253908693,12.195121951
19185,2017,90,84,33,0,6,33,13.939440874,13.010144815,5.1111283203,0,0.9292960582,5.1111283203
21231,2010,56,22,2,-1,34,1,NA,NA,NA,NA,NA,NA
21231,2011,218,204,38,-7,14,31,10.44661683,9.77573318,1.8209699061,-0.335441825,0.6708836496,1.4855280813
21231,2012,242,233,-80,-1,9,-81,11.604766586,11.173184358,-3.836286475,-0.047953581,0.4315822284,-3.884240056
21231,2013,245,220,-69,4,25,-65,11.780828505,10.578703147,-3.317865987,0.1923400572,1.2021253576,-3.12552593
21231,2014,210,250,-133,9,-40,-124,10.148849797,12.081964044,-6.427604871,0.4349507056,-1.933114247,-5.992654166
21231,2015,249,268,8,10,-19,18,12.082686335,13.004658385,0.3881987578,0.4852484472,-0.92197205,0.873447205
21231,2016,245,210,102,10,35,112,11.847195358,10.154738878,4.9323017408,0.4835589942,1.6924564797,5.415860735
21231,2017,254,190,-111,10,64,-101,12.250114543,9.1634715088,-5.353396513,0.4822879741,3.0866430346,-4.871108539
26163,2010,5920,4548,-8079,752,1372,-7327,NA,NA,NA,NA,NA,NA
26163,2011,23818,17976,-22576,3463,5842,-19113,13.169182079,9.9390888007,-12.48246933,1.9147232152,3.2300932785,-10.56774612
26163,2012,23270,17489,-17683,3628,5781,-14055,12.941305036,9.7262777731,-9.834168327,2.0176645755,3.2150272632,-7.816503751
26163,2013,23374,18151,-25771,3825,5223,-21946,13.087847994,10.163323733,-14.43000473,2.1417394788,2.9245242609,-12.28826526
26163,2014,23724,17762,-19057,4067,5962,-14990,13.377703883,10.015797352,-10.74603367,2.2933367768,3.3619065314,-8.452696898
26163,2015,23288,18474,-16173,4373,4814,-11800,13.190205332,10.463580097,-9.160305344,2.4768450669,2.7266252349,-6.683460277
26163,2016,23199,17983,-15166,4438,5216,-10728,13.186134864,10.221400201,-8.620238861,2.5225253901,2.9647346631,-6.097713471
26163,2017,22903,17881,-12416,4396,5022,-8020,13.049346849,10.187982841,-7.074212569,2.5046905972,2.861364008,-4.569521972
28153,2010,77,56,1,0,21,1,NA,NA,NA,NA,NA,NA
28153,2011,318,220,-254,-4,98,-258,15.370115276,10.633413084,-12.27675874,-0.193334783,4.7367021919,-12.47009353
28153,2012,277,223,-50,-4,54,-54,13.439099532,10.819202872,-2.42583024,-0.194066419,2.6198966596,-2.61989666
28153,2013,264,224,-189,-7,40,-196,12.856412379,10.90847111,-9.204022499,-0.340889722,1.9479412696,-9.544912221
28153,2014,281,220,-59,-6,61,-65,13.738144128,10.755842378,-2.884521365,-0.293341156,2.9823017503,-3.177862521
28153,2015,311,216,-52,-5,95,-57,15.194078706,10.552800645,-2.540489044,-0.244277793,4.6412780614,-2.784766837
28153,2016,283,225,-90,-5,58,-95,13.826460817,10.992769201,-4.39710768,-0.24428376,2.8336916162,-4.64139144
28153,2017,295,209,-84,-5,86,-89,14.426838811,10.221048513,-4.107981221,-0.244522692,4.2057902973,-4.352503912
29223,2010,34,58,9,0,-24,9,NA,NA,NA,NA,NA,NA
29223,2011,146,198,-44,0,-52,-44,10.847356885,14.710799064,-3.269066459,0,-3.863442178,-3.269066459
29223,2012,129,191,49,-3,-62,46,9.6243518484,14.250009326,3.6557615548,-0.223822136,-4.625657478,3.4319394188
29223,2013,178,191,81,-1,-13,80,13.25489612,14.222950331,6.0317223918,-0.074465709,-0.968054211,5.9572566833
29223,2014,129,203,76,-1,-74,75,9.5814609871,15.077802949,5.6448917443,-0.074274891,-5.496341962,5.570616853
29223,2015,146,199,8,-1,-53,7,10.863095238,14.806547619,0.5952380952,-0.074404762,-3.943452381,0.5208333333
29223,2016,131,184,-155,-1,-53,-156,9.8411148255,13.822634564,-11.64406716,-0.075123014,-3.981519739,-11.71919017
29223,2017,140,191,144,-1,-51,143,10.564841716,14.413462627,10.866694336,-0.075463155,-3.848620911,10.791231181
31179,2010,30,23,4,3,7,7,NA,NA,NA,NA,NA,NA
31179,2011,109,67,-225,20,42,-205,11.436365544,7.0296925821,-23.60717658,2.0984156961,4.4066729619,-21.50876089
31179,2012,90,72,12,25,18,37,9.4941716335,7.5953373068,1.2658895511,2.6372698982,1.8988343267,3.9031594493
31179,2013,113,64,-122,9,49,-113,11.925492058,6.7542609889,-12.87531001,0.9498179516,5.1712310696,-11.92549206
31179,2014,86,46,-77,15,40,-62,9.1154804176,4.8757220838,-8.161534793,1.5899093752,4.2397583338,-6.571625417
31179,2015,97,61,-74,16,36,-58,10.304350135,6.4800552398,-7.861050619,1.6996866203,3.8242948956,-6.161363999
31179,2016,113,53,-28,18,60,-10,11.985574883,5.6215528214,-2.969876962,1.9092066186,6.3640220619,-1.060670344
31179,2017,106,47,-214,18,59,-196,11.294017367,5.0077246817,-22.8011294,1.9178520058,6.2862926855,-20.8832774
36117,2010,256,231,-38,20,25,-18,NA,NA,NA,NA,NA,NA
36117,2011,992,855,-712,78,137,-634,10.608888152,9.143749365,-7.614443916,0.8341666087,1.4651387871,-6.780277307
36117,2012,1014,817,-466,65,197,-401,10.884207702,8.7696229706,-5.002012612,0.6977056219,2.114584731,-4.30430699
36117,2013,989,849,-855,45,140,-810,10.66531508,9.1555637034,-9.220267334,0.4852772281,1.5097513763,-8.734990106
36117,2014,930,816,-721,55,114,-666,10.094705707,8.8572901685,-7.826110553,0.5969987246,1.2374155382,-7.229111829
36117,2015,964,863,-660,62,101,-598,10.523155855,9.4206260404,-7.204650274,0.6768004803,1.1025298147,-6.527849794
36117,2016,1002,856,-643,63,146,-580,10.99389411,9.3919893792,-7.054963985,0.6912328632,1.6019047306,-6.363731121
36117,2017,962,839,-441,63,123,-378,10.595063714,9.2403934051,-4.856988667,0.6938555239,1.3546703085,-4.163133143
37191,2010,403,225,-22,78,178,56,NA,NA,NA,NA,NA,NA
37191,2011,1661,1144,527,174,517,701,13.452442659,9.2652585202,4.2681741609,1.4092263833,4.1871841389,5.6774005443
37191,2012,1769,1114,-631,446,655,-185,14.230151995,8.9612149927,-5.075876715,3.5877036685,5.268937002,-1.488173046
37191,2013,1728,1110,-839,388,618,-451,13.864929271,8.9062913721,-6.731872488,3.1131901373,4.9586378991,-3.61868235
37191,2014,1737,1102,-1041,351,635,-690,13.930603619,8.8379534764,-8.348738266,2.8149924412,5.092650143,-5.533745825
37191,2015,1698,1157,-1171,414,541,-757,13.632094028,9.2887707833,-9.401167318,3.3237261057,4.3433232444,-6.077441213
37191,2016,1601,1186,-739,348,415,-391,12.863053871,9.5287831921,-5.937412124,2.7959667376,3.3342706785,-3.141445386
37191,2017,1605,1316,-885,291,289,-594,12.909816286,10.585245005,-7.118496831,2.34065828,2.3245712815,-4.777838551
39169,2010,325,295,-163,8,30,-155,NA,NA,NA,NA,NA,NA
39169,2011,1460,1038,-249,69,422,-180,12.750479235,9.0650667435,-2.174568034,0.6025911419,3.6854124911,-1.571976892
39169,2012,1561,1024,-253,79,537,-174,13.597797871,8.9200160282,-2.203871148,0.688165299,4.6777818429,-1.515705849
39169,2013,1568,1091,-256,93,477,-163,13.619505077,9.4763265554,-2.223592666,0.8077895231,4.1431785215,-1.415803143
39169,2014,1552,1014,-116,86,538,-30,13.433856434,8.777017026,-1.004076898,0.7444018385,4.6568394083,-0.25967506
39169,2015,1593,1117,-281,96,476,-185,13.742769517,9.6363299127,-2.424179683,0.8281895001,4.1064396047,-1.595990183
39169,2016,1540,1113,-159,102,427,-57,13.248622444,9.5751407666,-1.367877252,0.8775061619,3.6734816778,-0.49037109
39169,2017,1524,1118,-897,103,406,-794,13.111933236,9.6188591586,-7.717456767,0.8861739654,3.4930740773,-6.831282801
42127,2010,117,146,32,-1,-29,31,NA,NA,NA,NA,NA,NA
42127,2011,422,594,70,-5,-172,65,7.9988627209,11.259062693,1.3268255698,-0.094773255,-3.260199972,1.2320523148
42127,2012,413,597,-313,-5,-184,-318,7.8738656295,11.38183482,-5.967360634,-0.09532525,-3.507969191,-6.062685884
42127,2013,396,640,187,1,-244,188,7.5898418783,12.266411116,3.5840919981,0.0191662674,-4.676569238,3.6032582655
42127,2014,398,586,45,-3,-188,42,7.6440705636,11.254837564,0.8642793351,-0.057618622,-3.610767,0.8066607127
42127,2015,404,614,-54,-3,-210,-57,7.7917068467,11.841851495,-1.041465767,-0.057859209,-4.050144648,-1.099324976
42127,2016,389,560,-309,-2,-171,-311,7.5575804086,10.879807272,-6.003322227,-0.038856455,-3.322226863,-6.042178681
42127,2017,392,555,143,-2,-163,141,7.6536340118,10.836139991,2.7920144482,-0.039049153,-3.182505979,2.7529652951
47181,2010,33,67,-5,0,-34,-5,NA,NA,NA,NA,NA,NA
47181,2011,129,183,11,0,-54,11,7.6041144743,10.787232161,0.6484128622,0,-3.183117687,0.6484128622
47181,2012,158,157,-22,-2,1,-24,9.3325457767,9.2734790313,-1.299468399,-0.118133491,0.0590667454,-1.41760189
47181,2013,150,218,3,0,-68,3,8.8841506752,12.911632315,0.1776830135,0,-4.027481639,0.1776830135
47181,2014,147,204,-5,1,-57,-4,8.7401153457,12.129139663,-0.297282835,0.059456567,-3.389024318,-0.237826268
47181,2015,143,224,-28,1,-81,-27,8.5462423427,13.387120873,-1.673390109,0.0597639325,-4.84087853,-1.613626177
47181,2016,134,194,47,1,-60,48,8.0379101434,11.636974387,2.8192669906,0.0599844041,-3.599064243,2.8792513946
47181,2017,131,200,-13,1,-69,-12,7.8801732435,12.030798845,-0.782001925,0.0601539942,-4.150625602,-0.721847931
49055,2010,10,2,-14,0,8,-14,NA,NA,NA,NA,NA,NA
49055,2011,34,20,-47,3,14,-44,12.330009066,7.2529465095,-17.0444243,1.0879419764,5.0770625567,-15.95648232
49055,2012,34,26,-48,5,8,-43,12.472487161,9.5377842993,-17.60821717,1.8341892883,2.9347028613,-15.77402788
49055,2013,26,22,-1,4,4,3,9.5834869149,8.1091043126,-0.368595651,1.4743826023,1.4743826023,1.1057869517
49055,2014,35,36,-23,2,-1,-21,12.934220251,13.303769401,-8.499630451,0.7390983001,-0.36954915,-7.760532151
49055,2015,28,27,-15,4,1,-11,10.410857037,10.039040714,-5.577244841,1.4872652909,0.3718163227,-4.08997955
49055,2016,42,21,-24,4,21,-20,15.645371578,7.8226857888,-8.94021233,1.4900353883,7.8226857888,-7.450176942
49055,2017,37,23,18,4,14,22,13.693560326,8.5122131754,6.6617320503,1.4803849001,5.1813471503,8.1421169504
54099,2010,98,93,-44,2,5,-42,NA,NA,NA,NA,NA,NA
54099,2011,383,492,-174,-1,-109,-175,9.0541594761,11.630930711,-4.113377934,-0.023640103,-2.576771235,-4.137018037
54099,2012,386,446,-250,-1,-60,-251,9.1897103813,10.618162772,-5.951884962,-0.02380754,-1.428452391,-5.975692502
54099,2013,477,469,-38,-7,8,-45,11.403980635,11.212718905,-0.908493216,-0.167354014,0.1912617297,-1.07584723
54099,2014,468,490,-295,-1,-22,-296,11.236899288,11.765129597,-7.083088226,-0.024010469,-0.528230308,-7.107098695
54099,2015,420,538,-183,-1,-118,-184,10.159897433,13.014344808,-4.426812453,-0.024190232,-2.854447374,-4.451002685
54099,2016,407,521,-392,0,-114,-392,9.9429562583,12.727961205,-9.576508239,0,-2.785004947,-9.576508239
54099,2017,368,508,-388,0,-140,-388,9.1051921864,12.569123996,-9.600039588,0,-3.46393181,-9.600039588
51820,2010,66,86,14,0,-20,14,NA,NA,NA,NA,NA,NA
51820,2011,294,242,55,6,52,61,13.966414099,11.496163987,2.6127645424,0.2850288592,2.4702501128,2.8977934016
51820,2012,296,248,-97,16,48,-81,14.03675163,11.760521636,-4.599881446,0.7587433314,2.2762299941,-3.841138115
51820,2013,274,246,55,31,28,86,12.970107216,11.6446948,2.6034886748,1.4674208894,1.3254124163,4.0709095643
51820,2014,295,243,20,36,52,56,13.892486284,11.443641244,0.9418634769,1.6953542584,2.4488450399,2.6372177353
51820,2015,294,293,171,40,1,211,13.741528394,13.694788502,7.9925216172,1.8695956999,0.0467398925,9.8621173171
51820,2016,379,230,110,42,149,152,17.50415666,10.622575282,5.0803620913,1.9397746167,6.8815813782,7.0201367079
51820,2017,346,214,350,42,132,392,15.681298013,9.6988374992,15.862584695,1.9035101634,5.9824605135,17.766094858
47183,2010,103,56,-19,1,47,-18,NA,NA,NA,NA,NA,NA
47183,2011,347,378,-160,6,-31,-154,9.9288953746,10.815914846,-4.578165014,0.171681188,-0.887019472,-4.406483826
47183,2012,364,373,-311,7,-9,-304,10.48946011,10.748814893,-8.96214861,0.2017203867,-0.259354783,-8.760428224
47183,2013,342,419,-349,18,-77,-331,9.9574914109,12.199382752,-10.16129971,0.5240784953,-2.241891341,-9.637221219
47183,2014,367,336,-215,25,31,-190,10.77336308,9.8633514846,-6.311370742,0.7338803188,0.9100115953,-5.577490423
47183,2015,353,386,-133,26,-33,-107,10.407913552,11.380891307,-3.921395191,0.7665885336,-0.972977754,-3.154806658
47183,2016,338,376,-267,29,-38,-238,10.027590708,11.154952977,-7.921203311,0.8603554158,-1.127362269,-7.060847895
47183,2017,343,357,-247,28,-14,-219,10.253344294,10.671848143,-7.383603617,0.8370076975,-0.418503849,-6.54659592
48479,2010,1328,307,-73,89,1021,16,NA,NA,NA,NA,NA,NA
48479,2011,5499,1170,-719,684,4329,-35,21.695517088,4.6160674656,-2.836711545,2.6986240568,17.079449623,-0.138087488
48479,2012,5437,1258,-424,638,4179,214,21.0915467,4.8801114124,-1.644807026,2.4749690629,16.211435288,0.8301620368
48479,2013,5501,1238,-1089,829,4263,-260,20.999148735,4.7258582319,-4.157075618,3.1645690422,16.273290503,-0.992506575
48479,2014,5500,1277,-2025,997,4223,-1028,20.710560503,4.8086155932,-7.625251822,3.7542597857,15.90194491,-3.870992036
48479,2015,5421,1350,-2666,1208,4071,-1458,20.191335343,5.0282794159,-9.929920684,4.4993789144,15.163055928,-5.430541769
48479,2016,5330,1375,-2662,1310,3955,-1352,19.660786874,5.0719665951,-9.819327328,4.8322009015,14.588820279,-4.987126427
48479,2017,5253,1358,-2827,1319,3895,-1508,19.19973684,4.963495646,-10.33269675,4.8209504838,14.236241194,-5.51174627
49057,2010,1063,392,193,52,671,245,NA,NA,NA,NA,NA,NA
49057,2011,4043,1534,-838,94,2509,-744,17.350888788,6.5832954243,-3.596350434,0.4034092372,10.767593363,-3.192941197
49057,2012,3986,1581,-152,236,2405,84,16.953333674,6.7243403256,-0.646489392,1.0037598462,10.228993348,0.3572704537
49057,2013,3962,1576,-689,208,2386,-481,16.697431748,6.6418860259,-2.903717939,0.8765940948,10.055545722,-2.027123844
49057,2014,3796,1688,-283,213,2108,-70,15.868205275,7.05625145,-1.183008981,0.8903919188,8.811953825,-0.292617063
49057,2015,3871,1770,429,252,2101,681,16.022450471,7.3262044259,1.7756732761,1.0430528335,8.6962460446,2.8187261096
49057,2016,3938,1694,1848,249,2244,2097,16.063732799,6.9100973492,7.5382880173,1.0157108854,9.1536354495,8.5539989027
49057,2017,3965,1575,1811,239,2390,2050,15.888981502,6.3115121982,7.2572372007,0.9577469304,9.577469304,8.2149841311
13307,2010,4,9,-14,0,-5,-14,NA,NA,NA,NA,NA,NA
13307,2011,14,18,-15,1,-4,-14,5.0468637347,6.4888248017,-5.407354001,0.3604902668,-1.441961067,-5.046863735
13307,2012,25,16,-4,-3,9,-7,9.0383224873,5.7845263919,-1.446131598,-1.084598698,3.2537960954,-2.530730296
13307,2013,18,15,-101,0,3,-101,6.6200809121,5.5167340934,-37.14600956,0,1.1033468187,-37.14600956
13307,2014,16,22,-51,0,-6,-51,6.0560181681,8.3270249811,-19.30355791,0,-2.271006813,-19.30355791
13307,2015,35,20,3,0,15,3,13.346043851,7.6263107722,1.1439466158,0,5.7197330791,1.1439466158
13307,2016,19,14,-23,0,5,-23,7.2463768116,5.3394355454,-8.771929825,0,1.9069412662,-8.771929825
13307,2017,24,17,-13,0,7,-13,9.2006900518,6.5171554533,-4.983707111,0,2.6835345984,-4.983707111
19187,2010,109,114,-133,3,-5,-130,NA,NA,NA,NA,NA,NA
19187,2011,442,445,-175,22,-3,-153,11.691420561,11.770774094,-4.628956104,0.5819259103,-0.079353533,-4.047030194
19187,2012,456,492,-418,33,-36,-385,12.153356165,13.112831652,-11.14057648,0.8795191962,-0.959475487,-10.26105729
19187,2013,440,463,-17,42,-23,25,11.792294807,12.408710218,-0.45561139,1.1256281407,-0.61641541,0.6700167504
19187,2014,421,433,-300,43,-12,-257,11.324205826,11.64698604,-8.0695053390000009,1.1566290986,-0.322780214,-6.912876241
19187,2015,451,454,-66,45,-3,-21,12.179807446,12.26082612,-1.782410846,1.2152801221,-0.081018675,-0.567130724
19187,2016,444,415,-342,49,29,-293,12.037903127,11.251643689,-9.272438895,1.3285073271,0.7862594385,-7.943931568
19187,2017,443,419,-219,48,24,-171,12.077920308,11.423586025,-5.970800333,1.3086685661,0.654334283,-4.662131767
21233,2010,42,56,-30,0,-14,-30,NA,NA,NA,NA,NA,NA
21233,2011,172,185,-43,1,-13,-42,12.695132302,13.654648116,-3.173783076,0.0738089087,-0.959515814,-3.099974167
21233,2012,138,168,-41,7,-30,-34,10.231316726,12.455516014,-3.039739027,0.5189798339,-2.224199288,-2.520759193
21233,2013,160,166,-103,7,-6,-96,11.936290052,12.383900929,-7.683986721,0.5222126898,-0.447610877,-7.161774031
21233,2014,159,170,-168,12,-11,-156,11.979657186,12.808438501,-12.65775099,0.9041250706,-0.828781315,-11.75362592
21233,2015,172,166,-45,13,6,-32,13.053542291,12.598186165,-3.415170948,0.9866049406,0.4553561264,-2.428566008
21233,2016,142,175,31,14,-33,45,10.783718104,13.289793439,2.3541919806,1.0631834751,-2.506075334,3.4173754557
21233,2017,142,154,-158,14,-12,-144,10.843005498,11.759315822,-12.0647526,1.0690287111,-0.916310324,-10.99572389
28155,2010,35,47,17,0,-12,17,NA,NA,NA,NA,NA,NA
28155,2011,130,128,-76,-2,2,-78,12.720156556,12.52446184,-7.436399217,-0.195694716,0.1956947162,-7.632093933
28155,2012,125,126,-102,-1,-1,-103,12.33958539,12.438302073,-10.06910168,-0.098716683,-0.098716683,-10.16781836
28155,2013,119,164,-95,0,-45,-95,11.88989359,16.386071839,-9.491931858,0,-4.496178248,-9.491931858
28155,2014,135,138,54,-1,-3,53,13.548775592,13.849859494,5.4195102369,-0.100361301,-0.301083902,5.3191489362
28155,2015,91,137,-72,-1,-46,-73,9.1650720113,13.797965555,-7.251485547,-0.100715077,-4.632893544,-7.352200624
28155,2016,129,129,-92,-1,0,-93,13.132444263,13.132444263,-9.365774203,-0.101801894,0,-9.467576097
28155,2017,118,137,9,-1,-19,8,12.076553065,14.021082796,0.9210930304,-0.10234367,-1.944529731,0.8187493604
29225,2010,130,101,30,0,29,30,NA,NA,NA,NA,NA,NA
29225,2011,470,278,-57,-6,192,-63,12.941063095,7.6545011496,-1.569448077,-0.165205061,5.286561945,-1.734653138
29225,2012,523,288,-233,-3,235,-236,14.375042946,7.9158936302,-6.404177833,-0.082457225,6.4591493163000004,-6.486635058
29225,2013,498,334,19,-3,164,16,13.654497347,9.1578355702,0.5209547181,-0.082256008,4.496661777,0.43869871
29225,2014,553,284,158,-3,269,155,15.040661463,7.7243180026,4.2973318465,-0.081594908,7.3163434602,4.215736938
29225,2015,567,348,337,-3,219,334,15.221067891,9.3420310864,9.0467370003,-0.080534751,5.8790368044,8.9662022496
29225,2016,570,336,307,-3,234,304,15.080960948,8.8898296116,8.1225526511,-0.079373479,6.1911313366,8.0431791724
29225,2017,574,343,373,-3,231,370,14.961553499,8.9404405057,9.7224032321,-0.078196273,6.0211129936,9.6442069595
31181,2010,11,18,4,0,-7,4,NA,NA,NA,NA,NA,NA
31181,2011,41,59,-35,0,-18,-35,10.837959292,15.596087761,-9.251916468,0,-4.758128469,-9.251916468
31181,2012,41,58,-3,-1,-17,-4,10.946469096,15.485248965,-0.800961153,-0.266987051,-4.538779869,-1.067948205
31181,2013,27,64,-55,0,-37,-55,7.3200488003,17.351226786,-14.91121052,0,-10.03117799,-14.91121052
31181,2014,35,54,22,0,-19,22,9.6048298573,14.818880351,6.0373216246,0,-5.214050494,6.0373216246
31181,2015,34,69,-20,0,-35,-20,9.3974571587,19.071310116,-5.527915976,0,-9.673852957,-5.527915976
31181,2016,35,43,0,0,-8,0,9.7588177889,11.989404712,0,0,-2.230586923,0
31181,2017,31,57,-32,0,-26,-32,8.7250211089,16.042780749,-9.006473403,0,-7.31775964,-9.006473403
54101,2010,27,40,15,1,-13,16,NA,NA,NA,NA,NA,NA
54101,2011,108,102,-42,3,6,-39,11.815546196,11.159126962,-4.594934632,0.3282096165,0.6564192331,-4.266725015
54101,2012,105,126,-127,4,-21,-123,11.5990058,13.918806959,-14.02927368,0.4418668876,-2.31980116,-13.58740679
54101,2013,88,136,-103,2,-48,-101,9.8798697654,15.268889637,-11.56393848,0.2245424947,-5.389019872,-11.33939598
54101,2014,99,115,-65,6,-16,-59,11.256395679,13.075611143,-7.39056282,0.6822057987,-1.819215463,-6.708357021
54101,2015,90,128,-79,6,-38,-73,10.341855789,14.708417122,-9.077851192,0.6894570526,-4.366561333,-8.38839414
54101,2016,74,122,-30,6,-48,-24,8.5931603089,14.167102131,-3.483713639,0.6967427277,-5.573941822,-2.786970911
54101,2017,74,121,-163,6,-47,-157,8.7331091049,14.279813536,-19.23644303,0.7080899274,-5.546704431,-18.5283531
22119,2010,102,143,29,3,-41,32,NA,NA,NA,NA,NA,NA
22119,2011,518,491,22,-6,27,16,12.568392192,11.913282947,0.5337927186,-0.145579832,0.6551092455,0.3882128862
22119,2012,522,456,-398,-2,66,-400,12.710316784,11.103265237,-9.691007816,-0.048698532,1.6070515474,-9.739706348
22119,2013,497,551,-201,16,-54,-185,12.185852642,13.509868824,-4.928282457,0.3923010911,-1.324016182,-4.535981366
22119,2014,512,573,-323,15,-61,-308,12.647596463,14.15443901,-7.9788548,0.3705350526,-1.506842547,-7.608319747
22119,2015,512,478,-270,16,34,-254,12.740279938,11.894245723,-6.718506998,0.3981337481,0.8460342146,-6.32037325
22119,2016,533,528,-302,17,5,-285,13.346521266,13.221319377,-7.562194038,0.4256864194,0.125201888,-7.136507619
22119,2017,515,530,-419,17,-15,-402,13.009485557,13.388402612,-10.5844164,0.4294393291,-0.378917055,-10.15497708
08123,2010,942,366,691,26,576,717,NA,NA,NA,NA,NA,NA
08123,2011,3754,1442,1851,157,2312,2008,14.643755729,5.6250121901,7.2204560083,0.6124319791,9.0187435392,7.8328879874
08123,2012,3792,1459,2716,131,2333,2847,14.520891013,5.587020039,10.400511601,0.5016447054,8.9338709739,10.902156306
08123,2013,3822,1567,3638,96,2255,3734,14.326464977,5.873775672,13.636755517,0.3598484139,8.4526893046,13.996603931
08123,2014,3956,1611,3251,147,2345,3398,14.5071032,5.9077207419,11.921787791,0.539065766,8.599382458,12.460853557
08123,2015,4081,1726,6143,201,2355,6344,14.575884964,6.1646599972,21.940617823,0.7179007297,8.4112249672,22.658518553
08123,2016,4314,1768,7097,205,2546,7302,14.911211925,6.1110391013,24.530568157,0.7085763664,8.8001728235,25.239144524
08123,2017,4485,1758,7419,203,2727,7622,14.978058897,5.8709983369,24.776414483,0.677936668,9.1070605601,25.454351151
18179,2010,98,44,-10,3,54,-7,NA,NA,NA,NA,NA,NA
18179,2011,330,259,-36,12,71,-24,11.912067285,9.3491679601,-1.299498249,0.4331660831,2.562899325,-0.866332166
18179,2012,370,267,-149,15,103,-134,13.352098445,9.6351629317,-5.37692613,0.5413012883,3.716935513,-4.835624842
18179,2013,336,283,-58,15,53,-43,12.12974495,10.216422086,-2.093825021,0.541506471,1.9133228642,-1.55231855
18179,2014,340,276,15,18,64,33,12.251590004,9.9454083563,0.5405113237,0.6486135885,2.3061816478,1.1891249122
18179,2015,327,315,8,18,12,26,11.755612676,11.324214046,0.2875990869,0.6470979455,0.4313986303,0.9346970323
18179,2016,340,266,-86,18,74,-68,12.213740458,9.5554557701,-3.089357881,0.646609789,2.6582846879,-2.442748092
18179,2017,335,245,36,20,90,56,12.002006306,8.7775867011,1.2897678418,0.7165376899,3.2244196045,2.0063055317
38103,2010,10,28,2,0,-18,2,NA,NA,NA,NA,NA,NA
38103,2011,33,88,59,1,-55,60,7.8683834049,20.982355746,14.067715784,0.2384358608,-13.11397234,14.306151645
38103,2012,44,68,55,4,-24,59,10.437670502,16.130945321,13.047088127,0.9488791365,-5.693274819,13.995967264
38103,2013,42,80,-49,3,-38,-46,10.020279136,19.086245974,-11.69032566,0.715734224,-9.065966838,-10.97459144
38103,2014,36,55,-11,3,-19,-8,8.7040618956,13.29787234,-2.659574468,0.7253384913,-4.593810445,-1.934235977
38103,2015,39,53,-16,4,-14,-12,9.4902056211,12.8969461,-3.893417691,0.9733544227,-3.406740479,-2.920063268
38103,2016,48,57,-32,4,-9,-28,11.773362767,13.980868286,-7.848908511,0.9811135639,-2.207505519,-6.867794947
38103,2017,43,49,-35,4,-6,-31,10.643564356,12.128712871,-8.663366337,0.9900990099,-1.485148515,-7.673267327
22121,2010,78,13,92,1,65,93,NA,NA,NA,NA,NA,NA
22121,2011,350,191,-15,2,159,-13,14.568158169,7.9500520291,-0.624349636,0.0832466181,6.6181061394,-0.541103018
22121,2012,313,161,-105,4,152,-101,12.975975789,6.6745434571,-4.352963124,0.1658271666,6.3014323322,-4.187135958
22121,2013,363,215,320,10,148,330,14.883759072,8.8154495879,13.120669154,0.4100209111,6.0683094838,13.530690065
22121,2014,348,209,403,6,139,409,13.970573476,8.3903731508,16.17856641,0.2408719565,5.5802003252,16.419438367
22121,2015,397,231,204,12,166,216,15.643162519,9.102192801,8.0383001359,0.4728411845,6.5409697185,8.5111413204
22121,2016,379,200,175,13,179,188,14.716446308,7.7659347273,6.7951928864,0.5047857573,6.950511581,7.2999786437
22121,2017,383,209,140,13,174,153,14.673767289,8.00735604,5.3637791655,0.4980652082,6.6664112486,5.8618443738
22123,2010,29,46,-11,0,-17,-11,NA,NA,NA,NA,NA,NA
22123,2011,151,125,-84,-1,26,-85,13.078688667,10.826729029,-7.275561907,-0.086613832,2.251959638,-7.362175739
22123,2012,133,116,-35,1,17,-34,11.557679774,10.080382359,-3.041494677,0.0868998479,1.4772974147,-2.954594829
22123,2013,126,159,-12,2,-33,-10,10.978956999,13.854398118,-1.045614952,0.1742691587,-2.875441119,-0.871345794
22123,2014,148,140,65,2,8,67,12.880205387,12.183978069,5.6568469605,0.1740568296,0.6962273182,5.8309037901
22123,2015,146,146,-248,2,0,-246,12.801964137,12.801964137,-21.7458021,0.1753693717,0,-21.57043272
22123,2016,130,127,-160,3,3,-157,11.601963409,11.334225792,-14.27933958,0.2677376171,0.2677376171,-14.01160196
22123,2017,130,149,-131,3,-19,-128,11.759916776,13.478673843,-11.85037767,0.2713826948,-1.718757067,-11.57899498
22125,2010,30,11,-6,3,19,-3,NA,NA,NA,NA,NA,NA
22125,2011,127,117,-156,4,10,-152,8.1556640123,7.5134857436,-10.01798099,0.2568713075,0.6421782687,-9.761109684
22125,2012,138,109,-71,1,29,-70,8.9127135338,7.0397519941,-4.585526528,0.0645848807,1.8729615397,-4.520941648
22125,2013,108,118,-7,2,-10,-5,6.9878036945,7.6348225551,-0.452913202,0.1294037721,-0.647018861,-0.32350943
22125,2014,138,131,-88,1,7,-87,8.9563862928,8.5020768432,-5.711318795,0.0649013499,0.4543094496,-5.646417445
22125,2015,112,120,-3,1,-8,-2,7.2904800651,7.8112286412,-0.195280716,0.065093572,-0.520748576,-0.130187144
22125,2016,106,111,-27,1,-5,-26,6.9095886839,7.2355126784,-1.75998957,0.0651847989,-0.325923995,-1.694804772
22125,2017,104,124,72,1,-20,73,6.7741410194,8.0768604462,4.6897899365,0.0651359713,-1.302719427,4.7549259078
36119,2010,2859,1512,-607,1093,1347,486,NA,NA,NA,NA,NA,NA
36119,2011,10978,7095,-1868,4810,3883,2942,11.503376458,7.4345469092,-1.957397269,5.040193183,4.0688295487,3.0827959136
36119,2012,10621,6908,-3795,4598,3713,803,11.064215892,7.1962718561,-3.953365908,4.7898752164,3.8679440362,0.8365093081
36119,2013,10550,7233,-1048,4581,3317,3533,10.926414997,7.4910672674,-1.085391746,4.7444461706,3.4353477293,3.6590544249
36119,2014,10586,6950,-4462,4716,3636,254,10.904116701,7.1588523587,-4.596086219,4.8577190969,3.7452643419,0.2616328776
36119,2015,10749,7106,-5487,5233,3643,-254,11.031149219,7.2925245466,-5.631027609,5.370360393,3.7386246726,-0.260667216
36119,2016,10558,7205,-6207,5346,3353,-861,10.802642033,7.3719488394,-6.350823934,5.46987349,3.4306931934,-0.880950444
36119,2017,10469,7386,-6795,5332,3083,-1463,10.688935538,7.5411670533,-6.937751168,5.4440160748,3.1477684843,-1.493735093
42129,2010,826,981,170,11,-155,181,NA,NA,NA,NA,NA,NA
42129,2011,3188,4390,569,47,-1202,616,8.738699721,12.033529415,1.5596989151,0.1288327751,-3.294829694,1.6885316901
42129,2012,3163,4317,-484,78,-1154,-406,8.6969074149,11.869917581,-1.330794559,0.2144668917,-3.173010167,-1.116327667
42129,2013,3212,4441,-908,64,-1229,-844,8.876667657,12.27312611,-2.509344406,0.1768700903,-3.396458453,-2.332474316
42129,2014,3152,4489,-530,78,-1337,-452,8.7584020362,12.473498331,-1.47270085,0.2167371062,-3.715096295,-1.255963744
42129,2015,3158,4600,-569,84,-1442,-485,8.8217588486,12.849933725,-1.589480933,0.2346509637,-4.028174876,-1.354829969
42129,2016,3104,4425,-957,82,-1321,-875,8.7217593002,12.433564724,-2.689021795,0.2304073011,-3.711805424,-2.458614493
42129,2017,3092,4460,-860,82,-1368,-778,8.7416862803,12.609288748,-2.431387517,0.2318299725,-3.867602468,-2.199557544
51193,2010,50,26,7,1,24,8,NA,NA,NA,NA,NA,NA
51193,2011,190,216,159,8,-26,167,10.823435586,12.304537298,9.0575066222,0.4557236036,-1.481101712,9.5132302259
51193,2012,194,198,-113,1,-4,-112,11.043748043,11.271454188,-6.432698602,0.0569265363,-0.227706145,-6.375772066
51193,2013,182,201,61,-3,-19,58,10.383979004,11.468020768,3.4803446112,-0.171164489,-1.084041764,3.3091801221
51193,2014,188,217,-72,-4,-29,-76,10.747156005,12.404961985,-4.115932087,-0.228662894,-1.65780598,-4.344594981
51193,2015,185,260,190,-2,-75,188,10.57384545,14.860539552,10.859625057,-0.114311843,-4.286694102,10.745313214
51193,2016,196,211,125,-3,-15,122,11.132568443,11.984550721,7.0998523231,-0.170396456,-0.851982279,6.9294558673
51193,2017,203,211,132,-3,-8,129,11.4563052,11.907785208,7.4494201304,-0.169305003,-0.451480008,7.2801151274
56045,2010,26,9,-31,1,17,-30,NA,NA,NA,NA,NA,NA
56045,2011,81,71,-64,-3,10,-67,11.297858986,9.9030615803,-8.926703396,-0.418439222,1.3947974057,-9.345142618
56045,2012,74,67,-78,2,7,-76,10.411537109,9.4266619768,-10.9743229,0.2813928948,0.9848751319,-10.69293
56045,2013,93,77,35,12,16,47,13.089373681,10.837438424,4.9261083744,1.6889514426,2.2519352569,6.615059817
56045,2014,74,75,-1,8,-1,7,10.365597423,10.505673063,-0.140075641,1.1206051268,-0.140075641,0.9805294859
56045,2015,74,68,25,10,6,35,10.33303079,9.4952174824,3.4908887803,1.3963555121,0.8378133073,4.8872442924
56045,2016,78,60,-9,9,18,0,10.849155018,8.3455038598,-1.251825579,1.251825579,2.5036511579,0
56045,2017,80,75,-287,9,5,-278,11.327433628,10.619469027,-40.63716814,1.2743362832,0.7079646018,-39.36283186
54103,2010,37,65,1,2,-28,3,NA,NA,NA,NA,NA,NA
54103,2011,173,215,-135,3,-42,-132,10.505860205,13.056415862,-8.198214611,0.1821825469,-2.550555657,-8.016032064
54103,2012,171,238,44,1,-67,45,10.446894951,14.540122797,2.6880899288,0.0610929529,-4.093227846,2.7491828818
54103,2013,170,226,-176,-1,-56,-177,10.467980296,13.916256158,-10.83743842,-0.061576355,-3.448275862,-10.89901478
54103,2014,151,210,-96,0,-59,-96,9.4098585405,13.086558235,-5.982426622,0,-3.676699695,-5.982426622
54103,2015,184,225,-137,0,-41,-137,11.585807386,14.16742751,-8.626389195,0,-2.581620124,-8.626389195
54103,2016,188,220,-121,0,-32,-121,11.961570274,13.997582236,-7.69867023,0,-2.036011962,-7.69867023
54103,2017,172,232,-144,0,-60,-144,11.068923354,14.930175687,-9.267005599,0,-3.861252333,-9.267005599
26165,2010,109,95,-4,0,14,-4,NA,NA,NA,NA,NA,NA
26165,2011,441,360,-185,3,81,-182,13.490570367,11.012710503,-5.659309564,0.0917725875,2.4778598633,-5.567536977
26165,2012,374,345,-152,5,29,-147,11.47996378,10.589806161,-4.665653729,0.1534754516,0.8901576193,-4.512178277
26165,2013,391,363,-77,9,28,-68,12.032064992,11.170433739,-2.369485945,0.2769529026,0.8616312526,-2.092533042
26165,2014,427,344,277,12,83,289,13.073696458,10.532439301,8.4810630415,0.3674106733,2.5412571569,8.8484737148
26165,2015,424,374,-19,12,50,-7,12.900477683,11.379194937,-0.578087443,0.3651078589,1.5212827456,-0.212979584
26165,2016,392,347,148,11,45,159,11.883109009,10.518976598,4.4864799321,0.3334545895,1.3641324118,4.8199345216
26165,2017,395,315,97,11,80,108,11.903685622,9.4928125848,2.9231835578,0.3314950426,2.4108730374,3.2546786005
48481,2010,130,139,10,3,-9,13,NA,NA,NA,NA,NA,NA
48481,2011,551,392,-197,18,159,-179,13.35142601,9.4986551649,-4.773558846,0.4361627372,3.8527708449,-4.337396108
48481,2012,535,398,-338,-1,137,-339,12.997424809,9.6691122880000009,-8.2114571689999991,-0.024294252,3.3283125213,-8.235751421
48481,2013,555,455,-72,7,100,-65,13.510388393,11.076084178,-1.752699035,0.170401295,2.434304215,-1.58229774
48481,2014,559,396,-194,12,163,-182,13.606270081,9.6387888229,-4.722032908,0.2920845098,3.9674812579,-4.429948398
48481,2015,550,433,176,19,117,195,13.341095425,10.50308058,4.2691505361,0.4608742056,2.838014845,4.7300247417
48481,2016,585,401,50,21,184,71,14.09417802,9.6611374122,1.2046306,0.505944852,4.4330406081,1.710575452
48481,2017,588,413,139,24,175,163,14.066649123,9.880146408,3.3252792995,0.5741489438,4.1865027152,3.8994282433
53073,2010,608,356,73,76,252,149,NA,NA,NA,NA,NA,NA
53073,2011,2285,1430,736,346,855,1082,11.284870125,7.062303842,3.6348640753,1.7087812093,4.2225662832,5.3436452847
53073,2012,2259,1476,354,320,783,674,11.064715606,7.2295352966,1.733912937,1.5673789261,3.8351803098,3.3012918631
53073,2013,2289,1600,328,313,689,641,11.136870632,7.7846190524,1.5958469057,1.5228661021,3.3522515794,3.1187130079
53073,2014,2221,1536,886,368,685,1254,10.721673373,7.4148988296,4.2770835697,1.7764861779,3.3067745431,6.0535697476
53073,2015,2358,1528,2329,412,830,2741,11.23325195,7.279223486,11.095099148,1.962722563,3.9540284642,13.057821711
53073,2016,2311,1638,3466,415,673,3881,10.79939344,7.6544381021,16.19675364,1.9393112408,3.1449553374,18.13606488
53073,2017,2373,1636,3950,421,737,4371,10.843588209,7.4758155539,18.049799167,1.9237887214,3.3677726548,19.973587889
30107,2010,4,9,-7,0,-5,-7,NA,NA,NA,NA,NA,NA
30107,2011,24,19,-31,0,5,-31,11.194029851,8.8619402985,-14.45895522,0,2.3320895522,-14.45895522
30107,2012,25,29,-39,0,-4,-39,11.842728565,13.737565135,-18.47465656,0,-1.89483657,-18.47465656
30107,2013,22,18,29,0,4,29,10.44386423,8.5449798244,13.766911939,0,1.8988844054,13.766911939
30107,2014,24,25,-43,0,-1,-43,11.417697431,11.893434824,-20.4567079,0,-0.475737393,-20.4567079
30107,2015,24,21,0,2,3,2,11.524609844,10.084033613,0,0.9603841537,1.4405762305,0.9603841537
30107,2016,25,19,18,4,6,22,11.918951132,9.0584028605,8.5816448153,1.9070321812,2.8605482718,10.488676996
30107,2017,24,19,20,4,5,24,11.291460833,8.9390731593,9.409550694,1.8819101388,2.3523876735,11.291460833
13309,2010,15,4,283,0,11,283,NA,NA,NA,NA,NA,NA
13309,2011,66,53,283,0,13,283,8.3401781765,6.6974158084,35.76167309,0,1.6427623681,35.76167309
13309,2012,54,69,-136,0,-15,-136,6.7550662997,8.6314736052,-17.01275957,0,-1.876407305,-17.01275957
13309,2013,61,55,-1,-1,6,-2,7.7005617623,6.9431294578,-0.126238717,-0.126238717,0.7574323045,-0.252477435
13309,2014,62,67,52,0,-5,52,7.8021770591,8.4313848864,6.5437614044,0,-0.629207827,6.5437614044
13309,2015,66,72,-67,0,-6,-67,8.3186286867,9.0748676582,-8.444668515,0,-0.756238972,-8.444668515
13309,2016,64,46,100,0,18,100,8.0427269871,5.780710022,12.566760917,0,2.2620169651,12.566760917
13309,2017,63,64,-65,0,-1,-65,7.8902874319,8.0155300895,-8.140772747,0,-0.125242658,-8.140772747
31183,2010,5,1,3,0,4,3,NA,NA,NA,NA,NA,NA
31183,2011,4,5,-9,0,-1,-9,4.8780487805,6.0975609756,-10.97560976,0,-1.219512195,-10.97560976
31183,2012,9,6,-22,0,3,-22,11.166253102,7.4441687345,-27.29528536,0,3.7220843672,-27.29528536
31183,2013,6,6,-19,0,0,-19,7.619047619,7.619047619,-24.12698413,0,0,-24.12698413
31183,2014,9,7,6,0,2,6,11.508951407,8.9514066496,7.6726342711,0,2.557544757,7.6726342711
31183,2015,7,2,-13,0,5,-13,8.9514066496,2.557544757,-16.62404092,0,6.3938618926,-16.62404092
31183,2016,9,3,20,0,6,20,11.385199241,3.7950664137,25.300442758,0,7.5901328273,25.300442758
31183,2017,9,3,8,0,6,8,11.104256632,3.7014188772,9.8704503393,0,7.4028377545,9.8704503393
41069,2010,4,5,8,0,-1,8,NA,NA,NA,NA,NA,NA
41069,2011,9,20,-21,0,-11,-21,6.2871114216,13.971358715,-14.66992665,0,-7.684247293,-14.66992665
41069,2012,9,28,12,0,-19,12,6.3716814159,19.82300885,8.4955752212,0,-13.45132743,8.4955752212
41069,2013,8,15,-25,0,-7,-25,5.7409400789,10.764262648,-17.94043775,0,-5.023322569,-17.94043775
41069,2014,13,16,-25,0,-3,-25,9.5307917889,11.730205279,-18.32844575,0,-2.19941349,-18.32844575
41069,2015,8,26,-6,0,-18,-6,5.9790732436,19.431988042,-4.484304933,0,-13.4529148,-4.484304933
41069,2016,14,11,-4,0,3,-4,10.558069382,8.2956259427,-3.016591252,0,2.2624434389,-3.016591252
41069,2017,10,14,36,0,-4,36,7.4543421543,10.436079016,26.835631755,0,-2.981736862,26.835631755
48483,2010,11,22,-9,0,-11,-9,NA,NA,NA,NA,NA,NA
48483,2011,70,54,35,5,16,40,12.922281706,9.9686173159,6.4611408529,0.9230201218,2.9536643899,7.3841609747
48483,2012,66,65,136,4,1,140,11.961939284,11.78069778,24.648844585,0.7249660172,0.1812415043,25.373810603
48483,2013,76,69,114,5,7,119,13.440622513,12.202670439,20.16093377,0.8842514811,1.2379520736,21.045185251
48483,2014,97,74,-44,5,23,-39,16.986253393,12.958585063,-7.705104632,0.8755800718,4.0276683303,-6.82952456
48483,2015,83,85,-41,8,-2,-33,14.599824099,14.951627089,-7.211961302,1.4072119613,-0.35180299,-5.80474934
48483,2016,80,44,-162,8,36,-154,14.265335235,7.8459343795,-28.88730385,1.4265335235,6.4194008559,-27.46077033
48483,2017,77,54,-222,8,23,-214,14.120667522,9.902805795,-40.71153493,1.46708234,4.2178617275,-39.24445259
05145,2010,244,136,147,2,108,149,NA,NA,NA,NA,NA,NA
05145,2011,937,804,493,41,133,534,12.06378226,10.351420423,6.3473262049,0.527870942,1.7123618362,6.8751971469
05145,2012,988,830,336,47,158,383,12.622165442,10.603641009,4.2925582881,0.6004471415,2.0185244331,4.8930054296
05145,2013,1036,814,-358,60,222,-298,13.196107403,10.368370102,-4.560044836,0.7642533245,2.8277373007,-3.795791512
05145,2014,996,853,-294,52,143,-242,12.700922602,10.877396566,-3.749067515,0.6631003768,1.8235260363,-3.085967138
05145,2015,1045,816,191,58,229,249,13.294911675,10.381481269,2.4299790716,0.737899404,2.9134304053,3.1678784756
05145,2016,892,828,-118,58,64,-60,11.314556075,10.502749361,-1.496768629,0.7356998345,0.8118067139,-0.761068794
05145,2017,906,813,28,58,93,86,11.478961572,10.30065757,0.3547581943,0.7348562596,1.1783040024,1.0896144539
13311,2010,54,59,61,1,-5,62,NA,NA,NA,NA,NA,NA
13311,2011,258,239,177,7,19,184,9.4484728631,8.7526550941,6.4820918479,0.2563539149,0.695817769,6.7384457628
13311,2012,238,263,227,24,-25,251,8.648255814,9.5566860465,8.2485465116,0.8720930233,-0.908430233,9.1206395349
13311,2013,275,251,157,22,24,179,9.9154482684,9.0501000559,5.6608195569,0.7932358615,0.8653482125,6.4540554183
13311,2014,277,259,160,23,18,183,9.915698663,9.2713572336,5.7274793721,0.8233251597,0.6443414294,6.5508045319
13311,2015,266,293,364,24,-27,388,9.4272753048,10.384179189,12.900481996,0.8505812305,-0.956903884,13.751063227
13311,2016,263,274,415,25,-11,440,9.1922687078,9.5767362203,14.504910699,0.8737898011,-0.384467512,15.3787005
13311,2017,272,280,609,24,-8,633,9.334568791,9.6091149319,20.899824977,0.8236384227,-0.274546141,21.7234634
17193,2010,28,72,-21,0,-44,-21,NA,NA,NA,NA,NA,NA
17193,2011,179,223,31,3,-44,34,12.265734745,15.280775688,2.1242333916,0.2055709734,-3.015040943,2.329804365
17193,2012,158,208,-17,3,-50,-14,10.855749081,14.291112714,-1.168023635,0.206121818,-3.435363633,-0.961901817
17193,2013,176,242,-27,3,-66,-24,12.156795027,16.715593162,-1.864962873,0.207218097,-4.558798135,-1.657744776
17193,2014,156,210,-117,4,-54,-113,10.871080139,14.634146341,-8.153310105,0.2787456446,-3.763066202,-7.87456446
17193,2015,165,236,3,6,-71,9,11.591555727,16.579437283,0.2107555587,0.4215111174,-4.987881555,0.632266676
17193,2016,162,218,-64,7,-56,-57,11.45281018,15.411806292,-4.524566985,0.494874514,-3.958996112,-4.029692471
17193,2017,154,210,-100,7,-56,-93,10.98979519,14.98608435,-7.136230643,0.499536145,-3.99628916,-6.636694498
18181,2010,76,34,0,2,42,2,NA,NA,NA,NA,NA,NA
18181,2011,286,269,-116,4,17,-112,11.60902744,10.918980354,-4.708556584,0.1623640201,0.6900470856,-4.546192564
18181,2012,295,240,-184,2,55,-182,12.028542304,9.7859327217,-7.50254842,0.0815494393,2.2426095821,-7.420998981
18181,2013,285,299,-61,12,-14,-49,11.665984445,12.239050348,-2.496930004,0.4911993451,-0.573065903,-2.005730659
18181,2014,291,252,-22,22,39,0,11.918414155,10.321100917,-0.901048493,0.9010484928,1.5973132372,0
18181,2015,275,312,-140,24,-37,-116,11.2903888,12.809459293,-5.747834298,0.9853430225,-1.519070493,-4.762491276
18181,2016,309,271,-244,26,38,-218,12.773609475,11.202744879,-10.08660425,1.0748020917,1.5708645956,-9.011802154
18181,2017,293,292,55,27,1,82,12.136776919,12.095354473,2.2782345753,1.1184060642,0.0414224468,3.3966406396
47185,2010,75,102,15,0,-27,15,NA,NA,NA,NA,NA,NA
47185,2011,282,337,237,4,-55,241,10.881728729,13.004051708,9.1452826548,0.1543507621,-2.122322979,9.2996334169
47185,2012,311,375,72,2,-64,74,11.955560681,14.415868989,2.7678468458,0.0768846346,-2.460308307,2.8447314804
47185,2013,293,338,198,3,-45,201,11.228204637,12.952672926,7.5876604714,0.1149645526,-1.724468289,7.702625024
47185,2014,329,408,134,1,-79,135,12.556772642,15.571924736,5.1143086142,0.0381664822,-3.015152093,5.1524750964
47185,2015,298,340,174,3,-42,177,11.332737541,12.929969006,6.6171017855,0.1140879618,-1.597231465,6.7311897473
47185,2016,283,362,166,3,-79,169,10.7170583,13.708745953,6.286331017,0.1136083919,-2.991687653,6.3999394089
47185,2017,295,351,354,3,-56,357,11.089391775,13.194496654,13.30727013,0.1127734757,-2.105104879,13.420043606
32033,2010,29,46,16,1,-17,17,NA,NA,NA,NA,NA,NA
32033,2011,115,89,74,0,26,74,11.408164278,8.8289271366,7.340905709,0,2.579237141,7.340905709
32033,2012,110,84,-139,-4,26,-143,10.918656013,8.3378827733,-13.79721078,-0.397042037,2.5807732394,-14.19425282
32033,2013,89,82,26,0,7,26,8.8698425354,8.1722144708,2.5911899542,0,0.6976280646,2.5911899542
32033,2014,108,95,-26,1,13,-25,10.752688172,9.4583831143,-2.588610115,0.0995619275,1.2943050577,-2.489048188
32033,2015,100,103,-172,1,-3,-171,10.048231511,10.349678457,-17.2829582,0.1004823151,-0.301446945,-17.18247588
32033,2016,100,93,-130,1,7,-129,10.198878123,9.4849566548,-13.25854156,0.1019887812,0.7139214686,-13.15655278
32033,2017,90,86,-157,1,4,-156,9.3090608192,8.8953247828,-16.23913943,0.1034340091,0.4137360364,-16.13570542
17195,2010,193,121,-93,4,72,-89,NA,NA,NA,NA,NA,NA
17195,2011,656,644,-235,14,12,-221,11.237398611,11.031836441,-4.02559249,0.2398225313,0.2055621697,-3.785769959
17195,2012,640,690,-468,6,-50,-462,11.031059326,11.892860836,-8.066462132,0.1034161812,-0.86180151,-7.963045951
17195,2013,631,657,-271,10,-26,-261,10.951153689,11.402389816,-4.703268859,0.1735523564,-0.451236127,-4.529716502
17195,2014,625,642,-431,6,-17,-425,10.915981871,11.212896578,-7.527661098,0.104793426,-0.296914707,-7.422867672
17195,2015,643,593,-149,12,50,-137,11.282582185,10.405242979,-2.614470833,0.2105614094,0.8773392057,-2.403909424
17195,2016,642,643,-413,12,-1,-401,11.314170911,11.33179423,-7.27843082,0.2114798301,-0.017623319,-7.06695099
17195,2017,641,616,-462,13,25,-449,11.379472568,10.935655385,-8.201741539,0.2307849351,0.4438171828,-7.970956604
13313,2010,379,145,-41,-12,234,-53,NA,NA,NA,NA,NA,NA
13313,2011,1470,729,-489,38,741,-451,14.283770916,7.083584352,-4.751540121,0.3692403366,7.2001865635,-4.382299784
13313,2012,1417,783,-605,74,634,-531,13.74300484,7.5940527801,-5.867690845,0.717701029,6.1489520595,-5.149989816
13313,2013,1358,804,-778,47,554,-731,13.175511788,7.8005239158,-7.548268167,0.4560007762,5.3749878723,-7.092267391
13313,2014,1381,816,-171,85,565,-86,13.379773387,7.9057893437,-1.656727914,0.8235197233,5.4739840431,-0.833208191
13313,2015,1385,767,-162,139,618,-23,13.350813098,7.3935549793,-1.561611352,1.3399010979,5.9572581189,-0.221710254
13313,2016,1439,854,-57,141,585,84,13.788345542,8.1829375213,-0.546167961,1.3510470615,5.605408021,0.8048791005
13313,2017,1423,812,-788,138,611,-650,13.594069432,7.7571218403,-7.527847303,1.3183285886,5.8369475917,-6.209518715
18183,2010,111,63,19,3,48,22,NA,NA,NA,NA,NA,NA
18183,2011,389,319,-88,15,70,-73,11.662419427,9.5637835407,-2.638285115,0.44970769,2.0986358867,-2.188577425
18183,2012,369,309,-88,6,60,-82,11.066790631,9.2673124794,-2.639234622,0.1799478151,1.7994781513,-2.459286807
18183,2013,360,278,-144,10,82,-134,10.808863268,8.3468444124,-4.323545307,0.3002462019,2.4620188555,-4.023299105
18183,2014,412,311,50,12,101,62,12.350305011,9.3226816949,1.4988234236,0.3597176217,3.0276233157,1.8585410453
18183,2015,393,322,-73,12,71,-61,11.751865197,9.628754691,-2.182916436,0.3588355785,2.1231105064,-1.824080858
18183,2016,397,280,-88,12,117,-76,11.863495099,8.3672005738,-2.629691609,0.3585943103,3.4962945255,-2.271097299
18183,2017,387,296,171,12,91,183,11.511005354,8.8042831648,5.0862581797,0.3569303986,2.7067221892,5.4431885782
21235,2010,132,77,20,9,55,29,NA,NA,NA,NA,NA,NA
21235,2011,536,467,58,14,69,72,14.9754135,13.047608404,1.6204738489,0.3911488601,1.9278050961,2.011622709
21235,2012,534,433,-180,-2,101,-182,14.90724844,12.087712687,-5.024915205,-0.055832391,2.8195357537,-5.080747596
21235,2013,519,482,68,-3,37,65,14.485068378,13.452414178,1.8978509629,-0.083728719,1.0326542004000001,1.8141222439
21235,2014,601,468,-171,6,133,-165,16.758686074,13.050025096,-4.768278401,0.1673080141,3.7086609782,-4.600970386
21235,2015,598,528,174,7,70,181,16.625427451,14.679307181,4.8374989574,0.194612027,1.9461202702,5.0321109845
21235,2016,576,461,-111,7,115,-104,15.956783711,12.770967519,-3.075005194,0.1939192465,3.1858161923,-2.881085948
21235,2017,586,441,-40,7,145,-33,16.206424492,12.196302391,-1.10624058,0.1935921014,4.0101221013,-0.912648478
53075,2010,107,80,-107,59,27,-48,NA,NA,NA,NA,NA,NA
53075,2011,443,247,-294,309,196,15,9.873186387,5.5049143061,-6.552408121,6.8867146582,4.3682720809,0.3343065368
53075,2012,430,230,972,360,200,1332,9.3965451307,5.0260590234,21.240562482,7.8668749932,4.3704861073,29.107437475
53075,2013,501,265,-390,329,236,-61,10.742543474,5.6821836739,-8.362458992,7.0544846367,5.0603598002,-1.307974355
53075,2014,415,266,-502,366,149,-136,8.8788095977,5.6909960313,-10.7401504,7.8304682235,3.1878135664,-2.909682181
53075,2015,456,275,575,393,181,968,9.6337688952,5.8098386978,12.14784455,8.3027876662,3.8239301974,20.450632216
53075,2016,427,292,79,397,135,476,8.8550631468,6.0554530184,1.6382903714,8.2329275627,2.7996101284,9.8712179341
53075,2017,443,256,-63,395,187,332,9.0802877816,5.2472994855,-1.291327608,8.096419128,3.8329882961,6.8050915203
30109,2010,1,2,-8,0,-1,-8,NA,NA,NA,NA,NA,NA
30109,2011,8,19,-17,0,-11,-17,8.0442433384,19.105077929,-17.09401709,0,-11.06083459,-17.09401709
30109,2012,7,16,60,0,-9,60,6.9478908189,15.8808933,59.553349876,0,-8.933002481,59.553349876
30109,2013,14,11,63,0,3,63,13.114754098,10.304449649,59.016393443,0,2.8103044496,59.016393443
30109,2014,14,13,-19,0,1,-19,12.808783166,11.893870082,-17.38334858,0,0.9149130833,-17.38334858
30109,2015,17,22,-9,0,-5,-9,15.762633287,20.398701901,-8.344923505,0,-4.636068614,-8.344923505
30109,2016,11,15,-21,0,-4,-21,10.382255781,14.15762152,-19.82067013,0,-3.775365739,-19.82067013
30109,2017,12,16,-23,0,-4,-23,11.611030479,15.481373972,-22.25447508,0,-3.870343493,-22.25447508
20203,2010,9,7,3,0,2,3,NA,NA,NA,NA,NA,NA
20203,2011,32,28,14,1,4,15,14.238042269,12.458286986,6.2291434928,0.4449388209,1.7797552836,6.6740823137
20203,2012,21,24,-27,-1,-3,-28,9.3666369313,10.704727921,-12.04281891,-0.44603033,-1.33809099,-12.48884924
20203,2013,35,28,-45,1,7,-44,15.847860539,12.678288431,-20.37582069,0.4527960154,3.1695721078,-19.92302468
20203,2014,28,27,-9,0,1,-9,12.811713567,12.354152368,-4.118050789,0,0.4575611988,-4.118050789
20203,2015,21,23,-23,2,-2,-21,9.6751900484,10.59663672,-10.59663672,0.9214466713,-0.921446671,-9.675190048
20203,2016,21,18,-35,3,3,-32,9.7879282219,8.3896527616,-16.3132137,1.3982754603,1.3982754603,-14.91493824
20203,2017,18,21,-4,3,-3,-1,8.4586466165,9.8684210526,-1.879699248,1.4097744361,-1.409774436,-0.469924812
48485,2010,457,266,-181,125,191,-56,NA,NA,NA,NA,NA,NA
48485,2011,1793,1330,-1774,257,463,-1517,13.657206404,10.130554667,-13.51248419,1.9575583078,3.5266517374,-11.55492589
48485,2012,1786,1298,-295,700,488,405,13.611352447,9.8922371088,-2.248235707,5.3347965918,3.7191153383,3.0865608853
48485,2013,1787,1329,-346,385,458,39,13.548861577,10.076349768,-2.623338615,2.9190328524,3.4725118088,0.295694237
48485,2014,1803,1330,-418,397,473,-21,13.622609149,10.04884646,-3.158208888,2.9995428908,3.5737626886,-0.158665997
48485,2015,1762,1341,-2666,511,421,-2155,13.376656899,10.180531726,-20.23959551,3.8793823355,3.1961251727,-16.36021318
48485,2016,1700,1345,-310,396,355,86,12.968140331,10.260087497,-2.364778531,3.0208138652,2.7080528337,0.6560353344
48485,2017,1676,1353,43,330,323,373,12.73024192,10.276859975,0.3266112187,2.5065512134,2.4533819452,2.8331624321
24045,2010,327,152,-39,99,175,60,NA,NA,NA,NA,NA,NA
24045,2011,1283,872,253,489,411,742,12.890002964,8.7607814376,2.541832229,4.9128694071,4.1292215262,7.4547016361
24045,2012,1230,891,-238,394,339,156,12.256672662,8.8786140992,-2.371616336,3.9261211617,3.378058563,1.5545048254
24045,2013,1197,918,-323,411,279,88,11.877710192,9.1092213501,-3.205096401,4.0783115195,2.7684888417,0.8732151185
24045,2014,1211,944,-63,403,267,340,11.960316637,9.3233186669,-0.622213004,3.9801879478,2.6369979704,3.3579749436
24045,2015,1201,920,-207,447,281,240,11.79741066,9.0371505471,-2.033358873,4.3908764071,2.7602601128,2.357517534
24045,2016,1252,999,-198,472,253,274,12.235942593,9.7633439697,-1.935077183,4.612911265,2.472598623,2.6778340818
24045,2017,1243,1046,-328,471,197,143,12.096852677,10.179652374,-3.192089846,4.5837631625,1.9172003036,1.3916733169
48487,2010,46,39,-38,3,7,-35,NA,NA,NA,NA,NA,NA
48487,2011,165,146,-96,9,19,-87,12.245806739,10.835683539,-7.124833012,0.6679530948,1.4101232002,-6.456879917
48487,2012,189,147,-222,7,42,-215,14.150943396,11.006289308,-16.62174304,0.5241090147,3.1446540881,-16.09763402
48487,2013,161,174,-83,10,-13,-73,12.170692066,13.153418755,-6.274331935,0.7559436066,-0.982726689,-5.518388328
48487,2014,148,165,-217,14,-17,-203,11.317147773,12.617090422,-16.59338559,1.0705410055,-1.29994265,-15.52284458
48487,2015,176,162,48,17,14,65,13.528575272,12.452438603,3.6896114378,1.3067373842,1.0761366694,4.996348822
48487,2016,166,137,-200,17,29,-183,12.797286359,10.56161585,-15.4184173,1.3105654705,2.2356705084,-14.10785183
48487,2017,161,137,-171,17,24,-154,12.549692104,10.678930548,-13.32917609,1.3251227687,1.8707615559,-12.00405332
01131,2010,21,63,-67,0,-42,-67,NA,NA,NA,NA,NA,NA
01131,2011,142,141,-124,0,1,-124,12.346752456,12.259803495,-10.78167116,0,0.086948961,-10.78167116
01131,2012,136,143,-130,0,-7,-130,11.958146487,12.573639321,-11.4305812,0,-0.615492834,-11.4305812
01131,2013,139,150,-148,0,-11,-148,12.379764874,13.359458497,-13.18133238,0,-0.979693623,-13.18133238
01131,2014,140,175,-168,0,-35,-168,12.669109995,15.836387494,-15.20293199,0,-3.167277499,-15.20293199
01131,2015,122,150,-22,0,-28,-22,11.166025993,13.728720483,-2.013545671,0,-2.56269449,-2.013545671
01131,2016,139,117,-47,0,22,-47,12.766348273,10.745775165,-4.316678913,0,2.020573108,-4.316678913
01131,2017,131,123,-165,0,8,-165,12.132999907,11.392053348,-15.28202278,0,0.7409465592,-15.28202278
13315,2010,21,55,19,0,-34,19,NA,NA,NA,NA,NA,NA
13315,2011,111,114,-31,2,-3,-29,12.03317253,12.358393409,-3.360615752,0.2168139195,-0.325220879,-3.143801832
13315,2012,80,94,-168,2,-14,-166,8.7704873102,10.305322589,-18.41802335,0.2192621828,-1.534835279,-18.19876117
13315,2013,84,109,13,1,-25,14,9.3049016893,12.074217668,1.4400443091,0.1107726392,-2.769315979,1.5508169482
13315,2014,115,112,-135,1,3,-134,12.838403572,12.503488697,-15.07116941,0.1116382919,0.3349148758,-14.95953112
13315,2015,77,103,31,1,-26,32,8.65508908,11.577586691,3.4845163828,0.1124037543,-2.922497611,3.5969201371
13315,2016,91,88,-37,1,3,-36,10.24428684,9.9065630981,-4.165259484,0.1125745807,0.337723742,-4.052684904
13315,2017,92,100,-61,1,-8,-60,10.414897832,11.320541122,-6.905530084,0.1132054112,-0.90564329,-6.792324673
13317,2010,28,19,-105,0,9,-105,NA,NA,NA,NA,NA,NA
13317,2011,109,128,-269,4,-19,-265,10.512103385,12.344488379,-25.94271386,0.3857652618,-1.832384994,-25.5569486
13317,2012,133,152,-128,5,-19,-123,13.089906993,14.959893706,-12.59780523,0.4921017666,-1.869986713,-12.10570346
13317,2013,104,167,-114,14,-63,-100,10.389091454,16.682483392,-11.38804256,1.3985315419,-6.293391938,-9.989511013
13317,2014,100,114,32,18,-14,50,10.05277708,11.460165871,3.2168886655,1.8094998743,-1.407388791,5.0263885398
13317,2015,115,153,-32,22,-38,-10,11.567670875,15.390031685,-3.218830156,2.2129457325,-3.822360811,-1.005884424
13317,2016,100,120,-99,24,-20,-75,10.131712259,12.158054711,-10.03039514,2.4316109422,-2.026342452,-7.598784195
13317,2017,98,138,87,24,-40,111,9.942173075,14.000202901,8.8262148727,2.4348178959,-4.058029827,11.261032769
37193,2010,172,161,-45,-1,11,-46,NA,NA,NA,NA,NA,NA
37193,2011,678,695,-299,-1,-17,-300,9.8115828775,10.057596017,-4.326936992,-0.014471361,-0.24601314,-4.341408353
37193,2012,672,709,24,9,-37,33,9.7483843359,10.285125735,0.3481565834,0.1305587188,-0.536741399,0.4787153022
37193,2013,687,808,-189,31,-121,-158,9.9877152556,11.746832499,-2.747712057,0.45068293,-1.759117243,-2.297029127
37193,2014,652,829,-31,35,-177,4,9.5115137457,12.09362714,-0.452234549,0.5105873943,-2.582113394,0.0583528451
37193,2015,690,826,-37,48,-136,11,10.089563151,12.078230671,-0.541034546,0.701882654,-1.98866752,0.1608481082
37193,2016,721,796,339,51,-75,390,10.529082758,11.62434102,4.9505673438,0.7447756181,-1.095258262,5.6953429619
37193,2017,709,829,14,51,-120,65,10.334523723,12.083667371,0.204066759,0.7433860506,-1.749143648,0.9474528096
27167,2010,18,6,0,0,12,0,NA,NA,NA,NA,NA,NA
27167,2011,72,82,-2,-1,-10,-3,10.939755375,12.459165844,-0.303882094,-0.151941047,-1.519410469,-0.455823141
27167,2012,70,74,20,-3,-4,17,10.634257501,11.241929358,3.038359286,-0.455753893,-0.607671857,2.5826053931
27167,2013,55,82,-69,0,-27,-69,8.407214919,12.534393152,-10.54723326,0,-4.127178233,-10.54723326
27167,2014,76,86,-19,0,-10,-19,11.730205279,13.273653342,-2.93255132,0,-1.543448063,-2.93255132
27167,2015,68,72,-100,0,-4,-100,10.603461718,11.227194761,-15.59332606,0,-0.623733042,-15.59332606
27167,2016,75,73,-19,0,2,-19,11.804517195,11.48973007,-2.990477689,0,0.3147871252,-2.990477689
27167,2017,74,83,-12,0,-9,-12,11.682058568,13.102849475,-1.894387876,0,-1.420790907,-1.894387876
13319,2010,33,42,-33,0,-9,-33,NA,NA,NA,NA,NA,NA
13319,2011,134,111,-137,0,23,-137,14.155926474,11.7261779,-14.4728502,0,2.4297485738,-14.4728502
13319,2012,106,108,70,1,-2,71,11.222869243,11.434621493,7.4113287454,0.1058761249,-0.21175225,7.5172048703
13319,2013,100,110,-107,-1,-10,-108,10.614584439,11.676042883,-11.35760535,-0.106145844,-1.061458444,-11.46375119
13319,2014,121,119,-81,0,2,-81,12.979351032,12.764816305,-8.688656476,0,0.2145347278,-8.688656476
13319,2015,97,124,-179,2,-27,-177,10.563572012,13.503947727,-19.49360196,0.2178056085,-2.940375715,-19.27579635
13319,2016,104,108,-31,2,-4,-29,11.472697187,11.913954771,-3.419746277,0.2206287921,-0.441257584,-3.199117485
13319,2017,100,139,-52,2,-39,-50,11.106791803,15.438440606,-5.775531738,0.2221358361,-4.331648803,-5.553395902
28157,2010,28,13,-31,0,15,-31,NA,NA,NA,NA,NA,NA
28157,2011,146,134,-299,0,12,-299,15.015169435,13.78104592,-30.75024425,0,1.2341235152,-30.75024425
28157,2012,101,96,-133,-1,5,-134,10.607572336,10.082444993,-13.96838733,-0.105025469,0.5251273434,-14.0734128
28157,2013,120,110,-125,-1,10,-126,12.764599511,11.700882885,-13.29645782,-0.106371663,1.0637166259,-13.40282949
28157,2014,107,115,-154,-1,-8,-155,11.551956815,12.415654521,-16.62618084,-0.107962213,-0.863697706,-16.73414305
28157,2015,110,127,-80,-1,-17,-81,12.043575847,13.904855751,-8.758964252,-0.109487053,-1.861279904,-8.868451306
28157,2016,91,117,-48,-1,-26,-49,10.059138893,12.933178577,-5.305919416,-0.110539988,-2.874039684,-5.416459404
28157,2017,90,124,-171,-1,-34,-172,10.105546822,13.923197844,-19.20053896,-0.112283854,-3.817651022,-19.31282282
17197,2010,2215,805,-294,189,1410,-105,NA,NA,NA,NA,NA,NA
17197,2011,8201,3909,-3322,838,4292,-2484,12.065413047,5.7509693451,-4.887367655,1.232876007,6.3144437015,-3.654491648
17197,2012,8099,3884,-3240,797,4215,-2443,11.883608426,5.6989671722,-4.754030288,1.1694327591,6.1846412541,-3.584597529
17197,2013,7840,4087,-2939,586,3753,-2353,11.476568916,5.9827470866,-4.302249495,0.8578149725,5.4938218292,-3.444434523
17197,2014,7719,4028,-2719,686,3691,-2033,11.274167929,5.8831906231,-3.971299728,1.0019535172,5.3909773063,-2.969346211
17197,2015,7925,4324,-2966,796,3601,-2170,11.549010064,6.3013147655,-4.322317205,1.1600015156,5.2476952985,-3.162315689
17197,2016,7789,4464,-1315,800,3325,-515,11.315867275,6.4853038279,-1.910433363,1.1622408294,4.8305634471,-0.748192534
17197,2017,7753,4527,-1081,793,3226,-288,11.216789449,6.549517069,-1.56395581,1.147286732,4.66727238,-0.416669078
48489,2010,86,17,18,2,69,20,NA,NA,NA,NA,NA,NA
48489,2011,341,154,-259,11,187,-248,15.363474578,6.9383433579,-11.66903201,0.4955959541,8.4251312203,-11.17343606
48489,2012,311,157,-135,13,154,-122,14.020376882,7.0778108376,-6.086015688,0.58606077,6.9425660445,-5.499954918
48489,2013,307,148,-342,9,159,-333,13.883550028,6.6930469192,-15.46636518,0.4070096099,7.1905031091,-15.05935557
48489,2014,291,176,-223,21,115,-202,13.236297476,8.005458267,-10.14327951,0.955196725,5.2308392086,-9.188082784
48489,2015,314,179,-228,31,135,-197,14.329720479,8.1688533942,-10.40501997,1.4147176269,6.160867085,-8.990302339
48489,2016,285,178,-261,32,107,-229,13.060812978,8.1572796847,-11.96095504,1.4664772467,4.9035332936,-10.4944778
48489,2017,289,186,-313,32,103,-281,13.335179033,8.5825027685,-14.44259874,1.4765596161,4.7526762643,-12.96603913
38105,2010,98,42,122,-2,56,120,NA,NA,NA,NA,NA,NA
38105,2011,348,226,1653,-19,122,1634,14.814499479,9.6209105809,70.368872523,-0.808837615,5.1935888976,69.560034908
38105,2012,446,233,2063,-13,213,2050,17.446409013,9.1143795963,80.699421061,-0.508527617,8.3320294164,80.190893444
38105,2013,524,239,2511,-9,285,2502,18.603990627,8.4854079386,89.150039054,-0.31953419,10.118582688,88.830504864
38105,2014,595,240,2097,5,355,2102,19.277811077,7.7759237959,67.942134167,0.1619984124,11.501887282,68.10413258
38105,2015,717,225,2615,8,492,2623,21.26618321,6.6734884549,77.56076582,0.2372795895,14.592694755,77.798045409
38105,2016,706,230,-1594,7,476,-1587,20.317716128,6.6190859906,-45.87314378,0.2014504432,13.698630137,-45.67169333
38105,2017,651,213,-1299,6,438,-1293,19.276323582,6.3069998816,-38.46381618,0.1776619685,12.9693237,-38.28615421
39171,2010,102,126,-124,2,-24,-122,NA,NA,NA,NA,NA,NA
39171,2011,447,343,-31,-2,104,-33,11.906823116,9.1365555452,-0.825752834,-0.053274376,2.7702675706,-0.87902721
39171,2012,444,356,-143,-6,88,-149,11.825494061,9.481702445,-3.808661375,-0.159803974,2.3437916156,-3.968465349
39171,2013,426,385,-125,-10,41,-135,11.369853873,10.275572163,-3.336224728,-0.266897978,1.0942817108,-3.603122706
39171,2014,429,412,-243,-6,17,-249,11.500569667,11.044836137,-6.514308692,-0.160847128,0.4557335299,-6.675155821
39171,2015,419,403,-200,-6,16,-206,11.29638866,10.865022984,-5.39207096,-0.161762129,0.4313656768,-5.553833088
39171,2016,431,392,-108,-6,39,-114,11.66157093,10.606347574,-2.922156985,-0.162342055,1.0552233556,-3.084499039
39171,2017,432,400,-163,-6,32,-169,11.722406892,10.854080456,-4.423037786,-0.162811207,0.8683264365,-4.585848993
51830,2010,30,10,-4,17,20,13,NA,NA,NA,NA,NA,NA
51830,2011,116,105,267,106,11,373,8.3330340146,7.5428325132,19.180345534,7.6146690133,0.7902015014,26.795014547
51830,2012,86,89,254,136,-3,390,6.0089435439,6.2185578535,17.747344885,9.5025153717,-0.20961431,27.249860257
51830,2013,106,132,23,114,-26,137,7.2787200439,9.0640664698,1.5793449152,7.8280574058,-1.785346426,9.407402321
51830,2014,118,123,-116,124,-5,8,8.0719636078,8.413995964,-7.935150665,8.4824024353,-0.342032356,0.54725177
51830,2015,88,78,102,135,10,237,5.9691368492,5.2908258436,6.9187722571,9.1571985755,0.6783110056,16.075970833
51830,2016,106,78,-82,138,28,56,7.10979945,5.2317392179,-5.500033537,9.2561540009,1.8780602321,3.7561204641
51830,2017,96,111,-45,140,-15,95,6.4036287229,7.4041957109,-3.001700964,9.338625221,-1.000566988,6.3369242571
45089,2010,93,101,-64,2,-8,-62,NA,NA,NA,NA,NA,NA
45089,2011,356,410,-207,23,-54,-184,10.399777982,11.977272395,-6.047061917,0.6718957685,-1.577494413,-5.375166148
45089,2012,358,413,-515,15,-55,-500,10.579039908,12.204311402,-15.21845126,0.4432558621,-1.625271494,-14.7751954
45089,2013,333,416,-407,3,-83,-404,9.9915986558,12.48199712,-12.21195391,0.0900144023,-2.490398464,-12.12193951
45089,2014,339,424,-283,12,-85,-271,10.300663922,12.883426262,-8.599079321,0.3646252716,-2.58276234,-8.23445405
45089,2015,350,420,-199,14,-70,-185,10.734056093,12.880867312,-6.103077607,0.4293622437,-2.146811219,-5.673715364
45089,2016,322,406,-562,15,-84,-547,10.011503902,12.623200572,-17.47349439,0.4663744054,-2.61169667,-17.00711998
45089,2017,326,391,-667,15,-65,-652,10.352492855,12.416640203,-21.18132741,0.4763416958,-2.064147348,-20.70498571
17199,2010,189,148,25,6,41,31,NA,NA,NA,NA,NA,NA
17199,2011,801,760,219,26,41,245,12.032447048,11.416554003,3.2897701667,0.3905663212,0.6158930449,3.6803364879
17199,2012,752,756,18,46,-4,64,11.268449839,11.328388402,0.2697235334,0.6892934742,-0.059938563,0.9590170076
17199,2013,790,754,565,58,36,623,11.774964042,11.238383402,8.4213350424,0.8644910309,0.5365806399,9.2858260733
17199,2014,776,737,-124,59,39,-65,11.512499073,10.93390698,-1.83962614,0.8753059862,0.5785920926,-0.964320154
17199,2015,826,738,76,67,88,143,12.237671583,10.933900276,1.1259843103,0.992644063,1.3037713067,2.1186283733
17199,2016,847,762,-118,68,85,-50,12.525231613,11.268272124,-1.744955526,1.0055675911,1.2569594889,-0.739387935
17199,2017,819,777,-420,68,42,-352,12.136210065,11.513840318,-6.223697469,1.0076462569,0.6223697469,-5.216051212
47187,2010,491,177,484,67,314,551,NA,NA,NA,NA,NA,NA
47187,2011,1963,988,2941,323,975,3264,10.538890007,5.3043419905,15.789544326,1.7341118046,5.2345480169,17.52365613
47187,2012,2006,982,3269,349,1024,3618,10.517264882,5.1485314627,17.139052293,1.8297734017,5.3687334193,18.968825694
47187,2013,2016,987,4475,359,1029,4834,10.28403526,5.0348922625,22.827905648,1.8313336598,5.2491429971,24.659239308
47187,2014,2086,1054,4707,412,1032,5119,10.321520816,5.2151883702,23.29021979,2.0385745812,5.106332446,25.328794371
47187,2015,2221,1099,4640,446,1122,5086,10.6607403,5.275170459,22.271875277,2.1407880116,5.3855698408,24.412663289
47187,2016,2306,1196,5884,441,1110,6325,10.717007789,5.5583440225,27.345565408,2.0495231722,5.1586637667,29.39508858
47187,2017,2337,1202,5797,440,1135,6237,10.499949455,5.4004874816,26.045445866,1.9768839367,5.0994619731,28.022329803
48491,2010,1498,404,2339,149,1094,2488,NA,NA,NA,NA,NA,NA
48491,2011,6134,1966,10600,823,4168,11423,14.125471214,4.5273355732,24.409845919,1.8952172822,9.5981356404,26.305063201
48491,2012,5987,2066,8905,873,3921,9778,13.330409119,4.6000710272,19.827508469,1.9437860633,8.7303380919,21.771294533
48491,2013,6053,2132,9348,952,3921,10300,13.066124997,4.6021771838,20.178776883,2.055005947,8.4639478132,22.23378283
48491,2014,6324,2296,12478,1112,4028,13590,13.191035352,4.7891551501,26.02747298,2.3194862922,8.4018802023,28.346959272
48491,2015,6434,2500,13609,1268,3934,14877,12.922208665,5.0210633608,27.332660511,2.5466833366,7.9011453046,29.879343847
48491,2016,6556,2798,15292,1271,3758,16563,12.66628606,5.4057761433,29.544363396,2.4555902352,7.2605099165,31.999953632
48491,2017,6714,2751,14494,1250,3963,15744,12.487515275,5.1166449986,26.957707237,2.3249023076,7.370870276,29.282609545
20205,2010,40,43,-14,1,-3,-13,NA,NA,NA,NA,NA,NA
20205,2011,110,136,-130,3,-26,-127,11.805741884,14.596189965,-13.95224041,0.3219747786,-2.790448082,-13.63026563
20205,2012,132,121,-130,0,11,-130,14.374387455,13.176521834,-14.15659371,0,1.1978656213,-14.15659371
20205,2013,113,132,-11,1,-19,-10,12.405313426,14.491162586,-1.207596882,0.1097815347,-2.08584916,-1.097815347
20205,2014,111,127,-104,1,-16,-103,12.28555617,14.05644715,-11.51079137,0.1106806862,-1.77089098,-11.40011068
20205,2015,91,117,-99,1,-26,-98,10.208660534,13.125420687,-11.1061252,0.1121830828,-2.916760153,-10.99394211
20205,2016,101,119,-142,2,-18,-140,11.513251639,13.565118267,-16.18694785,0.227985181,-2.051866629,-15.95896267
20205,2017,92,113,2,2,-21,4,10.594196223,13.012436665,0.2303086135,0.2303086135,-2.418240442,0.4606172271
37195,2010,235,223,51,15,12,66,NA,NA,NA,NA,NA,NA
37195,2011,1017,800,-411,89,217,-322,12.51761636,9.8466992018,-5.058741715,1.0954452862,2.6709171585,-3.963296429
37195,2012,987,742,-52,79,245,27,12.137011737,9.1242783274,-0.639437295,0.9714528138,3.01273341,0.3320155187
37195,2013,925,894,-307,106,31,-201,11.368664274,10.98766039,-3.773167494,1.3027874736,0.3810038838,-2.470380021
37195,2014,943,826,-350,82,117,-268,11.613372004,10.172476432,-4.310371369,1.0098584351,1.440895572,-3.300512934
37195,2015,944,837,74,104,107,178,11.617389164,10.300587638,0.9106851675,1.2798818571,1.3168015259999999,2.1905670246
37195,2016,964,804,-227,107,160,-120,11.840860796,9.8755726972,-2.78825249,1.3142864162,1.965288099,-1.473966074
37195,2017,942,865,59,107,77,166,11.550912301,10.606729449,0.7234647832,1.3120463017,0.9441828527,2.035511085
47189,2010,332,151,401,19,181,420,NA,NA,NA,NA,NA,NA
47189,2011,1309,884,1525,107,425,1632,11.312129212,7.6393599876,13.17876016,0.9246736637,3.6727692248,14.103433823
47189,2012,1363,936,1698,82,427,1780,11.563243647,7.9407161067,14.40527345,0.6956610264,3.6225275401,15.100934476
47189,2013,1344,936,2417,65,408,2482,11.157925323,7.770697993,20.066001121,0.5396318051,3.3872273303,20.605632926
47189,2014,1456,1049,2689,81,407,2770,11.78661054,8.4918643245,21.767991581,0.6557111633,3.2947462155,22.423702744
47189,2015,1414,1078,2824,91,336,2915,11.152299077,8.5022478113,22.273049925,0.7177222178,2.6500512659,22.990772143
47189,2016,1554,1021,3368,97,533,3465,11.914117155,7.8277436395,25.821587246,0.7436739795,4.086373516,26.565261225
47189,2017,1549,1086,3434,98,463,3532,11.522082752,8.0781032078,25.543468154,0.7289632729,3.4439795444,26.272431427
48493,2010,103,114,147,1,-11,148,NA,NA,NA,NA,NA,NA
48493,2011,446,346,499,8,100,507,10.285384837,7.9792447391,11.507639089,0.1844912078,2.306140098,11.692130297
48493,2012,511,305,476,3,206,479,11.610469872,6.9299282014,10.815232209,0.0681632282,4.6805416705,10.883395438
48493,2013,465,349,731,13,116,744,10.381318093,7.7915699232,16.31987855,0.2902303983,2.5897481693,16.610108948
48493,2014,522,361,729,16,161,745,11.425944775,7.9018506966,15.956922875,0.3502205295,3.524094078,16.307143404
48493,2015,558,433,861,22,125,883,11.960773806,9.2813889931,18.455602594,0.4715717271,2.6793848132,18.927174321
48493,2016,551,362,814,26,189,840,11.557177616,7.592918869,17.073579998,0.5453477641,3.9642587465,17.618927762
48493,2017,566,379,899,26,187,925,11.610970932,7.7748374259,18.442160543,0.5333661559,3.8361335057,18.975526699
51840,2010,94,99,-88,18,-5,-70,NA,NA,NA,NA,NA,NA
51840,2011,428,270,269,82,158,351,16.209051316,10.225336111,10.187464495,3.1054724484,5.9837152055,13.292936944
51840,2012,355,262,186,70,93,256,13.228006111,9.7626411298,6.9307299624,2.6083392331,3.4653649812,9.5390691955
51840,2013,360,260,121,107,100,228,13.247226362,9.5674412614,4.4525399717,3.9373700576,3.6797851006,8.3899100293
51840,2014,348,285,-164,124,63,-40,12.72464669,10.421046858,-5.996672578,4.5340695102,2.3035998318,-1.462603068
51840,2015,414,282,-252,144,132,-108,15.1257741,10.303063517,-9.20699293,5.2611388173,4.8227105826,-3.945854113
51840,2016,336,231,-72,150,105,78,12.22952192,8.4077963202,-2.62061184,5.4596080001,3.8217256001,2.8389961601000002
51840,2017,354,257,118,152,97,270,12.757216476,9.2615950124,4.2524054921,5.4776748712,3.4956214638,9.7300803633
09015,2010,290,247,88,41,43,129,NA,NA,NA,NA,NA,NA
09015,2011,1196,984,-697,281,212,-416,10.093167702,8.3040777748,-5.88205509,2.3713880637,1.7890899271,-3.510667027
09015,2012,1190,985,-896,282,205,-614,10.068022607,8.3336153508,-7.580628786,2.385867542,1.7344072557,-5.194761244
09015,2013,1179,1001,-781,234,178,-547,10.007342113,8.4964796055,-6.62912145,1.9861900376,1.5108625073,-4.642931413
09015,2014,1132,1030,-1172,267,102,-905,9.6556136049,8.7855848171,-9.996801365,2.2774282973,0.8700287877,-7.719373067
09015,2015,1081,969,-742,283,112,-459,9.2654495586,8.3054769864,-6.359818291,2.4256449816,0.9599725722,-3.934173309
09015,2016,1044,1001,-800,301,43,-499,8.9791775968,8.6093455693,-6.88059586,2.5888241922,0.3698320275,-4.291771667
09015,2017,1078,1029,-30,303,49,273,9.2770685152,8.8553835827,-0.258174448,2.6075619296,0.4216849325,2.3493874811
50025,2010,116,92,-31,-4,24,-35,NA,NA,NA,NA,NA,NA
50025,2011,409,429,-282,3,-20,-279,9.2218890217,9.6728371401,-6.35836847,0.0676422178,-0.450948118,-6.290726252
50025,2012,409,470,-180,12,-61,-168,9.276900744,10.660497187,-4.082743604,0.2721829069,-1.383596443,-3.810560697
50025,2013,418,437,-182,14,-19,-168,9.5260884923,9.9590925147,-4.147722741,0.3190555954,-0.433004022,-3.828667145
50025,2014,414,415,-176,30,-1,-146,9.4711917916,9.4940690665,-4.026400375,0.6863182458,-0.022877275,-3.340082129
50025,2015,359,460,-349,34,-101,-315,8.2664609646,10.592122684,-8.036197428,0.7828960245,-2.32566172,-7.253301403
50025,2016,388,439,-59,39,-51,-20,8.9850172522,10.166037561,-1.366278397,0.9031331774,-1.181020309,-0.463145219
50025,2017,371,438,-249,39,-67,-210,8.6263020833,10.184151786,-5.789620536,0.9068080357,-1.557849702,-4.8828125
50027,2010,139,168,-34,4,-29,-30,NA,NA,NA,NA,NA,NA
50027,2011,523,582,20,13,-59,33,9.2433855888,10.286138456,0.3534755483,0.2297591064,-1.042752868,0.5832346547
50027,2012,502,566,-395,1,-64,-394,8.9108998766,10.046950857,-7.011564644,0.0177507966,-1.13605098,-6.993813847
50027,2013,486,575,-33,-1,-89,-34,8.6719900076,10.260070482,-0.588838828,-0.017843601,-1.588080475,-0.606682429
50027,2014,454,551,-157,8,-97,-149,8.1286984235,9.8654467651,-2.811025666,0.1432369766,-1.736748342,-2.66778869
50027,2015,491,635,-157,8,-144,-149,8.8346693297,11.425692514,-2.824935,0.1439457325,-2.591023184,-2.680989267
50027,2016,466,578,-129,8,-112,-121,8.425087234,10.450000904,-2.332266638,0.1446366907,-2.02491367,-2.187629947
50027,2017,469,546,-21,8,-77,-13,8.5045424048,9.9008105609,-0.380800406,0.1450668214,-1.396268156,-0.235733585
48495,2010,23,13,-38,1,10,-37,NA,NA,NA,NA,NA,NA
48495,2011,116,65,17,7,51,24,16.284129992,9.1247280129,2.3864673265,0.9826630168,7.1594019794,3.3691303432
48495,2012,109,73,160,5,36,165,15.007572628,10.050943136,22.029464409,0.6884207628,4.9566294919,22.717885171
48495,2013,129,64,196,2,65,198,17.20458789,8.5356094959,26.140304081,0.2667377967,8.6689783942,26.407041878
48495,2014,137,69,107,5,68,112,17.73922051,8.9343519358,13.854719669,0.6474168069,8.8048685744,14.502136475
48495,2015,130,65,110,6,65,116,16.445287793,8.2226438963,13.915243517,0.7590132827,8.2226438963,14.674256799
48495,2016,129,51,-207,6,78,-201,16.260162602,6.4284363774,-26.09188883,0.7562866326,9.8317262242,-25.33560219
48495,2017,114,42,-377,6,72,-371,14.761103198,5.4383011783,-48.81522724,0.7769001683,9.3228020199,-48.03832707
22127,2010,44,22,-35,0,22,-35,NA,NA,NA,NA,NA,NA
22127,2011,188,151,-192,-2,37,-194,12.348111658,9.9178981938,-12.61083744,-0.13136289,2.4302134647,-12.74220033
22127,2012,174,142,-74,-3,32,-77,11.504512546,9.3887401236,-4.892723726,-0.198353665,2.1157724222,-5.091077391
22127,2013,167,194,-226,-3,-27,-229,11.151919866,12.954924875,-15.0918197,-0.20033389,-1.803005008,-15.29215359
22127,2014,160,165,-20,-2,-5,-22,10.786032088,11.123095591,-1.348254011,-0.134825401,-0.337063503,-1.483079412
22127,2015,166,170,-171,-2,-4,-173,11.26875297,11.540289186,-11.60817324,-0.135768108,-0.271536216,-11.74394135
22127,2016,170,180,-98,-2,-10,-100,11.653413765,12.338908692,-6.717850288,-0.137098985,-0.685494927,-6.854949273
22127,2017,166,196,-190,-2,-30,-192,11.510192761,13.590348079,-13.17431702,-0.138677021,-2.080155318,-13.31299404
17201,2010,890,511,-644,72,379,-572,NA,NA,NA,NA,NA,NA
17201,2011,3774,2762,-2870,301,1012,-2569,12.822364051,9.3840406755,-9.750976372,1.0226633756,3.4383233757,-8.728312996
17201,2012,3561,2624,-2883,382,937,-2501,12.161469895,8.9614425737,-9.845975206,1.3046002527,3.2000273215,-8.541374953
17201,2013,3619,2819,-2302,319,800,-1983,12.416542581,9.6717970535,-7.898005256,1.0944672792,2.7447455278,-6.803537977
17201,2014,3551,2870,-3340,399,681,-2941,12.254271827,9.9041847769,-11.52612444,1.3769232495,2.3500870498,-10.14920119
17201,2015,3643,3040,-2587,443,603,-2144,12.653457471,10.559020234,-8.985587285,1.5386993302,2.0944372372,-7.446887955
17201,2016,3588,2805,-2286,451,783,-1835,12.518557156,9.7866646663,-7.975870028,1.573542162,2.7318924897,-6.402327865
17201,2017,3531,2724,-2566,444,807,-2122,12.370678933,9.5433954728,-8.989850508,1.5555314207,2.8272834606,-7.434319087
19189,2010,35,40,-28,1,-5,-27,NA,NA,NA,NA,NA,NA
19189,2011,111,136,-129,-1,-25,-130,10.31646452,12.639992565,-11.98940471,-0.092941122,-2.323528045,-12.08234583
19189,2012,113,118,-87,-3,-5,-90,10.623795421,11.093874865,-8.179382316,-0.282047666,-0.470079443,-8.461429982
19189,2013,104,145,-133,0,-41,-133,9.9014614176,13.804922169,-12.66244585,0,-3.903460751,-12.66244585
19189,2014,140,107,91,-1,33,90,13.36005344,10.210897986,8.6840347361,-0.095428953,3.1491554538,8.588605783
19189,2015,119,139,58,0,-20,58,11.269472986,13.16350206,5.4926843127,0,-1.894029073,5.4926843127
19189,2016,112,117,28,0,-5,28,10.576514472,11.048680297,2.644128618,0,-0.472165825,2.644128618
19189,2017,109,117,-5,0,-8,-5,10.288842741,11.043987163,-0.471965263,0,-0.755144421,-0.471965263
55139,2010,504,363,-73,19,141,-54,NA,NA,NA,NA,NA,NA
55139,2011,1876,1447,-38,69,429,31,11.214696274,8.6501415287,-0.227163357,0.4124808331,2.5645547449,0.1853174757
55139,2012,1925,1427,460,104,498,564,11.456901221,8.4929859958,2.737753019,0.6189702478,2.9639152249,3.3567232667
55139,2013,1898,1426,173,111,472,284,11.236620252,8.4422657952,1.0242019513,0.6571469167,2.7943544568,1.681348868
55139,2014,1829,1402,-492,106,427,-386,10.804137353,8.2817936404,-2.906307041,0.6261555819,2.5223437122,-2.280151459
55139,2015,1829,1467,-608,115,362,-493,10.808031863,8.6688806685,-3.592828525,0.6795646059,2.1391511943,-2.913263919
55139,2016,1943,1455,-212,124,488,-88,11.47287371,8.5913696592,-1.25180094,0.7321854555,2.8815040506,-0.519615485
55139,2017,1911,1479,306,124,432,430,11.242201495,8.7007933076,1.8001641326,0.729478276,2.5414081872,2.5296424086
19191,2010,47,25,0,-2,22,-2,NA,NA,NA,NA,NA,NA
19191,2011,160,177,-15,2,-17,-13,7.5977016952,8.4049575004,-0.712284534,0.0949712712,-0.807255805,-0.617313263
19191,2012,180,179,-5,-1,1,-6,8.5551330798,8.5076045627,-0.237642586,-0.047528517,0.0475285171,-0.285171103
19191,2013,159,197,-160,0,-38,-160,7.5940298507,9.4089552239,-7.641791045,0,-1.814925373,-7.641791045
19191,2014,173,181,-140,2,-8,-138,8.3311261467,8.716380535,-6.741951795,0.0963135971,-0.385254388,-6.645638198
19191,2015,176,187,51,2,-11,53,8.4972842486,9.0283645142,2.4622812311,0.0965600483,-0.531080266,2.5588412794
19191,2016,172,151,-345,2,21,-343,8.3614885394,7.3406091247,-16.77159038,0.0972266109,1.0208794147,-16.67436377
19191,2017,170,188,-194,2,-18,-192,8.3723220882,9.2588032504,-9.554296971,0.0984979069,-0.886481162,-9.455799064
27169,2010,121,69,-98,17,52,-81,NA,NA,NA,NA,NA,NA
27169,2011,424,388,-175,61,36,-114,8.2499100098,7.5494459524,-3.405033613,1.1868974307,0.7004640574,-2.218136182
27169,2012,471,394,-158,74,77,-84,9.1727039028,7.6731323518,-3.077042923,1.4411466854,1.499571551,-1.635896237
27169,2013,495,382,-187,67,113,-120,9.6416988868,7.4406645955,-3.642419579,1.3050380311,2.2010342913,-2.337381548
27169,2014,499,415,-449,73,84,-376,9.7469504156,8.1061812073,-8.770302077,1.4259065738,1.6407692082,-7.344395504
27169,2015,472,451,-332,78,21,-254,9.2661667125,8.8539008206,-6.517727433,1.5312733127,0.4122658919,-4.986454121
27169,2016,479,422,-86,78,57,-8,9.4204181171,8.299408028,-1.691348555,1.5340138061,1.1210100891,-0.157334749
27169,2017,479,433,-122,78,46,-44,9.415696103,8.5114747653,-2.398152243,1.5332448769,0.9042213377,-0.864907366
01133,2010,59,61,-76,0,-2,-76,NA,NA,NA,NA,NA,NA
01133,2011,251,315,17,-4,-64,13,10.294901768,12.919896641,0.6972642632,-0.16406218,-2.624994873,0.5332020836
01133,2012,229,298,-94,-2,-69,-96,9.4355170993,12.278533169,-3.873094355,-0.082406263,-2.843016069,-3.955500618
01133,2013,250,319,68,0,-69,68,10.337199446,13.190266493,2.8117182493,0,-2.853067047,2.8117182493
01133,2014,247,300,4,1,-53,5,10.225202848,12.419274714,0.1655903295,0.0413975824,-2.194071866,0.2069879119
01133,2015,235,285,-162,1,-50,-161,9.7820883718,11.86338377,-6.74339709,0.041625908,-2.081295398,-6.701771182
01133,2016,243,325,50,1,-82,51,10.166300596,13.59690409,2.0918313984,0.041836628,-3.430603493,2.1336680264
01133,2017,231,321,-74,1,-90,-73,9.704047554,13.484845302,-3.108655926,0.0420088639,-3.780797748,-3.066647063
28159,2010,46,27,-17,0,19,-17,NA,NA,NA,NA,NA,NA
28159,2011,218,229,-146,-3,-11,-149,11.40167364,11.976987448,-7.635983264,-0.156903766,-0.575313808,-7.792887029
28159,2012,202,222,-41,-2,-20,-43,10.627943072,11.680214663,-2.157156762,-0.105227159,-1.052271591,-2.262383921
28159,2013,190,237,-167,-4,-47,-171,10.071561092,12.562947257,-8.852372118,-0.212032865,-2.491386165,-9.064404983
28159,2014,195,256,-92,-2,-61,-94,10.439531024,13.705230473,-4.925317201,-0.107072113,-3.265699449,-5.032389314
28159,2015,189,194,-148,-1,-5,-149,10.202979918,10.472900022,-7.989635068,-0.053984021,-0.269920104,-8.043619089
28159,2016,209,221,-73,-1,-12,-74,11.356535442,12.008585323,-3.966636781,-0.05433749,-0.652049882,-4.020974271
28159,2017,192,219,-84,-1,-27,-85,10.490083593,11.965251598,-4.589411572,-0.054635852,-1.475168005,-4.644047424
54105,2010,24,23,11,1,1,12,NA,NA,NA,NA,NA,NA
54105,2011,58,60,23,5,-2,28,10.101010101,10.449320794,4.0055729711,0.8707767328,-0.348310693,4.8763497039
54105,2012,56,62,27,-1,-6,26,9.7146326655,10.755486165,4.6838407494,-0.173475583,-1.0408535,4.5103651661
54105,2013,60,50,55,0,10,55,10.333247223,8.6110393524,9.4721432877,0,1.7222078705,9.4721432877
54105,2014,58,66,-40,0,-8,-40,9.9742046432,11.349957008,-6.878761823,0,-1.375752365,-6.878761823
54105,2015,58,74,31,0,-16,31,10.003449465,12.763021732,5.346671266,0,-2.759572266,5.346671266
54105,2016,57,52,-41,0,5,-41,9.848812095,8.9848812095,-7.084233261,0,0.8639308855,-7.084233261
54105,2017,53,50,22,0,3,22,9.1663784158,8.6475268073,3.8049117952,0,0.5188516084,3.8049117952
48497,2010,193,128,-67,0,65,-67,NA,NA,NA,NA,NA,NA
48497,2011,781,447,493,16,334,509,13.119105012,7.508629885,8.2813300522,0.2687652755,5.6104751266,8.5500953277
48497,2012,724,517,237,11,207,248,12.031474603,8.5915364226,3.9384799462,0.1827986473,3.4399381808,4.1212785934
48497,2013,777,501,311,27,276,338,12.800026358,8.2532988485,5.1233052732,0.4447885607,4.5467275093,5.5680938339
48497,2014,776,507,403,40,269,443,12.646366207,8.26250988,6.5676360584,0.6518745467,4.3838563268,7.2195106052
48497,2015,820,551,822,52,269,874,13.164337489,8.8457926296,13.196445629,0.8348116456,4.3185448591,14.031257275
48497,2016,785,626,1394,48,159,1442,12.330262548,9.8327953569,21.896033111,0.7539523596,2.4974671913,22.649985471
48497,2017,820,616,1459,49,204,1508,12.553005833,9.4300629181,22.335165256,0.7501186412,3.1229429144,23.085283897
51195,2010,132,88,82,0,44,82,NA,NA,NA,NA,NA,NA
51195,2011,446,484,-81,-3,-38,-84,10.746987952,11.662650602,-1.951807229,-0.072289157,-0.915662651,-2.024096386
51195,2012,412,490,-466,-4,-78,-470,10.007529938,11.902159392,-11.31919648,-0.097160485,-1.894629454,-11.41635697
51195,2013,471,542,-179,7,-71,-172,11.550912301,13.292132627,-4.389837159,0.1716696096,-1.741220326,-4.21816755
51195,2014,435,507,-720,8,-72,-712,10.802488297,12.59048636,-17.87998063,0.1986664514,-1.787998063,-17.68131418
51195,2015,389,558,-181,9,-169,-172,9.7955278002,14.051168413,-4.557816277,0.2266317486,-4.255640612,-4.331184529
51195,2016,421,469,-467,9,-48,-458,10.71601293,11.937791127,-11.8868837,0.2290834118,-1.221778196,-11.65780029
51195,2017,388,468,-377,9,-80,-368,9.9974233445,12.058747745,-9.713991239,0.2318989951,-2.061324401,-9.482092244
21237,2010,26,14,-4,0,12,-4,NA,NA,NA,NA,NA,NA
21237,2011,109,93,-14,-1,16,-15,14.805759305,12.632436838,-1.901657158,-0.135832654,2.1733224667,-2.037489813
21237,2012,84,104,-152,0,-20,-152,11.540839459,14.288658377,-20.88342378,0,-2.747818919,-20.88342378
21237,2013,88,110,107,0,-22,107,12.158894646,15.198618307,14.784110535,0,-3.039723661,14.784110535
21237,2014,81,97,-12,0,-16,-12,11.147044657,13.348930021,-1.651414023,0,-2.201885364,-1.651414023
21237,2015,85,103,10,0,-18,10,11.727373068,14.210816777,1.3796909492,0,-2.483443709,1.3796909492
21237,2016,100,113,-17,0,-13,-17,13.832215228999999,15.630403209,-2.351476589,0,-1.79818798,-2.351476589
21237,2017,91,106,64,0,-15,64,12.569928862,14.641895159,8.8403895297,0,-2.071966296,8.8403895297
39173,2010,318,208,292,35,110,327,NA,NA,NA,NA,NA,NA
39173,2011,1299,1017,743,129,282,872,10.266745702,8.0379371666,5.8723572417,1.0195613515,2.2288085359,6.8919185932
39173,2012,1376,976,745,151,400,896,10.770784248,7.6397423152,5.8315655992,1.1819683295,3.1310419325,7.0135339288
39173,2013,1360,996,3,151,364,154,10.570701281,7.7414841731,0.0233177234,1.1736587451,2.8292171074,1.1969764685
39173,2014,1410,1063,-212,186,347,-26,10.924220003,8.2357772079,-1.642506837,1.4410673195,2.6884427951,-0.201439518
39173,2015,1386,1131,-504,202,255,-302,10.727014508,8.7534295875,-3.900732548,1.5633888388,1.9735849203,-2.337343709
39173,2016,1365,1127,74,210,238,284,10.545141316,8.7065012921,0.5716779908,1.6223294333,1.8386400244,2.1940074241
39173,2017,1368,1091,306,209,277,515,10.515150118,8.3859859491,2.3520730526,1.606481268,2.1291641685,3.9585543206
48499,2010,91,156,85,3,-65,88,NA,NA,NA,NA,NA,NA
48499,2011,428,561,293,-5,-133,288,10.17557624,13.337612781,6.9659902761,-0.118873554,-3.162036542,6.8471167219
48499,2012,396,601,504,-5,-205,499,9.3634729973,14.210725433,11.917147451,-0.118225669,-4.847252435,11.798921782
48499,2013,405,635,193,-5,-230,188,9.546820673,14.968471919,4.5494725676,-0.117861984,-5.421651246,4.431610584
48499,2014,418,608,603,-5,-190,598,9.8100188925,14.269118389,14.151773665,-0.117344724,-4.459099497,14.034428942
48499,2015,426,629,598,1,-203,599,9.9026011762,14.621446338,13.900834515,0.0232455427,-4.718845161,13.924080058
48499,2016,405,615,815,0,-210,815,9.3057454362,14.130946773,18.726376618,0,-4.825201337,18.726376618
48499,2017,418,630,698,2,-212,700,9.4852332165,14.295925661,15.838977955,0.045383891,-4.810692445,15.884361846
54107,2010,261,277,46,-4,-16,42,NA,NA,NA,NA,NA,NA
54107,2011,992,1049,-21,-17,-57,-38,11.412859025,12.068638223,-0.241602862,-0.19558327,-0.655779198,-0.437186132
54107,2012,888,989,-146,-11,-101,-157,10.238789793,11.403336831,-1.683404628,-0.126831856,-1.164547037,-1.810236484
54107,2013,988,1014,-32,-21,-26,-53,11.415696583,11.716109651,-0.369739161,-0.242641324,-0.300413068,-0.612380485
54107,2014,1042,1037,-19,-19,5,-38,12.049516343,11.991697166,-0.21971287,-0.21971287,0.0578191763,-0.43942574
54107,2015,987,1126,20,-18,-139,2,11.426586785,13.035802148,0.2315417788,-0.208387601,-1.609215363,0.0231541779
54107,2016,980,1061,-483,-19,-81,-502,11.393891479,12.335631489,-5.6155608,-0.220901978,-0.94174001,-5.836462778
54107,2017,938,1059,-472,-19,-121,-491,10.982191989,12.39887134,-5.526220276,-0.222453782,-1.41667935,-5.748674058
55141,2010,228,163,0,6,65,6,NA,NA,NA,NA,NA,NA
55141,2011,858,739,-305,24,119,-281,11.48125598,9.8888673299,-4.081332254,0.3211540134,1.5923886499,-3.76017824
55141,2012,824,752,-412,11,72,-401,11.062555799,10.09592471,-5.5312779,0.1476797497,0.9666310893,-5.38359815
55141,2013,860,778,-504,14,82,-490,11.60272799,10.496421368,-6.799738264,0.1888816184,1.1063066223,-6.610856646
55141,2014,767,685,-442,18,82,-424,10.40021153,9.2883245083,-5.993342237,0.2440727608,1.1118870214,-5.749269477
55141,2015,811,868,-222,19,-57,-203,11.041975847,11.818045666,-3.022587716,0.2586899397,-0.776069819,-2.763897777
55141,2016,837,796,-179,18,41,-161,11.425685268,10.86600415,-2.443485858,0.2457136617,0.5596811183,-2.197772196
55141,2017,825,760,-150,18,65,-132,11.276499774,10.388048277,-2.050272686,0.2460327224,0.8884514974,-1.804239964
19193,2010,430,237,-40,37,193,-3,NA,NA,NA,NA,NA,NA
19193,2011,1502,910,-474,151,592,-323,14.655374288,8.8790882835,-4.624931699,1.4733432207,5.7762860042,-3.151588479
19193,2012,1566,948,-1179,216,618,-963,15.284609979,9.252752401,-11.50737878,2.1082220661,6.0318575779,-9.399156711
19193,2013,1509,932,-836,158,577,-678,14.75902878,9.1155830501,-8.176638873,1.5453456244,5.6434457295,-6.631293249
19193,2014,1555,912,-828,185,643,-643,15.21563639,8.9238973556,-8.101959441,1.8102204066,6.2917390347,-6.291739035
19193,2015,1548,994,-513,219,554,-294,15.12789817,9.7139087733,-5.013315091,2.1401871442,5.4139893968,-2.873127947
19193,2016,1513,907,-582,228,606,-354,14.74932005,8.8417933146,-5.67356528,2.2226338211,5.907526735,-3.450931459
19193,2017,1501,879,-1130,228,622,-902,14.634193901,8.5699243429,-11.01708135,2.2229155292,6.0642695578,-8.794165822
17203,2010,110,63,-47,4,47,-43,NA,NA,NA,NA,NA,NA
17203,2011,444,318,47,6,126,53,11.455995046,8.2049694249,1.2126841603,0.1548107439,3.2510256212,1.3674949041
17203,2012,458,398,-79,13,60,-66,11.791967044,10.247167868,-2.033985582,0.3347064882,1.5447991761,-1.699279094
17203,2013,441,363,106,8,78,114,11.328170154,9.3245482218,2.7228708306,0.2054996853,2.003621932,2.9283705159
17203,2014,442,375,-32,13,67,-19,11.320271482,9.6043027276,-0.819567166,0.3329491612,1.715968754,-0.486618005
17203,2015,426,416,-126,14,10,-112,10.918877355,10.66256568,-3.229527105,0.358836345,0.256311675,-2.87069076
17203,2016,436,391,-89,14,45,-75,11.194413064,10.039026394,-2.285098079,0.3594536305,1.1553866694,-1.925644449
17203,2017,437,411,-249,14,26,-235,11.254329827,10.584735832,-6.412650176,0.3605506123,0.6695939943,-6.052099563
21239,2010,81,35,50,-1,46,49,NA,NA,NA,NA,NA,NA
21239,2011,296,220,-187,-2,76,-189,11.850665599,8.8079271344,-7.486738064,-0.080072065,3.0427384646,-7.566810129
21239,2012,261,211,86,21,50,107,10.441044104,8.4408440844,3.4403440344,0.8400840084,2.00020002,4.2804280428
21239,2013,273,225,163,1,48,164,10.842153339,8.935840664,6.4735201255,0.0397148474,1.906312675,6.5132349729
21239,2014,276,224,196,5,52,201,10.861651679,8.8152535369,7.7133468448,0.1967690522,2.0463981425,7.910115897
21239,2015,273,253,240,11,20,251,10.63456819,9.8554789451,9.3490709361,0.4284990846,0.7790892447,9.7775700206
21239,2016,326,224,175,9,102,184,12.563346629,8.6324835732,6.7441277916,0.3468408579,3.9308630557,7.0909686494
21239,2017,305,229,193,9,76,202,11.628128634,8.7306277283,7.3581272994,0.3431251072,2.8975009055,7.7012524066
05147,2010,16,24,-7,0,-8,-7,NA,NA,NA,NA,NA,NA
05147,2011,81,106,-47,0,-25,-47,11.2305026,14.696707106,-6.516464471,0,-3.466204506,-6.516464471
05147,2012,88,99,-102,0,-11,-102,12.357814914,13.902541778,-14.32383092,0,-1.544726864,-14.32383092
05147,2013,83,96,-21,0,-13,-21,11.775555083,13.619919132,-2.97935731,0,-1.844364049,-2.97935731
05147,2014,77,100,-140,0,-23,-140,11.0775428,14.38641922,-20.14098691,0,-3.308876421,-20.14098691
05147,2015,53,108,-98,0,-55,-98,7.8004268158,15.895209361,-14.42343072,0,-8.094782545,-14.42343072
05147,2016,64,87,-73,0,-23,-73,9.5944831722,13.042500562,-10.94370737,0,-3.44801739,-10.94370737
05147,2017,57,99,-10,0,-42,-10,8.6402910414,15.006821282,-1.515840534,0,-6.366530241,-1.515840534
40151,2010,24,16,16,0,8,16,NA,NA,NA,NA,NA,NA
40151,2011,103,96,-135,-1,7,-136,11.652242774,10.86034278,-15.27235703,-0.113128571,0.7918999943,-15.3854856
40151,2012,101,103,54,4,-2,58,11.470103912,11.697234683,6.1325308046,0.4542615411,-0.227130771,6.5867923457
40151,2013,100,107,143,6,-7,149,11.226494527,12.012349144,16.053887174,0.6735896716,-0.785854617,16.727476845
40151,2014,107,106,235,11,1,246,11.75049418,11.640676477,25.807160114,1.2079947288,0.1098177026,27.015154843
40151,2015,130,98,10,11,32,21,14.043426596,10.586583126,1.0802635843,1.1882899427,3.4568434698,2.2685535271
40151,2016,102,89,-173,10,13,-163,11.076722593,9.6649834392,-18.78699028,1.0859531954,1.411739154,-17.70103709
40151,2017,101,105,-108,10,-4,-98,11.120286265,11.560693642,-11.89099917,1.1010184421,-0.440407377,-10.78998073
20207,2010,13,13,0,0,0,0,NA,NA,NA,NA,NA,NA
20207,2011,32,45,27,0,-13,27,9.651636254,13.572613482,8.1435680893,0,-3.920977228,8.1435680893
20207,2012,39,49,-38,0,-10,-38,11.823556162,14.855237229,-11.52038806,0,-3.031681067,-11.52038806
20207,2013,25,66,-19,0,-41,-19,7.7029733477,20.335849638,-5.854259744,0,-12.63287629,-5.854259744
20207,2014,33,44,-17,0,-11,-17,10.306058713,13.741411618,-5.309181761,0,-3.435352904,-5.309181761
20207,2015,30,54,-19,0,-24,-19,9.4741828517,17.053529133,-6.000315806,0,-7.579346281,-6.000315806
20207,2016,32,39,58,0,-7,58,10.094637224,12.302839117,18.296529968,0,-2.208201893,18.296529968
20207,2017,33,43,-38,0,-10,-38,10.406811731,13.560391044,-11.98360139,0,-3.153579313,-11.98360139
40153,2010,65,25,-139,3,40,-136,NA,NA,NA,NA,NA,NA
40153,2011,296,188,-4,3,108,-1,14.765301541,9.3779617898,-0.199531102,0.1496483264,5.3873397516,-0.049882775
40153,2012,317,186,409,8,131,417,15.556373451,9.1277143909,20.071156913,0.3925898663,6.4286590602,20.46374678
40153,2013,343,183,384,16,160,400,16.380133715,8.7392550143,18.338108883,0.7640878701,7.6408787011,19.102196753
40153,2014,310,177,132,31,133,163,14.505638482,8.2822516494,6.1765944504,1.4505638482,6.2233868326,7.6271582986
40153,2015,315,187,-109,37,128,-72,14.619543777,8.6789037663,-5.058826259,1.7172162532,5.9406400111,-3.341610006
40153,2016,306,208,-789,41,98,-748,14.400338832,9.788465611,-37.13028542,1.9294571637,4.6118732205,-35.20082825
40153,2017,281,255,-533,41,26,-492,13.580455743,12.323901119,-25.75936979,1.9814899838,1.2565546239,-23.77787981
24047,2010,114,122,48,11,-8,59,NA,NA,NA,NA,NA,NA
24047,2011,439,603,124,55,-164,179,8.5244373677,11.708965223,2.407813744,1.0679819026,-3.184527855,3.4757956465
24047,2012,463,590,183,23,-127,206,8.9829653486,11.446975282,3.5505025028,0.4462380195,-2.464009934,3.9967405223
24047,2013,424,598,113,44,-174,157,8.2223127194,11.596563694,2.1913239087,0.8532588671,-3.374250974,3.0445827758
24047,2014,438,584,137,39,-146,176,8.4936394663,11.324852622,2.6566863171,0.7562829662,-2.831213155,3.4129692833
24047,2015,438,659,56,45,-221,101,8.5018828371,12.791645638,1.0869987189,0.8734811134,-4.289762801,1.9604798323
24047,2016,454,640,203,46,-186,249,8.8181879983000009,12.430925813,3.9429342812,0.8934727928,-3.612737814,4.836407074
24047,2017,422,660,370,47,-238,417,8.1779775978,12.79020193,7.1702647184,0.9108174102,-4.612224332,8.0810821286
25027,2010,2264,1482,488,676,782,1164,NA,NA,NA,NA,NA,NA
25027,2011,8804,6602,-1680,3236,2202,1556,10.975681212,8.2305142388,-2.09440532,4.0342235803,2.7451669727,1.9398182605
25027,2012,8718,6497,-2771,3374,2221,603,10.82477779,8.0670545194,-3.440635381,4.1893553868,2.7577232704,0.7487200054
25027,2013,8582,6776,-1115,3466,1806,2351,10.610689571,8.3777712112,-1.378573628,4.2853239401,2.23291836,2.9067503125
25027,2014,8711,6725,-1289,3838,1986,2549,10.713905754,8.2712680746,-1.585377628,4.7204649621,2.4426376797,3.1350873341
25027,2015,8451,7210,-2186,4080,1241,1894,10.346467712,8.827124861,-2.676296109,4.9950997826,1.5193428505,2.3188036736
25027,2016,8735,7059,-3524,4183,1676,659,10.658808312,8.6136837867,-4.300130566,5.1042696245,2.0451245256,0.8041390587
25027,2017,8610,6971,-341,4169,1639,3828,10.456662236,8.4661315268,-0.414137262,5.0631620048,1.990530709,4.6490247432
13321,2010,57,65,31,0,-8,31,NA,NA,NA,NA,NA,NA
13321,2011,240,203,-205,-9,37,-214,11.10391413,9.3920607014,-9.484593319,-0.41639678,1.7118534283,-9.900990099
13321,2012,246,217,-187,-5,29,-192,11.471205409,10.118908837,-8.719981348,-0.233154581,1.3522965726,-8.953135929
13321,2013,271,206,-368,1,65,-367,12.772475551,9.7089666549,-17.34417344,0.0471309061,3.063508896,-17.29704254
13321,2014,275,234,-86,-1,41,-87,13.066615984,11.118502328,-4.08628718,-0.047514967,1.9481136558,-4.133802148
13321,2015,243,221,-346,-1,22,-347,11.648251564,10.593677348,-16.5855763,-0.047935192,1.0545742157,-16.63351149
13321,2016,251,207,-24,-1,44,-25,12.119748914,9.9951714148,-1.158860454,-0.048285852,2.1245774988,-1.207146306
13321,2017,211,217,-178,-1,-6,-179,10.22980704,10.520702027,-8.629884612,-0.048482498,-0.290894987,-8.678367109
19195,2010,18,16,-10,0,2,-10,NA,NA,NA,NA,NA,NA
19195,2011,73,83,-12,0,-10,-12,9.633148588,10.952757984,-1.583531275,0,-1.319609396,-1.583531275
19195,2012,82,93,-56,1,-11,-55,10.88471494,12.344859627,-7.433463861,0.1327404261,-1.460144687,-7.300723435
19195,2013,71,91,11,1,-20,12,9.4691917845,12.136569752,1.4670578821,0.1333688984,-2.667377967,1.6004267805
19195,2014,81,83,69,0,-2,69,10.759115362,11.024772531,9.1651723451,0,-0.265657169,9.1651723451
19195,2015,71,84,-41,0,-13,-41,9.4233193974,11.148715907,-5.441635145,0,-1.725396509,-5.441635145
19195,2016,87,96,-22,0,-9,-22,11.613936724,12.815378454,-2.936857562,0,-1.20144173,-2.936857562
19195,2017,82,75,-12,0,7,-12,10.974304069,10.037473233,-1.605995717,0,0.9368308351,-1.605995717
29227,2010,5,10,-14,0,-5,-14,NA,NA,NA,NA,NA,NA
29227,2011,21,42,-14,0,-21,-14,9.8268600842,19.653720168,-6.551240056,0,-9.826860084,-6.551240056
29227,2012,28,25,-41,0,3,-41,13.330159486,11.901928112,-19.5191621,0,1.4282313735,-19.5191621
29227,2013,25,30,4,0,-5,4,12.01345507,14.416146084,1.9221528111,0,-2.402691014,1.9221528111
29227,2014,20,28,-16,0,-8,-16,9.6688421562,13.536379019,-7.735073725,0,-3.867536862,-7.735073725
29227,2015,27,33,-6,0,-6,-6,13.170731707,16.097560976,-2.926829268,0,-2.926829268,-2.926829268
29227,2016,16,22,-10,0,-6,-10,7.858546169,10.805500982,-4.911591356,0,-2.946954813,-4.911591356
29227,2017,21,25,33,0,-4,33,10.281517748,12.239902081,16.156670747,0,-1.958384333,16.156670747
02275,2010,6,2,2,0,4,2,NA,NA,NA,NA,NA,NA
02275,2011,27,13,10,0,14,10,11.332633788,5.4564533054,4.1972717733,0,5.8761804827,4.1972717733
02275,2012,23,18,20,5,5,25,9.5475300955,7.4719800747,8.302200083,2.0755500208,2.0755500208,10.377750104
02275,2013,25,20,18,5,5,23,10.256410256,8.2051282051,7.3846153846,2.0512820513,2.0512820513,9.4358974359
02275,2014,28,11,-28,6,17,-22,11.4355728,4.492546457,-11.4355728,2.4504798856,6.9430263427,-8.985092914
02275,2015,23,32,13,6,-9,19,9.3839249286,13.055895553,5.3039575683,2.4479804162,-3.671970624,7.7519379845
02275,2016,20,11,29,7,9,36,8.0677692618,4.437273094,11.69826543,2.8237192416,3.6304961678,14.521984671
02275,2017,20,24,18,7,-4,25,7.9633685049,9.5560422059,7.1670316544,2.7871789767,-1.592673701,9.9542106311
19197,2010,44,62,-33,1,-18,-32,NA,NA,NA,NA,NA,NA
19197,2011,140,167,-137,12,-27,-125,10.683353047,12.743713991,-10.45442405,0.9157159754,-2.0603609450000002,-9.538708077
19197,2012,155,146,-25,9,9,-16,11.899735135,11.208782772,-1.919312119,0.6909523627,0.6909523627,-1.228359756
19197,2013,127,152,-19,5,-25,-14,9.768855044,11.691858005,-1.461482251,0.3846005923,-1.923002961,-1.076881658
19197,2014,156,164,-86,15,-8,-71,12.054709837,12.672900085,-6.645545167,1.1591067151,-0.618190248,-5.486438451
19197,2015,157,162,-76,19,-5,-57,12.197964416,12.58643462,-5.904747106,1.4761867765,-0.388470204,-4.428560329
19197,2016,160,165,-37,19,-5,-18,12.472715934,12.862488307,-2.88431556,1.4811350171,-0.389772373,-1.403180543
19197,2017,170,154,-68,19,16,-49,13.28125,12.03125,-5.3125,1.484375,1.25,-3.828125
27171,2010,501,184,77,10,317,87,NA,NA,NA,NA,NA,NA
27171,2011,1880,704,-103,65,1176,-38,14.961005889,5.6024192265,-0.819672131,0.5172688206,9.3585866624,-0.302403311
27171,2012,1830,637,-218,70,1193,-148,14.438838107,5.0259780735,-1.720036452,0.5523052828,9.412860034,-1.167731169
27171,2013,1831,705,-227,60,1126,-167,14.334644668,5.519347073,-1.777151469,0.4697316658,8.8152975946,-1.307419803
27171,2014,1772,739,512,69,1033,581,13.735901709,5.7284601372,3.9688384171,0.5348629898,8.007441572,4.5037014069
27171,2015,1753,743,98,76,1010,174,13.444798098,5.698508264,0.7516202017,0.582889136,7.746289834,1.3345093377
27171,2016,1798,778,320,81,1020,401,13.654572725,5.9083746274,2.4301797953,0.6151392607,7.7461980976,3.045319056
27171,2017,1735,815,903,82,920,985,13.01219096,6.1123548316,6.7723391569,0.6149853941,6.8998361289,7.387324551
29229,2010,54,54,32,3,0,35,NA,NA,NA,NA,NA,NA
29229,2011,228,233,-205,-1,-5,-206,12.161945911,12.428655252,-10.93508295,-0.053341868,-0.26670934,-10.98842481
29229,2012,249,216,-42,-3,33,-45,13.361236317,11.590470058,-2.253702511,-0.160978751,1.7707662589,-2.414681262
29229,2013,237,223,-238,0,14,-238,12.798012798,12.042012042,-12.85201285,0,0.756000756,-12.85201285
29229,2014,237,225,-143,-1,12,-144,12.920812321,12.266593976,-7.796101949,-0.054518195,0.6542183454,-7.850620144
29229,2015,255,233,-68,-1,22,-69,13.970688947,12.765374606,-3.725517052,-0.054787015,1.2053143405,-3.780304068
29229,2016,243,216,21,-1,27,20,13.313974194,11.834643728,1.1505903624,-0.054790017,1.479330466,1.0958003452
29229,2017,242,230,47,-1,12,46,13.221876195,12.566245971,2.5678850462,-0.054635852,0.6556302246,2.5132491941
39175,2010,66,72,-23,0,-6,-23,NA,NA,NA,NA,NA,NA
39175,2011,240,210,24,-1,30,23,10.614772225,9.2879256966,1.0614772225,-0.044228218,1.3268465281,1.0172490049
39175,2012,265,223,-134,-6,42,-140,11.732672171,9.8731543178,-5.932747438,-0.265645408,1.8595178536,-6.198392845
39175,2013,302,244,-141,-1,58,-142,13.424608819,10.846372688,-6.267780939,-0.044452347,2.5782361309,-6.312233286
39175,2014,239,247,-183,4,-8,-179,10.688251867,11.04601762,-8.183891597,0.1788828764,-0.357765753,-8.005008721
39175,2015,251,267,-101,5,-16,-96,11.300198091,12.020529444,-4.547091662,0.2251035476,-0.720331352,-4.321988115
39175,2016,246,247,-117,5,-1,-112,11.131725417,11.176976334,-5.294357211,0.2262545817,-0.045250916,-5.068102629
39175,2017,240,246,-10,5,-6,-5,10.891515963,11.163803862,-0.453813165,0.2269065826,-0.272287899,-0.226906583
20209,2010,627,359,-196,69,268,-127,NA,NA,NA,NA,NA,NA
20209,2011,2764,1332,-1520,452,1432,-1068,17.512347028,8.4393799717,-9.630523691,2.863813624,9.0729670566,-6.766710067
20209,2012,2731,1343,-500,584,1388,84,17.203528897,8.46002904,-3.149675741,3.6788212654,8.7434998567,0.5291455245
20209,2013,2800,1358,-537,579,1442,42,17.477552269,8.4766128504,-3.351944846,3.6141081299,9.0009394184,0.262163284
20209,2014,2680,1385,-714,609,1295,-105,16.592064288,8.5746302384,-4.420423098,3.7703608774,8.0174340496,-0.65006222
20209,2015,2723,1367,-760,702,1356,-58,16.731696826,8.3996436142,-4.669882331,4.3134965744,8.3320532121,-0.356385757
20209,2016,2807,1408,-1099,736,1399,-363,17.126192031,8.5905516135,-6.705267204,4.4905156161,8.5356404171,-2.214751588
20209,2017,2716,1392,-1191,739,1324,-452,16.475284041,8.4438863715,-7.224618296,4.4827816297,8.0313976694,-2.741836667
36121,2010,91,72,-50,4,19,-46,NA,NA,NA,NA,NA,NA
36121,2011,415,382,-335,18,33,-317,9.8824818127,9.0966459095,-7.977425078,0.4286377654,0.7858359032,-7.548787312
36121,2012,380,357,-182,17,23,-165,9.0943901972,8.5439402642,-4.355734252,0.4068542983,0.550449933,-3.948879954
36121,2013,377,396,-331,12,-19,-319,9.0740607023,9.5313741064,-7.966880882,0.2888295184,-0.457313404,-7.678051364
36121,2014,396,361,-268,11,35,-257,9.5953477102,8.7472740489,-6.493821178,0.2665374364,0.8480736613,-6.227283741
36121,2015,383,382,-217,13,1,-204,9.3281537319,9.3037982391,-5.285141932,0.316621406,0.0243554928,-4.968520526
36121,2016,352,353,-533,16,-1,-517,8.6490736646,8.6736448966,-13.09646666,0.393139712,-0.024571232,-12.70332694
36121,2017,353,332,18,16,21,34,8.723372708,8.2044185242,0.4448178718,0.3953936638,0.5189541838,0.8402115356
42131,2010,81,92,-28,0,-11,-28,NA,NA,NA,NA,NA,NA
42131,2011,301,271,24,18,30,42,10.649966387,9.5885079432,0.8491667551,0.6368750663,1.0614584439,1.4860418215
42131,2012,294,288,53,12,6,65,10.377325191,10.165543045,1.8707422964,0.4235642935,0.2117821468,2.29430659
42131,2013,274,309,-240,9,-35,-231,9.7049551943,10.944639252,-8.500690681,0.3187759005,-1.239684058,-8.181914781
42131,2014,282,280,9,10,2,19,10.032195521,9.9610451982,0.3201764528,0.3557516142,0.0711503228,0.675928067
42131,2015,280,311,-339,11,-31,-328,10.021653931,11.131194187,-12.13335958,0.393707833,-1.109540257,-11.73965175
42131,2016,248,312,-211,12,-64,-199,8.9759134259,11.292278181,-7.636765052,0.4343183916,-2.316364755,-7.20244666
42131,2017,248,315,-121,12,-67,-109,9.0477927764,11.492156147,-4.414447282,0.4377964247,-2.444363371,-3.976650857
54109,2010,54,100,-28,0,-46,-28,NA,NA,NA,NA,NA,NA
54109,2011,271,352,-192,-1,-81,-193,11.487675123,14.921260677,-8.13886946,-0.042389945,-3.433585554,-8.181259405
54109,2012,243,332,-161,0,-89,-161,10.415327247,14.229994428,-6.900690069,0,-3.814667181,-6.900690069
54109,2013,230,332,-165,0,-102,-165,9.9685773107,14.38942464,-7.151370679,0,-4.420847329,-7.151370679
54109,2014,219,324,-263,0,-105,-263,9.6234125764,14.23737751,-11.5568836,0,-4.613964934,-11.5568836
54109,2015,218,322,-302,0,-104,-302,9.7432344857,14.391383048,-13.49750832,0,-4.648148562,-13.49750832
54109,2016,209,365,-265,0,-156,-265,9.5160041889,16.61885899,-12.06574694,0,-7.102854801,-12.06574694
54109,2017,198,347,-394,0,-149,-394,9.2172334334,16.15343435,-18.3413635,0,-6.936200917,-18.3413635
51197,2010,63,50,-2,0,13,-2,NA,NA,NA,NA,NA,NA
51197,2011,255,333,26,2,-78,28,8.7285423334,11.3984494,0.8899690222,0.0684591556,-2.669907067,0.9584281778
51197,2012,309,342,164,2,-33,166,10.563199727,11.691308435,5.6063584309,0.0683702248,-1.128108709,5.6747286557
51197,2013,267,372,62,1,-105,63,9.1143388691,12.698629436,2.1164382393,0.0341361006,-3.584290566,2.1505743399
51197,2014,265,380,-110,3,-115,-107,9.0882589982,13.03222045,-3.772484867,0.1028859509,-3.943961452,-3.669598916
51197,2015,318,402,139,3,-84,142,10.937983696,13.827262408,4.7810683452,0.1031885254,-2.889278712,4.8842568706
51197,2016,284,397,-48,3,-113,-45,9.7858484227,13.679513464,-1.653946212,0.1033716383,-3.893665041,-1.550574574
51197,2017,278,364,26,3,-86,29,9.6153846154,12.589928058,0.8992805755,0.1037631433,-2.974543442,1.0030437189
37197,2010,132,91,-8,-2,41,-10,NA,NA,NA,NA,NA,NA
37197,2011,391,390,-79,-3,1,-82,10.183750277,10.15770488,-2.057586373,-0.078136191,0.0260453971,-2.135722564
37197,2012,388,370,-204,0,18,-204,10.141404637,9.6709271021,-5.332078727,0,0.4704775347,-5.332078727
37197,2013,404,397,-107,17,7,-90,10.597555217,10.413934211,-2.806778238,0.4459367294,0.1836210062,-2.360841509
37197,2014,412,445,-180,27,-33,-153,10.846672283,11.715459141,-4.738837405,0.7108256108,-0.868786858,-4.028011794
37197,2015,356,438,-177,30,-82,-147,9.424471859,11.595277175,-4.685762694,0.7941970668,-2.170805316,-3.891565627
37197,2016,371,432,97,32,-61,129,9.8428069245,11.461166014,2.5734562579,0.8489752603,-1.61835909,3.4224315182
37197,2017,392,407,35,32,-15,67,10.38410596,10.781456954,0.9271523179,0.8476821192,-0.397350993,1.7748344371
53077,2010,1185,423,332,-30,762,302,NA,NA,NA,NA,NA,NA
53077,2011,4334,1846,-736,21,2488,-715,17.677782242,7.5295768386,-3.00204147,0.0856560745,10.148205403,-2.916385395
53077,2012,4111,1816,-1866,-66,2295,-1932,16.695162017,7.3749487287,-7.578003484,-0.268032278,9.3202132887,-7.846035762
53077,2013,4017,1849,-1793,-5,2168,-1798,16.288315759,7.4974099672,-7.2703386,-0.020274229,8.7909057917,-7.290612829
53077,2014,4064,1873,-1967,17,2191,-1950,16.457672317,7.5849459274,-7.965610592,0.0688436096,8.8727263892,-7.896766983
53077,2015,4069,1916,-1313,112,2153,-1201,16.438079464,7.7403195508,-5.304300402,0.4524612681,8.6977599127,-4.851839134
53077,2016,3959,2061,-696,119,1898,-577,15.92105025,8.2882759702,-2.798952002,0.4785564485,7.6327742802,-2.320395553
53077,2017,3942,2027,-1172,127,1915,-1045,15.783278212999999,8.1158561488,-4.692542381,0.5084922205,7.6674220646,-4.184050161
02282,2010,2,0,-4,1,2,-3,NA,NA,NA,NA,NA,NA
02282,2011,8,5,-15,5,3,-10,12.139605463,7.5872534143,-22.76176024,7.5872534143,4.5523520486,-15.17450683
02282,2012,8,2,-2,4,6,2,12.121212121,3.0303030303,-3.03030303,6.0606060606,9.0909090909,3.0303030303
02282,2013,9,3,-21,1,6,-20,13.688212928,4.5627376426,-31.9391635,1.5209125475,9.1254752852,-30.41825095
02282,2014,7,2,-3,1,5,-2,10.719754977,3.0627871363,-4.594180704,1.5313935681,7.6569678407,-3.062787136
02282,2015,9,4,-26,1,5,-25,13.953488372,6.2015503876,-40.31007752,1.5503875969,7.7519379845,-38.75968992
02282,2016,7,2,-30,1,5,-29,11.226944667,3.2076984763,-48.11547715,1.6038492382,8.0192461909,-46.51162791
02282,2017,8,2,-13,1,6,-12,13.147082991,3.2867707477,-21.36400986,1.6433853739,9.8603122432,-19.72062449
28161,2010,31,55,-29,0,-24,-29,NA,NA,NA,NA,NA,NA
28161,2011,175,176,-110,0,-1,-110,13.920929123,14.000477289,-8.750298306,0,-0.079548166,-8.750298306
28161,2012,140,157,-109,0,-17,-109,11.241819569,12.606897659,-8.752559521,0,-1.36507809,-8.752559521
28161,2013,147,168,10,0,-21,10,11.869675804,13.565343776,0.8074609391,0,-1.695667972,0.8074609391
28161,2014,147,166,-51,0,-19,-51,11.910549344,13.450008102,-4.132231405,0,-1.539458759,-4.132231405
28161,2015,172,186,168,0,-14,168,13.888888889,15.019379845,13.565891473,0,-1.130490956,13.565891473
28161,2016,166,148,10,0,18,10,13.306079917,11.863251974,0.8015710793,0,1.4428279428,0.8015710793
28161,2017,157,170,20,0,-13,20,12.567037541,13.607620267,1.600896502,0,-1.040582726,1.600896502
41071,2010,260,215,36,14,45,50,NA,NA,NA,NA,NA,NA
41071,2011,1177,862,-31,25,315,-6,11.838009364,8.6698080472,-0.311791241,0.2514445489,3.1682013166,-0.060346692
41071,2012,1119,829,-69,21,290,-48,11.224121329,8.3152784465,-0.692103996,0.2106403467,2.9088428824,-0.481463649
41071,2013,1077,817,-294,53,260,-241,10.789096701,8.1844865412,-2.945213027,0.5309397634,2.60461016,-2.414273264
41071,2014,1128,836,563,66,292,629,11.247719046,8.3360754634,5.613888141,0.6581112208,2.9116435829,6.2719993618
41071,2015,1091,954,455,90,137,545,10.793377556,9.4380221704,4.5013627752,0.89037945,1.3553553851,5.3917422253
41071,2016,1169,929,2359,97,240,2456,11.375246918,9.0398668833,22.954839589,0.9438827639,2.3353800344,23.898722353
41071,2017,1185,891,1209,98,294,1307,11.294373305,8.4922249915,11.523120106,0.9340494379,2.8021483137,12.457169544
37199,2010,44,38,-18,1,6,-17,NA,NA,NA,NA,NA,NA
37199,2011,154,222,-43,1,-68,-42,8.6767895879,12.508099276,-2.42273995,0.0563427895,-3.831309688,-2.36639716
37199,2012,185,237,-18,3,-52,-15,10.477134362,13.422058615,-1.019396857,0.1698994761,-2.944924253,-0.849497381
37199,2013,168,232,-6,0,-64,-6,9.552238806,13.191186923,-0.341151386,0,-3.638948117,-0.341151386
37199,2014,163,217,50,1,-54,51,9.2882785344,12.365376945,2.8491651946,0.0569833039,-3.07709841,2.9061484985
37199,2015,189,223,46,2,-34,48,10.767696909,12.704742914,2.6207093007,0.1139438826,-1.937046005,2.7346531833
37199,2016,158,214,118,2,-56,120,8.9821210312,12.165657599,6.7081663398,0.1136977346,-3.183536568,6.8218640744
37199,2017,170,199,150,2,-29,152,9.6137533224,11.253746536,8.4827235198,0.1131029803,-1.639993214,8.5958265
46135,2010,55,67,11,2,-12,13,NA,NA,NA,NA,NA,NA
46135,2011,260,221,37,-13,39,24,11.572271058,9.8364303995,1.6468231891,-0.578613553,1.7358406587,1.0682096361
46135,2012,249,205,44,-4,44,40,11.047272566,9.0951440804,1.9521284855,-0.177466226,1.9521284855,1.7746622596
46135,2013,273,201,-3,2,72,-1,12.071900772,8.8881027659,-0.13265825,0.0884388335,3.1837980057,-0.044219417
46135,2014,279,203,-42,4,76,-38,12.309185564,8.956145769,-1.852995676,0.1764757787,3.3530397953,-1.676519898
46135,2015,269,241,-31,4,28,-27,11.859362945,10.624931114,-1.366692384,0.1763474044,1.2344318307,-1.19034498
46135,2016,284,259,-84,4,25,-80,12.53641741,11.432859539,-3.707954445,0.1765692593,1.1035578706,-3.531385186
46135,2017,291,207,-51,4,84,-47,12.85108638,9.1414944356,-2.252252252,0.1766472355,3.7095919449,-2.075605017
36123,2010,75,38,-27,2,37,-25,NA,NA,NA,NA,NA,NA
36123,2011,313,241,0,9,72,9,12.316773242,9.4835218888,0,0.3541564191,2.8332513527,0.3541564191
36123,2012,309,255,-180,11,54,-169,12.167989132,10.041544429,-7.088149009,0.4331646616,2.1264447026,-6.654984347
36123,2013,325,268,-186,14,57,-172,12.855504134,10.600846486,-7.357303904,0.5537755627,2.254657648,-6.803528341
36123,2014,297,231,-156,15,66,-141,11.791797356,9.1713979434,-6.193671338,0.595545321,2.6203994124,-5.598126017
36123,2015,287,286,-100,17,1,-83,11.430847356,11.39101862,-3.982873643,0.6770885194,0.0398287364,-3.305785124
36123,2016,328,245,-145,18,83,-127,13.097210853,9.7829776189,-5.78992553,0.7187493761,3.3142332342,-5.071176153
36123,2017,326,258,-153,18,68,-135,13.046001161,10.324749385,-6.122816496,0.7203313524,2.7212517758,-5.402485143
04025,2010,462,641,140,21,-179,161,NA,NA,NA,NA,NA,NA
04025,2011,1842,2613,606,88,-771,694,8.7329205503,12.388230944,2.8730455231,0.4172079307,-3.655310393,3.2902534538
04025,2012,1733,2602,1747,33,-869,1780,8.1998239853,12.311564922,8.2660660717,0.1561420609,-4.111740937,8.4222081326
04025,2013,1860,2724,3207,-6,-864,3201,8.7322508785,12.788522254,15.056090628,-0.028168551,-4.056271376,15.027922076
04025,2014,1878,2833,4133,25,-955,4158,8.7003453731,13.124642408,19.147245701,0.1158192941,-4.424297035,19.263064995
04025,2015,1975,2852,3889,49,-877,3938,9.0155889804,13.018966973,17.752721795,0.2236779038,-4.003377993,17.976399699
04025,2016,1861,2980,4801,57,-1119,4858,8.3643456843,13.39374,21.578303939,0.2561889866,-5.029394315,21.834492926
04025,2017,1887,2895,4735,57,-1008,4792,8.339760149,12.794703566999999,20.92674314,0.2519164433,-4.454943418,21.178659584
28163,2010,86,35,11,1,51,12,NA,NA,NA,NA,NA,NA
28163,2011,405,251,-28,11,154,-17,14.362975441,8.9014983598,-0.992995833,0.3901055058,5.4614770813,-0.602890327
28163,2012,382,264,-65,20,118,-45,13.498233216,9.3286219081,-2.296819788,0.7067137809,4.1696113074,-1.590106007
28163,2013,369,318,-410,10,51,-400,13.101366945,11.290608912,-14.55707438,0.3550505947,1.810758033,-14.20202379
28163,2014,343,317,-225,13,26,-212,12.292805304,11.360989159,-8.063793567,0.4659080728,0.9318161455,-7.597885494
28163,2015,339,307,-454,16,32,-438,12.277715403,11.118757017,-16.4427221,0.5794791931,1.1589583862,-15.86324291
28163,2016,306,321,-210,19,-15,-191,11.205302378,11.754581907,-7.689913397,0.6957540692,-0.549279528,-6.994159328
28163,2017,296,268,-197,19,28,-178,10.90982806,9.8778172972,-7.260932864,0.7002930173,1.0320107624,-6.560639847
05149,2010,79,86,-43,6,-7,-37,NA,NA,NA,NA,NA,NA
05149,2011,317,215,-352,27,102,-325,14.387509645,9.7580901375,-15.97603595,1.2254345754,4.6294195071,-14.75060137
05149,2012,280,270,-153,12,10,-141,12.810248199,12.352739334,-6.999885623,0.5490106371,0.4575088642,-6.450874986
05149,2013,297,265,-58,16,32,-42,13.633233877,12.164333257,-2.662382373,0.7344503098,1.4689006197,-1.927932063
05149,2014,253,235,-81,23,18,-58,11.627906977,10.800625057,-3.722768637,1.0570824524,0.8272819193,-2.665686184
05149,2015,272,273,-284,28,-1,-256,12.587056619,12.633332562,-13.14236794,1.2957264166,-0.046275943,-11.84664152
05149,2016,265,250,-40,30,15,-10,12.334760752,11.636566747,-1.86185068,1.3963880097,0.6981940048,-0.46546267
05149,2017,265,238,-21,32,27,11,12.323002162,11.067450999,-0.976539794,1.4880606385,1.2555511637,0.5115208445
27173,2010,24,33,-6,0,-9,-6,NA,NA,NA,NA,NA,NA
27173,2011,100,120,-120,-3,-20,-123,9.6599690881,11.591962906,-11.59196291,-0.289799073,-1.931993818,-11.88176198
27173,2012,135,142,-127,0,-7,-127,13.215859031,13.901125795,-12.43269701,0,-0.68526676500000006,-12.43269701
27173,2013,116,121,-71,2,-5,-69,11.471518987,11.965981013,-7.021360759,0.1977848101,-0.494462025,-6.823575949
27173,2014,105,107,-98,3,-2,-95,10.471726339,10.671187793,-9.77361125,0.2991921811,-0.199461454,-9.474419069
27173,2015,115,118,-146,3,-3,-143,11.607953972,11.910770163,-14.73705461,0.3028161906,-0.302816191,-14.43423842
27173,2016,123,106,36,4,17,40,12.470218482,10.746692351,3.6498200436,0.4055355604,1.7235261317,4.055355604
27173,2017,124,111,-42,4,13,-38,12.551242472,11.235386406,-4.251227289,0.4048787894,1.3158560656,-3.846348499
30111,2010,494,347,234,-1,147,233,NA,NA,NA,NA,NA,NA
30111,2011,1983,1368,732,4,615,736,13.306135048,9.1794214549,4.9117956908,0.0268404136,4.1267135927,4.9386361044
30111,2012,2014,1332,1196,22,682,1218,13.368380528,8.8414512725,7.9387205119,0.146029976,4.5269292551,8.0847504879
30111,2013,1978,1460,1498,-23,518,1475,12.961185247,9.5669011431,9.8159026797,-0.150711456,3.3942841042,9.6651912234
30111,2014,1976,1351,867,0,625,867,12.801699983,8.7525792899,5.6169402253,0,4.049120693,5.6169402253
30111,2015,2067,1433,605,3,634,608,13.274677285,9.2030055873,3.8854280393,0.0192665853,4.0716716974,3.9046946246
30111,2016,2003,1515,835,3,488,838,12.759099538,9.6505420866,5.3189456385,0.0191099843,3.108557451,5.3380556228
30111,2017,2004,1484,815,3,520,818,12.658387761,9.3737761664,5.1479970186,0.0189496823,3.2846115947,5.1669467009
48501,2010,38,21,-45,-4,17,-49,NA,NA,NA,NA,NA,NA
48501,2011,123,55,38,6,68,44,15.560756531,6.9580618635,4.8073881966,0.7590612942,8.6026946676,5.5664494908
48501,2012,133,71,-11,24,62,13,16.628117772,8.8766643746,-1.375257861,3.0005626055,7.7514533975,1.6253047446
48501,2013,156,57,25,47,99,72,19.208274334,7.0184079296,3.0782490919,5.7871082928,12.189866404,8.8653573847
48501,2014,165,62,11,62,103,73,19.893899204,7.4752833374,1.3262599469,7.4752833374,12.418615867,8.8015432843
48501,2015,177,67,65,67,110,132,20.817406645,7.8800352837,7.6448103499,7.8800352837,12.937371361,15.524845634
48501,2016,157,44,-182,70,113,-112,18.205009276,5.1020408163,-21.1038961,8.1168831169,13.10296846,-12.98701299
48501,2017,159,48,-241,72,111,-169,18.495899494,5.5836677718,-28.03466527,8.3755016577,12.912231722,-19.65916361
06113,2010,566,225,-306,206,341,-100,NA,NA,NA,NA,NA,NA
06113,2011,2425,1230,-1186,957,1195,-229,12.029277028,6.1014477297,-5.883184559,4.7472239653,5.9278292984,-1.135960594
06113,2012,2322,1174,694,977,1148,1671,11.411104449,5.7694386837,3.410554043,4.8013131124,5.6416657657,8.2118671555
06113,2013,2507,1289,-559,1113,1218,554,12.183505856,6.2642756476,-2.716625358,5.4089517422,5.9192302085,2.6923263837999998
06113,2014,2471,1162,-322,1251,1309,929,11.893445128,5.5929515334,-1.549854039,6.0213273393,6.3004935948,4.4714732999
06113,2015,2411,1270,1046,1374,1141,2420,11.445498587,6.0289436768,4.9655709338,6.5226524504,5.4165549097,11.488223384
06113,2016,2383,1333,1109,1368,1050,2477,11.125454321,6.2233447794,5.1775614106,6.3867484307,4.9021095411,11.564309841
06113,2017,2406,1340,726,1363,1066,2089,11.060162041,6.1598574958,3.3373556283,6.2655863932,4.9003045452,9.6029420215
23031,2010,487,392,1,0,95,1,NA,NA,NA,NA,NA,NA
23031,2011,1816,1788,975,7,28,982,9.1852631153,9.0436401157,4.9315151638,0.0354057499,0.1416229996,4.9669209137
23031,2012,1894,1673,508,7,221,515,9.5386784851,8.4256647865,2.5584206285,0.0352538276,1.1130136986,2.5936744561
23031,2013,1780,1760,398,45,20,443,8.9389065909,8.8384694382,1.9986993389,0.2259835936,0.1004371527,2.2246829325
23031,2014,1835,1820,1045,103,15,1148,9.1786944245,9.1036642249,5.2271039093,0.515207371,0.0750301997,5.7423112803
23031,2015,1873,2032,593,116,-159,709,9.3297568435,10.121765033,2.9538418624,0.5778172952,-0.792008189,3.5316591575
23031,2016,1908,2038,1214,125,-130,1339,9.463323422,10.108099127,6.0212131207,0.6199766393,-0.644775705,6.64118976
23031,2017,1911,1966,1897,124,-55,2021,9.4042035953,9.6748635628,9.3353083309,0.6102151993,-0.270659967,9.9455235302
31185,2010,49,19,-30,1,30,-29,NA,NA,NA,NA,NA,NA
31185,2011,163,147,99,5,16,104,11.874408101,10.70882203,7.2120638158,0.3642456473,1.1655860712,7.5763094631
31185,2012,169,146,25,6,23,31,12.233965542,10.568987983,1.8097582163000001,0.4343419719,1.664977559,2.2441001882
31185,2013,162,154,4,5,8,9,11.697173183,11.119535001,0.2888190909,0.3610238637,0.5776381819,0.6498429546
31185,2014,201,162,23,6,39,29,14.46980059,11.662227341,1.6557483263,0.431934346,2.8075732489,2.0876826722
31185,2015,176,160,-142,10,16,-132,12.692002596,11.538184178,-10.24013846,0.7211365111,1.1538184178,-9.519001947
31185,2016,164,161,-60,9,3,-51,11.896557978,11.678938015,-4.35239926,0.652859889,0.217619963,-3.699539371
31185,2017,161,144,20,9,17,29,11.68063264,10.447273914,1.4510102659,0.6529546197,1.233358726,2.1039648856
42133,2010,1256,952,100,81,304,181,NA,NA,NA,NA,NA,NA
42133,2011,5004,3740,-484,539,1264,55,11.475379761,8.5767226829,-1.109928818,1.2360570925,2.8986570779,0.1261282747
42133,2012,4838,3668,-894,553,1170,-341,11.06859532,8.3918163775,-2.045333654,1.2651784233,2.6767789427,-0.78015523
42133,2013,4758,3818,-54,606,940,552,10.857944179,8.712827002,-0.123230136,1.3829159673,2.145117177,1.2596858316
42133,2014,4936,3801,-203,669,1135,466,11.22621877,8.6448252726,-0.461694167,1.5215438325,2.5813934976,1.0598496651
42133,2015,4937,4128,-68,697,809,629,11.191636083,9.3577220475,-0.154148522,1.5800223515,1.833914035,1.4258738294
42133,2016,4881,4070,452,736,811,1188,11.022649388,9.1911868487,1.0207411439,1.6620917741,1.8314625391,2.682832918
42133,2017,4891,3988,666,732,903,1398,10.992406901,8.9629357435,1.4968192591,1.6451526992,2.0294711576,3.1419719582
45091,2010,743,426,465,22,317,487,NA,NA,NA,NA,NA,NA
45091,2011,2845,1786,2074,104,1059,2178,12.450711375,7.8161583538,9.076546711,0.4551402401,4.6345530216,9.531686951
45091,2012,2934,1839,2806,89,1095,2895,12.638788675,7.9218583413,12.087403211,0.3833852052,4.7169303337,12.470788417
45091,2013,2888,1891,3398,105,997,3503,12.215083598,7.998172813,14.372179385999999,0.4441079563,4.2169107851,14.816287342
45091,2014,2966,1911,4565,127,1055,4692,12.275372276,7.9090480172,18.893147147,0.5256143894,4.3663242586,19.418761537
45091,2015,2871,2077,5078,161,794,5239,11.595736517,8.3888348123,20.509630802,0.6502659628,3.2069017048,21.159896765
45091,2016,3024,2044,6210,163,980,6373,11.890578368,8.0371501933,24.418152006,0.6409273393,3.8534281749,25.059079345
45091,2017,3036,2052,7268,161,984,7429,11.578130452,7.8255348116,27.717342598,0.6139917664,3.7525956407,28.331334364
51199,2010,136,61,-116,66,75,-50,NA,NA,NA,NA,NA,NA
51199,2011,663,394,210,97,269,307,10.110097899,6.0081124767,3.2022934521,1.4791545945,4.1019854219,4.6814480466
51199,2012,589,400,-480,311,189,-169,8.9409728811,6.0719680007,-7.286361601,4.7209551206,2.8690048803,-2.56540648
51199,2013,622,381,-279,217,241,-62,9.4263133567,5.7739958021,-4.22820165,3.2886012836,3.6523175546,-0.939600367
51199,2014,648,413,66,218,235,284,9.7678625264,6.2255049744,0.9948748869,3.2861018993,3.542357552,4.2809767863
51199,2015,675,396,695,252,279,947,10.042998914,5.8918926961,10.340569252,3.7493862612,4.1511062177,14.089955513
51199,2016,662,473,-473,205,189,-268,9.7666767481,6.9783052898,-6.97830529,3.0244240685,2.7883714583,-3.953881221
51199,2017,645,520,-287,159,125,-128,9.5216303393,7.6763531418,-4.236756446,2.3471925953,1.8452771975,-1.88956385
48503,2010,61,92,3,1,-31,4,NA,NA,NA,NA,NA,NA
48503,2011,217,239,-149,-5,-22,-154,11.772045461,12.965524724,-8.083109556,-0.271245287,-1.193479263,-8.354354843
48503,2012,243,261,-50,0,-18,-50,13.270349234,14.253338066,-2.730524534,0,-0.982988832,-2.730524534
48503,2013,242,235,72,3,7,75,13.211409854,12.829261635,3.9306673946,0.1637778081,0.3821482189,4.0944452027
48503,2014,214,280,-34,9,-66,-25,11.686325907,15.290519878,-1.856705985,0.4914809961,-3.604193971,-1.3652249890000001
48503,2015,237,268,-101,13,-31,-88,13.017686477,14.720421839,-5.547621663,0.7140503131,-1.702735362,-4.83357135
48503,2016,214,249,-47,15,-35,-32,11.815044859,13.747412008,-2.59489303,0.8281573499,-1.93236715,-1.76673568
48503,2017,220,247,-88,15,-27,-73,12.202562538,13.700149759,-4.881025015,0.8319929003,-1.497587221,-4.049032115
06115,2010,283,98,-23,48,185,25,NA,NA,NA,NA,NA,NA
06115,2011,1252,555,-617,77,697,-540,17.285416465,7.6624649667,-8.518452044,1.0630807251,9.6229514987,-7.455371319
06115,2012,1219,535,-540,177,684,-363,16.774113648,7.3618956537,-7.430698417,2.4356178144,9.4122179947,-4.995080602
06115,2013,1231,591,-443,134,640,-309,16.864053264,8.0963895035,-6.068867259,1.8357295998,8.7676637601,-4.233137659
06115,2014,1199,589,-259,146,610,-113,16.33503859,8.0244684982,-3.528586318,1.9890872678,8.3105700915,-1.53949905
06115,2015,1196,601,-215,186,595,-29,16.179325365,8.1302462748,-2.908490764,2.5161827073,8.0490790907,-0.392308057
06115,2016,1131,547,248,151,584,399,15.141981176,7.3233100826,3.3202575877,2.0216084506,7.8186710937,5.3418660383
06115,2017,1152,512,1088,116,640,1204,15.136385137,6.7272822831,14.295474852,1.5241498923,8.4091028538,15.819624744
02290,2010,21,8,13,0,13,13,NA,NA,NA,NA,NA,NA
02290,2011,95,54,-27,2,41,-25,16.897901103,9.6051227321,-4.802561366,0.3557452864,7.2927783707,-4.44681608
02290,2012,87,60,-37,2,27,-35,15.459795646,10.661928032,-6.57485562,0.3553976011,4.7978676144,-6.219458019
02290,2013,92,63,-96,3,29,-93,16.450603487,11.26508717,-17.16584712,0.5364327224,5.1855163165,-16.62941439
02290,2014,85,61,-125,2,24,-123,15.420899855,11.066763425,-22.6777939,0.3628447025,4.3541364296,-22.3149492
02290,2015,86,53,-36,2,33,-34,15.742266154,9.7016291415,-6.589785832,0.3660992129,6.0406370126,-6.223686619
02290,2016,77,62,-68,2,15,-66,14.16091954,11.402298851,-12.50574713,0.367816092,2.7586206897,-12.13793103
02290,2017,65,76,-37,2,-11,-35,12.062726176,14.104110606,-6.8664749,0.3711608054,-2.04138443,-6.495314095
04027,2010,708,264,803,44,444,847,NA,NA,NA,NA,NA,NA
04027,2011,3254,1338,3184,249,1916,3433,16.282007981,6.6949375164,15.931749665,1.2459188652,9.5870704645,17.177668531
04027,2012,3236,1436,-2888,545,1800,-2343,15.99264615,7.0968602818,-14.27279422,2.6934462769,8.8957858685,-11.57934794
04027,2013,3074,1349,-2667,602,1725,-2065,15.221024225,6.679623188,-13.20574873,2.9808251736,8.5414010373,-10.22492356
04027,2014,3167,1382,-1284,721,1785,-563,15.645339373,6.8272368216,-6.343105701,3.561821815,8.8181025518,-2.781283886
04027,2015,3027,1432,-1981,899,1595,-1082,14.889435977,7.0438296397,-9.74429226,4.4220690266,7.8456063375,-5.322223233
04027,2016,3018,1512,-444,849,1506,405,14.757188506,7.3932634266,-2.171037673,4.1513760907,7.3639250796,1.9803384178
04027,2017,3014,1605,-113,779,1409,666,14.595747669,7.7724535529,-0.547219471,3.772424497,6.8232941159,3.2252050257
08125,2010,38,14,-22,5,24,-17,NA,NA,NA,NA,NA,NA
08125,2011,155,118,-12,21,37,9,15.384615385,11.712158809,-1.191066998,2.0843672457,3.6724565757,0.8933002481
08125,2012,156,113,-83,16,43,-67,15.46545058,11.20253792,-8.228412809,1.5862000595,4.2629126599,-6.642212749
08125,2013,140,92,-38,26,48,-12,13.86962552,9.1143253418,-3.764612641,2.5757875966,4.7553001783,-1.188825045
08125,2014,142,80,-41,43,62,2,13.999112732,7.8868240745,-4.041997338,4.2391679401,6.1122886578,0.1971706019
08125,2015,140,98,-204,48,42,-156,13.834675626,9.6842729384,-20.15909877,4.7433173576,4.1504026879,-15.41578141
08125,2016,142,100,-41,52,42,11,14.071945298,9.9098206322,-4.063026459,5.1531067288,4.1621246655,1.0900802695
08125,2017,154,97,-152,52,57,-100,15.25281038,9.6072896548,-15.05472193,5.1502996088,5.645520725,-9.904422325
48505,2010,91,11,-13,2,80,-11,NA,NA,NA,NA,NA,NA
48505,2011,316,78,-79,-21,238,-100,22.324267043,5.5104203462,-5.581066761,-1.483574709,16.813846697,-7.064641469
48505,2012,275,83,-156,7,192,-149,19.303664186,5.8261968272,-10.95044223,0.4913659975,13.477467359,-10.45907623
48505,2013,289,88,-87,11,201,-76,20.166073547,6.1405345056,-6.070755704,0.7675668132,14.025539041,-5.303188891
48505,2014,289,89,-212,14,200,-198,20.077112786,6.1829170864,-14.72784744,0.972593699,13.8941957,-13.75525374
48505,2015,300,82,-120,21,218,-99,20.752628666,5.6723851688,-8.301051467,1.4526840066,15.080243498,-6.84836746
48505,2016,255,108,-244,30,147,-214,17.607457276,7.4572760228,-16.8479199,2.0714655619,10.150181253,-14.77645434
48505,2017,264,109,-308,26,155,-282,18.351812589,7.5770741372,-21.41044802,1.8073754823,10.774738452,-19.60307254
48507,2010,37,9,12,6,28,18,NA,NA,NA,NA,NA,NA
48507,2011,205,72,-11,21,133,10,17.381719518,6.1047990504,-0.932677633,1.7805663897,11.276920468,0.847888757
48507,2012,201,92,2,26,109,28,16.843340177,7.7093895337,0.1675954246,2.1787405204,9.1339506431,2.346335945
48507,2013,211,86,40,21,125,61,17.445946505,7.1106701393,3.3072884369,1.7363264294,10.335276365,5.0436148663000004
48507,2014,203,93,-96,36,110,-60,16.623674405,7.6157720182,-7.861442083,2.9480407812,9.0079023871,-4.913401302
48507,2015,206,107,-76,37,99,-39,16.794391,8.7233001794,-6.195988912,3.0164682863,8.0710908202,-3.179520626
48507,2016,176,113,-307,40,63,-267,14.433919711,9.2672325419,-25.17734859,3.280436298,5.1666871694,-21.89691229
48507,2017,181,99,-264,40,82,-224,15.058862681,8.2366154998,-21.964308,3.3279254545,6.8222471817,-18.63638255
46137,2010,15,2,10,0,13,10,NA,NA,NA,NA,NA,NA
46137,2011,45,15,-17,2,30,-15,15.889830508,5.2966101695,-6.002824859,0.7062146893,10.593220339,-5.296610169
46137,2012,42,7,4,0,35,4,14.690451207,2.4484085345,1.3990905911,0,12.242042672,1.3990905911
46137,2013,34,16,-45,1,18,-44,11.861154718,5.5817198674,-15.69858713,0.3488574917,6.2794348509,-15.34972964
46137,2014,40,10,-26,1,30,-25,14.000700035,3.5001750088,-9.100455023,0.3500175009,10.500525026,-8.750437522
46137,2015,33,17,-38,1,16,-37,11.580979119,5.9659589402,-13.33567293,0.3509387612,5.615020179,-12.98473416
46137,2016,29,15,20,1,14,21,10.152284264,5.2511815158,7.0015753545,0.3500787677,4.9011027481,7.3516541222
46137,2017,29,25,-124,1,4,-123,10.301953819,8.8809946714,-44.04973357,0.3552397869,1.4209591474,-43.69449378
